N_in_packets,N_out_packets,in_first_thirty,out_first_thirty,out_fraction,in_fraction,out_std,in_std,out_mean,in_mean,N_packets,time_fraction,sum_N,incoming_packets_size,outgoing_packets_size,total_packets_size,y
1300,121,21,9,0.0851513019,0.914848698,398.4863354,515.4839532,705.1061538,774.322314,1421,140.1380671,2842,-665600,61952,-603648,0
438,80,22,8,0.154440154,0.845559846,150.5911461,139.2319507,265.4063927,227.1625,518,50.98425197,1036,-224256,40960,-183296,0
1240,118,23,7,0.086892489,0.913107511,381.8786418,472.7355082,669.2596774,787.1101695,1358,122.2322232,2716,-634880,60416,-574464,0
1324,122,21,9,0.0843706777,0.915629322,406.2052885,513.9160376,714.5030211,821.1393443,1446,108.2335329,2892,-677888,62464,-615424,0
1291,115,22,8,0.0817923186,0.918207681,395.0288894,503.9934902,695.7405112,790.6086957,1406,132.1428571,2812,-660992,58880,-602112,0
491,68,22,8,0.121645796,0.878354204,160.9670509,161.2141721,284.0753564,250.5735294,559,52.04841713,1118,-251392,34816,-216576,0
1261,115,23,7,0.0835755814,0.916424419,386.9542191,481.7139607,678.1784298,801.6782609,1376,86.86868687,2752,-645632,58880,-586752,0
1277,126,22,8,0.0898075552,0.910192445,394.346698,488.0052272,691.5677369,807.7301587,1403,158.5310734,2806,-653824,64512,-589312,0
494,70,22,8,0.124113475,0.875886525,161.5978177,169.4687473,285.6639676,260.1714286,564,47.71573604,1128,-252928,35840,-217088,0
490,74,22,8,0.131205674,0.868794326,162.4325979,163.4145004,286.0102041,259.2567568,564,45.66801619,1128,-250880,37888,-212992,0
1306,117,22,8,0.0822206606,0.917779339,399.775986,508.2418494,703.4012251,807.982906,1423,111.6078431,2846,-668672,59904,-608768,0
500,67,22,8,0.118165785,0.881834215,162.4912322,169.9711178,287.538,257.5970149,567,46.28571429,1134,-256000,34304,-221696,0
492,71,22,8,0.126110124,0.873889876,162.1446144,162.4521403,285.9939024,254.3239437,563,39.50877193,1126,-251904,36352,-215552,0
1327,116,22,8,0.0803880804,0.91961192,405.6371624,516.8925188,714.0203466,813.2844828,1443,135.2389878,2886,-679424,59392,-620032,0
1316,136,22,8,0.0936639118,0.906336088,406.6674515,500.9794065,711.0972644,875.5441176,1452,132.967033,2904,-673792,69632,-604160,0
482,70,22,8,0.126811594,0.873188406,159.3120275,157.5730482,279.939834,252.8142857,552,47.01873935,1104,-246784,35840,-210944,0
492,72,23,7,0.127659574,0.872340426,162.5187859,163.3988666,285.4369919,262.4305556,564,53.91969407,1128,-251904,36864,-215040,0
1302,115,23,7,0.0811573747,0.918842625,397.4590106,512.7628993,700.4239631,806.0956522,1417,133.0516432,2834,-666624,58880,-607744,0
492,68,22,8,0.121428571,0.878571429,161.4257985,159.7221386,284.9207317,248.5147059,560,24.22145329,1120,-251904,34816,-217088,0
1079,99,22,8,0.084040747,0.915959253,329.2394315,435.4768854,583.3364226,656.6767677,1178,40.94542927,2356,-552448,50688,-501760,0
517,112,21,9,0.178060413,0.821939587,182.5283387,171.2504422,323.8781431,274.0178571,629,15.88785047,1258,-264704,57344,-207360,0
3468,1604,20,10,0.316246057,0.683753943,1184.912527,1241.757034,1969.078431,3763.319202,5072,97.05319556,10144,-1775616,821248,-954368,0
3444,1577,21,9,0.31408086,0.68591914,1194.294926,1209.74869,1960.071138,3714.169943,5021,254.6146045,10042,-1763328,807424,-955904,0
3576,1645,21,9,0.315073741,0.684926259,1233.00642,1286.388012,2039.950224,3852.382371,5221,282.9810298,10442,-1830912,842240,-988672,0
873,163,21,9,0.157335907,0.842664093,294.0417853,313.0285868,533.2623139,439.4355828,1036,105.8222676,2072,-446976,83456,-363520,0
860,159,21,9,0.156035329,0.843964671,287.9839773,316.1703266,523.1697674,438.7672956,1019,93.31501832,2038,-440320,81408,-358912,0
3548,1635,21,9,0.31545437,0.68454563,1229.130445,1280.445778,2029.243236,3813.199388,5183,260.8454957,10366,-1816576,837120,-979456,0
882,146,20,10,0.142023346,0.857976654,291.9540349,311.2539388,528.4444444,430.260274,1028,103.006012,2056,-451584,74752,-376832,0
3440,1455,21,9,0.297242084,0.702757916,1172.138142,1261.030984,1961.94593,3597.158763,4895,213.7554585,9790,-1761280,744960,-1016320,0
3471,1479,21,9,0.298787879,0.701212121,1217.689917,1167.129743,1971.925382,3657.317106,4950,251.6522623,9900,-1777152,757248,-1019904,0
3524,1527,21,9,0.302316373,0.697683627,1203.851265,1219.056897,1988.936152,3765.43222,5051,255.4881133,10102,-1804288,781824,-1022464,0
3471,1490,20,10,0.300342673,0.699657327,1197.73443,1234.218024,1977.849899,3653.103356,4961,310.6449593,9922,-1777152,762880,-1014272,0
666,121,21,9,0.153748412,0.846251588,227.5489637,213.3381998,406.0465465,327.6942149,787,34.74613687,1574,-340992,61952,-279040,0
864,152,22,8,0.149606299,0.850393701,287.4577948,316.2581516,520.2743056,441.5723684,1016,50.22244192,2032,-442368,77824,-364544,0
3570,1543,22,8,0.301779777,0.698220223,1200.814631,1260.657885,2010.046218,3822.473104,5113,122.3205742,10226,-1827840,790016,-1037824,0
3625,1476,21,9,0.289355028,0.710644972,1274.991261,1276.132181,2081.26731,3704.645664,5101,90.26720934,10202,-1856000,755712,-1100288,0
3468,1480,20,10,0.299110752,0.700889248,1220.869932,1214.750833,1988.194925,3614.031081,4948,276.1160714,9896,-1775616,757760,-1017856,0
866,168,20,10,0.162475822,0.837524178,294.023407,311.7766007,530.7066975,449.422619,1034,103.7111334,2068,-443392,86016,-357376,0
3522,1570,21,9,0.308326787,0.691673213,1202.837698,1265.811784,2001.649631,3768.769427,5092,249.6078431,10184,-1803264,803840,-999424,0
3457,1571,20,10,0.312450278,0.687549722,1216.661745,1232.914819,1986.259184,3676.898791,5028,89.94633274,10056,-1769984,804352,-965632,0
4241,434,22,8,0.0928342246,0.907165775,1358.214524,1260.54254,2332.455789,2392.177419,4675,591.0240202,9350,-2171392,222208,-1949184,0
5124,446,22,8,0.0800718133,0.919928187,1616.07092,1495.50004,2803.598361,2577.571749,5570,313.9797069,11140,-2623488,228352,-2395136,0
4249,447,22,8,0.0951873935,0.904812606,1355.855323,1340.296171,2329.725112,2526.966443,4696,363.1863882,9392,-2175488,228864,-1946624,0
4286,429,22,8,0.0909862142,0.909013786,1370.76159,1259.418367,2352.896407,2408.988345,4715,661.2903226,9430,-2194432,219648,-1974784,0
4344,436,23,7,0.0912133891,0.908786611,1390.55961,1267.78559,2386.658149,2428.777523,4780,541.9501134,9560,-2224128,223232,-2000896,0
5260,463,22,8,0.080901625,0.919098375,1659.96649,1549.813211,2876.862357,2693.153348,5723,322.786238,11446,-2693120,237056,-2456064,0
4242,430,22,8,0.0920376712,0.907962329,1357.866804,1254.320174,2334.08298,2360.344186,4672,621.2765957,9344,-2171904,220160,-1951744,0
4296,405,22,8,0.0861518826,0.913848117,1357.160559,1336.243519,2330.208333,2571.545679,4701,398.7277354,9402,-2199552,207360,-1992192,0
4322,421,23,7,0.0887623867,0.911237613,1376.403233,1290.046535,2364.205229,2452.021378,4743,281.1499704,9486,-2212864,215552,-1997312,0
4337,429,21,9,0.0900125892,0.909987411,1385.139668,1277.670469,2381.431404,2404.412587,4766,559.3896714,9532,-2220544,219648,-2000896,0
4264,422,21,9,0.0900554844,0.909944516,1362.515287,1249.461223,2341.83818,2360.291469,4686,577.8051788,9372,-2183168,216064,-1967104,0
5096,449,22,8,0.0809738503,0.91902615,1608.286964,1499.740949,2789.211146,2589.008909,5545,627.2624434,11090,-2609152,229888,-2379264,0
4359,427,22,8,0.0892185541,0.910781446,1388.11671,1309.283855,2384.006653,2490.412178,4786,508.607864,9572,-2231808,218624,-2013184,0
4320,413,22,8,0.0872596662,0.912740334,1372.716954,1297.209283,2365.855324,2378.973366,4733,263.2369299,9466,-2211840,211456,-2000384,0
3879,417,23,7,0.0970670391,0.902932961,1229.066586,1298.046949,2114.995102,2460.167866,4296,82.2043628,8592,-1986048,213504,-1772544,0
4583,447,22,8,0.0888667992,0.911133201,1447.785153,1486.688757,2500.914248,2665.044743,5030,479.047619,10060,-2346496,228864,-2117632,0
4794,489,22,8,0.0925610449,0.907438955,1523.381993,1529.804957,2623.562161,2822.758691,5283,101.6352443,10566,-2454528,250368,-2204160,0
4518,460,21,9,0.092406589,0.907593411,1435.321731,1446.886051,2475.918105,2622.897826,4978,436.2839614,9956,-2313216,235520,-2077696,0
4241,409,22,8,0.0879569892,0.912043011,1350.474987,1253.795231,2320.708559,2375.183374,4650,345.7249071,9300,-2171392,209408,-1961984,0
1177,91,22,8,0.0717665615,0.928233438,363.7873383,378.2296772,626.2752761,740.8791209,1268,20.00315507,2536,-602624,46592,-556032,0
2077,153,22,8,0.0686098655,0.931390135,626.5146642,744.1356059,1143.740491,732.130719,2230,227.3190622,4460,-1063424,78336,-985088,0
2083,145,22,8,0.0650807899,0.93491921,629.5255891,736.993712,1137.80941,779.6482759,2228,198.9285714,4456,-1066496,74240,-992256,0
2077,150,22,8,0.0673551863,0.932644814,626.8288794,745.0567115,1140.130958,752.1733333,2227,197.2542073,4454,-1063424,76800,-986624,0
2081,138,22,8,0.0621901758,0.937809824,625.9047774,754.2281322,1132.389236,772.3768116,2219,187.4155405,4438,-1065472,70656,-994816,0
2076,157,21,9,0.0703090013,0.929690999,627.6140962,722.8533901,1147.846339,709.1210191,2233,126.4439411,4466,-1062912,80384,-982528,0
2115,146,22,8,0.0645731977,0.935426802,638.8010978,747.6505691,1154.789125,786.3835616,2261,227.693857,4522,-1082880,74752,-1008128,0
2096,149,22,8,0.0663697105,0.93363029,631.1331251,750.0658553,1150.670324,733.7583893,2245,203.1674208,4490,-1073152,76288,-996864,0
1009,119,21,9,0.105496454,0.894503546,311.9952103,309.5064619,596.814668,290.5042017,1128,19.76520063,2256,-516608,60928,-455680,0
2148,156,23,7,0.0677083333,0.932291667,653.9682257,761.9937923,1170.247207,908.1346154,2304,177.6407093,4608,-1099776,79872,-1019904,0
2100,153,21,9,0.0679094541,0.932090546,635.5116451,747.1498416,1152.094286,782.5686275,2253,206.8870523,4506,-1075200,78336,-996864,0
2031,137,22,8,0.0631918819,0.936808118,611.3053621,728.7476891,1107.796652,739.1313869,2168,185.1409052,4336,-1039872,70144,-969728,0
2205,198,22,8,0.0823970037,0.917602996,678.990879,816.9851708,1218.851247,1014.338384,2403,218.852459,4806,-1128960,101376,-1027584,0
2122,194,22,8,0.0837651123,0.916234888,656.780056,769.3320774,1172.625825,1003.989691,2316,164.2553191,4632,-1086464,99328,-987136,0
2101,156,22,8,0.0691182986,0.930881701,635.9588689,745.2569015,1155.734412,768.9423077,2257,201.1586453,4514,-1075712,79872,-995840,0
2081,148,22,8,0.0663974877,0.933602512,627.7304957,755.4926741,1139.233061,774.2635135,2229,211.6809117,4458,-1065472,75776,-989696,0
2177,189,22,8,0.0798816568,0.920118343,666.8935368,838.9262541,1193.074414,1073.216931,2366,179.9239544,4732,-1114624,96768,-1017856,0
2074,142,22,8,0.0640794224,0.935920578,625.9467505,739.6001459,1131.110415,778.2605634,2216,175.0394945,4432,-1061888,72704,-989184,0
2095,147,22,8,0.0655664585,0.934433541,633.0119664,737.6924216,1146.304057,768,2242,246.1031833,4484,-1072640,75264,-997376,0
2089,153,22,8,0.0682426405,0.93175736,628.8842876,728.5756081,1153.692197,681.9607843,2242,177.6545166,4484,-1069568,78336,-991232,0
2060,141,23,7,0.0640617901,0.93593821,622.2503332,715.1318126,1125.186893,747.6312057,2201,189.7413793,4402,-1054720,72192,-982528,0
5331,429,22,8,0.0744791667,0.925520833,1663.125608,1645.532605,2896.417558,2682.699301,5760,681.6568047,11520,-2729472,219648,-2509824,0
5238,419,21,9,0.074067527,0.925932473,1630.985637,1650.429367,2841.534555,2672.303103,5657,364.4974227,11314,-2681856,214528,-2467328,0
5209,454,21,9,0.0801695215,0.919830479,1629.519915,1688.961083,2842.705894,2709.165198,5663,583.814433,11326,-2667008,232448,-2434560,0
4999,406,22,8,0.0751156337,0.924884366,1561.836752,1538.145574,2710.456691,2611.187192,5405,413.5424637,10810,-2559488,207872,-2351616,0
5265,384,23,7,0.067976633,0.932023367,1622.728628,1735.996853,2828.390883,2778.507813,5649,484.0616967,11298,-2695680,196608,-2499072,0
6726,542,22,8,0.0745734728,0.925426527,2088.193163,2196.73178,3657.825751,3345.0369,7268,521.0035842,14536,-3443712,277504,-3166208,0
5162,409,23,7,0.0734159038,0.926584096,1602.516632,1678.181581,2788.045331,2760.185819,5571,537.7413127,11142,-2642944,209408,-2433536,0
5392,411,23,7,0.0708254351,0.929174565,1675.685782,1664.719188,2910.308791,2792.995134,5803,517.201426,11606,-2760704,210432,-2550272,0
3673,311,23,7,0.078062249,0.921937751,1135.78026,1296.624962,1979.007351,2151.85209,3984,320,7968,-1880576,159232,-1721344,0
3341,277,22,8,0.0765616363,0.923438364,1033.256093,1164.740717,1800.027537,1923.750903,3618,368.0569685,7236,-1710592,141824,-1568768,0
6971,551,21,9,0.0732517947,0.926748205,2160.307511,2300.348036,3775.138574,3588.950998,7522,501.1325783,15044,-3569152,282112,-3287040,0
5146,427,22,8,0.076619415,0.923380585,1610.535919,1583.369925,2796.181695,2676.346604,5573,318.2752713,11146,-2634752,218624,-2416128,0
6890,542,23,7,0.0729278794,0.927072121,2133.207237,2270.917266,3741.714369,3395.97048,7432,516.8289291,14864,-3527680,277504,-3250176,0
5217,423,22,8,0.075,0.925,1619.962501,1723.819865,2826.71037,2743.905437,5640,235.5889724,11280,-2671104,216576,-2454528,0
6980,560,22,8,0.074270557,0.925729443,2168.354448,2263.608045,3789.539112,3533.191071,7540,212.5740062,15080,-3573760,286720,-3287040,0
7191,550,22,8,0.0710502519,0.928949748,2226.006089,2332.676329,3888.352524,3644.123636,7741,400.2585315,15482,-3681792,281600,-3400192,0
6926,531,22,8,0.0712082607,0.928791739,2143.04964,2261.223974,3746.902397,3495.493409,7457,260.0976631,14914,-3546112,271872,-3274240,0
5120,403,22,8,0.0729675901,0.92703241,1593.835646,1600.766835,2763.609766,2741.548387,5523,479.8436142,11046,-2621440,206336,-2415104,0
5171,452,22,8,0.0803841366,0.919615863,1617.095202,1691.19777,2815.506865,2771.880531,5623,611.8607182,11246,-2647552,231424,-2416128,0
7330,562,22,8,0.0712113533,0.928788647,2263.141448,2429.772544,3977.839154,3537.752669,7892,364.1901246,15784,-3752960,287744,-3465216,0
9405,495,21,9,0.05,0.95,2825.459398,3228.772894,5007.712174,3863.468687,9900,722.6277372,19800,-4815360,253440,-4561920,0
9316,494,22,8,0.0503567788,0.949643221,2798.500894,3205.023077,4964.285208,3796.910931,9810,680.3051318,19620,-4769792,252928,-4516864,0
9348,492,22,8,0.05,0.95,2809.119297,3181.052416,4979.550171,3798.546748,9840,414.3157895,19680,-4786176,251904,-4534272,0
9315,483,22,8,0.0492957746,0.950704225,2798.741283,3180.893572,4952.643264,3874.594203,9798,780.0955414,19596,-4769280,247296,-4521984,0
9317,458,22,8,0.0468542199,0.95314578,2796.857006,3154.73009,4932.535151,3982.030568,9775,481.0531496,19550,-4770304,234496,-4535808,0
9311,502,22,8,0.051156629,0.948843371,2800.225606,3155.28842,4970.649662,3726.438247,9813,880.0896861,19626,-4767232,257024,-4510208,0
4016,371,22,8,0.0845680419,0.915431958,1248.352518,1154.059502,2271.243775,1357.851752,4387,77.16798593,8774,-2056192,189952,-1866240,0
9020,465,23,7,0.049024776,0.950975224,2718.881904,2891.107614,4797.405211,3687.655914,9485,174.9677181,18970,-4618240,238080,-4380160,0
9272,483,22,8,0.0495130702,0.95048693,2785.085929,3160.815533,4935.143119,3781.041408,9755,718.3357879,19510,-4747264,247296,-4499968,0
9416,488,24,6,0.049273021,0.950726979,2826.652608,3233.164522,5009.530905,3852.084016,9904,550.8342603,19808,-4820992,249856,-4571136,0
9269,500,22,8,0.0511823114,0.948817689,2783.218242,3122.24459,4959.901931,3496.468,9769,675.1209399,19538,-4745728,256000,-4489728,0
9382,482,22,8,0.048864558,0.951135442,2811.374228,3255.669352,4993.599872,3743.207469,9864,854.025974,19728,-4803584,246784,-4556800,0
2407,214,23,7,0.0816482259,0.918351774,746.8597674,681.6270666,1355.505609,810.4158879,2621,49.62135555,5242,-1232384,109568,-1122816,0
9301,484,21,9,0.0494634645,0.950536536,2796.584683,3265.665689,4923.010644,4316.28719,9785,177.3930384,19570,-4762112,247808,-4514304,0
9302,469,22,8,0.0479991813,0.952000819,2795.686554,3163.462093,4927.994195,4053.100213,9771,773.6342043,19542,-4762624,240128,-4522496,0
9321,488,23,7,0.0497502294,0.950249771,2797.611229,3233.678002,4961.311018,3829.436475,9809,837.6601196,19618,-4772352,249856,-4522496,0
9294,483,22,8,0.0494016569,0.950598343,2788.398875,3165.678355,4953.345277,3650.853002,9777,588.267148,19554,-4758528,247296,-4511232,0
9302,465,22,8,0.0476092966,0.952390703,2792.119078,3174.169822,4931.467641,3934.443011,9767,718.6902134,19534,-4762624,238080,-4524544,0
9356,485,22,8,0.0492836094,0.950716391,2812.054123,3202.610947,4970.370992,3968.597938,9841,829.7639123,19682,-4790272,248320,-4541952,0
9308,480,22,8,0.0490396404,0.95096036,2795.830958,3184.667061,4946.797164,3880.370833,9788,770.7086614,19576,-4765696,245760,-4519936,0
2146,353,22,8,0.141256503,0.858743497,728.2244525,674.6795314,1239.141659,1316.011331,2499,73.52162401,4998,-1098752,180736,-918016,0
1492,283,22,8,0.15943662,0.84056338,518.1033574,452.4624853,859.5127346,1038.187279,1775,46.97009791,3550,-763904,144896,-619008,0
2378,370,23,7,0.134643377,0.865356623,783.7787453,728.5081548,1310.607233,1785.140541,2748,48.26132771,5496,-1217536,189440,-1028096,0
654,101,22,8,0.133774834,0.866225166,213.0447208,242.7740151,371.1804281,422.1584158,755,33.79588183,1510,-334848,51712,-283136,0
1667,286,22,8,0.146441372,0.853558628,561.2988701,562.5478792,955.9256149,1099.835664,1953,55.95988539,3906,-853504,146432,-707072,0
1783,375,22,8,0.173772011,0.826227989,621.6089042,617.3693415,1056.136287,1190.586667,2158,60.29617212,4316,-912896,192000,-720896,0
1576,341,23,7,0.177882107,0.822117893,559.9591792,517.4626306,945.590736,1020.973607,1917,49.45820433,3834,-806912,174592,-632320,0
1629,349,21,9,0.176440849,0.823559151,580.058174,510.4635272,964.3020258,1107.114613,1978,59.72222222,3956,-834048,178688,-655360,0
2029,338,22,8,0.142796789,0.857203211,692.1317383,624.3786991,1174.158206,1243.079882,2367,70.82585278,4734,-1038848,173056,-865792,0
1742,363,22,8,0.172446556,0.827553444,609.9730596,576.0251053,1023.671068,1193.746556,2105,37.22369584,4210,-891904,185856,-706048,0
1551,335,22,8,0.177624602,0.822375398,548.8407194,511.2503457,921.3655706,1045.979104,1886,51.54413774,3772,-794112,171520,-622592,0
1553,309,22,8,0.165950591,0.834049409,533.2933288,529.0556868,899.1320026,1094.177994,1862,57.06405149,3724,-795136,158208,-636928,0
1724,325,21,9,0.158613958,0.841386042,597.0724296,537.5344055,997.2465197,1172.221538,2049,59.75503062,4098,-882688,166400,-716288,0
1571,317,21,9,0.167902542,0.832097458,549.2138481,494.5839647,912.7886696,1101.656151,1888,55.82495565,3776,-804352,162304,-642048,0
2071,376,22,8,0.15365754,0.84634246,715.8773314,649.0200617,1214.233221,1277.795213,2447,72.76241451,4894,-1060352,192512,-867840,0
1762,336,23,7,0.160152526,0.839847474,606.6277355,566.5608576,1014.753689,1231.71131,2098,62.49627644,4196,-902144,172032,-730112,0
1750,345,23,7,0.164677804,0.835322196,603.5857242,590.2440768,1019.711429,1191.492754,2095,62.79976019,4190,-896000,176640,-719360,0
1571,306,22,8,0.163026105,0.836973895,547.3843786,482.5295605,908.2527053,1096.856209,1877,55.38506934,3754,-804352,156672,-647680,0
637,54,22,8,0.0781476122,0.921852388,194.1058003,245.6902597,340.6310832,409.3333333,691,10.95260739,1382,-326144,27648,-298496,0
633,63,22,8,0.0905172414,0.909482759,193.2447722,248.4578923,339.4834123,439.0952381,696,9.787652932,1392,-324096,32256,-291840,0
9444,518,23,7,0.0519975908,0.948002409,2872.982147,2807.199405,5025.641042,4176.735521,9962,634.522293,19924,-4835328,265216,-4570112,0
9417,544,22,8,0.0546129907,0.945387009,2866.704552,3002.248456,5001.138261,4632.393382,9961,966.1493695,19922,-4821504,278528,-4542976,0
9439,525,22,8,0.0526896829,0.947310317,2871.430856,2835.164385,5029.212099,4142.660952,9964,1038.998957,19928,-4832768,268800,-4563968,0
9433,529,22,8,0.0531017868,0.946898213,2877.405399,2783.108862,5014.144281,4399.395085,9962,837.8469302,19924,-4829696,270848,-4558848,0
9418,544,21,9,0.0546075085,0.945392491,2873.36,2745.764681,5036.868656,4022.930147,9962,539.9457995,19924,-4822016,278528,-4543488,0
9436,527,22,8,0.0528957141,0.947104286,2871.102004,2876.848574,5020.69309,4289.195446,9963,1130.874007,19926,-4831232,269824,-4561408,0
9442,522,23,7,0.052388599,0.947611401,2870.27488,2907.284053,5018.744334,4326.908046,9964,694.3554007,19928,-4834304,267264,-4567040,0
9449,514,23,7,0.0515908863,0.948409114,2873.01417,2879.705034,5011.116203,4446.749027,9963,1079.414951,19926,-4837888,263168,-4574720,0
9417,546,22,8,0.0548027702,0.94519723,2873.285867,2830.355937,5023.306573,4269.575092,9963,764.6201074,19926,-4821504,279552,-4541952,0
9389,552,21,9,0.0555276129,0.944472387,2860.635827,2914.494403,5016.220258,4201.846014,9941,624.8271527,19882,-4807168,282624,-4524544,0
9435,528,22,8,0.0529960855,0.947003914,2865.716158,3035.768242,5000.72708,4647.359848,9963,931.1214953,19926,-4830720,270336,-4560384,0
9435,528,22,8,0.0529960855,0.947003914,2871.501037,2889.974289,5015.971171,4374.958333,9963,1393.426573,19926,-4830720,270336,-4560384,0
9436,527,21,9,0.0528957141,0.947104286,2865.777821,3036.622084,4999.933658,4660.895636,9963,1283.891753,19926,-4831232,269824,-4561408,0
9449,515,21,9,0.0516860699,0.94831393,2870.784356,2892.467308,5019.838501,4297.429126,9964,958.0769231,19928,-4837888,263680,-4574208,0
9428,535,22,8,0.0536986851,0.946301315,2866.442877,3014.262806,5004.099279,4592.557009,9963,1668.844221,19926,-4827136,273920,-4553216,0
9441,523,22,8,0.0524889603,0.94751104,2872.504151,2859.920451,5020.413092,4298.107075,9964,1025.102881,19928,-4833792,267776,-4566016,0
9406,556,22,8,0.0558120859,0.944187914,2862.460262,3078.116374,4998.587285,4692.429856,9962,1053.065539,19924,-4815872,284672,-4531200,0
9447,515,22,8,0.0516964465,0.948303554,2871.466364,2882.731164,5015.695776,4354.223301,9962,1303.926702,19924,-4836864,263680,-4573184,0
9418,549,24,6,0.0550817698,0.94491823,2866.513747,2983.704815,5021.215439,4345.575592,9967,183.7912595,19934,-4822016,281088,-4540928,0
5253,303,22,8,0.0545356371,0.945464363,1602.491193,1552.884451,2805.869027,2304.013201,5556,85.09725839,11112,-2689536,155136,-2534400,0
1629,176,22,8,0.0975069252,0.902493075,512.0555048,549.8160319,878.8649478,1126.386364,1805,138.8461538,3610,-834048,90112,-743936,0
1672,171,22,8,0.0927835052,0.907216495,521.9715892,568.3062046,897.409689,1162.438596,1843,127.4550484,3686,-856064,87552,-768512,0
1726,176,23,7,0.0925341746,0.907465825,540.2980538,575.9296644,927.0457706,1191.318182,1902,163.6833046,3804,-883712,90112,-793600,0
1665,177,21,9,0.0960912052,0.903908795,523.808551,562.3290593,899.9927928,1123.813559,1842,115.6308851,3684,-852480,90624,-761856,0
1705,185,22,8,0.0978835979,0.902116402,537.6936203,569.7360359,922.0058651,1162.027027,1890,116.8108776,3780,-872960,94720,-778240,0
1767,181,23,7,0.0929158111,0.907084189,553.1620054,598.2494395,950.9518959,1204.38674,1948,118.9255189,3896,-904704,92672,-812032,0
1629,181,23,7,0.1,0.9,512.2732224,551.4590834,878.7998772,1145.801105,1810,137.3292868,3620,-834048,92672,-741376,0
1613,182,22,8,0.101392758,0.898607242,507.8347887,548.0997186,871.3490391,1134.197802,1795,151.7328825,3590,-825856,93184,-732672,0
1660,189,23,7,0.102217415,0.897782585,524.369549,555.4770293,897.789759,1163.989418,1849,32.24062772,3698,-849920,96768,-753152,0
1662,175,22,8,0.0952640174,0.904735983,521.7217533,559.3208355,895.7172082,1140.12,1837,112.1489621,3674,-850944,89600,-761344,0
1592,171,23,7,0.0969937606,0.903006239,500.4406136,540.720359,860.0012563,1086.807018,1763,105.5688623,3526,-815104,87552,-727552,0
1639,180,22,8,0.09895547,0.90104453,517.1306028,549.3502574,886.7888957,1121.35,1819,136.8698269,3638,-839168,92160,-747008,0
1742,185,22,8,0.0960041515,0.903995848,547.7029751,586.6907258,940.456372,1185.691892,1927,170.6820195,3854,-891904,94720,-797184,0
1607,175,22,8,0.0982042649,0.901795735,505.7893224,544.0796288,868.5034225,1102.674286,1782,129.2240754,3564,-822784,89600,-733184,0
1654,181,22,8,0.0986376022,0.901362398,520.4855512,555.0127219,892.3035067,1152.81768,1835,148.4627832,3670,-846848,92672,-754176,0
1636,180,21,9,0.0991189427,0.900881057,515.1572491,559.0105186,885.6026895,1116.611111,1816,104.3678161,3632,-837632,92160,-745472,0
1630,176,23,7,0.0974529347,0.902547065,514.0761506,542.3790683,881.1779141,1110.232955,1806,111.0018439,3612,-834560,90112,-744448,0
1646,175,21,9,0.0961010434,0.903898957,512.6427628,583.0442641,885.4896719,1150.942857,1821,98.91363389,3642,-842752,89600,-753152,0
1663,186,21,9,0.100594916,0.899405084,525.6455221,558.5713822,901.3385448,1136.553763,1849,97.83068783,3698,-851456,95232,-756224,0
1168,67,22,8,0.0542510121,0.945748988,348.2411662,475.6176784,620.8030822,569.1343284,1235,19.07041384,2470,-598016,34304,-563712,0
9374,584,22,8,0.0586463145,0.941353685,2876.692327,2820.413852,5000.270749,4646.101027,9958,1398.595506,19916,-4799488,299008,-4500480,0
9289,661,22,8,0.0664321608,0.933567839,2877.979376,2765.488833,5001.659274,4607.885023,9950,882.0921986,19900,-4755968,338432,-4417536,0
9398,555,21,9,0.0557620818,0.944237918,2863.681663,2994.981389,5003.192275,4533.477477,9953,1014.576962,19906,-4811776,284160,-4527616,0
9318,633,21,9,0.0636116973,0.936388303,2881.306235,2709.777436,5003.2698,4574.578199,9951,1100.774336,19902,-4770816,324096,-4446720,0
9369,584,22,8,0.0586757761,0.941324224,2881.099796,2693.32876,5008.446899,4472.503425,9953,688.3125864,19906,-4796928,299008,-4497920,0
9358,595,22,8,0.0597809706,0.940219029,2873.362374,2861.451364,4990.939731,4757.759664,9953,814.4844517,19906,-4791296,304640,-4486656,0
9315,634,23,7,0.0637249975,0.936275003,2872.777641,2826.023778,5004.374557,4543.416404,9949,831.8561873,19898,-4769280,324608,-4444672,0
9284,664,22,8,0.0667470848,0.933252915,2884.43513,2605.706901,5020.094248,4337.004518,9948,868.8209607,19896,-4753408,339968,-4413440,0
3825,411,22,8,0.0970254958,0.902974504,1223.976213,1201.839132,2134.560261,1969.034063,4236,76.09125202,8472,-1958400,210432,-1747968,0
9310,638,22,8,0.0641334942,0.935866506,2864.057845,2965.202167,4995.198281,4672.460815,9948,895.409541,19896,-4766720,326656,-4440064,0
9299,646,22,8,0.064957265,0.935042735,2875.621713,2784.376519,4993.862888,4672.684211,9945,578.87078,19890,-4761088,330752,-4430336,0
9265,683,22,8,0.0686570165,0.931342984,2878.140356,2727.647454,5013.959093,4439.231332,9948,1135.616438,19896,-4743680,349696,-4393984,0
9332,614,23,7,0.0617333601,0.93826664,2866.963989,2932.382049,4980.155379,4872.346906,9946,612.0615385,19892,-4777984,314368,-4463616,0
9320,632,23,7,0.0635048232,0.936495177,2882.984481,2666.251879,5011.729936,4456.969937,9952,1181.947743,19904,-4771840,323584,-4448256,0
9350,604,21,9,0.060679124,0.939320876,2874.942819,2783.1842,5016.087807,4380.155629,9954,1133.712984,19908,-4787200,309248,-4477952,0
9386,570,22,8,0.0572519084,0.942748092,2875.013876,2784.543238,5016.494353,4352.859649,9956,821.4521452,19912,-4805632,291840,-4513792,0
9350,608,22,8,0.061056437,0.938943563,2877.605972,2738.835158,5023.99893,4295.182566,9958,655.9947299,19916,-4787200,311296,-4475904,0
9351,602,21,9,0.0604842761,0.939515724,2880.587531,2684.06905,5015.931023,4372.275748,9953,692.6235212,19906,-4787712,308224,-4479488,0
9301,648,22,8,0.0651321741,0.934867826,2871.987647,2848.631582,4999.956026,4616.796296,9949,1232.83767,19898,-4762112,331776,-4430336,0
2961,231,22,8,0.0723684211,0.927631579,908.3681718,1074.917434,1594.851739,1617.627706,3192,50.1020248,6384,-1516032,118272,-1397760,0
984,164,18,12,0.142857143,0.857142857,315.9361114,412.1083943,573.4126016,581.0243902,1148,28.75031305,2296,-503808,83968,-419840,1
963,107,19,11,0.1,0.9,305.0277215,286.490884,555.1152648,358.9626168,1070,102.5886865,2140,-493056,54784,-438272,1
964,154,18,12,0.137745975,0.862254025,306.0647208,411.9615937,558.1815353,567.7532468,1118,32.07114171,2236,-493568,78848,-414720,1
1045,151,18,12,0.126254181,0.873745819,334.2026293,411.8606857,603.8076555,561.7682119,1196,131.1403509,2392,-535040,77312,-457728,1
959,169,18,12,0.149822695,0.850177305,311.3248706,397.1066917,563.6673618,569.2248521,1128,30.4947283,2256,-491008,86528,-404480,1
1092,158,18,12,0.1264,0.8736,348.3519478,436.3542817,629.8452381,595.4683544,1250,38.94080997,2500,-559104,80896,-478208,1
1114,164,18,12,0.128325509,0.871674491,357.7216976,435.0560319,645.8581688,596.3109756,1278,157.5832306,2556,-570368,83968,-486400,1
944,120,18,12,0.112781955,0.887218045,305.0051699,267.942388,554.2108051,361.7083333,1064,60.8,2128,-483328,61440,-421888,1
1009,120,18,12,0.106288751,0.893711249,320.8848248,314.8564417,585.864222,389.5666667,1129,126.4277716,2258,-516608,61440,-455168,1
938,142,19,11,0.131481481,0.868518519,297.9756984,390.7994954,541.2942431,535.2535211,1080,129.3413174,2160,-480256,72704,-407552,1
969,155,18,12,0.137900356,0.862099644,311.3687867,396.3086999,565.0773994,546.3870968,1124,135.5850422,2248,-496128,79360,-416768,1
1058,138,18,12,0.115384615,0.884615385,333.69756,421.9690939,602.9319471,564.5217391,1196,92.28395062,2392,-541696,70656,-471040,1
920,122,18,12,0.117082534,0.882917466,298.7876496,269.5142036,541.951087,367.2786885,1042,118.2746879,2084,-471040,62464,-408576,1
960,164,18,12,0.145907473,0.854092527,309.0754679,402.9475261,562.03125,565.2439024,1124,32.22477064,2248,-491520,83968,-407552,1
944,160,18,12,0.144927536,0.855072464,306.8754588,381.0181508,553.2955508,547.80625,1104,98.22064057,2208,-483328,81920,-401408,1
926,112,18,12,0.107899807,0.892100193,296.7578045,272.361123,539.2343413,356.3392857,1038,88.5665529,2076,-474112,57344,-416768,1
894,109,19,11,0.108673978,0.891326022,277.3933992,366.6961503,493.1935123,574.2293578,1003,95.16129032,2006,-457728,55808,-401920,1
943,142,18,12,0.130875576,0.869124424,297.3082561,403.0415037,541.3340403,554.0633803,1085,135.7947434,2170,-482816,72704,-410112,1
1041,131,19,11,0.111774744,0.888225256,334.8885603,333.9687876,603.8194044,448.870229,1172,123.7592397,2344,-532992,67072,-465920,1
575,107,18,12,0.156891496,0.843108504,192.6346122,215.6525788,347.2504348,310.5981308,682,10.63299033,1364,-294400,54784,-239616,1
918,132,22,8,0.125714286,0.874285714,294.1492072,356.7513225,531.2331155,485.6287879,1050,72.16494845,2100,-470016,67584,-402432,1
814,83,21,9,0.0925306577,0.907469342,254.5544778,298.5240885,449.5012285,444.0843373,897,133.2838039,1794,-416768,42496,-374272,1
933,114,22,8,0.108882521,0.891117479,297.9713092,328.3128927,531.7749196,460.3684211,1047,92.5729443,2094,-477696,58368,-419328,1
987,114,22,8,0.103542234,0.896457766,310.2177153,371.9467471,557.9777102,490.5877193,1101,149.7959184,2202,-505344,58368,-446976,1
1008,137,21,9,0.119650655,0.880349345,324.3137015,365.3785,582.640873,502.0656934,1145,150.0655308,2290,-516096,70144,-445952,1
922,131,22,8,0.124406458,0.875593542,295.1826505,359.0853777,530.0737527,505.3664122,1053,38.78453039,2106,-472064,67072,-404992,1
991,126,21,9,0.112802149,0.887197851,318.6272013,330.7044425,573.110999,448.015873,1117,147.5561427,2234,-507392,64512,-442880,1
907,137,20,10,0.131226054,0.868773946,293.180609,348.4272513,528.2844542,484.2043796,1044,55.0052687,2088,-464384,70144,-394240,1
1025,117,22,8,0.102451839,0.897548161,325.2721936,350.1515901,582.9902439,470.8376068,1142,169.1851852,2284,-524800,59904,-464896,1
905,120,22,8,0.117073171,0.882926829,291.3949111,312.3137561,525.4154696,419.3666667,1025,102.7054108,2050,-463360,61440,-401920,1
941,119,22,8,0.112264151,0.887735849,300.349567,321.2344615,546.2678002,405.8151261,1060,114.5945946,2120,-481792,60928,-420864,1
920,100,21,9,0.0980392157,0.901960784,293.9425932,250.3561072,527.3869565,355.14,1020,145.2991453,2040,-471040,51200,-419840,1
884,96,22,8,0.0979591837,0.902040816,280.3467802,258.5457424,507.270362,336.0729167,980,101.8711019,1960,-452608,49152,-403456,1
985,115,22,8,0.104545455,0.895454545,312.3921464,335.6567328,564.4558376,430.9652174,1100,94.99136442,2200,-504320,58880,-445440,1
1059,136,21,9,0.113807531,0.886192469,338.5139683,379.9354525,609.4645892,508.7279412,1195,150.6935687,2390,-542208,69632,-472576,1
1054,116,21,9,0.0991452991,0.900854701,336.6745364,322.7717047,598.9108159,463.6465517,1170,112.3919308,2340,-539648,59392,-480256,1
1062,106,21,9,0.0907534247,0.909246575,334.4083701,341.3255447,596.4557439,464.7169811,1168,142.0924574,2336,-543744,54272,-489472,1
1018,136,22,8,0.117850953,0.882149047,325.7235446,380.7953554,583.7770138,530.5147059,1154,64.50531023,2308,-521216,69632,-451584,1
914,140,21,9,0.132827324,0.867172676,297.1118488,345.5620866,532.5251641,494.6928571,1054,69.20551543,2108,-467968,71680,-396288,1
546,99,20,10,0.153488372,0.846511628,182.9958967,200.2109682,328.529304,292.5050505,645,9.872952702,1290,-279552,50688,-228864,1
2650,281,19,11,0.0958717161,0.904128284,817.507794,873.4369963,1402.096981,2068.644128,2931,74.22132185,5862,-1356800,143872,-1212928,1
2691,311,18,12,0.103597602,0.896402398,842.3234711,1009.778451,1468.607952,1786.106109,3002,207.6071923,6004,-1377792,159232,-1218560,1
2982,295,18,12,0.090021361,0.909978639,916.4410741,1155.776478,1606.950369,1962.972881,3277,229.6426069,6554,-1526784,151040,-1375744,1
2534,287,19,11,0.101736973,0.898263027,777.1014535,1029.513098,1372.790845,1748.358885,2821,314.84375,5642,-1297408,146944,-1150464,1
2764,313,18,12,0.101722457,0.898277543,866.0873455,1014.686351,1504.587916,1842.881789,3077,251.8003273,6154,-1415168,160256,-1254912,1
2718,305,19,11,0.100893152,0.899106848,843.8315551,1026.729585,1471.007726,1877.301639,3023,207.3388203,6046,-1391616,156160,-1235456,1
2890,259,18,12,0.0822483328,0.917751667,882.8449911,1130.442792,1551.937024,1832.343629,3149,393.625,6298,-1479680,132608,-1347072,1
2749,356,18,12,0.114653784,0.885346216,857.8644987,1053.871261,1496.64387,1988.176966,3105,65.97960051,6210,-1407488,182272,-1225216,1
2790,289,18,12,0.0938616434,0.906138357,873.5292783,928.2683922,1497.170251,1953.477509,3079,60.95822609,6158,-1428480,147968,-1280512,1
3115,323,19,11,0.0939499709,0.906050029,963.3831271,1169.468699,1679.301124,2107.176471,3438,282.0344545,6876,-1594880,165376,-1429504,1
2683,242,18,12,0.0827350427,0.917264957,832.2247034,957.8920426,1450.405143,1602.636364,2925,296.0526316,5850,-1373696,123904,-1249792,1
3138,336,19,11,0.0967184801,0.90328152,966.2130698,1208.144253,1689.76928,2183.270833,3474,341.5929204,6948,-1606656,172032,-1434624,1
2661,291,19,11,0.0985772358,0.901422764,826.5782146,873.2865642,1414.51522,2043.309278,2952,78.36474648,5904,-1362432,148992,-1213440,1
2800,287,18,12,0.0929705215,0.907029478,866.4869633,1067.924049,1517.015714,1807.261324,3087,275.1336898,6174,-1433600,146944,-1286656,1
2485,231,18,12,0.0850515464,0.914948454,770.9018208,911.549857,1353.170221,1415.835498,2716,232.5342466,5432,-1272320,118272,-1154048,1
2673,310,18,12,0.103922226,0.896077774,835.4382755,906.3657736,1432.303404,2006.73871,2983,52.26914316,5966,-1368576,158720,-1209856,1
2759,317,18,12,0.103055917,0.896944083,852.7457102,1079.518218,1495.425516,1913.397476,3076,219.0883191,6152,-1412608,162304,-1250304,1
2693,300,19,11,0.100233879,0.899766121,840.3882186,997.1028986,1461.382102,1816.73,2993,355.8858502,5986,-1378816,153600,-1225216,1
2702,179,19,11,0.0621312044,0.937868796,824.1143447,886.0486704,1460.828275,1141.692737,2881,51.07250488,5762,-1383424,91648,-1291776,1
2085,154,18,12,0.0687807057,0.931219294,637.5400623,741.6692033,1109.741966,1258.883117,2239,41.60936629,4478,-1067520,78848,-988672,1
1042,172,18,12,0.141680395,0.858319605,339.9169133,407.4743205,611.9328215,580.6453488,1214,99.34533552,2428,-533504,88064,-445440,1
969,134,18,12,0.121486854,0.878513146,308.1536502,377.0541089,561.7667699,481.3731343,1103,74.12634409,2206,-496128,68608,-427520,1
1000,159,18,12,0.13718723,0.86281277,319.2936383,417.5357396,583.112,560.427673,1159,116.1322645,2318,-512000,81408,-430592,1
877,144,18,12,0.141038198,0.858961802,280.6665503,367.0865021,516.7468643,476,1021,24.5196926,2042,-449024,73728,-375296,1
973,165,18,12,0.144991213,0.855008787,312.5980791,409.9341265,570.4820144,563.7090909,1138,32.32036353,2276,-498176,84480,-413696,1
1007,145,18,12,0.125868056,0.874131944,322.7889189,387.9911001,585.5273088,513.8068966,1152,167.9300292,2304,-515584,74240,-441344,1
1047,162,18,12,0.133995037,0.866004963,338.5713134,408.5436766,610.1470869,571.7345679,1209,143.7574316,2418,-536064,82944,-453120,1
935,109,18,12,0.10440613,0.89559387,296.8541877,277.8641784,543.6716578,340.8899083,1044,108.8633994,2088,-478720,55808,-422912,1
949,162,18,12,0.145814581,0.854185419,307.3764648,389.7246016,557.2550053,548.6481481,1111,147.9360852,2222,-485888,82944,-402944,1
1024,130,18,12,0.112651646,0.887348354,331.7085409,290.5672909,599.5498047,403.8153846,1154,35.48585486,2308,-524288,66560,-457728,1
966,120,18,12,0.110497238,0.889502762,311.1345755,281.8605935,564.0403727,378.15,1086,93.86343993,2172,-494592,61440,-433152,1
1018,125,18,12,0.10936133,0.89063867,321.0970071,381.4710259,583.7721022,476.128,1143,137.214886,2286,-521216,64000,-457216,1
1057,154,18,12,0.12716763,0.87283237,337.3212629,422.9730331,610.5666982,574.6558442,1211,135.7623318,2422,-541184,78848,-462336,1
1002,142,18,12,0.124125874,0.875874126,320.3912417,390.7059464,577.8812375,534.528169,1144,29.07242694,2288,-513024,72704,-440320,1
1062,164,18,12,0.133768352,0.866231648,340.6456916,429.4310246,616.806968,592.0853659,1226,33.5890411,2452,-543744,83968,-459776,1
890,145,18,12,0.140096618,0.859903382,286.2140029,366.1993957,520.5359551,502.4344828,1035,63.84947563,2070,-455680,74240,-381440,1
906,153,18,12,0.144475921,0.855524079,292.8975679,372.5719058,531.1214128,523.3594771,1059,58.18681319,2118,-463872,78336,-385536,1
951,107,18,12,0.101134216,0.898865784,301.6046013,281.0219372,549.4227129,352.4299065,1058,79.42942943,2116,-486912,54784,-432128,1
958,129,18,12,0.118675253,0.881324747,309.5624765,301.4706842,564.82881,389.3178295,1087,130.8062575,2174,-490496,66048,-424448,1
984,164,18,12,0.142857143,0.857142857,315.9298878,412.1694556,575.2388211,570.0670732,1148,31.31478451,2296,-503808,83968,-419840,1
2375,234,18,12,0.0896895362,0.910310464,721.5936182,996.4838159,1284.696842,1511.068376,2609,215.2640264,5218,-1216000,119808,-1096192,1
2337,227,19,11,0.0885335413,0.911466459,710.4017492,962.431252,1258.673513,1527.797357,2564,250.8806262,5128,-1196544,116224,-1080320,1
2402,226,19,11,0.0859969559,0.914003044,728.9191192,1000.978861,1295.75229,1513.756637,2628,266.2613982,5256,-1229824,115712,-1114112,1
2210,104,18,12,0.0449438202,0.95505618,659.3809291,826.6103622,1161.027602,1082.538462,2314,44.84496124,4628,-1131520,53248,-1078272,1
2385,154,18,12,0.0606538007,0.939346199,720.7056413,880.7378332,1282.050314,1083.376623,2539,203.12,5078,-1221120,78848,-1142272,1
2298,200,18,12,0.0800640512,0.919935949,693.3455397,898.4709155,1215.696258,1637.905,2498,64.39804073,4996,-1176576,102400,-1074176,1
2386,187,19,11,0.072677808,0.927322192,723.3450478,949.1324448,1278.054484,1401.139037,2573,326.9377382,5146,-1221632,95744,-1125888,1
2423,243,18,12,0.0911477869,0.908852213,733.8949537,1023.865779,1306.560462,1602.119342,2666,50.28291211,5332,-1240576,124416,-1116160,1
2333,156,19,11,0.0626757734,0.937324227,705.327049,878.6849656,1255.222889,1092.115385,2489,269.9566161,4978,-1194496,79872,-1114624,1
2317,153,18,12,0.0619433198,0.93805668,702.682475,821.2599472,1250.598187,1006.856209,2470,167.5712347,4940,-1186304,78336,-1107968,1
2285,184,18,12,0.0745240988,0.925475901,687.3202187,847.3515099,1197.692341,1698.304348,2469,67.23856209,4938,-1169920,94208,-1075712,1
2344,141,18,12,0.0567404427,0.943259557,707.3117577,824.6345127,1258.731229,981.4822695,2485,245.5533597,4970,-1200128,72192,-1127936,1
2335,153,19,11,0.0614951768,0.938504823,706.9900802,848.1507298,1257.32591,1048.75817,2488,201.9480519,4976,-1195520,78336,-1117184,1
2296,192,18,12,0.077170418,0.922829582,687.4618488,880.9738535,1203.789199,1731.333333,2488,66.17021277,4976,-1175552,98304,-1077248,1
2413,228,18,12,0.0863309353,0.913669065,730.5311504,1008.446683,1297.506424,1569.640351,2641,260.4536489,5282,-1235456,116736,-1118720,1
2356,221,18,12,0.0857586341,0.914241366,716.2967007,978.4741908,1274.554754,1442.995475,2577,308.9928058,5154,-1206272,113152,-1093120,1
2398,143,19,11,0.0562770563,0.943722944,723.6371687,847.9632683,1285.2598,1031.874126,2541,193.6737805,5082,-1227776,73216,-1154560,1
2306,147,18,12,0.0599266205,0.94007338,699.7338541,795.9450057,1241.244579,1003.544218,2453,236.5477338,4906,-1180672,75264,-1105408,1
2350,174,18,12,0.0689381933,0.931061807,715.968577,872.6148536,1271.587234,1139.770115,2524,199.8416469,5048,-1203200,89088,-1114112,1
1047,99,18,12,0.0863874346,0.913612565,326.1013788,342.15525,587.8376313,421.8686869,1146,17.91464749,2292,-536064,50688,-485376,1
2575,280,18,12,0.0980735552,0.901926445,807.5105277,959.7266746,1437.307961,1342.4,2855,68.36685824,5710,-1318400,143360,-1175040,1
2689,244,18,12,0.0831912717,0.916808728,843.3212376,773.1770241,1504.035701,1058.848361,2933,258.1866197,5866,-1376768,124928,-1251840,1
2672,250,19,11,0.0855578371,0.914442163,844.07939,761.149354,1492.733533,1127.676,2922,261.3595707,5844,-1368064,128000,-1240064,1
2797,263,19,11,0.0859477124,0.914052288,875.8829296,916.7894738,1555.835181,1261.060837,3060,381.0709838,6120,-1432064,134656,-1297408,1
2618,303,18,12,0.103731599,0.896268401,830.5086911,927.976203,1481.115737,1287.194719,2921,329.6839729,5842,-1340416,155136,-1185280,1
2560,244,18,12,0.0870185449,0.912981455,807.2286502,712.8411809,1441.634375,991.9098361,2804,212.5852919,5608,-1310720,124928,-1185792,1
2679,275,18,12,0.0930941097,0.90690589,839.2113912,961.685357,1493.088839,1325.636364,2954,344.6907818,5908,-1371648,140800,-1230848,1
2629,274,18,12,0.0943851188,0.905614881,828.8213156,913.5224539,1464.12248,1335.686131,2903,278.0651341,5806,-1346048,140288,-1205760,1
2599,292,18,12,0.101003113,0.898996887,820.3746889,947.2019669,1455.672951,1359.90411,2891,76.5219693,5782,-1330688,149504,-1181184,1
2580,264,18,12,0.0928270042,0.907172996,809.3221327,927.2626758,1423.668992,1411.075758,2844,75.81978139,5688,-1320960,135168,-1185792,1
1397,186,18,12,0.117498421,0.882501579,441.6675936,558.5022517,793.7695061,778.7096774,1583,259.5081967,3166,-715264,95232,-620032,1
2573,248,18,12,0.0879120879,0.912087912,801.2363247,939.3734611,1413.249903,1387.657258,2821,72.03779367,5642,-1317376,126976,-1190400,1
2744,286,19,11,0.0943894389,0.905610561,872.4091561,861.7437949,1539.923105,1281.174825,3030,208.9655172,6060,-1404928,146432,-1258496,1
2630,234,18,12,0.0817039106,0.918296089,818.721774,909.8396253,1438.21673,1368.247863,2864,283.0039526,5728,-1346560,119808,-1226752,1
2608,277,18,12,0.0960138648,0.903986135,819.6207038,942.1754002,1453.774156,1341.559567,2885,50.71190016,5770,-1335296,141824,-1193472,1
2708,311,17,13,0.103014243,0.896985757,858.6934897,959.6628113,1529.355982,1341.459807,3019,321.1702128,6038,-1386496,159232,-1227264,1
2572,264,19,11,0.0930888575,0.906911142,806.5529026,928.0643813,1421.585925,1388.435606,2836,75.40547727,5672,-1316864,135168,-1181696,1
2689,242,19,11,0.0825656772,0.917434323,847.2950445,738.0290821,1499.257345,1096.458678,2931,255.5361813,5862,-1376768,123904,-1252864,1
2792,263,19,11,0.0860883797,0.91391162,875.6792575,880.8261151,1558.93553,1199.589354,3055,220.7369942,6110,-1429504,134656,-1294848,1
1154,187,18,12,0.139448173,0.860551827,380.8987456,422.5458098,675.1585789,645.3368984,1341,20.16844638,2682,-590848,95744,-495104,1
871,109,18,12,0.11122449,0.88877551,278.2905519,281.3065839,507.8300804,352.0183486,980,111.8721461,1960,-445952,55808,-390144,1
886,146,18,12,0.141472868,0.858527132,285.7710798,362.4995063,519.3656885,499.109589,1032,57.81512605,2064,-453632,74752,-378880,1
932,145,18,12,0.13463324,0.86536676,298.2797191,380.7604005,543.8208155,508.0137931,1077,123.3676976,2154,-477184,74240,-402944,1
972,166,18,12,0.145869947,0.854130053,312.6295167,409.2644497,568.3971193,575.9578313,1138,31.85890258,2276,-497664,84992,-412672,1
978,152,18,12,0.134513274,0.865486726,311.2272587,409.0530614,568.7453988,544.6184211,1130,112.7744511,2260,-500736,77824,-422912,1
977,173,18,12,0.150434783,0.849565217,317.3709489,404.5334058,573.7082907,585.6184971,1150,33.10305124,2300,-500224,88576,-411648,1
123,63,18,12,0.338709677,0.661290323,46.2268773,58.31676906,80.7398374,118.4126984,186,21.52777778,372,-62976,32256,-30720,1
980,172,18,12,0.149305556,0.850694444,316.9444919,410.0773115,574.2561224,589.2848837,1152,31.65704864,2304,-501760,88064,-413696,1
980,128,18,12,0.115523466,0.884476534,310.7384148,368.2016725,567.2255102,457.0703125,1108,120.6971678,2216,-501760,65536,-436224,1
982,142,18,12,0.12633452,0.87366548,315.0548085,377.9691748,571.1160896,502.915493,1124,71.59235669,2248,-502784,72704,-430080,1
958,150,18,12,0.135379061,0.864620939,306.0904692,396.0437947,557.651357,534.3733333,1108,120.9606987,2216,-490496,76800,-413696,1
972,160,18,12,0.141342756,0.858657244,310.5292233,411.6584464,564.1347737,580.86875,1132,31.7264574,2264,-497664,81920,-415744,1
943,67,18,12,0.0663366337,0.933663366,289.6572299,289.6390807,514.3711559,380.641791,1010,85.30405405,2020,-482816,34304,-448512,1
979,111,18,12,0.101834862,0.898165138,311.074693,287.0720914,565.9897855,364.7837838,1090,24.61607949,2180,-501248,56832,-444416,1
954,159,18,12,0.142857143,0.857142857,305.3554264,403.9343171,557.0524109,556.6855346,1113,30.66115702,2226,-488448,81408,-407040,1
879,112,18,12,0.113017154,0.886982846,281.9612379,272.9302128,515.2366325,345.0267857,991,17.40428521,1982,-450048,57344,-392704,1
977,173,18,12,0.150434783,0.849565217,315.730026,411.4613003,572.5158649,592.3526012,1150,20.14363286,2300,-500224,88576,-411648,1
966,172,18,12,0.151142355,0.848857645,315.4659422,392.8335871,574.1024845,543.6511628,1138,79.91573034,2276,-494592,88064,-406528,1
896,143,18,12,0.137632339,0.862367661,289.1491896,358.629732,525.0245536,488.5174825,1039,117.4011299,2078,-458752,73216,-385536,1
1032,129,18,12,0.111111111,0.888888889,331.1572925,322.5663566,601.2655039,418.875969,1161,105.0678733,2322,-528384,66048,-462336,1
1532,185,18,12,0.107746069,0.892253931,478.772603,617.847212,860.4836815,846.7135135,1717,48.9871612,3434,-784384,94720,-689664,1
1530,192,18,12,0.111498258,0.888501742,480.0366832,611.4030395,870.7732026,787.6041667,1722,291.3705584,3444,-783360,98304,-685056,1
1471,200,18,12,0.119688809,0.880311191,465.9043751,589.3874614,837.7702243,822.98,1671,73.32163229,3342,-753152,102400,-650752,1
1442,137,18,12,0.0867637745,0.913236225,448.2797955,457.7542928,814.0152566,537.2262774,1579,36.89252336,3158,-738304,70144,-668160,1
1379,141,19,11,0.0927631579,0.907236842,421.0689486,541.7934224,739.1660624,969.1489362,1520,38.98435496,3040,-706048,72192,-633856,1
1530,210,18,12,0.120689655,0.879310345,484.3477293,615.1144736,877.4830065,819.6238095,1740,223.0769231,3480,-783360,107520,-675840,1
1580,162,18,12,0.0929965557,0.907003444,492.1260578,584.6758071,883.5848101,753.6358025,1742,167.1785029,3484,-808960,82944,-726016,1
1541,153,18,12,0.0903187721,0.909681228,479.0784955,542.4317326,866.8598313,652.5098039,1694,213.3501259,3388,-788992,78336,-710656,1
1566,215,18,12,0.120718697,0.879281303,497.8979256,616.0935694,899.5523627,828.7069767,1781,46.17578429,3562,-801792,110080,-691712,1
1471,160,18,12,0.0980993256,0.901900674,457.6674454,567.6285603,827.2352141,712.70625,1631,205.6746532,3262,-753152,81920,-671232,1
1515,145,18,12,0.0873493976,0.912650602,473.4693506,464.5594871,854.840264,576.1862069,1660,136.5131579,3320,-775680,74240,-701440,1
1374,140,19,11,0.0924702774,0.907529723,419.6593028,553.9480663,740.5720524,923.6357143,1514,43.09706803,3028,-703488,71680,-631808,1
1461,200,18,12,0.120409392,0.879590608,464.8749066,572.5517405,837.9295003,780.38,1661,219.1292876,3322,-748032,102400,-645632,1
1385,144,19,11,0.0941792021,0.905820798,423.402051,553.8131422,745.7920578,949.7430556,1529,39.35649936,3058,-709120,73728,-635392,1
1376,153,18,12,0.100065402,0.899934598,424.9239941,545.3835146,748.1162791,916.8431373,1529,41.48128052,3058,-704512,78336,-626176,1
1374,147,18,12,0.0966469428,0.903353057,423.8338649,519.715771,739.2838428,963.9795918,1521,40.58164354,3042,-703488,75264,-628224,1
1625,155,18,12,0.0870786517,0.912921348,508.5088434,505.5092195,913.8516923,645.683871,1780,147.4730737,3560,-832000,79360,-752640,1
1499,141,18,12,0.0859756098,0.91402439,468.1645085,430.276374,847.7284857,531.0283688,1640,138.7478849,3280,-767488,72192,-695296,1
1556,149,18,12,0.0873900293,0.912609971,488.7214421,463.8762112,875.8901028,613.9597315,1705,167.3209028,3410,-796672,76288,-720384,1
1147,92,18,12,0.0742534302,0.92574657,354.1605203,391.0200006,626.0575414,544.4782609,1239,19.75761442,2478,-587264,47104,-540160,1
3654,276,19,11,0.0702290076,0.929770992,1124.096444,1262.990789,1961.637931,2016.630435,3930,431.3940724,7860,-1870848,141312,-1729536,1
3451,310,19,11,0.082424887,0.917575113,1056.251557,1264.763982,1835.346566,2389.225806,3761,88.82853094,7522,-1766912,158720,-1608192,1
3524,339,19,11,0.0877556303,0.91224437,1078.398103,1403.981255,1901.459989,2249.471976,3863,431.6201117,7726,-1804288,173568,-1630720,1
3569,234,19,11,0.0615303708,0.938469629,1085.476455,1268.502105,1896.477164,1986.235043,3803,305.7073955,7606,-1827328,119808,-1707520,1
3618,295,19,11,0.0753897266,0.924610273,1111.590517,1309.866541,1938.639027,2182.186441,3913,305.4644809,7826,-1852416,151040,-1701376,1
3596,321,18,12,0.0819504723,0.918049528,1108.171632,1186.48804,1902.467464,2592.305296,3917,100.7199794,7834,-1841152,164352,-1676800,1
3520,258,18,12,0.0682901006,0.931709899,1075.634961,1275.642688,1884.547443,1957.069767,3778,235.5361596,7556,-1802240,132096,-1670144,1
3791,264,18,12,0.0651048089,0.934895191,1162.688986,1277.009612,2032.156423,1968.314394,4055,442.6855895,8110,-1940992,135168,-1805824,1
3458,310,19,11,0.0822717622,0.917728238,1056.683639,1168.261795,1820.18074,2601.970968,3768,100.6141522,7536,-1770496,158720,-1611776,1
3708,426,18,12,0.103047896,0.896952104,1163.097083,1305.391928,2003.932578,2620.805164,4134,107.0707071,8268,-1898496,218112,-1680384,1
3614,313,19,11,0.0797046091,0.920295391,1115.541536,1295.368305,1940.973437,2229.872204,3927,231.9551093,7854,-1850368,160256,-1690112,1
2880,214,19,11,0.069166128,0.930833872,868.4794458,1165.920824,1536.507292,1695.439252,3094,354.8165138,6188,-1474560,109568,-1364992,1
3550,292,18,12,0.0760020822,0.923997918,1093.932647,1269.531547,1909.167324,2071.434932,3842,303.4755134,7684,-1817600,149504,-1668096,1
3384,360,18,12,0.0961538462,0.903846154,1035.604697,1372.266521,1829.100768,2280.452778,3744,236.8121442,7488,-1732608,184320,-1548288,1
3218,225,18,12,0.0653499855,0.934650015,982.228996,1053.445462,1752.843692,1280.866667,3443,124.2960289,6886,-1647616,115200,-1532416,1
3554,217,18,12,0.0575444179,0.942455582,1077.833414,1179.305185,1910.872538,1478.640553,3771,334.0124004,7542,-1819648,111104,-1708544,1
3596,243,19,11,0.0632977338,0.936702266,1098.26393,1243.560373,1925.444939,1839.423868,3839,89.50804383,7678,-1841152,124416,-1716736,1
2851,167,18,12,0.0553346587,0.944665341,860.9842834,982.9424938,1527.101719,1209.005988,3018,106.305037,6036,-1459712,85504,-1374208,1
3627,306,19,11,0.0778032037,0.922196796,1128.652772,1201.500771,1954.086022,2120.068627,3933,448.9726027,7866,-1857024,156672,-1700352,1
2594,186,18,12,0.0669064748,0.933093525,786.7092112,972.6250645,1405.736315,1178.010753,2780,43.56001254,5560,-1328128,95232,-1232896,1
3233,389,20,10,0.107399227,0.892600773,1031.966571,1117.197978,1843.69069,1543.96144,3622,378.8702929,7244,-1655296,199168,-1456128,1
2739,297,22,8,0.097826087,0.902173913,872.568698,871.8702991,1545.75575,1267.141414,3036,184.1115828,6072,-1402368,152064,-1250304,1
2973,384,22,8,0.114387846,0.885612154,964.5340976,973.4124653,1708.693912,1449.104167,3357,418.5785536,6714,-1522176,196608,-1325568,1
3180,410,22,8,0.114206128,0.885793872,1020.966591,1126.948851,1822.460063,1586.395122,3590,286.2838915,7180,-1628160,209920,-1418240,1
2614,329,22,8,0.11179069,0.88820931,833.5560983,967.3041713,1473.904361,1456.869301,2943,52.22715173,5886,-1338368,168448,-1169920,1
9452,521,20,10,0.0522410508,0.947758949,2870.96472,2880.73231,5035.696255,4103.550864,9973,726.3656227,19946,-4839424,266752,-4572672,1
2974,357,21,9,0.107175023,0.892824977,950.0706178,1038.56816,1685.396436,1504.417367,3331,228.1506849,6662,-1522688,182784,-1339904,1
3157,382,22,8,0.107940096,0.892059904,1009.129402,1099.395328,1794.159645,1570.335079,3539,225.9897829,7078,-1616384,195584,-1420800,1
2885,381,21,9,0.116656461,0.883343539,931.5605845,996.3263708,1662.855459,1411.215223,3266,454.2420028,6532,-1477120,195072,-1282048,1
2939,341,22,8,0.103963415,0.896036585,936.1335271,1010.287367,1665.019735,1429.170088,3280,97.61904762,6560,-1504768,174592,-1330176,1
2927,382,22,8,0.115442732,0.884557268,949.9297113,955.5992319,1688.971985,1394.696335,3309,203.8817006,6618,-1498624,195584,-1303040,1
3197,371,21,9,0.103979821,0.896020179,1012.429301,1152.400197,1807.006256,1590.557951,3568,62.38852946,7136,-1636864,189952,-1446912,1
1121,200,21,9,0.151400454,0.848599546,382.7590517,368.1479152,671.1427297,604.15,1321,23.51789211,2642,-573952,102400,-471552,1
2899,350,20,10,0.107725454,0.892274546,933.4606611,939.5656448,1654.249051,1382.734286,3249,288.8,6498,-1484288,179200,-1305088,1
2924,393,22,8,0.118480555,0.881519445,943.0245291,1046.691505,1679.543434,1506.152672,3317,348.4243697,6634,-1497088,201216,-1295872,1
2984,397,21,9,0.117420881,0.882579119,980.4476781,910.9154962,1720.991957,1465.56927,3381,250.2590674,6762,-1527808,203264,-1324544,1
2656,324,21,9,0.108724832,0.891275168,847.9656959,952.305887,1498.798193,1422.475309,2980,211.3475177,5960,-1359872,165888,-1193984,1
8393,539,21,9,0.0603448276,0.939655172,2559.234285,2754.815622,4514.573812,3717.922078,8932,472.5925926,17864,-4297216,275968,-4021248,1
9401,571,19,11,0.0572603289,0.942739671,2863.398115,2852.211215,5060.985533,3760.162872,9972,928.4916201,19944,-4813312,292352,-4520960,1
827,204,21,9,0.197866149,0.802133851,298.2768859,292.6198399,507.8041112,549.2254902,1031,16.00186249,2062,-423424,104448,-318976,1
4980,302,22,8,0.0571753124,0.942824688,1514.685496,1680.594495,2646.287751,2562.549669,5282,152.2190202,10564,-2549760,154624,-2395136,2
4882,304,22,8,0.0586193598,0.94138064,1487.704062,1638.350474,2598.150553,2518.815789,5186,139.746699,10372,-2499584,155648,-2343936,2
4911,325,23,7,0.0620702827,0.937929717,1494.841244,1741.372093,2612.360415,2711.273846,5236,143.0601093,10472,-2514432,166400,-2348032,2
4870,311,21,9,0.0600270218,0.939972978,1480.844659,1710.202071,2589.001027,2622.302251,5181,90.60860441,10362,-2493440,159232,-2334208,2
4940,292,22,8,0.0558103976,0.944189602,1502.045188,1644.413776,2617.325101,2602.541096,5232,110.6598985,10464,-2529280,149504,-2379776,2
4903,290,21,9,0.0558444059,0.944155594,1489.836682,1647.668039,2597.446257,2589.455172,5193,128.7307883,10386,-2510336,148480,-2361856,2
5068,323,22,8,0.0599146726,0.940085327,1543.632931,1739.794609,2690.276243,2785.80805,5391,128.3571429,10782,-2594816,165376,-2429440,2
4889,336,21,9,0.0643062201,0.93569378,1499.652693,1628.384421,2616.699325,2559.172619,5225,129.7169811,10450,-2503168,172032,-2331136,2
4888,305,21,9,0.0587329097,0.94126709,1488.728874,1655.456259,2600.237111,2545.121311,5193,145.5845248,10386,-2502656,156160,-2346496,2
4858,299,21,9,0.0579794454,0.942020555,1478.502835,1644.685384,2582.114245,2528.401338,5157,132.3325635,10314,-2487296,153088,-2334208,2
5075,322,22,8,0.0596627756,0.940337224,1546.135621,1733.871027,2697.701872,2719.459627,5397,152.9328422,10794,-2598400,164864,-2433536,2
4896,298,22,8,0.057373893,0.942626107,1490.244962,1641.096096,2601.02982,2539.506711,5194,147.5149105,10388,-2506752,152576,-2354176,2
4922,335,22,8,0.0637245577,0.936275442,1509.903942,1624.437444,2633.650752,2560.668657,5257,138.487882,10514,-2520064,171520,-2348544,2
4929,315,21,9,0.0600686499,0.93993135,1501.382952,1696.212706,2620.622236,2651.88254,5244,145.7071409,10488,-2523648,161280,-2362368,2
5112,313,20,10,0.0576958525,0.942304147,1554.185983,1746.933106,2717.610329,2637.702875,5425,144.20521,10850,-2617344,160256,-2457088,2
4963,331,21,9,0.0625236116,0.937476388,1515.299503,1710.568446,2646.365303,2664.513595,5294,129.1534521,10588,-2541056,169472,-2371584,2
4910,309,21,9,0.0592067446,0.940793255,1495.964958,1664.123292,2615.360896,2524.815534,5219,141.9749728,10438,-2513920,158208,-2355712,2
4900,303,20,10,0.0582356333,0.941764367,1491.48633,1662.293317,2603.400408,2579.353135,5203,133.5472279,10406,-2508800,155136,-2353664,2
4879,306,20,10,0.0590163934,0.940983607,1485.744673,1661.896189,2596.474073,2537.607843,5185,148.9514507,10370,-2498048,156672,-2341376,2
4956,305,21,9,0.0579737692,0.942026231,1505.45443,1714.836455,2623.050242,2760.177049,5261,123.3818011,10522,-2537472,156160,-2381312,2
1616,101,20,10,0.0588235294,0.941176471,485.8502403,631.399397,860.9034653,828.5445545,1717,147.6354256,3434,-827392,51712,-775680,2
2404,182,20,10,0.0703789637,0.929621036,732.394734,873.1827229,1274.098586,1549.769231,2586,182.4982357,5172,-1230848,93184,-1137664,2
2313,188,20,10,0.075169932,0.924830068,705.9987899,878.1588475,1237.283614,1419.755319,2501,166.6222518,5002,-1184256,96256,-1088000,2
2374,197,20,10,0.0766238818,0.923376118,727.1573844,902.2846301,1281.791491,1336.715736,2571,289.527027,5142,-1215488,100864,-1114624,2
2338,190,20,10,0.0751582278,0.924841772,716.7718315,857.2117081,1251.160393,1428.647368,2528,208.4089035,5056,-1197056,97280,-1099776,2
2360,196,20,10,0.0766823161,0.923317684,722.4264703,887.6251482,1265.19322,1438.72449,2556,311.7073171,5112,-1208320,100352,-1107968,2
2334,196,20,10,0.0774703557,0.922529644,715.8673484,855.4801445,1247.294773,1482.290816,2530,208.4019769,5060,-1195008,100352,-1094656,2
2316,196,19,11,0.0780254777,0.921974522,711.500322,864.6556304,1248.388601,1352.346939,2512,48.62562911,5024,-1185792,100352,-1085440,2
2325,196,20,10,0.0777469258,0.922253074,712.4027988,866.2919093,1244.539355,1456.260204,2521,255.9390863,5042,-1190400,100352,-1090048,2
2319,192,20,10,0.0764635603,0.92353644,712.7743183,836.7177638,1241.063389,1436.40625,2511,108.1395349,5022,-1187328,98304,-1089024,2
2337,200,19,11,0.0788332676,0.921166732,718.0219935,867.7597234,1255.628156,1425.25,2537,255.4884189,5074,-1196544,102400,-1094144,2
2327,190,20,10,0.0754866905,0.924513309,714.9755635,828.0030407,1241.889128,1468.563158,2517,178.5106383,5034,-1191424,97280,-1094144,2
2318,193,20,10,0.076861808,0.923138192,711.1434524,845.3200849,1238.567731,1465.367876,2511,127.4619289,5022,-1186816,98816,-1088000,2
1910,122,19,11,0.0600393701,0.93996063,575.484885,736.3325601,1020.365445,955.9836066,2032,95.04209542,4064,-977920,62464,-915456,2
2330,193,20,10,0.0764962346,0.923503765,715.2513185,848.3517683,1246.351931,1450.911917,2523,246.1463415,5046,-1192960,98816,-1094144,2
2341,190,20,10,0.0750691426,0.924930857,715.7346323,878.7428758,1253.124733,1424.636842,2531,108.4404456,5062,-1198592,97280,-1101312,2
2392,203,20,10,0.0782273603,0.92177264,735.7043009,871.2787728,1282.407609,1481.729064,2595,128.4653465,5190,-1224704,103936,-1120768,2
2327,204,20,10,0.0806005531,0.919399447,715.9248667,860.855762,1250.159003,1446.696078,2531,167.7269715,5062,-1191424,104448,-1086976,2
2334,200,19,11,0.0789265983,0.921073402,716.5327337,854.1730436,1247.616538,1499.54,2534,239.5085066,5068,-1195008,102400,-1092608,2
1559,102,20,10,0.0614087899,0.93859121,470.3380235,587.0588124,839.5336754,700.5686275,1661,26.22355542,3322,-798208,52224,-745984,2
2349,213,18,12,0.0831381733,0.916861827,721.3332066,908.1263044,1270.393359,1403.985915,2562,150.1758499,5124,-1202688,109056,-1093632,2
2372,214,18,12,0.0827532869,0.917246713,727.2926261,929.750296,1286.352867,1372.719626,2586,190.8487085,5172,-1214464,109568,-1104896,2
2384,209,18,12,0.0806016197,0.91939838,731.1247342,901.5211421,1279.894715,1492.114833,2593,220.3058624,5186,-1220608,107008,-1113600,2
2359,214,18,12,0.0831713953,0.916828605,724.3547591,911.6036616,1275.233574,1416.705607,2573,250.7797271,5146,-1207808,109568,-1098240,2
2352,191,19,11,0.07510814,0.92489186,716.8462462,899.7841424,1256.859694,1458.439791,2543,199.6075353,5086,-1204224,97792,-1106432,2
2336,207,18,12,0.0813999214,0.918600079,715.8406888,905.898975,1260.91524,1397.091787,2543,153.6555891,5086,-1196032,105984,-1090048,2
2368,211,18,12,0.0818146568,0.918185343,727.11113,893.2391004,1272.199324,1489.772512,2579,209.1646391,5158,-1212416,108032,-1104384,2
2342,213,18,12,0.0833659491,0.916634051,718.4121603,900.8500031,1260.785226,1467.28169,2555,279.5404814,5110,-1199104,109056,-1090048,2
2396,207,19,11,0.0795236266,0.920476373,736.6997092,885.2112544,1286.579299,1480.492754,2603,188.6231884,5206,-1226752,105984,-1120768,2
2362,198,18,12,0.07734375,0.92265625,722.561336,909.7202117,1274.636325,1350.449495,2560,217.502124,5120,-1209344,101376,-1107968,2
2330,209,18,12,0.0823158724,0.917684128,715.5888905,885.6087396,1254.34206,1444.559809,2539,195.6086287,5078,-1192960,107008,-1085952,2
2347,206,18,12,0.080689385,0.919310615,719.2407643,899.1128606,1262.622923,1440.800971,2553,222,5106,-1201664,105472,-1096192,2
2344,218,17,13,0.0850897736,0.914910226,721.4577449,888.817945,1263.318686,1476.990826,2562,53.28618968,5124,-1200128,111616,-1088512,2
2342,200,18,12,0.0786782061,0.921321794,714.3281717,916.4484025,1257.53971,1434.975,2542,248,5084,-1199104,102400,-1096704,2
2384,207,19,11,0.0798919336,0.920108066,733.0288671,887.8551613,1282.627936,1450.004831,2591,188.7108521,5182,-1220608,105984,-1114624,2
2354,215,18,12,0.0836901518,0.916309848,720.1008356,909.9045351,1262.500425,1531.344186,2569,143.27942,5138,-1205248,110080,-1095168,2
243,44,18,12,0.153310105,0.846689895,79.89784244,83.72693651,152.3415638,97.93181818,287,5.691056911,574,-124416,22528,-101888,2
2353,211,18,12,0.0822932917,0.917706708,722.5072329,900.9173845,1269.143221,1431.450237,2564,189.3648449,5128,-1204736,108032,-1096704,2
2355,212,18,12,0.0825866771,0.917413323,724.892819,888.3618001,1271.008493,1428.316038,2567,194.469697,5134,-1205760,108544,-1097216,2
2439,219,18,12,0.0823927765,0.917607223,746.7746178,963.6658371,1322.742517,1404.757991,2658,215.5717762,5316,-1248768,112128,-1136640,2
424,36,21,9,0.0782608696,0.92173913,129.4479155,134.4366733,238.6037736,135.0555556,460,8.775276612,920,-217088,18432,-198656,2
2492,207,21,9,0.0766950722,0.923304928,762.587119,952.5900467,1343.447833,1428.879227,2699,329.1463415,5398,-1275904,105984,-1169920,2
2340,192,21,9,0.0758293839,0.924170616,720.4429313,818.9450037,1249.039316,1479.302083,2532,207.2013093,5064,-1198080,98304,-1099776,2
2327,186,21,9,0.0740151214,0.925984879,707.9362216,896.5661473,1242.339063,1440.419355,2513,204.9755302,5026,-1191424,95232,-1096192,2
2340,199,21,9,0.0783773139,0.921622686,718.9363549,856.4988491,1253.109829,1468.60804,2539,166.4918033,5078,-1198080,101888,-1096192,2
2334,202,21,9,0.0796529968,0.920347003,716.3057015,865.4433647,1249.760925,1485.019802,2536,255.6451613,5072,-1195008,103424,-1091584,2
2337,200,21,9,0.0788332676,0.921166732,718.2350971,851.111115,1250.352161,1486.9,2537,223.7213404,5074,-1196544,102400,-1094144,2
2355,198,20,10,0.0775558167,0.922444183,724.2620576,857.0869215,1263.078556,1442.580808,2553,112.5661376,5106,-1205760,101376,-1104384,2
2361,201,21,9,0.0784543326,0.921545667,724.3034532,882.3928487,1267.075815,1450.930348,2562,171.4859438,5124,-1208832,102912,-1105920,2
2320,187,21,9,0.0745911448,0.925408855,709.5114853,869.8518613,1243.15819,1388.508021,2507,119.2673644,5014,-1187840,95744,-1092096,2
2341,199,21,9,0.0783464567,0.921653543,716.4256079,897.5291643,1259.331055,1401.889447,2540,296.3827305,5080,-1198592,101888,-1096704,2
2329,194,21,9,0.0768925882,0.923107412,710.8518995,888.8187575,1245.521683,1459.824742,2523,302.8811525,5046,-1192448,99328,-1093120,2
2331,191,21,9,0.0757335448,0.924266455,715.0445317,855.7463673,1248.655513,1418.256545,2522,137.3638344,5044,-1193472,97792,-1095680,2
2339,194,21,9,0.0765890249,0.923410975,714.9218316,899.7947699,1259.39333,1358.71134,2533,304.4471154,5066,-1197568,99328,-1098240,2
2349,200,21,9,0.078462142,0.921537858,721.2826921,860.7855372,1256.813963,1488.595,2549,214.9241147,5098,-1202688,102400,-1100288,2
2481,201,21,9,0.0749440716,0.925055928,759.4456476,925.9828723,1329.996372,1483.492537,2682,334.8314607,5364,-1270272,102912,-1167360,2
2421,222,21,9,0.0839954597,0.91600454,741.3416836,966.3912407,1326.8038,1269.612613,2643,176.671123,5286,-1239552,113664,-1125888,2
2401,200,21,9,0.0768935025,0.923106498,735.7135768,908.115193,1293.360267,1392.715,2601,126.754386,5202,-1229312,102400,-1126912,2
2490,203,21,9,0.0753806164,0.924619384,762.5354919,931.926832,1336.875502,1471.187192,2693,234.991274,5386,-1274880,103936,-1170944,2
2383,197,21,9,0.0763565891,0.923643411,731.4136431,871.7072148,1275.950063,1466.502538,2580,194.4235117,5160,-1220096,100864,-1119232,2
4511,287,18,12,0.0598165902,0.94018341,1371.1713,1586.382232,2395.789625,2457.818815,4798,334.5885635,9596,-2309632,146944,-2162688,2
4495,288,19,11,0.0602132553,0.939786745,1359.046939,1679.784052,2385.172191,2498.565972,4783,200.125523,9566,-2301440,147456,-2153984,2
4490,288,19,11,0.0602762662,0.939723734,1361.929127,1626.096017,2390.339866,2376.40625,4778,343.7410072,9556,-2298880,147456,-2151424,2
4484,290,19,11,0.0607457059,0.939254294,1364.979193,1566.214666,2391.573595,2324.513793,4774,407.337884,9548,-2295808,148480,-2147328,2
4480,281,19,11,0.059021214,0.940978786,1359.055822,1596.95208,2376.061384,2459.736655,4761,250.052521,9522,-2293760,143872,-2149888,2
4477,283,18,12,0.0594537815,0.940546218,1357.540302,1613.524223,2380.358499,2382.738516,4760,352.0710059,9520,-2292224,144896,-2147328,2
4488,286,19,11,0.0599078341,0.940092166,1367.568868,1531.077719,2393.775847,2289.017483,4774,392.5986842,9548,-2297856,146432,-2151424,2
4503,284,19,11,0.0593273449,0.940672655,1368.819054,1574.594281,2394.97002,2378.619718,4787,386.6720517,9574,-2305536,145408,-2160128,2
4474,286,18,12,0.0600840336,0.939915966,1362.908674,1535.861419,2386.097005,2292.944056,4760,396.9974979,9520,-2290688,146432,-2144256,2
4510,273,18,12,0.0570771482,0.942922852,1365.544207,1610.041395,2388.625499,2447.747253,4783,235.8481262,9566,-2309120,139776,-2169344,2
4496,294,18,12,0.0613778706,0.938622129,1367.40693,1599.194489,2395.156361,2400.755102,4790,254.787234,9580,-2301952,150528,-2151424,2
4570,287,18,12,0.0590899732,0.940910027,1390.868001,1567.959343,2433.978993,2349.71777,4857,426.0526316,9714,-2339840,146944,-2192896,2
4508,303,18,12,0.0629806693,0.937019331,1371.510741,1624.184935,2408.540373,2368.20462,4811,442.1875,9622,-2308096,155136,-2152960,2
4565,301,19,11,0.0618577887,0.938142211,1390.606485,1599.257899,2440.704491,2324.23588,4866,352.6086957,9732,-2337280,154112,-2183168,2
4488,286,19,11,0.0599078341,0.940092166,1362.404914,1603.515548,2383.366533,2452.363636,4774,350.5139501,9548,-2297856,146432,-2151424,2
4541,291,19,11,0.0602235099,0.93977649,1381.414226,1590.167854,2417.677164,2398.130584,4832,355.2941176,9664,-2324992,148992,-2176000,2
4510,294,19,11,0.0611990008,0.938800999,1369.124657,1633.55589,2399.861863,2442.969388,4804,391.2052117,9608,-2309120,150528,-2158592,2
4530,276,19,11,0.0574282147,0.942571785,1373.761581,1594.021404,2405.10287,2377.192029,4806,177.0165746,9612,-2319360,141312,-2178048,2
4494,305,18,12,0.0635549073,0.936445093,1369.785976,1595.811684,2404.401424,2335.147541,4799,366.6157372,9598,-2300928,156160,-2144768,2
1564,110,18,12,0.0657108722,0.934289128,472.0066359,585.6323319,851.6227621,636.7,1674,25.35979397,3348,-800768,56320,-744448,2
9568,410,20,10,0.0410903989,0.958909601,2871.947549,2934.243004,5027.535953,4101.870732,9978,1225.798526,19956,-4898816,209920,-4688896,2
9549,428,21,9,0.0428986669,0.957101333,2871.272046,2948.974719,5026.539114,4151.474299,9977,302.8840316,19954,-4889088,219136,-4669952,2
9567,411,21,9,0.0411906194,0.958809381,2875.471821,2887.376485,5022.625902,4218.416058,9978,1059.235669,19956,-4898304,210432,-4687872,2
9553,424,20,10,0.0424977448,0.957502255,2874.228387,2908.827605,5022.544227,4233.226415,9977,911.1415525,19954,-4891136,217088,-4674048,2
9560,418,21,9,0.0418921628,0.958107837,2874.325433,2889.693759,5026.464017,4144.102871,9978,1029.721362,19956,-4894720,214016,-4680704,2
9558,419,21,9,0.0419965922,0.958003408,2873.864292,2897.506708,5025.396003,4158.754177,9977,964.893617,19954,-4893696,214528,-4679168,2
9552,425,21,9,0.0425979753,0.957402025,2873.178594,2927.747258,5023.275649,4218.644706,9977,856.3948498,19954,-4890624,217600,-4673024,2
9555,422,21,9,0.0422972838,0.957702716,2872.829495,2925.283401,5024.807117,4178.248815,9977,1076.26753,19954,-4892160,216064,-4676096,2
9563,414,21,9,0.0414954395,0.95850456,2873.9728,2905.743252,5023.632228,4189.028986,9977,777.6305534,19954,-4896256,211968,-4684288,2
9559,419,20,10,0.0419923832,0.958007617,2869.015767,2946.138439,5034.70635,3958.169451,9978,866.8983493,19956,-4894208,214528,-4679680,2
7168,352,21,9,0.0468085106,0.953191489,2162.990171,2230.410898,3791.950056,3120.0625,7520,168.7612208,15040,-3670016,180224,-3489792,2
9555,422,21,9,0.0422972838,0.957702716,2873.847691,2910.694394,5023.550078,4206.7109,9977,587.573616,19954,-4892160,216064,-4676096,2
9552,425,21,9,0.0425979753,0.957402025,2872.634865,2918.367103,5026.574435,4144.503529,9977,926.369545,19954,-4890624,217600,-4673024,2
9551,426,20,10,0.0426982059,0.957301794,2872.020602,2908.834428,5029.872788,4072.624413,9977,850.5541347,19954,-4890112,218112,-4672000,2
5609,298,21,9,0.0504486203,0.94955138,1705.453798,1614.891059,2981.580674,2434.872483,5907,104.0331103,11814,-2871808,152576,-2719232,2
9564,413,21,9,0.041395209,0.958604791,2874.135714,2907.509663,5022.764534,4207.101695,9977,644.5090439,19954,-4896768,211456,-4685312,2
9555,422,21,9,0.0422972838,0.957702716,2871.013678,2913.659493,5032.012664,4015.099526,9977,965.8276864,19954,-4892160,216064,-4676096,2
2127,148,21,9,0.0650549451,0.934945055,643.7748644,817.8638666,1133.413258,1203.918919,2275,107.5141777,4550,-1089024,75776,-1013248,2
9553,424,21,9,0.0424977448,0.957502255,2871.186644,2919.957822,5030.77965,4047.676887,9977,1060.255048,19954,-4891136,217088,-4674048,2
1567,104,21,9,0.0622381807,0.937761819,473.6571988,575.3584019,846.6081685,676.1634615,1671,24.35505028,3342,-802304,53248,-749056,2
4528,288,21,9,0.0598006645,0.940199336,1376.147644,1591.600059,2401.358436,2520.78125,4816,296.1869619,9632,-2318336,147456,-2170880,2
4522,271,21,9,0.0565407887,0.943459211,1373.250838,1545.515879,2393.929235,2448.239852,4793,216.8778281,9586,-2315264,138752,-2176512,2
4498,293,21,9,0.0611563348,0.938843665,1372.320756,1537.686617,2393.286794,2437.651877,4791,399.5829858,9582,-2302976,150016,-2152960,2
4492,280,21,9,0.0586756077,0.941324392,1358.043503,1655.166397,2379.215939,2503.357143,4772,297.6918278,9544,-2299904,143360,-2156544,2
4482,296,21,9,0.0619506069,0.938049393,1364.125486,1584.355814,2379.972111,2533.77027,4778,84.00140647,9556,-2294784,151552,-2143232,2
4482,278,19,11,0.0584033613,0.941596639,1361.97956,1555.307881,2376.927488,2438.097122,4760,465.2981427,9520,-2294784,142336,-2152448,2
4488,290,21,9,0.0606948514,0.939305149,1364.477882,1588.860091,2384.294786,2470.055172,4778,409.4258783,9556,-2297856,148480,-2149376,2
4533,293,21,9,0.0607128056,0.939287194,1377.623748,1614.322512,2412.588352,2427.604096,4826,257.3866667,9652,-2320896,150016,-2170880,2
4467,279,19,11,0.0587863464,0.941213654,1360.409994,1516.014376,2372.509066,2389.365591,4746,315.1394422,9492,-2287104,142848,-2144256,2
4469,276,21,9,0.058166491,0.941833509,1355.264961,1585.386556,2369.985008,2421.818841,4745,306.5245478,9490,-2288128,141312,-2146816,2
4477,299,21,9,0.0626046901,0.93739531,1362.250789,1597.863985,2378.633683,2536.230769,4776,85.3009466,9552,-2292224,153088,-2139136,2
4489,279,20,10,0.0585151007,0.941484899,1363.432864,1569.553623,2381.338605,2435.365591,4768,436.6300366,9536,-2298368,142848,-2155520,2
4484,290,20,10,0.0607457059,0.939254294,1365.127147,1565.331235,2385.789474,2413.948276,4774,410.4901118,9548,-2295808,148480,-2147328,2
4488,281,21,9,0.0589222059,0.941077794,1365.790106,1540.018791,2382.959002,2417.597865,4769,357.2284644,9538,-2297856,143872,-2153984,2
88,35,20,10,0.284552846,0.715447154,36.24830966,32.40652492,64.94318182,54.6,123,3.515290083,246,-45056,17920,-27136,2
4497,279,21,9,0.0584170854,0.941582915,1362.472109,1614.93974,2382.370692,2487.293907,4776,287.7108434,9552,-2302464,142848,-2159616,2
4486,272,20,10,0.0571668768,0.942833123,1363.260402,1532.118812,2376.818547,2423.724265,4758,394.2004971,9516,-2296832,139264,-2157568,2
4609,284,20,10,0.058042101,0.941957899,1400.76958,1590.307345,2445.078759,2478.179577,4893,208.9239966,9786,-2359808,145408,-2214400,2
4496,287,20,10,0.0600041815,0.939995819,1363.985125,1620.580498,2393.005338,2376.250871,4783,370.2012384,9566,-2301952,146944,-2155008,2
4493,296,20,10,0.0618083107,0.938191689,1367.71487,1589.442042,2396.611841,2370.533784,4789,243.4672089,9578,-2300416,151552,-2148864,2
4487,285,21,9,0.0597233864,0.940276614,1364.480103,1568.901201,2384.782037,2413.547368,4772,393.0807249,9544,-2297344,145920,-2151424,2
4508,291,21,9,0.0606376328,0.939362367,1371.408393,1585.426573,2397.927684,2432.103093,4799,336.7719298,9598,-2308096,148992,-2159104,2
4492,270,21,9,0.056698866,0.943301134,1364.793457,1527.625795,2376.880232,2458.359259,4762,341.8521177,9524,-2299904,138240,-2161664,2
2350,193,19,11,0.0758946127,0.924105387,720.3660124,877.8816457,1263.545106,1374.948187,2543,178.2060266,5086,-1203200,98816,-1104384,2
4601,284,20,10,0.0581371546,0.941862845,1402.635023,1511.354169,2456.143664,2230.06338,4885,85.41703095,9770,-2355712,145408,-2210304,2
4494,282,20,10,0.0590452261,0.940954774,1365.409774,1575.608986,2388.881397,2382.421986,4776,354.5657016,9552,-2300928,144384,-2156544,2
4534,289,19,11,0.0599212109,0.940078789,1380.891407,1560.018226,2413.031098,2395.823529,4823,338.4561404,9646,-2321408,147968,-2173440,2
4395,236,21,9,0.0509609156,0.949039084,1332.069641,1407.220622,2327.063936,2109.957627,4631,422.1513218,9262,-2250240,120832,-2129408,2
1619,92,20,10,0.0537697253,0.946230275,486.2564975,612.9259897,857.2637431,833.7608696,1711,142.2277639,3422,-828928,47104,-781824,2
4486,285,20,10,0.0597359044,0.940264096,1364.339953,1566.266536,2388.479046,2346.978947,4771,455.2480916,9542,-2296832,145920,-2150912,2
4489,294,19,11,0.0614676981,0.938532302,1366.86094,1577.40342,2392.878815,2378.581633,4783,417.7292576,9566,-2298368,150528,-2147840,2
4491,309,21,9,0.064375,0.935625,1360.003439,1671.473948,2374.79047,2774.161812,4800,482.4120603,9600,-2299392,158208,-2141184,2
4512,290,21,9,0.0603915035,0.939608496,1374.046075,1562.491975,2398.115027,2454.165517,4802,141.1107846,9604,-2310144,148480,-2161664,2
4469,293,21,9,0.0615287694,0.938471231,1359.59582,1586.12987,2378.252405,2431.03413,4762,430.5605787,9524,-2288128,150016,-2138112,2
4494,295,20,10,0.0615994989,0.938400501,1367.604112,1591.750273,2394.260792,2406.261017,4789,183.6977369,9578,-2300928,151040,-2149888,2
4466,294,20,10,0.0617647059,0.938235294,1360.144051,1570.78635,2381.280116,2368.64966,4760,329.6398892,9520,-2286592,150528,-2136064,2
1553,102,19,11,0.0616314199,0.93836858,468.1072557,584.3171203,838.2189311,672.4117647,1655,24.54033215,3310,-795136,52224,-742912,2
1557,99,20,10,0.0597826087,0.940217391,468.7937164,571.9002025,840.7122672,636.4343434,1656,26.44100271,3312,-797184,50688,-746496,2
1560,98,20,10,0.0591073583,0.940892642,467.6191741,608.3155055,839.0929487,676.7959184,1658,26.42231076,3316,-798720,50176,-748544,2
4486,285,20,10,0.0597359044,0.940264096,1364.071272,1568.216607,2380.829024,2467.392982,4771,460.9661836,9542,-2296832,145920,-2150912,2
2373,207,20,10,0.0802325581,0.919767442,729.1837578,871.3687886,1270.182891,1523.410628,2580,174.3243243,5160,-1214976,105984,-1108992,2
2411,219,20,10,0.083269962,0.916730038,744.8579886,852.0849875,1289.686022,1599.689498,2630,158.9123867,5260,-1234432,112128,-1122304,2
2395,234,19,11,0.0890072271,0.910992773,737.5356231,917.5778641,1291.844259,1552,2629,46.14709496,5258,-1226240,119808,-1106432,2
2387,208,19,11,0.0801541426,0.919845857,735.0302347,858.7704981,1276.936741,1539.721154,2595,244.1204139,5190,-1222144,106496,-1115648,2
2367,225,20,10,0.0868055556,0.913194444,729.3061044,883.668947,1271.890156,1555.395556,2592,341.0526316,5184,-1211904,115200,-1096704,2
2400,225,19,11,0.0857142857,0.914285714,741.5125604,872.3282734,1288.731667,1571.862222,2625,200.3816794,5250,-1228800,115200,-1113600,2
2370,212,20,10,0.0821068939,0.917893106,729.5548276,860.4491085,1267.908861,1555.231132,2582,115.6291984,5164,-1213440,108544,-1104896,2
2388,225,20,10,0.0861079219,0.913892078,737.9597446,867.6274619,1282.311558,1569.026667,2613,316.3438257,5226,-1222656,115200,-1107456,2
2415,254,19,11,0.0951667291,0.904833271,754.5488696,874.9955531,1310.715114,1565.897638,2669,148.1132075,5338,-1236480,130048,-1106432,2
2399,205,20,10,0.0787250384,0.921274962,735.4447783,887.3599395,1282.28762,1539.034146,2604,232.7077748,5208,-1228288,104960,-1123328,2
2400,213,20,10,0.0815154994,0.918484501,741.2649644,843.8359895,1283.44125,1572.450704,2613,221.6284987,5226,-1228800,109056,-1119744,2
2413,234,20,10,0.0884019645,0.911598036,745.5978836,897.7361018,1300.149192,1569.948718,2647,189.8852224,5294,-1235456,119808,-1115648,2
2423,223,20,10,0.0842781557,0.915721844,749.046702,864.5976211,1298.746595,1592.457399,2646,286.9848156,5292,-1240576,114176,-1126400,2
2393,232,20,10,0.0883809524,0.911619048,741.1602701,878.4499274,1290.443377,1545.663793,2625,279.2553191,5250,-1225216,118784,-1106432,2
2395,225,20,10,0.0858778626,0.914122137,739.9232739,881.1208081,1289.065553,1538.657778,2620,211.631664,5240,-1226240,115200,-1111040,2
2392,225,19,11,0.0859763088,0.914023691,738.7670137,880.6838813,1286.910117,1543.84,2617,228.9588801,5234,-1224704,115200,-1109504,2
2467,239,20,10,0.0883222469,0.911677753,762.5410542,945.0221339,1342.659505,1465.39749,2706,293.8110749,5412,-1263104,122368,-1140736,2
2413,219,20,10,0.0832066869,0.916793313,744.9257789,855.3204736,1290.113137,1607.237443,2632,261.8905473,5264,-1235456,112128,-1123328,2
2396,227,19,11,0.0865421273,0.913457873,741.0769811,879.3090266,1290.754174,1536.251101,2623,228.2854656,5246,-1226752,116224,-1110528,2
2403,226,19,11,0.085964245,0.914035755,742.1694634,892.6614419,1295.592593,1521.353982,2629,124.0679566,5258,-1230336,115712,-1114624,2
4462,282,20,10,0.0594435076,0.940556492,1351.413643,1627.995884,2369.341103,2422.48227,4744,490.5894519,9488,-2284544,144384,-2140160,2
4481,296,19,11,0.0619635755,0.938036425,1364.222717,1585.547723,2391.396786,2352.716216,4777,364.3783371,9554,-2294272,151552,-2142720,2
4477,275,21,9,0.0578703704,0.94212963,1362.076111,1519.914812,2380.142059,2317.207273,4752,149.5750708,9504,-2292224,140800,-2151424,2
4468,298,20,10,0.0625262274,0.937473773,1358.079251,1612.817906,2374.564906,2517.466443,4766,82.61397123,9532,-2287616,152576,-2135040,2
4484,284,20,10,0.0595637584,0.940436242,1363.624681,1564.363152,2384.00959,2392.242958,4768,341.5472779,9536,-2295808,145408,-2150400,2
4499,290,21,9,0.0605554395,0.93944456,1367.436526,1592.004679,2386.647033,2524.586207,4789,352.1323529,9578,-2303488,148480,-2155008,2
4494,289,19,11,0.0604223291,0.939577671,1364.952946,1604.09417,2386.76413,2473.418685,4783,483.1313131,9566,-2300928,147968,-2152960,2
4481,289,19,11,0.0605870021,0.939412998,1363.799223,1567.187251,2384.737559,2397.321799,4770,295.1732673,9540,-2294272,147968,-2146304,2
4483,292,20,10,0.0611518325,0.938848168,1363.646823,1588.037153,2386.957395,2404.006849,4775,205.1998281,9550,-2295296,149504,-2145792,2
4486,283,20,10,0.059341581,0.940658419,1364.143297,1562.122171,2385.946054,2370.003534,4769,458.9990375,9538,-2296832,144896,-2151936,2
4487,276,21,9,0.0579466723,0.942053328,1365.402595,1521.888935,2381.290172,2393.539855,4763,466.503428,9526,-2297344,141312,-2156032,2
4500,290,21,9,0.0605427975,0.939457203,1370.479761,1560.066919,2392.326667,2444.741379,4790,344.1091954,9580,-2304000,148480,-2155520,2
4481,294,20,10,0.0615706806,0.938429319,1368.427012,1522.113742,2390.655657,2347.52381,4775,477.977978,9550,-2294272,150528,-2143744,2
4501,292,19,11,0.0609221782,0.939077822,1368.985458,1591.245147,2393.4008,2452.479452,4793,501.8848168,9586,-2304512,149504,-2155008,2
4466,282,21,9,0.0593934288,0.940606571,1369.303825,1381.591525,2384.628527,2214.095745,4748,88.4336003,9496,-2286592,144384,-2142208,2
4585,288,21,9,0.0591011697,0.94089883,1397.596445,1544.164654,2439.318866,2400.083333,4873,353.628447,9746,-2347520,147456,-2200064,2
4472,275,20,10,0.057931325,0.942068675,1356.752171,1573.830919,2370.462209,2431.530909,4747,521.0757409,9494,-2289664,140800,-2148864,2
4517,285,19,11,0.0593502707,0.940649729,1374.977351,1552.621218,2398.212973,2453.596491,4802,177.2609819,9604,-2312704,145920,-2166784,2
4378,284,21,9,0.0609180609,0.939081939,1333.108589,1527.59543,2334.236866,2289.309859,4662,106.2200957,9324,-2241536,145408,-2096128,2
4466,281,20,10,0.0591952812,0.940804719,1357.167585,1563.914361,2377.371697,2320.412811,4747,434.7069597,9494,-2286592,143872,-2142720,2
235,31,20,10,0.116541353,0.883458647,74.77024219,70.66143575,140.5361702,80.16129032,266,51.953125,532,-120320,15872,-104448,3
240,33,20,10,0.120879121,0.879120879,76.57122501,68.86010092,145.15,77.72727273,273,17.41071429,546,-122880,16896,-105984,3
239,31,21,9,0.114814815,0.885185185,76.3585038,72.39178295,141.8619247,86.4516129,270,44.26229508,540,-122368,15872,-106496,3
246,30,21,9,0.108695652,0.891304348,78.02367482,73.25134811,144.9268293,85.8,276,45.61983471,552,-125952,15360,-110592,3
242,30,20,10,0.110294118,0.889705882,76.55781054,71.34270966,143.446281,80.46666667,272,53.86138614,544,-123904,15360,-108544,3
3243,167,20,10,0.048973607,0.951026393,975.7893295,1138.440583,1705.843047,1698.838323,3410,205.4216867,6820,-1660416,85504,-1574912,3
3264,167,21,9,0.048673856,0.951326144,982.6050237,1132.822375,1715.933517,1717.299401,3431,346.9160768,6862,-1671168,85504,-1585664,3
242,34,20,10,0.123188406,0.876811594,77.97847817,71.31350445,145.9008264,85.82352941,276,49.90958409,552,-123904,17408,-106496,3
250,31,21,9,0.110320285,0.889679715,79.57938185,72.55296963,147.728,86.74193548,281,52.42537313,562,-128000,15872,-112128,3
3162,165,21,9,0.049594229,0.950405771,952.2172406,1105.953483,1664.179001,1660.569697,3327,288.0519481,6654,-1618944,84480,-1534464,3
244,33,20,10,0.119133574,0.880866426,78.3426718,71.42192177,146.1680328,86,277,58.19327731,554,-124928,16896,-108032,3
236,30,20,10,0.112781955,0.887218045,74.98165856,71.25855894,140.029661,82.13333333,266,34.45595855,532,-120832,15360,-105472,3
3184,163,20,10,0.0487003287,0.951299671,957.8240913,1117.069961,1674.891646,1656.582822,3347,452.2972973,6694,-1630208,83456,-1546752,3
243,32,21,9,0.116363636,0.883636364,77.2773811,70.34906688,145.691358,79.59375,275,21.08895706,550,-124416,16384,-108032,3
236,31,20,10,0.116104869,0.883895131,75.48065779,69.9643584,140.6483051,83.38709677,267,27.87056367,534,-120832,15872,-104960,3
239,29,20,10,0.108208955,0.891791045,75.77316122,72.37590142,140.5146444,84.93103448,268,31.30841121,536,-122368,14848,-107520,3
238,29,20,10,0.108614232,0.891385768,75.4729322,70.9734924,140.2058824,83.06896552,267,60.13513514,534,-121856,14848,-107008,3
245,30,20,10,0.109090909,0.890909091,77.45338387,73.01579738,144.7836735,82.6,275,33.37378641,550,-125440,15360,-110080,3
236,31,20,10,0.116104869,0.883895131,75.22652758,72.14583739,140.6271186,83.5483871,267,31.82359952,534,-120832,15872,-104960,3
3205,167,21,9,0.0495255042,0.950474496,966.0451501,1105.020698,1685.171295,1712,3372,110.2681491,6744,-1640960,85504,-1555456,3
3369,277,20,10,0.0759736698,0.92402633,1042.021156,1090.769052,1789.488572,2237.162455,3646,289.1356067,7292,-1724928,141824,-1583104,3
3486,262,20,10,0.0699039488,0.930096051,1071.501574,1147.860891,1846.190763,2251.164122,3748,290.3175833,7496,-1784832,134144,-1650688,3
6085,694,20,10,0.102374982,0.897625018,2010.900622,1390.181318,3374.994412,3521.569164,6779,489.4584838,13558,-3115520,355328,-2760192,3
5825,620,20,10,0.0961986036,0.903801396,1904.175268,1378.775668,3210.164807,3343.58871,6445,400.8084577,12890,-2982400,317440,-2664960,3
3498,287,20,10,0.0758256275,0.924174373,1082.818142,1149.885797,1864.352487,2242.160279,3785,290.9300538,7570,-1790976,146944,-1644032,3
5797,611,20,10,0.095349563,0.904650437,1890.75957,1389.666278,3184.924444,3390.227496,6408,491.7881811,12816,-2968064,312832,-2655232,3
5802,781,21,9,0.118638918,0.881361082,1963.080166,1313.696055,3255.145467,3565.790013,6583,512.694704,13166,-2970624,399872,-2570752,3
3500,275,20,10,0.0728476821,0.927152318,1076.647158,1180.48697,1858.191429,2267.381818,3775,270.2219041,7550,-1792000,140800,-1651200,3
5787,685,20,10,0.105840544,0.894159456,1921.710426,1321.730708,3215.972525,3409.919708,6472,422.1787345,12944,-2962944,350720,-2612224,3
3321,268,21,9,0.0746726108,0.925327389,1022.171462,1114.949036,1761.665462,2208.074627,3589,247.5172414,7178,-1700352,137216,-1563136,3
6823,581,21,9,0.0784710967,0.921528903,2161.839646,1825.297509,3701.452294,3714.803787,7404,133.1415213,14808,-3493376,297472,-3195904,3
7181,678,20,10,0.0862705179,0.913729482,2300.141202,1902.021988,3922.05988,4014.097345,7859,306.1550448,15718,-3676672,347136,-3329536,3
6901,687,20,10,0.0905376911,0.909462309,2244.056871,1546.80128,3807.366614,3665.253275,7588,494.0104167,15176,-3533312,351744,-3181568,3
5877,617,21,9,0.0950107792,0.904989221,1917.505676,1394.90966,3233.092734,3384.730956,6494,368.3494044,12988,-3009024,315904,-2693120,3
7053,904,20,10,0.113610657,0.886389343,2375.222986,1555.929199,3986.010067,3924.307522,7957,394.8883375,15914,-3611136,462848,-3148288,3
3394,272,20,10,0.0741953082,0.925804692,1047.500428,1125.105393,1804.914555,2190.1875,3666,162.4280018,7332,-1737728,139264,-1598464,3
5727,596,20,10,0.0942590542,0.905740946,1862.13207,1413.846796,3145.599965,3319.588926,6323,398.4247007,12646,-2932224,305152,-2627072,3
5822,585,20,10,0.0913063836,0.908693616,1885.485026,1435.123506,3188.809172,3355.181197,6407,394.2769231,12814,-2980864,299520,-2681344,3
3419,272,21,9,0.0736927662,0.926307234,1056.849813,1122.578938,1821.086575,2159.158088,3691,169.4674013,7382,-1750528,139264,-1611264,3
238,29,20,10,0.108614232,0.891385768,74.02118477,84.78228395,139.7983193,86.4137931,267,3.678192589,534,-121856,14848,-107008,3
9502,463,21,9,0.0464626192,0.953537381,2850.845193,3281.740655,5017.906441,4266.62635,9965,1421.540656,19930,-4865024,237056,-4627968,3
9368,555,21,9,0.0559306661,0.944069334,2832.409588,3204.276648,5020.311913,3977.736937,9923,179.9927444,19846,-4796416,284160,-4512256,3
9447,516,21,9,0.051791629,0.948208371,2852.769101,3041.335012,5046.398328,3802.986434,9963,704.0989399,19926,-4836864,264192,-4572672,3
9421,541,21,9,0.0543063642,0.945693636,2852.365423,3051.578133,5045.019,3875.377079,9962,1181.73191,19924,-4823552,276992,-4546560,3
9442,521,21,9,0.0522934859,0.947706514,2852.624077,3091.790253,5039.524995,3939.483685,9963,1254.785894,19926,-4834304,266752,-4567552,3
9434,529,21,9,0.0530964569,0.946903543,2853.042005,2999.54302,5051.60706,3740.652174,9963,761.6972477,19926,-4830208,270848,-4559360,3
9430,535,20,10,0.0536879077,0.946312092,2852.542859,3072.251315,5045.209756,3886.480374,9965,807.5364668,19930,-4828160,273920,-4554240,3
9468,496,21,9,0.0497792051,0.950220795,2855.025203,3053.510255,5040.35488,3878.125,9964,1364.931507,19928,-4847616,253952,-4593664,3
9425,537,21,9,0.0539048384,0.946095162,2854.883422,2967.000432,5050.917454,3763.139665,9962,1827.889908,19924,-4825600,274944,-4550656,3
9430,535,21,9,0.0536879077,0.946312092,2840.814577,3292.034322,5039.519512,3986.77757,9965,342.2046703,19930,-4828160,273920,-4554240,3
9426,537,20,10,0.0538994279,0.946100572,2860.878321,2927.0496,5043.556758,3901.489758,9963,1128.312571,19926,-4826112,274944,-4551168,3
9487,477,21,9,0.0478723404,0.95212766,2857.554962,3048.974139,5034.45926,3949.08805,9964,1203.381643,19928,-4857344,244224,-4613120,3
9458,506,21,9,0.0507828181,0.949217182,2850.831313,3009.452427,5055.275428,3622.203557,9964,1302.48366,19928,-4842496,259072,-4583424,3
9434,528,21,9,0.0530014053,0.946998595,2857.394116,2950.91079,5046.989082,3811.378788,9962,709.0391459,19924,-4830208,270336,-4559872,3
9445,519,21,9,0.0520875151,0.947912485,2854.577995,3024.927122,5045.685866,3832.614644,9964,760.610687,19928,-4835840,265728,-4570112,3
9445,518,21,9,0.0519923718,0.948007628,2845.235572,3218.959815,5038.682583,3948.472973,9963,742.9530201,19926,-4835840,265216,-4570624,3
9486,479,21,9,0.0480682388,0.951931761,2858.561072,3024.221079,5036.595615,3921.605428,9965,1040.187891,19930,-4856832,245248,-4611584,3
9444,517,21,9,0.0519024194,0.948097581,2854.348662,3073.507721,5035.231999,3990.348162,9961,895.7733813,19922,-4835328,264704,-4570624,3
160,27,21,9,0.144385027,0.855614973,50.45592097,71.24726549,94.69375,89.88888889,187,3.108894431,374,-81920,13824,-68096,3
9450,512,21,9,0.0513953021,0.948604698,2851.282336,3000.106691,5053.45164,3653.486328,9962,1116.816143,19924,-4838400,262144,-4576256,3
828,59,21,9,0.0665163472,0.933483653,251.7392516,271.095703,454.4009662,298.0338983,887,22.54129606,1774,-423936,30208,-393728,3
3011,147,20,10,0.0465484484,0.953451552,906.1106769,1016.378621,1582.430754,1519.469388,3158,200.3807107,6316,-1541632,75264,-1466368,3
3056,144,20,10,0.045,0.955,917.363948,1050.014873,1601.742801,1574.125,3200,174.1970604,6400,-1564672,73728,-1490944,3
3037,214,20,10,0.0658258997,0.9341741,912.6592452,1196.943439,1601.779058,1969.733645,3251,81.41748059,6502,-1554944,109568,-1445376,3
3041,155,20,10,0.0484981227,0.951501877,915.1341694,1049.178137,1605.49852,1461.193548,3196,230.7581227,6392,-1556992,79360,-1477632,3
2464,118,20,10,0.045701007,0.954298993,737.2608208,877.0597523,1300.504058,1103.483051,2582,44.3718852,5164,-1261568,60416,-1201152,3
3001,145,20,10,0.0460902734,0.953909727,900.316986,1050.441871,1579.347551,1452.475862,3146,405.9354839,6292,-1536512,74240,-1462272,3
3058,229,21,9,0.0696683906,0.930331609,921.7845401,1165.562935,1610.232505,2094.921397,3287,66.99959234,6574,-1565696,117248,-1448448,3
2997,141,21,9,0.0449330784,0.955066922,899.8246181,1025.663436,1570.34668,1551.503546,3138,204.4299674,6276,-1534464,72192,-1462272,3
2989,140,21,9,0.0447427293,0.955257271,895.7317318,1046.670077,1569.506189,1468.792857,3129,254.5972335,6258,-1530368,71680,-1458688,3
2974,145,20,10,0.0464892594,0.953510741,893.5893925,1026.731009,1563.77236,1482.627586,3119,273.5964912,6238,-1522688,74240,-1448448,3
3037,207,20,10,0.063810111,0.936189889,911.1276258,1157.402191,1591.278894,2080.560386,3244,81.2421738,6488,-1554944,105984,-1448960,3
2976,144,21,9,0.0461538462,0.953846154,893.2498759,1038.323319,1564.738911,1472.895833,3120,474.1641337,6240,-1523712,73728,-1449984,3
3036,147,21,9,0.0461828464,0.953817154,911.786449,1051.973614,1595.280632,1524.244898,3183,186.2492686,6366,-1554432,75264,-1479168,3
3003,138,20,10,0.0439350525,0.956064947,900.0972859,1039.451557,1573.21312,1522.84058,3141,237.5945537,6282,-1537536,70656,-1466880,3
3056,154,20,10,0.0479750779,0.952024922,919.6756958,1051.249752,1610.157723,1513.071429,3210,190.1658768,6420,-1564672,78848,-1485824,3
2993,142,21,9,0.0452950558,0.954704944,898.371121,1033.033369,1570.817574,1508.612676,3135,196.6750314,6270,-1532416,72704,-1459712,3
3029,152,21,9,0.0477837158,0.952216284,910.2326433,1059.313895,1596.825025,1474.921053,3181,295.9069767,6362,-1550848,77824,-1473024,3
2986,142,20,10,0.0453964194,0.954603581,896.523627,1028.467031,1566.455459,1523.380282,3128,339.630836,6256,-1528832,72704,-1456128,3
2984,144,21,9,0.0460358056,0.953964194,896.1267903,1032.979877,1567.350536,1505.430556,3128,297.338403,6256,-1527808,73728,-1454080,3
9348,607,21,9,0.0609743847,0.939025615,2839.064951,2914.579754,5083.595421,3351.795717,9955,743.4652726,19910,-4786176,310784,-4475392,3
1306,264,20,10,0.168152866,0.831847134,458.9182268,416.6000948,799.9464012,714.0340909,1570,28.29848594,3140,-668672,135168,-533504,3
9337,618,21,9,0.0620793571,0.937920643,2842.00848,2903.895188,5080.719931,3426.064725,9955,646.009085,19910,-4780544,316416,-4464128,3
9447,516,21,9,0.051791629,0.948208371,2848.342016,3110.059007,5047.256589,3787.273256,9963,1433.52518,19926,-4836864,264192,-4572672,3
9361,597,21,9,0.0599517975,0.940048202,2843.514845,2899.337413,5080.098814,3402.103853,9958,801.7713366,19916,-4792832,305664,-4487168,3
9387,573,21,9,0.0575301205,0.94246988,2836.111308,2963.845224,5085.510919,3260.190227,9960,869.1099476,19920,-4806144,293376,-4512768,3
9385,570,21,9,0.0572576595,0.942742341,2838.278749,3091.35889,5062.207352,3591.533333,9955,701.5503876,19910,-4805120,291840,-4513280,3
9345,610,21,9,0.0612757408,0.938724259,2837.420111,3030.787969,5072.916854,3523.904918,9955,1850.371747,19910,-4784640,312320,-4472320,3
9381,576,21,9,0.0578487496,0.94215125,2843.652828,3015.620549,5063.819529,3597.590278,9957,874.9560633,19914,-4803072,294912,-4508160,3
5890,511,21,9,0.0798312764,0.920168724,1824.003139,1818.042544,3288.943294,2187.328767,6401,112.9123302,12802,-3015680,261632,-2754048,3
9419,541,21,9,0.0543172691,0.945682731,2840.000844,3007.111831,5072.736809,3374.624769,9960,1046.218487,19920,-4822528,276992,-4545536,3
9328,627,21,9,0.0629834254,0.937016575,2836.825756,2998.53399,5078.908984,3476.757576,9955,1241.27182,19910,-4775936,321024,-4454912,3
9337,617,21,9,0.0619851316,0.938014868,2845.029404,2913.165057,5073.109136,3530.656402,9954,1203.62757,19908,-4780544,315904,-4464640,3
9357,598,21,9,0.0600703164,0.939929684,2841.154241,2981.536008,5071.65427,3512.576923,9955,738.5014837,19910,-4790784,306176,-4484608,3
9375,584,21,9,0.0586404257,0.941359574,2846.136205,2982.918764,5065.697173,3604.296233,9959,1406.638418,19918,-4800000,299008,-4500992,3
9349,606,21,9,0.0608739327,0.939126067,2836.768808,3014.936665,5075.872179,3468.087459,9955,1149.538106,19910,-4786688,310272,-4476416,3
9394,559,21,9,0.0561639707,0.943836029,2839.310977,3107.640307,5055.620183,3655.78712,9953,1675.589226,19906,-4809728,286208,-4523520,3
9380,577,21,9,0.0579491815,0.942050819,2841.226939,3063.926281,5062.388806,3623.389948,9957,874.9560633,19914,-4802560,295424,-4507136,3
1049,250,21,9,0.192455735,0.807544265,384.0198947,334.4385214,650.5061964,647.876,1299,23.16746923,2598,-537088,128000,-409088,3
9426,536,21,9,0.0538044569,0.946195543,2849.02717,3038.423288,5054.287184,3701.477612,9962,1004.233871,19924,-4826112,274432,-4551680,3
256,35,21,9,0.120274914,0.879725086,83.07079623,82.78960794,150.6992188,111.6285714,291,85.58823529,582,-131072,17920,-113152,3
259,38,20,10,0.127946128,0.872053872,84.28042951,85.6331519,154.6563707,110.4473684,297,48.13614263,594,-132608,19456,-113152,3
2724,205,20,10,0.0699897576,0.930010242,817.3732018,1087.531749,1436.487518,1843.868293,2929,62.89456732,5858,-1394688,104960,-1289728,3
252,36,21,9,0.125,0.875,82.15082882,80.74553747,149.734127,107.8611111,288,49.74093264,576,-129024,18432,-110592,3
247,35,20,10,0.124113475,0.875886525,80.55037653,78.30025934,146.5910931,105.5714286,282,52.6119403,564,-126464,17920,-108544,3
253,38,20,10,0.130584192,0.869415808,82.76121197,80.29964658,152.2450593,104.4210526,291,45.04643963,582,-129536,19456,-110080,3
253,34,21,9,0.118466899,0.881533101,81.56490863,81.49596122,149.3438735,104.2352941,287,45.12578616,574,-129536,17408,-112128,3
261,36,20,10,0.121212121,0.878787879,84.57298958,85.18704909,154.0574713,112.3333333,297,35.31510107,594,-133632,18432,-115200,3
256,37,21,9,0.126279863,0.873720137,83.64750608,80.06045013,152.78125,107,293,48.03278689,586,-131072,18944,-112128,3
2662,141,21,9,0.0503032465,0.949696753,798.1618469,989.2147563,1396.885049,1498.567376,2803,49.93764475,5606,-1362944,72192,-1290752,3
1877,91,20,10,0.0462398374,0.953760163,562.5659001,603.2274017,998.5636654,694.4175824,1968,34.83802443,3936,-961024,46592,-914432,3
254,37,21,9,0.127147766,0.872852234,82.62186677,86.21203921,150.7244094,113.5675676,291,49.3220339,582,-130048,18944,-111104,3
2656,136,20,10,0.0487106017,0.951289398,795.2167096,992.9112947,1397.413027,1378.669118,2792,309.8779134,5584,-1359872,69632,-1290240,3
2662,142,20,10,0.0506419401,0.94935806,798.9411191,985.6822957,1403.459805,1384.507042,2804,200.2857143,5608,-1362944,72704,-1290240,3
253,35,21,9,0.121527778,0.878472222,82.19211965,80.19788791,149.7035573,106.8857143,288,27.37642586,576,-129536,17920,-111616,3
2724,201,21,9,0.0687179487,0.931282051,816.6306763,1055.564903,1429.352423,1919,2925,61.78707224,5850,-1394688,102912,-1291776,3
251,34,20,10,0.119298246,0.880701754,80.46374729,86.29985646,147.9123506,106.7352941,285,37.74834437,570,-128512,17408,-111104,3
253,39,20,10,0.133561644,0.866438356,83.209685,83.2140211,151.7865613,112.2051282,292,64.03508772,584,-129536,19968,-109568,3
52,19,20,10,0.267605634,0.732394366,20.79666102,18.12636469,38.36538462,29.52631579,71,1.511925043,142,-26624,9728,-16896,3
264,40,20,10,0.131578947,0.868421053,85.66075946,95.1771736,157.0568182,122.425,304,4.867894315,608,-135168,20480,-114688,3
9470,499,20,10,0.050055171,0.949944829,2853.597798,2969.357141,5059.377402,3573.468938,9969,935.1782364,19938,-4848640,255488,-4593152,3
9435,530,21,9,0.0531861515,0.946813848,2847.656621,2928.193087,5072.064547,3397.483019,9965,499.7492477,19930,-4830720,271360,-4559360,3
9435,530,21,9,0.0531861515,0.946813848,2850.336914,2950.100237,5065.069952,3522,9965,1057.855626,19930,-4830720,271360,-4559360,3
9470,499,22,8,0.050055171,0.949944829,2855.294697,2942.964071,5058.882788,3582.855711,9969,1283.011583,19938,-4848640,255488,-4593152,3
3973,359,21,9,0.0828716528,0.917128347,1235.666791,1266.867248,2219.005034,1585.43454,4332,78.86400874,8664,-2034176,183808,-1850368,3
9474,493,21,9,0.0494632287,0.950536771,2853.671449,2953.666924,5058.360249,3555.016227,9967,554.6466333,19934,-4850688,252416,-4598272,3
5801,409,21,9,0.0658615137,0.934138486,1774.491523,1854.673481,3162.256852,2300.496333,6210,132.9479769,12420,-2970112,209408,-2760704,3
9461,506,22,8,0.0507675329,0.949232467,2853.023014,2985.723593,5056.893352,3621.067194,9967,922.8703704,19934,-4844032,259072,-4584960,3
9476,491,22,8,0.0492625665,0.950737434,2852.34028,3037.190969,5051.88835,3673.796334,9967,878.1497797,19934,-4851712,251392,-4600320,3
9458,509,20,10,0.0510685261,0.948931474,2849.312044,2967.672076,5065.91531,3461.888016,9967,711.420414,19934,-4842496,260608,-4581888,3
9526,446,22,8,0.0447252306,0.955274769,2854.221552,3059.039598,5049.947932,3631.331839,9972,738.6666667,19944,-4877312,228352,-4648960,3
9444,523,21,9,0.0524731614,0.947526839,2849.737405,2941.838821,5068.662643,3455.216061,9967,390.7095257,19934,-4835328,267776,-4567552,3
9470,497,20,10,0.049864553,0.950135447,2853.278389,2963.129624,5058.362408,3567.074447,9967,835.4568315,19934,-4848640,254464,-4594176,3
9458,509,21,9,0.0510685261,0.948931474,2852.234008,2975.400982,5059.717171,3577.058939,9967,802.4959742,19934,-4842496,260608,-4581888,3
9448,516,21,9,0.0517864312,0.948213569,2849.855797,2986.60224,5060.160775,3560.525194,9964,844.4067797,19928,-4837376,264192,-4573184,3
9456,511,20,10,0.0512691883,0.948730812,2852.593065,3028.765397,5052.966053,3707.790607,9967,1014.96945,19934,-4841472,261632,-4579840,3
9428,533,20,10,0.0535086839,0.946491316,2850.10966,2922.7482,5064.353627,3506.594747,9961,1002.112676,19922,-4827136,272896,-4554240,3
9447,519,21,9,0.052077062,0.947922938,2853.226382,2985.99339,5055.929184,3665.121387,9966,1046.848739,19932,-4836864,265728,-4571136,3
9465,502,21,9,0.0503662085,0.949633792,2852.189486,3010.765814,5055.582673,3634.338645,9967,887.5333927,19934,-4846080,257024,-4589056,3
9464,502,21,9,0.0503712623,0.949628738,2856.827265,2973.577511,5049.052937,3747.657371,9966,792.8400955,19932,-4845568,257024,-4588544,3
2959,137,21,9,0.044250646,0.955749354,888.256795,1004.497234,1549.717134,1522.211679,3096,257.5707155,6192,-1515008,70144,-1444864,3
3114,153,20,10,0.0468319559,0.953168044,935.0924003,1093.418331,1633.683044,1640.45098,3267,56.87674095,6534,-1594368,78336,-1516032,3
2967,136,21,9,0.043828553,0.956171447,890.1034268,1010.74739,1553.496461,1519.352941,3103,339.1256831,6206,-1519104,69632,-1449472,3
3003,194,21,9,0.0606818893,0.939318111,908.531303,1039.359365,1572.536131,2008.64433,3197,75.09983556,6394,-1537536,99328,-1438208,3
3005,212,20,10,0.0658999067,0.934100093,903.5851664,1147.484879,1578.726123,2038.117925,3217,57.99531278,6434,-1538560,108544,-1430016,3
2952,142,20,10,0.0458952812,0.954104719,887.4349478,1004.327778,1548.995257,1516.415493,3094,327.4074074,6188,-1511424,72704,-1438720,3
3019,211,21,9,0.0653250774,0.934674923,914.3405037,1092.679209,1589.052666,1993.909953,3230,82.67212695,6460,-1545728,108032,-1437696,3
2966,137,21,9,0.0441508218,0.955849178,889.9447004,1012.638785,1553.874241,1511.423358,3103,365.4888104,6206,-1518592,70144,-1448448,3
2976,138,21,9,0.0443159923,0.955684008,892.8864424,1019.053278,1560.107863,1501.26087,3114,208.5733423,6228,-1523712,70656,-1453056,3
2974,137,21,9,0.044037287,0.955962713,892.9041802,1003.624088,1555.720915,1562.058394,3111,454.1605839,6222,-1522688,70144,-1452544,3
2953,138,21,9,0.0446457457,0.955354254,886.3910591,1009.729739,1547.671859,1510.224638,3091,376.9512195,6182,-1511936,70656,-1441280,3
3045,141,21,9,0.0442561205,0.955743879,914.1562495,1032.385433,1594.367488,1574.765957,3186,208.2352941,6372,-1559040,72192,-1486848,3
3039,138,20,10,0.0434372049,0.956562795,912.2205976,1018.999223,1589.56104,1576.644928,3177,176.0110803,6354,-1555968,70656,-1485312,3
3069,138,21,9,0.04303087,0.95696913,921.3622634,1019.044814,1604.519713,1592.442029,3207,325.9146341,6414,-1571328,70656,-1500672,3
3094,211,21,9,0.0638426626,0.936157337,937.4855485,1110.773715,1628.624434,2010.43128,3305,68.1443299,6610,-1584128,108032,-1476096,3
2957,136,21,9,0.0439702554,0.956029745,886.899915,1011.796298,1550.048698,1480.713235,3093,365.6028369,6186,-1513984,69632,-1444352,3
3048,143,21,9,0.0448135381,0.955186462,915.2115289,1039.787136,1596.802822,1578.888112,3191,279.6669588,6382,-1560576,73216,-1487360,3
2972,137,21,9,0.044065616,0.955934384,891.4025958,1019.832473,1556.860363,1514.642336,3109,240.4485692,6218,-1521664,70144,-1451520,3
2963,135,21,9,0.043576501,0.956423499,890.0741741,982.5635918,1548.526493,1570.866667,3098,376.4277035,6196,-1517056,69120,-1447936,3
3057,209,21,9,0.0639926516,0.936007348,925.7759595,1100.573132,1608.462872,1999.712919,3266,75.91817759,6532,-1565184,107008,-1458176,3
2986,144,21,9,0.0460063898,0.95399361,896.3836287,1041.034777,1564.759879,1580.847222,3130,55.67413732,6260,-1528832,73728,-1455104,3
3060,207,21,9,0.0633608815,0.936639118,925.6057207,1102.87772,1608.107516,2016.758454,3267,83.68340164,6534,-1566720,105984,-1460736,3
3012,142,21,9,0.045022194,0.954977806,904.2420106,1033.5333,1578.921979,1547.338028,3154,381.3784764,6308,-1542144,72704,-1469440,3
2999,209,21,9,0.0651496259,0.934850374,908.5038403,1074.212661,1577.039013,1998.545455,3208,78.09152872,6416,-1535488,107008,-1428480,3
2992,201,21,9,0.0629502036,0.937049796,906.3216517,1049.55632,1570.378342,1993.278607,3193,78.95647873,6386,-1531904,102912,-1428992,3
3023,209,20,10,0.0646658416,0.935334158,916.7716426,1075.729233,1590.826331,1987.84689,3232,83.57900181,6464,-1547776,107008,-1440768,3
2968,134,21,9,0.0431979368,0.956802063,891.3252103,982.7498129,1551.02965,1561.91791,3102,483.1775701,6204,-1519616,68608,-1451008,3
3016,139,21,9,0.0440570523,0.955942948,905.3944933,1020.432955,1578.320292,1571.05036,3155,370.7403055,6310,-1544192,71168,-1473024,3
3043,145,21,9,0.0454830615,0.954516939,915.1327907,1021.046048,1597.174827,1538.365517,3188,61.842871,6376,-1558016,74240,-1483776,3
3038,204,20,10,0.0629241209,0.937075879,919.1635699,1068.716267,1592.747202,2049.691176,3242,74.28964253,6484,-1555456,104448,-1451008,3
2971,139,21,9,0.0446945338,0.955305466,891.677933,1018.865008,1557.148771,1520.258993,3110,200.9043928,6220,-1521152,71168,-1449984,3
2971,139,20,10,0.0446945338,0.955305466,891.8473235,1014.980532,1557.894985,1504.309353,3110,341.7582418,6220,-1521152,71168,-1449984,3
3024,143,21,9,0.0451531418,0.954846858,908.4369854,1029.064867,1584.790013,1567.293706,3167,364.8617512,6334,-1548288,73216,-1475072,3
2969,136,21,9,0.0438003221,0.956199678,891.0707922,1004.12076,1551.883126,1577.382353,3105,260.9243697,6210,-1520128,69632,-1450496,3
2971,136,21,9,0.0437721275,0.956227873,892.0551702,996.5220514,1552.404578,1588.852941,3107,535.6896552,6214,-1521152,69632,-1451520,3
3044,210,21,9,0.0645359557,0.935464044,915.6390734,1150.318563,1597.909658,2056.419048,3254,57.34931265,6508,-1558528,107520,-1451008,3
2971,136,21,9,0.0437721275,0.956227873,891.9109702,999.9659797,1554.169303,1550.301471,3107,262.8595601,6214,-1521152,69632,-1451520,3
3066,210,21,9,0.0641025641,0.935897436,927.8333111,1122.807239,1615.321592,1976.904762,3276,74.01717126,6552,-1569792,107520,-1462272,3
2976,134,21,9,0.0430868167,0.956913183,892.5159516,1007.586296,1555.145497,1563.373134,3110,380.195599,6220,-1523712,68608,-1455104,3
2998,142,20,10,0.0452229299,0.95477707,900.4777346,1023.424719,1572.399266,1530.401408,3140,291.5506035,6280,-1534976,72704,-1462272,3
3020,204,20,10,0.0632754342,0.936724566,908.6477348,1115.760316,1581.736424,2067.921569,3224,78.32847425,6448,-1546240,104448,-1441792,3
2984,134,21,9,0.0429762668,0.957023733,894.2026526,1020.717212,1556.902815,1617.335821,3118,211.3898305,6236,-1527808,68608,-1459200,3
3026,206,21,9,0.0637376238,0.936262376,916.0959074,1083.650438,1590.542961,1997.791262,3232,75.47874825,6464,-1549312,105472,-1443840,3
3042,142,21,9,0.0445979899,0.95540201,913.5963833,1030.604412,1593.402038,1573.176056,3184,203.7108125,6368,-1557504,72704,-1484800,3
2979,133,21,9,0.0427377892,0.957262211,893.8065292,994.7943927,1556.919436,1547.105263,3112,333.5476956,6224,-1525248,68096,-1457152,3
2987,134,21,9,0.0429349567,0.957065043,896.7800698,988.9266926,1559.578172,1592.69403,3121,352.2573363,6242,-1529344,68608,-1460736,3
3043,135,21,9,0.0424795469,0.957520453,911.0840348,1049.925455,1589.394019,1591.888889,3178,69.5404814,6356,-1558016,69120,-1488896,3
2972,134,21,9,0.0431423052,0.956857695,891.2307374,1008.824902,1553.950538,1543.507463,3106,278.5650224,6212,-1521664,68608,-1453056,3
2958,133,21,9,0.0430281462,0.956971854,887.9505395,983.9064445,1545.511494,1556.864662,3091,392.7573062,6182,-1514496,68096,-1446400,3
3050,143,20,10,0.0447854682,0.955214532,915.6378448,1042.113354,1599.392787,1545.965035,3193,350.8791209,6386,-1561600,73216,-1488384,3
3012,200,21,9,0.0622665006,0.937733499,910.9255238,1072.38056,1580.704183,1994.985,3212,82.00153178,6424,-1542144,102400,-1439744,3
2981,132,21,9,0.0424028269,0.957597173,893.8330821,1001.115871,1556.479369,1568.757576,3113,322.9253112,6226,-1526272,67584,-1458688,3
3005,200,21,9,0.0624024961,0.937597504,902.4618688,1103.127927,1569.911148,2100.16,3205,86.57482442,6410,-1538560,102400,-1436160,3
3239,206,20,10,0.059796807,0.940203193,981.1316309,1104.922008,1696.620871,2137.76699,3445,90.65789474,6890,-1658368,105472,-1552896,3
2992,204,21,9,0.0638297872,0.936170213,905.6502848,1074.487777,1572.837233,1974.887255,3196,75.77050735,6392,-1531904,104448,-1427456,3
2969,136,21,9,0.0438003221,0.956199678,890.9231079,1003.152175,1548.91647,1642.147059,3105,56.1482821,6210,-1520128,69632,-1450496,3
3005,200,21,9,0.0624024961,0.937597504,908.3997359,1061.558695,1574.75807,2027.335,3205,83.31167143,6410,-1538560,102400,-1436160,3
3071,207,21,9,0.0631482611,0.936851739,929.1174782,1105.365807,1614.144904,2015.661836,3278,77.82526116,6556,-1572352,105984,-1466368,3
2969,132,21,9,0.0425669139,0.957433086,890.8963262,986.3759855,1549.967329,1574.227273,3101,296.1795606,6202,-1520128,67584,-1452544,3
179,16,23,7,0.0820512821,0.917948718,54.97201765,62.24419526,100.6201117,68.6875,195,3.082516598,390,-91648,8192,-83456,3
1003,141,20,10,0.123251748,0.876748252,322.0431485,356.2530226,591.2073779,439.4255319,1144,139.1727494,2288,-513536,72192,-441344,4
965,133,19,11,0.121129326,0.878870674,307.117753,369.0383834,561.6673575,461.2180451,1098,76.56903766,2196,-494080,68096,-425984,4
975,150,19,11,0.133333333,0.866666667,314.5524945,368.0397858,578.9682051,459.2066667,1125,87.14175058,2250,-499200,76800,-422400,4
1173,215,19,11,0.154899135,0.845100865,391.2039396,448.7262315,692.5464621,705.1581395,1388,87.79253637,2776,-600576,110080,-490496,4
1050,150,20,10,0.125,0.875,338.9451312,389.1944552,609.3038095,538.8733333,1200,78.99934167,2400,-537600,76800,-460800,4
1198,215,19,11,0.152158528,0.847841472,397.2184512,462.9115667,706.6978297,708.6837209,1413,80.6046777,2826,-613376,110080,-503296,4
1064,167,19,11,0.135662063,0.864337937,346.3359077,405.6904684,622.5817669,574.0658683,1231,105.5746141,2462,-544768,85504,-459264,4
970,140,19,11,0.126126126,0.873873874,309.0682741,376.0091236,569.5494845,458.1571429,1110,95.77221743,2220,-496640,71680,-424960,4
1062,163,20,10,0.133061224,0.866938776,348.0662551,381.121147,623.3258004,545.7239264,1225,126.8115942,2450,-543744,83456,-460288,4
1048,145,19,11,0.12154233,0.87845767,335.4753129,395.4394081,607.0725191,524.2,1193,149.4987469,2386,-536576,74240,-462336,4
1180,213,20,10,0.152907394,0.847092606,391.5518361,456.1852604,695.4661017,705.4976526,1393,63.46241458,2786,-604160,109056,-495104,4
939,111,20,10,0.105714286,0.894285714,295.2252715,360.7198254,530.0532481,486.981982,1050,93.25044405,2100,-480768,56832,-423936,4
1171,218,20,10,0.156947444,0.843052556,391.0291994,450.3033349,692.0742955,710.7155963,1389,89.43979395,2778,-599552,111616,-487936,4
1300,263,19,11,0.168266155,0.831733845,440.508578,495.3938022,768.5853846,848.3079848,1563,120.1383551,3126,-665600,134656,-530944,4
849,116,19,11,0.120207254,0.879792746,270.2843124,318.9716452,495.2579505,393.2844828,965,22.46798603,1930,-434688,59392,-375296,4
1063,166,20,10,0.135069162,0.864930838,347.2801955,392.021479,626.1683913,543.4819277,1229,106.1312608,2458,-544256,84992,-459264,4
1045,158,21,9,0.131338321,0.868661679,338.5941208,396.0319469,609.9004785,549.7468354,1203,107.989228,2406,-535040,80896,-454144,4
973,137,21,9,0.123423423,0.876576577,310.9865161,366.503007,569.1336074,458.6715328,1110,29.87886945,2220,-498176,70144,-428032,4
1273,229,21,9,0.152463382,0.847536618,428.695386,444.1986749,731.8004713,861.0087336,1502,108.2132565,3004,-651776,117248,-534528,4
485,78,20,10,0.138543517,0.861456483,156.3010755,173.6211311,295.8474227,195.8974359,563,8.909637601,1126,-248320,39936,-208384,4
1075,156,23,7,0.126726239,0.873273761,354.8790312,346.336258,628.6344186,528.9358974,1231,119.0522244,2462,-550400,79872,-470528,4
1365,274,22,8,0.167175107,0.832824893,454.2698003,537.1175535,792.4974359,957.0109489,1639,40.44916091,3278,-698880,140288,-558592,4
1387,280,22,8,0.167966407,0.832033593,464.4804379,547.5108739,815.3749099,926.2607143,1667,41.48830264,3334,-710144,143360,-566784,4
962,138,22,8,0.125454545,0.874545455,318.6302596,291.8502342,564.462578,453.1666667,1100,121.8161683,2200,-492544,70656,-421888,4
1037,138,23,7,0.117446809,0.882553191,340.0756673,319.3358703,599.5747348,501.0217391,1175,165.960452,2350,-530944,70656,-460288,4
1012,138,23,7,0.12,0.88,331.5148373,314.6751262,590.326087,466.7753623,1150,201.754386,2300,-518144,70656,-447488,4
1404,277,23,7,0.164782867,0.835217133,467.5954306,558.1821954,823.6680912,928.8483755,1681,42.94839039,3362,-718848,141824,-577024,4
991,128,22,8,0.114387846,0.885612154,323.2645631,302.5073006,573.1190716,458.4296875,1119,227.9022403,2238,-507392,65536,-441856,4
1044,148,22,8,0.124161074,0.875838926,344.8506308,319.2441078,611.5354406,490.4391892,1192,276.5661253,2384,-534528,75776,-458752,4
1030,136,22,8,0.116638079,0.883361921,336.688598,320.881319,595.8194175,490.1985294,1166,135.5813953,2332,-527360,69632,-457728,4
1051,124,23,7,0.105531915,0.894468085,340.8508257,276.7711034,606.9676499,427.233871,1175,214.0255009,2350,-538112,63488,-474624,4
979,127,22,8,0.11482821,0.88517179,318.5682789,309.9632706,565.2900919,462.6141732,1106,113.7860082,2212,-501248,65024,-436224,4
1132,156,23,7,0.121118012,0.878881988,374.8200905,331.4727112,658.70053,541.4551282,1288,95.54896142,2576,-579584,79872,-499712,4
1315,257,22,8,0.163486005,0.836513995,437.8829613,513.1958049,764.4836502,899.151751,1572,36.97953423,3144,-673280,131584,-541696,4
1033,144,22,8,0.122344945,0.877655055,339.6991063,325.5050793,601.9535334,496.0763889,1177,114.4941634,2354,-528896,73728,-455168,4
1032,129,22,8,0.111111111,0.888888889,336.8673223,276.5194984,600.2354651,427.1162791,1161,199.4845361,2322,-528384,66048,-462336,4
1371,274,22,8,0.16656535,0.83343465,459.8271932,524.344152,796.6097739,955.0474453,1645,39.12009512,3290,-701952,140288,-561664,4
1411,263,23,7,0.157108722,0.842891278,467.6007687,551.3642458,820.9872431,926.0912548,1674,32.10586881,3348,-722432,134656,-587776,4
1105,159,22,8,0.125791139,0.874208861,365.2555699,334.9429205,651.081448,503.3647799,1264,104.9833887,2528,-565760,81408,-484352,4
370,67,23,7,0.153318078,0.846681922,123.6549384,126.0860311,228.8,164.880597,437,6.976372925,874,-189440,34304,-155136,4
1436,157,22,8,0.0985561833,0.901443817,457.2568957,416.1636682,822.4498607,564.2229299,1593,273.7113402,3186,-735232,80384,-654848,4
1854,291,22,8,0.135664336,0.864335664,596.2521056,745.6925117,1062.549083,1139.584192,2145,50.01165773,4290,-949248,148992,-800256,4
1811,300,23,7,0.142112743,0.857887257,576.4380138,745.8623486,1021.36444,1265.083333,2111,37.36283186,4222,-927232,153600,-773632,4
1526,155,22,8,0.0922070196,0.90779298,484.0417689,423.7296822,866.1592398,593.3032258,1681,164,3362,-781312,79360,-701952,4
1820,306,22,8,0.143932267,0.856067733,582.4410737,747.6727007,1032.310989,1249.003268,2126,37.16783217,4252,-931840,156672,-775168,4
1511,158,22,8,0.0946674655,0.905332534,480.1375951,425.6058116,860.6128392,590.056962,1669,133.8412189,3338,-773632,80896,-692736,4
1480,159,23,7,0.0970103722,0.902989628,471.7999885,394.3748376,848.8932432,551.0566038,1639,165.0553877,3278,-757760,81408,-676352,4
1872,293,22,8,0.135334873,0.864665127,596.3691281,772.3121995,1063.797543,1205.686007,2165,56.04452498,4330,-958464,150016,-808448,4
1524,165,23,7,0.0976909414,0.902309059,485.1254919,420.7184757,874.5761155,571.8242424,1689,192.8082192,3378,-780288,84480,-695808,4
1513,159,23,7,0.0950956938,0.904904306,480.6717227,429.7901912,862.2822208,591.163522,1672,141.4551607,3344,-774656,81408,-693248,4
1496,163,22,8,0.098251959,0.901748041,476.6959785,406.3422404,859.9298128,555.3067485,1659,191.349481,3318,-765952,83456,-682496,4
1931,311,22,8,0.138715433,0.861284567,621.0583998,784.0111005,1106.449508,1214.948553,2242,45.81119738,4484,-988672,159232,-829440,4
1488,167,22,8,0.100906344,0.899093656,473.1873156,461.9577546,852.6303763,608.5389222,1655,197.9665072,3310,-761856,85504,-676352,4
1495,160,22,8,0.0966767372,0.903323263,473.8183401,432.8589962,856.0247492,566.14375,1655,145.814978,3310,-765440,81920,-683520,4
1420,140,22,8,0.0897435897,0.91025641,447.2115567,429.1314062,800.906338,573.5214286,1560,188.8619855,3120,-727040,71680,-655360,4
1498,158,23,7,0.095410628,0.904589372,474.7278994,423.9455487,856.6548732,561.5632911,1656,146.8085106,3312,-766976,80896,-686080,4
1439,143,22,8,0.090391909,0.909608091,453.5222146,413.8634428,815.8922863,546.041958,1582,138.0453752,3164,-736768,73216,-663552,4
1503,162,23,7,0.0972972973,0.902702703,477.0577659,433.5990563,861.0219561,573.0185185,1665,199.879952,3330,-769536,82944,-686592,4
1421,127,23,7,0.0820413437,0.917958656,445.1627651,408.7994951,793.5714286,561.1102362,1548,185.6115108,3096,-727552,65024,-662528,4
395,54,23,7,0.120267261,0.879732739,125.9406851,137.8653346,233.7544304,160.962963,449,7.040928336,898,-202240,27648,-174592,4
5137,282,22,8,0.0520391216,0.947960878,1550.242852,1652.434917,2748.388748,2010.698582,5419,195.4201226,10838,-2630144,144384,-2485760,4
5692,469,22,8,0.0761240058,0.923875994,1745.835832,2093.33979,3047.453443,3488.136461,6161,153.948026,12322,-2914304,240128,-2674176,4
5178,265,23,7,0.0486863862,0.951313614,1554.164941,1777.734337,2751.633256,2142.977358,5443,205.5513595,10886,-2651136,135680,-2515456,4
5680,458,22,8,0.0746171391,0.925382861,1739.161105,2126.652627,3053.610035,3266.563319,6138,130.5957447,12276,-2908160,234496,-2673664,4
5708,473,22,8,0.0765248342,0.923475166,1751.663981,2123.874234,3070.614226,3337.008457,6181,146.1229314,12362,-2922496,242176,-2680320,4
5146,286,22,8,0.0526509573,0.947349043,1554.367238,1682.25056,2750.691605,2101.29021,5432,208.362102,10864,-2634752,146432,-2488320,4
5191,272,22,8,0.049789493,0.950210507,1561.521285,1730.223899,2765.197457,2098.441176,5463,155.4196302,10926,-2657792,139264,-2518528,4
5151,278,23,7,0.0512064837,0.948793516,1554.651283,1638.358929,2752.128907,2027.046763,5429,196.7028986,10858,-2637312,142336,-2494976,4
5115,253,23,7,0.0471311475,0.952868852,1535.902644,1683.589261,2715.856696,2050.549407,5368,187.2993719,10736,-2618880,129536,-2489344,4
5133,265,21,9,0.0490922564,0.950907744,1542.700358,1714.134269,2732.321449,2063.754717,5398,206.8991951,10796,-2628096,135680,-2492416,4
5168,294,23,7,0.0538264372,0.946173563,1564.956091,1603.362892,2773.142802,1999.493197,5462,187.7621176,10924,-2646016,150528,-2495488,4
5134,279,22,8,0.0515425827,0.948457417,1550.162378,1622.671722,2745.200429,2004.057348,5413,198.0607391,10826,-2628608,142848,-2485760,4
5108,263,22,8,0.0489666729,0.951033327,1536.694663,1652.39876,2721.496085,1996.593156,5371,165.4651879,10742,-2615296,134656,-2480640,4
5193,271,22,8,0.0495973646,0.950402635,1566.425461,1637.932836,2767.060466,2070.239852,5464,204.8743907,10928,-2658816,138752,-2520064,4
5800,505,22,8,0.0800951626,0.919904837,1785.955989,2130.230262,3116.71,3569.79604,6305,162.5,12610,-2969600,258560,-2711040,4
5188,283,23,7,0.0517272893,0.948272711,1566.402517,1659.794673,2773.01542,2057.427562,5471,205.8314522,10942,-2656256,144896,-2511360,4
5147,284,23,7,0.0522923955,0.947707604,1554.649189,1671.240867,2750.34525,2093.552817,5431,198.719356,10862,-2635264,145408,-2489856,4
5213,290,22,8,0.0526985281,0.947301472,1576.220176,1633.522171,2792.456359,2024.762069,5503,192.6820728,11006,-2669056,148480,-2520576,4
5727,490,23,7,0.0788161493,0.921183851,1759.710418,2105.655681,3068.734067,3579.618367,6217,144.1121929,12434,-2932224,250880,-2681344,4
5116,266,22,8,0.0494240059,0.950575994,1537.730485,1723.045477,2723.215794,2081.507519,5382,197.6496511,10764,-2619392,136192,-2483200,4
1148,107,22,8,0.0852589641,0.914741036,358.7472736,367.8855211,641.6062718,482.0186916,1255,232.83859,2510,-587776,54784,-532992,4
1161,119,22,8,0.09296875,0.90703125,366.8435059,343.9056933,659.372093,456.3781513,1280,214.0468227,2560,-594432,60928,-533504,4
1709,330,23,7,0.161844041,0.838155959,558.7617864,661.2234881,967.9795202,1289.40303,2039,48.90861118,4078,-875008,168960,-706048,4
1769,376,23,7,0.175291375,0.824708625,588.3049931,675.3554456,1011.088751,1364.279255,2145,48.92791971,4290,-905728,192512,-713216,4
1194,106,23,7,0.0815384615,0.918461538,371.1203898,365.5897463,667.9631491,453.7924528,1300,157.5757576,2600,-611328,54272,-557056,4
1860,413,23,7,0.181698196,0.818301804,624.4265228,720.9090489,1075.469355,1414.11138,2273,56.51417205,4546,-952320,211456,-740864,4
1904,410,23,7,0.177182368,0.822817632,641.1533233,711.0939584,1094.586134,1449.665854,2314,52.32926278,4628,-974848,209920,-764928,4
1160,124,23,7,0.0965732087,0.903426791,368.0741952,349.6697338,660.9517241,469.8870968,1284,262.0408163,2568,-593920,63488,-530432,4
1281,158,22,8,0.109798471,0.890201529,409.2935934,461.14333,723.206089,694.0063291,1439,144.332999,2878,-655872,80896,-574976,4
1744,330,22,8,0.159112825,0.840887175,569.866661,662.8134033,983.3818807,1323.506061,2074,50.70904645,4148,-892928,168960,-723968,4
1726,339,23,7,0.164164649,0.835835351,571.2376274,662.2949535,987.3713789,1265.315634,2065,47.90071909,4130,-883712,173568,-710144,4
1274,154,23,7,0.107843137,0.892156863,405.2118486,465.0377579,718.3178964,682.9155844,1428,142.6573427,2856,-652288,78848,-573440,4
1295,157,22,8,0.108126722,0.891873278,410.2254849,482.8240104,733.434749,669.2993631,1452,123.1552163,2904,-663040,80384,-582656,4
1140,132,22,8,0.103773585,0.896226415,366.7417173,322.7686846,656.5701754,463.1666667,1272,225.9325044,2544,-583680,67584,-516096,4
1160,132,22,8,0.102167183,0.897832817,371.2162675,328.8732954,668.7034483,451.3787879,1292,183.2624113,2584,-593920,67584,-526336,4
1269,159,22,8,0.111344538,0.888655462,404.1560573,470.3679133,718.7257683,680.7735849,1428,225.2365931,2856,-649728,81408,-568320,4
1154,131,22,8,0.101945525,0.898054475,369.5824215,334.0254829,663.1065858,465.8778626,1285,196.1832061,2570,-590848,67072,-523776,4
1871,416,22,8,0.181897683,0.818102317,630.3215292,700.9650293,1074.937467,1454.615385,2287,55.42898691,4574,-957952,212992,-744960,4
1144,119,22,8,0.0942201108,0.905779889,362.6345117,338.2402008,649.7762238,461.1092437,1263,220.4188482,2526,-585728,60928,-524800,4
1270,158,23,7,0.110644258,0.889355742,404.4676351,469.3391759,717.3645669,691.4746835,1428,289.0688259,2856,-650240,80896,-569344,4
1615,134,22,8,0.0766152087,0.923384791,493.4484382,622.7185806,880.54613,808.1567164,1749,281.1897106,3498,-826880,68608,-758272,4
1605,142,22,8,0.0812821981,0.918717802,491.5105248,609.7770122,887.8392523,717.5774648,1747,213.5696822,3494,-821760,72704,-749056,4
1620,133,22,8,0.0758699373,0.924130063,494.6267492,626.3850874,881.2709877,824.9774436,1753,286.4379085,3506,-829440,68096,-761344,4
1655,145,23,7,0.0805555556,0.919444444,505.1158669,635.614889,916.3462236,719.6344828,1800,229.8850575,3600,-847360,74240,-773120,4
1620,133,22,8,0.0758699373,0.924130063,494.4201998,626.613564,882.6530864,808.1428571,1753,273.0529595,3506,-829440,68096,-761344,4
1664,143,23,7,0.0791366906,0.920863309,508.7518023,623.8664333,919.9429087,718.4825175,1807,203.0337079,3614,-851968,73216,-778752,4
1588,132,22,8,0.076744186,0.923255814,484.3719973,617.6270373,867.8356423,772.25,1720,166.023166,3440,-813056,67584,-745472,4
1674,147,23,7,0.0807248764,0.919275124,513.1567239,626.5606802,926.0322581,739.8163265,1821,301.9900498,3642,-857088,75264,-781824,4
1615,151,23,7,0.0855039638,0.914496036,495.9087788,625.557125,895.4947368,755.2119205,1766,248.3825598,3532,-826880,77312,-749568,4
1698,159,23,7,0.0856219709,0.914378029,521.4987921,639.630677,947.5259128,731.1572327,1857,150.1212611,3714,-869376,81408,-787968,4
1613,138,22,8,0.0788121074,0.921187893,491.1659408,643.0455892,883.6249225,786.8768116,1751,119.5221843,3502,-825856,70656,-755200,4
1598,152,23,7,0.0868571429,0.913142857,489.2746697,630.8196889,889.456821,728.7697368,1750,31.73164098,3500,-818176,77824,-740352,4
1544,141,22,8,0.0836795252,0.916320475,470.1533536,629.9390377,851.8037565,746.5957447,1685,154.0219378,3370,-790528,72192,-718336,4
1648,138,23,7,0.0772676372,0.922732363,502.886953,646.1719654,897.586165,844.7028986,1786,167.5422139,3572,-843776,70656,-773120,4
1607,145,23,7,0.0827625571,0.917237443,491.8592182,634.2467783,883.8332296,795.2275862,1752,287.6847291,3504,-822784,74240,-748544,4
1618,145,23,7,0.0822461713,0.917753829,494.9509745,634.5240716,891.8009889,772.6344828,1763,333.2703214,3526,-828416,74240,-754176,4
1564,150,23,7,0.0875145858,0.912485414,479.1270428,628.1313079,866.3401535,765.3266667,1714,250.5847953,3428,-800768,76800,-723968,4
1643,155,22,8,0.0862068966,0.913793103,505.0427515,625.8205055,915.0334753,734.8451613,1798,142.3594616,3596,-841216,79360,-761856,4
1649,131,23,7,0.0735955056,0.926404494,502.8628843,623.8560469,899.9714979,771.2748092,1780,238.6058981,3560,-844288,67072,-777216,4
1339,129,23,7,0.0878746594,0.912125341,410.0590529,508.0824169,752.9365198,543.1317829,1468,23.19848293,2936,-685568,66048,-619520,4
1087,141,22,8,0.114820847,0.885179153,356.3265522,313.5622516,630.550138,490.7659574,1228,119.223301,2456,-556544,72192,-484352,4
1022,149,23,7,0.127241674,0.872758326,338.622761,310.9898476,602.5939335,472.1812081,1171,221.780303,2342,-523264,76288,-446976,4
1097,148,22,8,0.118875502,0.881124498,360.0902326,327.663976,640.0501367,496.6216216,1245,103.8365304,2490,-561664,75776,-485888,4
1102,152,23,7,0.121212121,0.878787879,364.4975866,308.311196,647.0344828,485.875,1254,132.1390938,2508,-564224,77824,-486400,4
1022,138,23,7,0.118965517,0.881034483,336.4139074,303.5146878,594.5577299,476.3913043,1160,256.6371681,2320,-523264,70656,-452608,4
1018,125,23,7,0.10936133,0.89063867,330.1513872,307.3918634,585.3781925,463.048,1143,33.84660942,2286,-521216,64000,-457216,4
1132,154,22,8,0.119751166,0.880248834,370.8542584,345.3094543,661.8462898,508.6428571,1286,22.47073213,2572,-579584,78848,-500736,4
1452,289,23,7,0.165996554,0.834003446,483.8416839,561.3826967,839.3477961,1030.027682,1741,46.35250266,3482,-743424,147968,-595456,4
1105,152,23,7,0.120922832,0.879077168,366.4686752,301.1797911,648.0651584,490.4013158,1257,125.9519038,2514,-565760,77824,-487936,4
1085,158,23,7,0.127111826,0.872888174,360.132443,327.0750859,638.835023,506.3924051,1243,140.4519774,2486,-555520,80896,-474624,4
1364,251,23,7,0.155417957,0.844582043,448.3834414,537.3045075,785.7837243,928.7290837,1615,40.6391545,3230,-698368,128512,-569856,4
1029,127,22,8,0.109861592,0.890138408,333.9600919,307.9784462,592.8318756,462.3779528,1156,145.7755359,2312,-526848,65024,-461824,4
1021,136,22,8,0.117545376,0.882454624,334.2842775,310.0098879,593.8090108,467.8235294,1157,172.172619,2314,-522752,69632,-453120,4
1407,266,22,8,0.158995816,0.841004184,465.6161156,560.0183306,822.901919,911.5714286,1673,41.08546169,3346,-720384,136192,-584192,4
1025,137,22,8,0.117900172,0.882099828,334.9542475,316.906193,596.6312195,468.2919708,1162,146.3476071,2324,-524800,70144,-454656,4
1062,154,22,8,0.126644737,0.873355263,352.8843782,313.4118742,625.6346516,490.3376623,1216,117.4879227,2432,-543744,78848,-464896,4
1433,268,23,7,0.15755438,0.84244562,474.6612643,547.256028,823.2247034,999.5149254,1701,41.51818404,3402,-733696,137216,-596480,4
1052,127,22,8,0.107718405,0.892281595,342.2948245,308.8083225,601.0941065,498.1023622,1179,147.1910112,2358,-538624,65024,-473600,4
1089,151,22,8,0.121774194,0.878225806,359.7117866,331.6993128,632.84573,531.4635762,1240,126.0162602,2480,-557568,77312,-480256,4
419,69,23,7,0.141393443,0.858606557,136.1449784,146.3041619,256.7016706,170.4057971,488,7.876049064,976,-214528,35328,-179200,4
992,137,22,8,0.121346324,0.878653676,331.2626367,262.4249707,579.1229839,462.7372263,1129,180.64,2258,-507904,70144,-437760,4
1258,258,23,7,0.170184697,0.829815303,421.2447342,493.2537834,734.2511924,876.7364341,1516,39.17312661,3032,-644096,132096,-512000,4
1461,301,23,7,0.170828604,0.829171396,491.5744006,573.5480113,860.4072553,983.8803987,1762,42.75661247,3524,-748032,154112,-593920,4
941,141,23,7,0.130314233,0.869685767,315.5011769,273.4294842,555.1753454,450.2340426,1082,40.84560211,2164,-481792,72192,-409600,4
906,147,22,8,0.13960114,0.86039886,307.4346014,270.2106743,538.9922737,453.0884354,1053,114.5810664,2106,-463872,75264,-388608,4
971,145,22,8,0.129928315,0.870071685,324.781434,280.5527349,574.8197734,449.2137931,1116,182.0554649,2232,-497152,74240,-422912,4
900,135,22,8,0.130434783,0.869565217,298.8386494,289.5489515,528.0777778,450.8148148,1035,172.5,2070,-460800,69120,-391680,4
976,168,23,7,0.146853147,0.853146853,325.6304481,354.306226,577.7930328,541.75,1144,20.49811862,2288,-499712,86016,-413696,4
976,149,22,8,0.132444444,0.867555556,324.3570297,317.440819,574.3852459,488.4228188,1125,96.31849315,2250,-499712,76288,-423424,4
1236,238,23,7,0.1614654,0.8385346,412.8470831,477.4965535,721.5598706,820.2815126,1474,29.10742496,2948,-632832,121856,-510976,4
1292,270,22,8,0.172855314,0.827144686,434.4008878,509.8685404,759.5851393,886.3666667,1562,36.59793814,3124,-661504,138240,-523264,4
912,110,23,7,0.107632094,0.892367906,296.5327062,248.8639616,526.6655702,385.7636364,1022,216.5254237,2044,-466944,56320,-410624,4
1385,252,23,7,0.153940134,0.846059866,454.4741277,548.7669816,798.9711191,929.0793651,1637,38.88361045,3274,-709120,129024,-580096,4
1305,257,23,7,0.16453265,0.83546735,435.0004743,505.0454709,756.1578544,910.1828794,1562,40.70888715,3124,-668160,131584,-536576,4
901,124,22,8,0.12097561,0.87902439,296.9157643,278.5252147,522.6259711,443.0564516,1025,74.43718228,2050,-461312,63488,-397824,4
1410,290,22,8,0.170588235,0.829411765,474.4743881,553.933702,831.4340426,943.2,1700,43.00531242,3400,-721920,148480,-573440,4
1341,263,23,7,0.163965087,0.836034913,447.0350584,511.3607209,772.9492916,953.1749049,1604,38.53916386,3208,-686592,134656,-551936,4
923,129,23,7,0.122623574,0.877376426,306.0103788,280.1787805,534.3391116,470.4108527,1052,73.56643357,2104,-472576,66048,-406528,4
1310,266,22,8,0.168781726,0.831218274,437.9120856,521.7617978,770.2923664,878.1691729,1576,37.89372445,3152,-670720,136192,-534528,4
401,55,23,7,0.120614035,0.879385965,127.674801,141.8352041,237.3167082,164.2181818,456,7.211766567,912,-205312,28160,-177152,4
1118,160,22,8,0.125195618,0.874804382,368.9190473,350.1663104,655.0697674,530.70625,1278,129.7461929,2556,-572416,81920,-490496,4
1086,148,22,8,0.11993517,0.88006483,356.4141876,325.6743496,635.5092081,485.3513514,1234,175.2840909,2468,-556032,75776,-480256,4
1151,162,22,8,0.123381569,0.876618431,378.6770999,352.3371588,676.2884448,519.9567901,1313,107.4468085,2626,-589312,82944,-506368,4
1371,265,23,7,0.16198044,0.83801956,453.8842093,534.6767596,790.3719912,964.0226415,1636,39.32692308,3272,-701952,135680,-566272,4
993,139,23,7,0.122791519,0.877208481,327.8260832,300.3847141,580.6586103,465.352518,1132,154.4338336,2264,-508416,71168,-437248,4
1166,155,22,8,0.117335352,0.882664648,381.0780476,352.5739005,679.780446,519.7225806,1321,96.77655678,2642,-596992,79360,-517632,4
995,132,22,8,0.117125111,0.882874889,325.460944,305.2210916,577.6974874,460.75,1127,155.2341598,2254,-509440,67584,-441856,4
1084,151,23,7,0.122267206,0.877732794,357.5080648,320.1790955,636.2195572,487.205298,1235,142.7745665,2470,-555008,77312,-477696,4
991,135,23,7,0.119893428,0.880106572,326.4228212,296.8180262,576.8920283,465.1925926,1126,139.3564356,2252,-507392,69120,-438272,4
1032,141,22,8,0.120204604,0.879795396,337.0259996,338.563426,598.3885659,503.6453901,1173,20.57894737,2346,-528384,72192,-456192,4
1055,147,22,8,0.122296173,0.877703827,346.9492795,330.1298018,615.5620853,500.5782313,1202,237.0808679,2404,-540160,75264,-464896,4
1085,149,22,8,0.120745543,0.879254457,356.5170536,327.6786043,634.7797235,491.6711409,1234,137.5696767,2468,-555520,76288,-479232,4
1135,157,23,7,0.121517028,0.878482972,374.4775691,326.4296916,666.7488987,500.1146497,1292,99.00383142,2584,-581120,80384,-500736,4
1455,286,22,8,0.164273406,0.835726594,482.3796773,586.9737881,853.6797251,959.1153846,1741,42.60890847,3482,-744960,146432,-598528,4
1413,284,22,8,0.167354154,0.832645846,471.8116572,563.4882266,831.6730361,935.2077465,1697,40.15617605,3394,-723456,145408,-578048,4
1490,288,22,8,0.161979753,0.838020247,496.7880802,572.8484284,863.6255034,1023.364583,1778,42.00330735,3556,-762880,147456,-615424,4
1579,299,23,7,0.159211928,0.840788072,522.6356638,624.0666567,918.9012033,1048.280936,1878,41.45695364,3756,-808448,153088,-655360,4
1042,118,22,8,0.101724138,0.898275862,335.0604069,285.7852133,598.8694818,418.2881356,1160,80.1658604,2320,-533504,60416,-473088,4
1428,266,22,8,0.157024793,0.842975207,472.1866463,548.1300215,820.1736695,994.1992481,1694,37.47787611,3388,-731136,136192,-594944,4
1145,156,23,7,0.119907763,0.880092237,374.2041754,359.2623058,668.8375546,520.0769231,1301,117.8442029,2602,-586240,79872,-506368,4
1254,150,23,7,0.106837607,0.893162393,405.9476665,326.7956225,728.5446571,484.7666667,1404,222.1518987,2808,-642048,76800,-565248,4
1306,157,22,8,0.107313739,0.892686261,423.0859283,361.0194388,755.4770291,536.7070064,1463,140.1340996,2926,-668672,80384,-588288,4
1286,151,22,8,0.105080028,0.894919972,416.3966214,344.4622906,741.8475894,524.4172185,1437,126.3852243,2874,-658432,77312,-581120,4
1200,148,22,8,0.109792285,0.890207715,388.019876,346.9949659,697.1958333,490.4797297,1348,222.8099174,2696,-614400,75776,-538624,4
1267,149,23,7,0.105225989,0.894774011,409.1715969,340.8781006,732.8855564,501.1409396,1416,177.443609,2832,-648704,76288,-572416,4
1554,267,23,7,0.146622735,0.853377265,501.7924982,633.7991786,890.021879,1033.097378,1821,43.59588221,3642,-795648,136704,-658944,4
1556,275,23,7,0.150191152,0.849808848,506.723017,622.7732136,893.2634961,1044.647273,1831,45.64946397,3662,-796672,140800,-655872,4
1198,147,22,8,0.10929368,0.89070632,386.9770506,352.0279313,694.6602671,496.4761905,1345,233.5069444,2690,-613376,75264,-538112,4
1192,118,22,8,0.0900763359,0.909923664,378.9251047,314.6025866,673.9597315,469.0254237,1310,228.6212914,2620,-610304,60416,-549888,4
1195,136,23,7,0.102178813,0.897821187,384.2342925,340.5807361,685.1640167,497.6102941,1331,201.3615734,2662,-611840,69632,-542208,4
1196,144,23,7,0.107462687,0.892537313,387.1859427,337.2974695,691.3319398,497.4791667,1340,229.0598291,2680,-612352,73728,-538624,4
1606,293,22,8,0.154291732,0.845708268,526.2043608,646.6002743,931.6805729,1050.412969,1899,49.453125,3798,-822272,150016,-672256,4
1554,270,22,8,0.148026316,0.851973684,504.3302348,620.2440663,887.479408,1056.507407,1824,48.0126349,3648,-795648,138240,-657408,4
1522,259,23,7,0.145423919,0.854576081,494.1399526,610.3330286,875.0597898,984.6718147,1781,35.08668243,3562,-779264,132608,-646656,4
1270,154,22,8,0.108146067,0.891853933,411.0381596,354.9438417,736.3110236,516.1363636,1424,127.484333,2848,-650240,78848,-571392,4
1544,276,23,7,0.151648352,0.848351648,502.6538994,623.140193,888.1185233,1035.706522,1820,45.90163934,3640,-790528,141312,-649216,4
1281,143,23,7,0.100421348,0.899578652,413.3648821,342.5483156,732.2279469,535.7762238,1424,105.7164068,2848,-655872,73216,-582656,4
1669,281,23,7,0.144102564,0.855897436,541.7540018,658.7666471,952.5272618,1111.946619,1950,45.0658655,3900,-854528,143872,-710656,4
1288,154,22,8,0.106796117,0.893203883,418.052754,352.93407,743.0217391,541.5,1442,105.3323594,2884,-659456,78848,-580608,4
1577,284,23,7,0.152606126,0.847393874,515.7903021,624.3456293,905.247305,1074,1861,44.54284347,3722,-807424,145408,-662016,4
2170,336,24,6,0.134078212,0.865921788,676.2615591,858.7939959,1187.142396,1682.059524,2506,85.49982941,5012,-1111040,172032,-939008,5
2245,370,24,6,0.141491396,0.858508604,708.8884215,892.4197535,1242.859688,1703.243243,2615,85.45751634,5230,-1149440,189440,-960000,5
2286,372,24,6,0.139954853,0.860045147,724.2863434,880.7571087,1260.794838,1751.704301,2658,93.2958933,5316,-1170432,190464,-979968,5
2305,378,24,6,0.140887067,0.859112933,742.807685,848.7356065,1278.796963,1727.404762,2683,88.11165846,5366,-1180160,193536,-986624,5
2192,353,24,6,0.13870334,0.86129666,686.6638582,881.2076081,1208.370438,1674.325779,2545,91.61267099,5090,-1122304,180736,-941568,5
2115,329,24,6,0.134615385,0.865384615,656.0248723,852.3650387,1157.065248,1643.151976,2444,74.71721186,4888,-1082880,168448,-914432,5
2205,343,24,6,0.134615385,0.865384615,689.9975827,864.0826003,1207.905669,1702.606414,2548,95.53805774,5096,-1128960,175616,-953344,5
2263,348,24,6,0.133282267,0.866717733,710.1749154,882.1449733,1241.248785,1727.068966,2611,84.96583144,5222,-1158656,178176,-980480,5
2953,819,24,6,0.217126193,0.782873807,1097.736316,948.2911873,1772.290891,2298.294261,3772,94.48897796,7544,-1511936,419328,-1092608,5
2191,339,24,6,0.133992095,0.866007905,693.5663968,843.0445698,1207.693291,1639.112094,2530,87.24137931,5060,-1121792,173568,-948224,5
1762,337,24,6,0.160552644,0.839447356,562.6863728,687.1333343,980.0783201,1415.58457,2099,71.63822526,4198,-902144,172544,-729600,5
2940,799,24,6,0.213693501,0.786306499,1085.609914,930.4174734,1749.622789,2312.939925,3739,94.65822785,7478,-1505280,409088,-1096192,5
2220,363,24,6,0.140534262,0.859465738,696.0557728,875.4481736,1219.802252,1733.539945,2583,92.8802589,5166,-1136640,185856,-950784,5
1707,309,24,6,0.15327381,0.84672619,555.9253333,622.2418127,951.9607499,1320.838188,2016,61.8404908,4032,-873984,158208,-715776,5
1934,337,24,6,0.148392779,0.851607221,603.6912712,766.3511959,1061.008273,1566.367953,2271,79.23935799,4542,-990208,172544,-817664,5
2134,344,24,6,0.13882163,0.86117837,676.7609354,813.3091187,1175.441425,1636.886628,2478,80.84828711,4956,-1092608,176128,-916480,5
2202,352,24,6,0.137823023,0.862176977,686.6357322,906.5636196,1215.798365,1663.485795,2554,89.39446972,5108,-1127424,180224,-947200,5
2140,348,24,6,0.139871383,0.860128617,675.6709246,823.2362784,1176.570093,1662.229885,2488,87.39023534,4976,-1095680,178176,-917504,5
2230,354,24,6,0.136996904,0.863003096,698.8966543,869.2347197,1221.930942,1737.045198,2584,85.22427441,5168,-1141760,181248,-960512,5
2215,328,24,6,0.128981518,0.871018482,690.6060582,827.8969284,1199.928217,1758.704268,2543,90.3374778,5086,-1134080,167936,-966144,5
3638,361,22,8,0.0902725681,0.909727432,1098.854893,1486.808183,1941.379054,2590.756233,3999,142.9746157,7998,-1862656,184832,-1677824,5
4782,1177,22,8,0.197516362,0.802483638,1586.566336,1578.42171,2648.291928,4327.687341,5959,127.3290598,11918,-2448384,602624,-1845760,5
3638,357,22,8,0.0893617021,0.910638298,1098.796792,1485.880369,1940.885102,2580.028011,3995,137.7586207,7990,-1862656,182784,-1679872,5
3641,373,22,8,0.0929247633,0.907075237,1102.284654,1499.321542,1950.543532,2563.474531,4014,144.9620802,8028,-1864192,190976,-1673216,5
3650,373,22,8,0.092716878,0.907283122,1105.451107,1497.657686,1954.789315,2571.836461,4023,79.74231913,8046,-1868800,190976,-1677824,5
3660,383,22,8,0.0947316349,0.905268365,1109.304067,1527.499767,1968.709836,2531.248042,4043,70.57078024,8086,-1873920,196096,-1677824,5
3651,379,22,8,0.094044665,0.905955335,1107.905942,1487.342641,1956.666941,2582.253298,4030,74.05365674,8060,-1869312,194048,-1675264,5
3656,353,21,9,0.0880518833,0.911948117,1103.348367,1487.122925,1947.347101,2602.107649,4009,130.7993475,8018,-1871872,180736,-1691136,5
3699,360,22,8,0.088691796,0.911308204,1116.722485,1496.796608,1969.356853,2653.108333,4059,150.5005562,8118,-1893888,184320,-1709568,5
3678,389,22,8,0.0956478977,0.904352102,1116.952291,1512.931336,1976.568787,2577.012853,4067,86.49510846,8134,-1883136,199168,-1683968,5
3645,381,22,8,0.0946348733,0.905365127,1105.2916,1521.581892,1961.805213,2508.060367,4026,152.269289,8052,-1866240,195072,-1671168,5
3734,393,22,8,0.0952265568,0.904773443,1132.392775,1544.930527,2006.099089,2614.132316,4127,114.6388889,8254,-1911808,201216,-1710592,5
3644,368,22,8,0.0917248255,0.908275174,1101.882796,1493.565094,1947.943743,2586.334239,4012,154.6050096,8024,-1865728,188416,-1677312,5
3660,367,22,8,0.0911348398,0.90886516,1106.650666,1496.418026,1955.393443,2598.468665,4027,145.3265969,8054,-1873920,187904,-1686016,5
3643,376,22,8,0.0935556108,0.906444389,1104.217409,1505.631703,1955.553116,2537.526596,4019,148.1932153,8038,-1865216,192512,-1672704,5
3636,380,22,8,0.0946215139,0.905378486,1103.07565,1513.939359,1956.871287,2502.505263,4016,138.6740331,8032,-1861632,194560,-1667072,5
3640,362,22,8,0.0904547726,0.909545227,1099.715129,1503.689393,1946.731593,2552.209945,4002,114.2123288,8004,-1863680,185344,-1678336,5
3639,355,22,8,0.088883325,0.911116675,1098.325066,1474.147691,1937.350646,2614.073239,3994,145.0254176,7988,-1863168,181760,-1681408,5
4709,1196,22,8,0.20254022,0.79745978,1594.959681,1530.50406,2633.206626,4212.119565,5905,124.0285654,11810,-2411008,612352,-1798656,5
3632,385,21,9,0.0958426687,0.904157331,1100.802268,1527.827402,1957.169879,2497.953247,4017,139.9651568,8034,-1859584,197120,-1662464,5
7437,1195,23,7,0.138438369,0.861561631,2336.078687,2820.992111,4061.139303,5905.719665,8632,281.4476687,17264,-3807744,611840,-3195904,5
6012,484,23,7,0.0745073892,0.925492611,1828.081758,2379.673058,3236.837159,3393.369835,6496,228.9742686,12992,-3078144,247808,-2830336,5
6136,501,23,7,0.0754859123,0.924514088,1869.704845,2407.495019,3308.375978,3449.117764,6637,217.8923178,13274,-3141632,256512,-2885120,5
7400,1187,22,8,0.138232211,0.861767789,2310.840327,2803.261521,4023.362568,5981.20893,8587,218.0548502,17174,-3788800,607744,-3181056,5
5987,488,23,7,0.0753667954,0.924633205,1826.201092,2326.069814,3224.12761,3408.192623,6475,213.555409,12950,-3065344,249856,-2815488,5
1680,135,23,7,0.0743801653,0.925619835,518.7893939,518.4052718,928.8422619,648.6296296,1815,45.70637119,3630,-860160,69120,-791040,5
5920,490,23,7,0.0764430577,0.923556942,1802.772715,2347.872514,3196.110473,3318.940816,6410,217.9530772,12820,-3031040,250880,-2780160,5
6026,500,23,7,0.0766166105,0.92338339,1836.422764,2382.312178,3259.828244,3307.752,6526,236.2780594,13052,-3085312,256000,-2829312,5
5953,495,23,7,0.0767679901,0.92323201,1814.064769,2356.093722,3218.93835,3291.385859,6448,197.9735953,12896,-3047936,253440,-2794496,5
6055,477,23,7,0.0730251072,0.926974893,1844.804352,2338.527118,3277.208588,3130.566038,6532,209.8971722,13064,-3100160,244224,-2855936,5
6126,514,23,7,0.0774096386,0.922590361,1870.265717,2403.020064,3321.304767,3310.90856,6640,196.915777,13280,-3136512,263168,-2873344,5
6020,502,23,7,0.0769702545,0.923029745,1835.78013,2374.601635,3261.40598,3262.62749,6522,176.9877883,13044,-3082240,257024,-2825216,5
7528,1215,23,7,0.138968318,0.861031682,2361.814755,2836.742125,4102.882837,6039.41893,8743,178.1740371,17486,-3854336,622080,-3232256,5
5888,498,23,7,0.077983088,0.922016912,1792.877527,2358.41524,3184.657099,3298.052209,6386,211.8076285,12772,-3014656,254976,-2759680,5
6127,498,23,7,0.0751698113,0.924830189,1864.053743,2429.769226,3308.385344,3369.7751,6625,217.355643,13250,-3137024,254976,-2882048,5
5976,500,23,7,0.0772081532,0.922791847,1818.873777,2392.654874,3237.775435,3247.16,6476,224.7830614,12952,-3059712,256000,-2803712,5
5894,508,23,7,0.0793502031,0.920649797,1799.613954,2338.244667,3201.029522,3206.958661,6402,203.7555697,12804,-3017728,260096,-2757632,5
5981,492,23,7,0.0760080334,0.923991967,1822.488575,2354.195333,3226.334058,3366.660569,6473,208.6718246,12946,-3062272,251904,-2810368,5
5896,496,23,7,0.0775969962,0.922403004,1797.613992,2337.57527,3193.226934,3235.407258,6392,189.5048918,12784,-3018752,253952,-2764800,5
3866,274,23,7,0.0661835749,0.933816425,1185.359873,1179.92226,2111.805742,1487.69708,4140,62.36818319,8280,-1979392,140288,-1839104,5
2342,361,24,6,0.133555309,0.866444691,749.9525087,948.5372884,1337.444492,1446.429363,2703,93.95203337,5406,-1199104,184832,-1014272,5
2279,326,24,6,0.125143954,0.874856046,725.4063907,909.8618219,1288.158403,1406.754601,2605,96.98436337,5210,-1166848,166912,-999936,5
2231,376,24,6,0.144227081,0.855772919,723.5113881,900.8823345,1288.931869,1393.406915,2607,83.34398977,5214,-1142272,192512,-949760,5
2286,354,24,6,0.134090909,0.865909091,730.1298411,932.5243542,1300.484252,1449.754237,2640,94.31939979,5280,-1170432,181248,-989184,5
2289,350,24,6,0.132625995,0.867374005,729.238465,942.0778628,1305.404107,1415.457143,2639,96.59590044,5278,-1171968,179200,-992768,5
2301,361,24,6,0.135612322,0.864387678,742.7632088,912.8133956,1321.448501,1395.567867,2662,77.83625731,5324,-1178112,184832,-993280,5
2292,311,24,6,0.119477526,0.880522474,727.6771487,889.0857621,1278.874782,1472.427653,2603,96.37171418,5206,-1173504,159232,-1014272,5
2291,357,24,6,0.134818731,0.865181269,735.7135891,922.7384484,1310.634221,1413.481793,2648,89.94565217,5296,-1172992,182784,-990208,5
2286,361,24,6,0.136380808,0.863619192,740.1104277,899.7603153,1315.901137,1375.285319,2647,73.85602679,5294,-1170432,184832,-985600,5
2231,312,24,6,0.122689737,0.877310263,703.2846185,920.5797266,1260.158225,1356.676282,2543,100.8326725,5086,-1142272,159744,-982528,5
2280,355,24,6,0.134724858,0.865275142,729.0407427,933.7944561,1304.152193,1406.938028,2635,100.6109202,5270,-1167360,181760,-985600,5
857,144,24,6,0.143856144,0.856143856,282.3734004,305.2963875,518.5227538,396.7152778,1001,17.92621777,2002,-438784,73728,-365056,5
2273,352,24,6,0.134095238,0.865904762,725.8358605,934.1866941,1300.544215,1393.431818,2625,107.0118223,5250,-1163776,180224,-983552,5
2336,361,24,6,0.133852429,0.866147571,748.118104,945.2907291,1332.42637,1456.246537,2697,107.5358852,5394,-1196032,184832,-1011200,5
2326,351,24,6,0.131116922,0.868883078,744.5634561,937.3841277,1332.314703,1383.301994,2677,94.62707671,5354,-1190912,179712,-1011200,5
2306,359,24,6,0.134709193,0.865290807,738.3680239,937.8854429,1317.156982,1434.766017,2665,105.2943501,5330,-1180672,183808,-996864,5
2343,353,24,6,0.130934718,0.869065282,746.727247,955.4555289,1333.074264,1450.886686,2696,100.9737828,5392,-1199616,180736,-1018880,5
2353,374,24,6,0.137147048,0.862852952,756.8647595,951.2615044,1349.481513,1455.342246,2727,89.00130548,5454,-1204736,191488,-1013248,5
2397,377,24,6,0.135904831,0.864095169,770.1190549,970.1054712,1375.768043,1462.092838,2774,94.96747689,5548,-1227264,193024,-1034240,5
2298,332,24,6,0.126235741,0.873764259,731.5686933,916.8007643,1295.852916,1451.490964,2630,98.50187266,5260,-1176576,169984,-1006592,5
2035,268,24,6,0.116369952,0.883630048,645.2071806,796.9978362,1157.342998,1111.429104,2303,46.11533841,4606,-1041920,137216,-904704,5
2439,380,24,6,0.134799574,0.865200426,782.7681712,976.4076438,1386.366134,1561.692105,2819,115.2493868,5638,-1248768,194560,-1054208,5
2572,532,24,6,0.171391753,0.828608247,840.4959939,1053.51907,1477.332037,1915.906015,3104,54.22781272,6208,-1316864,272384,-1044480,5
2424,436,24,6,0.152447552,0.847552448,785.9559416,1003.161343,1401.534653,1591.536697,2860,102.2889843,5720,-1241088,223232,-1017856,5
2544,515,24,6,0.168355672,0.831644328,830.7505188,1046.401251,1464.040094,1855.829126,3059,106.3260341,6118,-1302528,263680,-1038848,5
2487,392,24,6,0.136158388,0.863841612,806.4276085,967.3879967,1424.524729,1538.181122,2879,87.56082725,5758,-1273344,200704,-1072640,5
1263,195,24,6,0.133744856,0.866255144,403.9791375,516.6670107,732.8416469,707.8564103,1458,92.80712922,2916,-646656,99840,-546816,5
2598,528,24,6,0.16890595,0.83109405,852.104751,1051.377556,1493.409931,1908.375,3126,115.0533677,6252,-1330176,270336,-1059840,5
2578,524,24,6,0.168923275,0.831076725,846.6517654,1038.556149,1481.75097,1894.65458,3102,122.318612,6204,-1319936,268288,-1051648,5
2448,434,24,6,0.150589868,0.849410132,795.5821538,994.4513657,1409.985703,1619.258065,2882,101.6220028,5764,-1253376,222208,-1031168,5
2572,509,24,6,0.165206102,0.834793898,837.2534266,1059.719919,1477.563764,1861.546169,3081,119.8832685,6162,-1316864,260608,-1056256,5
2483,533,24,6,0.176724138,0.823275862,829.1477162,966.0340881,1432.217882,1863.863039,3016,79.45205479,6032,-1271296,272896,-998400,5
2593,564,24,6,0.178650618,0.821349382,857.1197866,1053.568129,1499.794061,1943.150709,3157,55.26960784,6314,-1327616,288768,-1038848,5
2426,438,24,6,0.152932961,0.847067039,786.1930865,1003.566214,1399.74155,1613.942922,2864,105.7997784,5728,-1242112,224256,-1017856,5
2575,530,24,6,0.170692432,0.829307568,844.4018956,1037.665379,1476.655922,1923.916981,3105,113.1147541,6210,-1318400,271360,-1047040,5
2420,439,24,6,0.153550192,0.846449808,787.0046132,991.4322987,1397.131405,1611.189066,2859,105.615072,5718,-1239040,224768,-1014272,5
2396,429,24,6,0.151858407,0.848141593,775.214452,993.9258555,1382.090985,1585.629371,2825,88.97637795,5650,-1226752,219648,-1007104,5
2589,519,24,6,0.166988417,0.833011583,848.2413096,1051.840064,1489.836616,1877.069364,3108,120.0927357,6216,-1325568,265728,-1059840,5
2571,522,24,6,0.168768186,0.831231814,841.7224814,1044.12733,1476.753403,1892.984674,3093,102.1803766,6186,-1316352,267264,-1049088,5
1800,236,24,6,0.115913556,0.884086444,572.5202148,682.1356744,1033.518333,903.9533898,2036,32.01761283,4072,-921600,120832,-800768,5
2663,413,21,9,0.13426528,0.86573472,834.6994803,1017.318243,1453.717987,2085.169492,3076,93.58077274,6152,-1363456,211456,-1152000,5
2667,436,22,8,0.140509185,0.859490815,844.9311051,1002.850226,1463.902512,2090.889908,3103,68.12294182,6206,-1365504,223232,-1142272,5
2613,419,22,8,0.138192612,0.861807388,816.9255408,1018.38483,1429.113662,2061.465394,3032,102.4670497,6064,-1337856,214528,-1123328,5
2736,417,22,8,0.132254995,0.867745005,850.6088867,1048.108054,1485.176901,2179.465228,3153,108.2389289,6306,-1400832,213504,-1187328,5
2623,406,22,8,0.134037636,0.865962364,815.6849535,1008.682095,1425.255814,2094.800493,3029,103.7684138,6058,-1342976,207872,-1135104,5
4194,802,22,8,0.160528423,0.839471577,1409.412671,1390.424495,2358.777062,3229.170823,4996,100.4827031,9992,-2147328,410624,-1736704,5
2607,385,22,8,0.128676471,0.871323529,810.8587357,1012.464061,1418.485232,2024.771429,2992,94.92385787,5984,-1334784,197120,-1137664,5
3742,815,21,9,0.178845732,0.821154268,1297.263333,1136.042595,2118.830305,3014.404908,4557,98.95765472,9114,-1915904,417280,-1498624,5
3201,520,22,8,0.13974738,0.86025262,1069.983463,1006.686024,1794.374883,2271.128846,3721,72.12638108,7442,-1638912,266240,-1372672,5
2610,410,22,8,0.135761589,0.864238411,825.8140894,969.4343378,1428.254789,2034.060976,3020,97.23116549,6040,-1336320,209920,-1126400,5
2614,413,22,8,0.136438718,0.863561282,821.7888027,984.600312,1426.827085,2065.743341,3027,105.987395,6054,-1338368,211456,-1126912,5
2606,380,22,8,0.127260549,0.872739451,806.4080159,1009.24455,1411.72947,2054.273684,2986,101.1517615,5972,-1334272,194560,-1139712,5
2397,375,22,8,0.135281385,0.864718615,741.1800087,961.7953235,1307.236963,1893.149333,2772,105,5544,-1227264,192000,-1035264,5
4067,830,22,8,0.169491525,0.830508475,1384.731152,1356.859916,2310.601918,3127.150602,4897,91.60119716,9794,-2082304,424960,-1657344,5
2621,422,22,8,0.138678935,0.861321065,823.6672833,1006.700988,1435.22625,2060.943128,3043,94.44444444,6086,-1341952,216064,-1125888,5
4381,870,21,9,0.165682727,0.834317273,1496.965905,1425.78331,2491.339648,3304.1,5251,99.20649915,10502,-2243072,445440,-1797632,5
4164,837,22,8,0.167366527,0.832633473,1430.134731,1356.577026,2379.708694,3104.413381,5001,102.3955774,10002,-2131968,428544,-1703424,5
3138,480,22,8,0.132669983,0.867330017,1037.447103,990.5595261,1745.061504,2230.766667,3618,69.33691069,7236,-1606656,245760,-1360896,5
2547,397,21,9,0.134850543,0.865149457,791.2027505,945.5196702,1375.697684,2093.546599,2944,99.42586964,5888,-1304064,203264,-1100800,5
2621,425,21,9,0.139527249,0.860472751,823.4266569,1018.396693,1438.040061,2050.536471,3046,103.6054422,6092,-1341952,217600,-1124352,5
1907,173,22,8,0.0831730769,0.916826923,591.9539042,661.6228626,1024.392764,1218.052023,2080,70.53238386,4160,-976384,88576,-887808,5
1913,182,22,8,0.0868735084,0.913126492,588.3123047,714.5620282,1025.43701,1285.159341,2095,76.85253118,4190,-979456,93184,-886272,5
1913,186,22,8,0.0886136255,0.911386374,588.4909322,722.6224535,1027.418191,1282.252688,2099,61.14185843,4198,-979456,95232,-884224,5
1921,186,22,8,0.0882771713,0.911722829,590.7455103,718.3742553,1029.450807,1307.543011,2107,74.53130527,4214,-983552,95232,-888320,5
1924,199,22,8,0.0937352803,0.90626472,595.5048182,700.4990201,1032.85395,1343.79397,2123,81.03053435,4246,-985088,101888,-883200,5
1849,205,22,8,0.099805258,0.900194742,575.5682181,686.9924603,1001.161709,1265.058537,2054,66.17268041,4108,-946688,104960,-841728,5
1933,188,22,8,0.0886374352,0.911362565,593.2894484,742.9976176,1038.593378,1291.382979,2121,75.45357524,4242,-989696,96256,-893440,5
1914,191,22,8,0.090736342,0.909263658,590.3762536,703.4479411,1025.763845,1325.931937,2105,74.04150545,4210,-979968,97792,-882176,5
1923,182,22,8,0.0864608076,0.913539192,591.2872768,716.174652,1030.156526,1294.362637,2105,70.21347565,4210,-984576,93184,-891392,5
1952,195,22,8,0.0908244061,0.909175594,600.6701661,726.4204473,1045.427254,1360.020513,2147,82.35519755,4294,-999424,99840,-899584,5
1918,192,22,8,0.0909952607,0.909004739,589.915924,721.6305682,1028.489572,1325.322917,2110,36.90746895,4220,-982016,98304,-883712,5
1832,189,22,8,0.0935180604,0.90648194,564.8824264,683.683028,983.3580786,1278.936508,2021,76.96115765,4042,-937984,96768,-841216,5
1925,207,22,8,0.0970919325,0.902908068,596.6269998,715.7136806,1037.822857,1333.183575,2132,66.54182272,4264,-985600,105984,-879616,5
1922,192,21,9,0.0908230842,0.909176916,591.8989206,719.8714393,1031.388137,1318.890625,2114,81.90623789,4228,-984064,98304,-885760,5
1908,198,22,8,0.094017094,0.905982906,586.3834303,714.7846741,1021.205975,1364.69697,2106,38.89196676,4212,-976896,101376,-875520,5
1915,196,22,8,0.0928469919,0.907153008,592.0264984,710.5292534,1030.141514,1308.647959,2111,75.90794678,4222,-980480,100352,-880128,5
1916,190,22,8,0.0902184236,0.909781576,589.4435531,717.3847877,1027.012526,1320.605263,2106,77.34116783,4212,-980992,97280,-883712,5
1907,192,22,8,0.0914721296,0.90852787,590.3576771,696.2696829,1025.090194,1297.411458,2099,71.5893588,4198,-976384,98304,-878080,5
1918,199,22,8,0.0940009447,0.905999055,594.8803663,689.6534829,1029.924922,1339.231156,2117,75.25773196,4234,-982016,101888,-880128,5
1917,188,22,8,0.0893111639,0.910688836,590.0392144,721.0887337,1029.232655,1295.351064,2105,71.9166382,4210,-981504,96256,-885248,5
5558,615,23,7,0.0996274097,0.90037259,1755.435516,1984.001306,3055.816841,3368.814634,6173,173.2042649,12346,-2845696,314880,-2530816,5
5397,533,23,7,0.0898819562,0.910118044,1686.175634,1941.468687,2945.676302,3166.228893,5930,157.9648375,11860,-2763264,272896,-2490368,5
2054,160,23,7,0.0722673893,0.927732611,628.2518631,660.1635247,1136.519961,734.95625,2214,38.71306172,4428,-1051648,81920,-969728,5
4623,353,23,7,0.0709405145,0.929059486,1437.802156,1307.244446,2529.04629,1957.492918,4976,144.7774222,9952,-2366976,180736,-2186240,5
4583,334,23,7,0.0679275981,0.932072402,1420.815988,1297.760971,2495.96247,1951.817365,4917,160.4241436,9834,-2346496,171008,-2175488,5
4552,331,23,7,0.067786197,0.932213803,1408.922667,1342.407845,2474.264499,1998.29003,4883,177.8870674,9766,-2330624,169472,-2161152,5
4694,343,23,7,0.0680960889,0.931903911,1459.149277,1265.26155,2558.29804,1981.201166,5037,155.8477723,10074,-2403328,175616,-2227712,5
4545,329,23,7,0.0675010259,0.932498974,1407.658508,1270.160164,2478.309791,1873.729483,4874,144.5004447,9748,-2327040,168448,-2158592,5
4630,342,23,7,0.0687851971,0.931214803,1437.460636,1326.567628,2519.625918,2038.040936,4972,139.545327,9944,-2370560,175104,-2195456,5
4561,321,23,7,0.0657517411,0.934248259,1408.371859,1295.435113,2481.493751,1873.239875,4882,158.8675561,9764,-2335232,164352,-2170880,5
4553,331,23,7,0.0677723178,0.932227682,1411.917453,1244.860307,2484.579837,1863.679758,4884,133.187892,9768,-2331136,169472,-2161664,5
2292,149,22,8,0.0610405571,0.938959443,698.7328652,714.4745673,1242.262653,893.9261745,2441,42.78702892,4882,-1173504,76288,-1097216,5
4661,347,23,7,0.0692891374,0.930710863,1447.021845,1343.300405,2539.213688,2038.216138,5008,149.9401198,10016,-2386432,177664,-2208768,5
4640,336,23,7,0.0675241158,0.932475884,1434.207649,1378.071075,2523.678664,2002.699405,4976,157.3190009,9952,-2375680,172032,-2203648,5
2618,319,23,7,0.108614232,0.891385768,840.7303368,897.9957365,1456.965623,1567.76489,2937,50.82194151,5874,-1340416,163328,-1177088,5
4569,334,23,7,0.0681215582,0.931878442,1412.762036,1347.002343,2489.996936,1932.215569,4903,130.7118102,9806,-2339328,171008,-2168320,5
5558,592,23,7,0.0962601626,0.903739837,1754.231762,1959.169182,3063.776178,3185.569257,6150,188.9400922,12300,-2845696,303104,-2542592,5
4596,337,22,8,0.0683154267,0.931684573,1421.47758,1329.886234,2509.376849,1889.065282,4933,141.7936189,9866,-2353152,172544,-2180608,5
4583,337,23,7,0.068495935,0.931504065,1416.529689,1391.365266,2494.242199,2001.626113,4920,147.5704859,9840,-2346496,172544,-2173952,5
1050,126,23,7,0.107142857,0.892857143,329.5310892,402.1019376,599.28,498.6666667,1176,16.03271984,2352,-537600,64512,-473088,5
3286,330,23,7,0.0912610619,0.908738938,1046.100001,1021.043031,1810.020694,1793.357576,3616,76.88709334,7232,-1682432,168960,-1513472,5
850,95,23,7,0.100529101,0.899470899,268.6625092,306.8450801,474.8329412,456.6,945,36.54292343,1890,-435200,48640,-386560,5
775,86,22,8,0.099883856,0.900116144,245.4513667,273.9600524,428.6154839,452.4883721,861,33.24324324,1722,-396800,44032,-352768,5
3365,333,23,7,0.090048675,0.909951325,1070.638915,1034.81836,1845.998217,1884.885886,3698,99.03588645,7396,-1722880,170496,-1552384,5
3320,333,23,7,0.0911579524,0.908842048,1056.515095,1034.450648,1828.24759,1814.561562,3653,101.3596004,7306,-1699840,170496,-1529344,5
3287,342,23,7,0.0942408377,0.905759162,1052.076822,1001.766318,1809.032552,1872.353801,3629,98.64093504,7258,-1682944,175104,-1507840,5
792,85,23,7,0.0969213227,0.903078677,251.0654121,271.8218555,439.9406566,430.2352941,877,37.54280822,1754,-405504,43520,-361984,5
3332,334,23,7,0.0911074741,0.908892526,1060.132465,1037.927105,1827.778211,1890.580838,3666,95.29503509,7332,-1705984,171008,-1534976,5
3295,337,23,7,0.0927863436,0.907213656,1047.864847,1053.662522,1820.202124,1780.302671,3632,104.6082949,7264,-1687040,172544,-1514496,5
771,85,23,7,0.0992990654,0.900700935,244.5613831,265.8089055,432.8819715,388.7529412,856,34.72616633,1712,-394752,43520,-351232,5
776,84,22,8,0.0976744186,0.902325581,246.2690598,264.6387119,433.2152062,405.4166667,860,34.6215781,1720,-397312,43008,-354304,5
797,83,23,7,0.0943181818,0.905681818,253.2062981,261.7419376,439.7603513,447.6024096,880,35.27054108,1760,-408064,42496,-365568,5
4123,566,23,7,0.12070804,0.87929196,1367.570518,1232.126229,2320.199127,2525.660777,4689,108.016586,9378,-2110976,289792,-1821184,5
776,88,22,8,0.101851852,0.898148148,246.1312849,273.2591894,437.1688144,391.3295455,864,33.141542,1728,-397312,45056,-352256,5
3292,333,23,7,0.091862069,0.908137931,1048.903197,1021.845702,1812.674362,1816.219219,3625,92.56894791,7250,-1685504,170496,-1515008,5
796,81,23,7,0.0923603193,0.907639681,252.4519033,260.0787513,439.3190955,435.8641975,877,32.1127792,1754,-407552,41472,-366080,5
790,83,23,7,0.0950744559,0.904925544,249.690644,272.0606771,434.5835443,460,873,31.69934641,1746,-404480,42496,-361984,5
3343,326,23,7,0.0888525484,0.911147452,1063.38744,1011.931159,1828.071792,1906.046012,3669,94.27029805,7338,-1711616,166912,-1544704,5
1381,140,23,7,0.0920447074,0.907955293,427.1477927,519.7446869,776.1397538,611.6571429,1521,22.27266071,3042,-707072,71680,-635392,5
1357,137,23,7,0.0917001339,0.908299866,422.1109066,488.1447291,762.7826087,596.1240876,1494,23.59816775,2988,-694784,70144,-624640,5
5503,410,22,8,0.0693387451,0.930661255,1675.009033,2088.453856,2959.522624,2923.141463,5913,103.3199371,11826,-2817536,209920,-2607616,5
6335,404,21,9,0.0599495474,0.940050453,1907.921001,2458.44024,3373.934807,3308.299505,6739,192.2133485,13478,-3243520,206848,-3036672,5
6344,408,22,8,0.0604265403,0.93957346,1912.387803,2447.108201,3384.667087,3249.509804,6752,200.3560831,13504,-3248128,208896,-3039232,5
6448,405,22,8,0.0590982052,0.940901795,1940.100024,2507.519375,3432.614144,3337.617284,6853,220.5664628,13706,-3301376,207360,-3094016,5
7041,598,22,8,0.0782824977,0.921717502,2152.101178,2702.334826,3776.556313,4331.516722,7639,155.422177,15278,-3604992,306176,-3298816,5
6400,426,22,8,0.0624084383,0.937591562,1930.960879,2485.718088,3404.076406,3555.075117,6826,120.0703606,13652,-3276800,218112,-3058688,5
6405,404,22,8,0.0593332354,0.940666765,1928.9139,2470.927919,3414.175332,3259.534653,6809,171.9878757,13618,-3279360,206848,-3072512,5
6423,391,22,8,0.0573818609,0.942618139,1933.684009,2450.464529,3409.645493,3372.255754,6814,224.2184929,13628,-3288576,200192,-3088384,5
6354,415,21,9,0.0613089083,0.938691092,1916.515927,2453.818137,3394.149512,3244.913253,6769,177.2917758,13538,-3253248,212480,-3040768,5
6333,408,21,9,0.0605251446,0.939474855,1907.814515,2456.36153,3382.647876,3190.20098,6741,181.9433198,13482,-3242496,208896,-3033600,5
7164,628,22,8,0.0805954825,0.919404517,2197.384877,2721.162488,3851.138749,4413.964968,7792,167.9310345,15584,-3667968,321536,-3346432,5
6467,418,22,8,0.0607116921,0.939288308,1952.448016,2467.101158,3445.837328,3399.102871,6885,229.9599198,13770,-3311104,214016,-3097088,5
6316,426,22,8,0.0631859982,0.936814002,1910.156743,2417.370481,3377.24525,3286.319249,6742,196.5597668,13484,-3233792,218112,-3015680,5
6408,410,22,8,0.0601349369,0.939865063,1930.518818,2482.062419,3415.184769,3320.65122,6818,204.560456,13636,-3280896,209920,-3070976,5
7217,602,22,8,0.0769919427,0.923008057,2209.705201,2718.427489,3870.283774,4386.13289,7819,148.8482772,15638,-3695104,308224,-3386880,5
6401,412,22,8,0.0604726259,0.939527374,1932.531869,2431.467251,3417.555226,3243.009709,6813,166.3736264,13626,-3277312,210944,-3066368,5
6531,946,22,8,0.126521332,0.873478668,1987.641533,2481.836254,3489.83341,5459.197674,7477,257.7387108,14954,-3343872,484352,-2859520,5
6474,418,22,8,0.060650029,0.939349971,1954.479636,2469.839997,3447.778653,3426.696172,6892,215.1061174,13784,-3314688,214016,-3100672,5
6336,421,22,8,0.062305757,0.937694243,1913.620325,2438.509366,3384.652778,3293.926366,6757,201.4609422,13514,-3244032,215552,-3028480,5
6368,406,22,8,0.0599350458,0.940064954,1921.599412,2422.351771,3395.50581,3261.931034,6774,172.4102825,13548,-3260416,207872,-3052544,5
3214,178,23,7,0.0524764151,0.947523585,968.4777427,1140.333952,1706.589297,1514.325843,3392,69.95256754,6784,-1645568,91136,-1554432,6
2900,162,23,7,0.052906597,0.947093403,875.8656344,989.6736892,1544.330345,1301.820988,3062,70.84683017,6124,-1484800,82944,-1401856,6
3218,176,23,7,0.0518562169,0.948143783,970.6708725,1132.926266,1698.878496,1672.295455,3394,88.75523013,6788,-1647616,90112,-1557504,6
3226,185,22,8,0.0542362943,0.945763706,976.0302018,1119.841933,1711.83788,1604.2,3411,95.35923959,6822,-1651712,94720,-1556992,6
3237,172,22,8,0.0504546788,0.949545321,974.9708236,1115.231631,1717.792709,1464.244186,3409,73.29606536,6818,-1657344,88064,-1569280,6
3250,188,23,7,0.0546829552,0.945317045,981.9672099,1154.133505,1725.473538,1616.234043,3438,88.19907645,6876,-1664000,96256,-1567744,6
2919,159,22,8,0.0516569201,0.94834308,881.2252074,1012.518777,1541.894484,1495.540881,3078,76.32035705,6156,-1494528,81408,-1413120,6
3190,166,23,7,0.0494636472,0.950536353,962.566916,995.2329746,1699.975549,1265.807229,3356,60.10028653,6712,-1633280,84992,-1548288,6
2806,155,22,8,0.05234718,0.94765282,847.3773245,971.1571611,1487.627227,1361.025806,2961,68.52580421,5922,-1436672,79360,-1357312,6
3120,177,23,7,0.0536851683,0.946314832,942.3548527,1104.503859,1648.924679,1650.327684,3297,81.85203575,6594,-1597440,90624,-1506816,6
3223,160,22,8,0.0472953,0.9527047,969.6682425,1104.549582,1695.419485,1623.11875,3383,87.05609882,6766,-1650176,81920,-1568256,6
3228,176,22,8,0.0517038778,0.948296122,974.6257541,1119.656184,1702.201673,1707.971591,3404,90.48378522,6808,-1652736,90112,-1562624,6
3187,172,22,8,0.051205716,0.948794284,961.3943076,1052.610131,1698.807342,1331.517442,3359,71.02981603,6718,-1631744,88064,-1543680,6
2915,163,23,7,0.0529564652,0.947043535,879.5239079,1019.473626,1549.727616,1356.595092,3078,75.07317073,6156,-1492480,83456,-1409024,6
3133,182,22,8,0.0549019608,0.945098039,944.5219656,1150.011901,1658.98819,1640.989011,3315,87.97770701,6630,-1604096,93184,-1510912,6
3253,174,23,7,0.0507732711,0.949226729,979.4061848,1158.465992,1715.063941,1694.109195,3427,90.95010616,6854,-1665536,89088,-1576448,6
3114,180,23,7,0.0546448087,0.945355191,940.878903,1105.549939,1653.061978,1551.277778,3294,88.5483871,6588,-1594368,92160,-1502208,6
3224,180,22,8,0.0528789659,0.947121034,972.7775093,1139.858535,1708.477047,1595.444444,3404,87.12567187,6808,-1650688,92160,-1558528,6
3249,170,22,8,0.049722141,0.950277859,977.6914326,1145.092688,1715.510619,1604.682353,3419,87.82430003,6838,-1663488,87040,-1576448,6
3227,170,23,7,0.0500441566,0.949955843,971.2796635,1143.267002,1697.37713,1729.805882,3397,78.19981584,6794,-1652224,87040,-1565184,6
4274,271,24,6,0.0596259626,0.940374037,1307.505306,1369.163388,2284.283575,2095.04428,4545,138.1039198,9090,-2188288,138752,-2049536,6
4247,272,24,6,0.0601903076,0.939809692,1298.077963,1401.156546,2261.306569,2239.599265,4519,153.7597822,9038,-2174464,139264,-2035200,6
4296,285,24,6,0.0622134905,0.937786509,1318.858019,1374.692887,2292.886639,2262.561404,4581,156.2947799,9162,-2199552,145920,-2053632,6
4247,283,24,6,0.0624724062,0.937527594,1298.127547,1443.727004,2265.536379,2264.954064,4530,162.3074167,9060,-2174464,144896,-2029568,6
4251,264,24,6,0.0584717608,0.941528239,1295.554882,1420.368306,2263.489532,2169.606061,4515,146.5909091,9030,-2176512,135168,-2041344,6
4254,271,24,6,0.0598895028,0.940110497,1296.582362,1443.2699,2271.395628,2131.210332,4525,161.8383405,9050,-2178048,138752,-2039296,6
4341,267,24,6,0.0579427083,0.942057292,1324.677134,1416.647866,2302.098134,2343.550562,4608,398.615917,9216,-2222592,136704,-2085888,6
4400,269,24,6,0.0576140501,0.94238595,1340.872143,1456.75645,2334.096591,2349.776952,4669,164.9240551,9338,-2252800,137728,-2115072,6
4301,265,24,6,0.0580376697,0.94196233,1309.593205,1447.607137,2287.372239,2220.65283,4566,152.047952,9132,-2202112,135680,-2066432,6
4394,277,24,6,0.0593020766,0.940697923,1334.152539,1535.678316,2351.733273,2086.425993,4671,88.19864048,9342,-2249728,141824,-2107904,6
4276,274,24,6,0.0602197802,0.93978022,1310.40026,1357.095403,2281.482226,2182.142336,4550,137.4207188,9100,-2189312,140288,-2049024,6
4253,283,24,6,0.0623897707,0.937610229,1300.600317,1433.172232,2273.882201,2187.614841,4536,162,9072,-2177536,144896,-2032640,6
4338,276,24,6,0.0598179454,0.940182055,1326.73367,1408.667746,2302.124712,2391.985507,4614,152.2269878,9228,-2221056,141312,-2079744,6
2017,94,23,7,0.0445286594,0.955471341,603.6437159,721.3853779,1054.872087,1080.202128,2111,51.2005821,4222,-1032704,48128,-984576,6
4272,276,24,6,0.0606860158,0.939313984,1305.816718,1411.247807,2283.120787,2141.065217,4548,172.6651481,9096,-2187264,141312,-2045952,6
4244,275,24,6,0.0608541713,0.939145829,1293.59846,1462.048541,2262.959708,2214.323636,4519,79.28070175,9038,-2172928,140800,-2032128,6
4285,260,24,6,0.0572057206,0.942794279,1304.519907,1430.036304,2272.158693,2286.865385,4545,147.1349951,9090,-2193920,133120,-2060800,6
2768,215,24,6,0.0720750922,0.927924908,858.9631358,888.3834893,1492.295882,1488.190698,2983,55.38432974,5966,-1417216,110080,-1307136,6
4257,285,24,6,0.0627476882,0.937252312,1308.231732,1350.126635,2278.288466,2170.101754,4542,139.9691834,9084,-2179584,145920,-2033664,6
2904,206,24,6,0.0662379421,0.933762058,890.5470253,993.2374003,1552.573347,1596.757282,3110,110.7155571,6220,-1486848,105472,-1381376,6
2680,146,22,8,0.0516631281,0.948336872,811.1340633,844.6827883,1429.526119,1119.321918,2826,49.57025083,5652,-1372160,74752,-1297408,6
2567,137,22,8,0.0506656805,0.94933432,771.7204845,914.9671521,1361.46903,1184.445255,2704,72.64911338,5408,-1314304,70144,-1244160,6
2605,139,23,7,0.0506559767,0.949344023,783.7374252,919.268752,1381.520537,1203.446043,2744,73.58541164,5488,-1333760,71168,-1262592,6
2579,136,22,8,0.050092081,0.949907919,778.4481287,854.7326336,1368.388135,1161.007353,2715,54.13758724,5430,-1320448,69632,-1250816,6
2564,131,23,7,0.0486085343,0.951391466,770.6456303,883.7560658,1358.74844,1137.625954,2695,57.06118992,5390,-1312768,67072,-1245696,6
170,31,22,8,0.154228856,0.845771144,57.97265075,36.67326274,108.6,59.32258065,201,3.525697246,402,-87040,15872,-71168,6
2571,148,23,7,0.0544317764,0.945568224,777.3160653,882.3584452,1371.681058,1157.081081,2719,71.83619551,5438,-1316352,75776,-1240576,6
2563,140,22,8,0.0517943026,0.948205697,771.8530469,868.3635411,1368.351151,1052.657143,2703,68.34386852,5406,-1312256,71680,-1240576,6
2567,126,22,8,0.0467879688,0.953212031,769.7676952,910.4316787,1353.082197,1223.087302,2693,66.29739045,5386,-1314304,64512,-1249792,6
2562,139,22,8,0.0514624213,0.948537579,770.357914,909.9687975,1362.472678,1139.539568,2701,65.73375517,5402,-1311744,71168,-1240576,6
2566,133,22,8,0.0492775102,0.95072249,771.9144368,894.7834821,1357.574045,1203.87218,2699,75.43320291,5398,-1313792,68096,-1245696,6
2587,139,22,8,0.0509904622,0.949009538,778.1052252,905.7619554,1375.869733,1133.280576,2726,72.15457914,5452,-1324544,71168,-1253376,6
2574,140,22,8,0.0515843773,0.948415623,774.9120062,902.3921891,1368.679099,1151.964286,2714,73.13392617,5428,-1317888,71680,-1246208,6
2578,131,22,8,0.0483573274,0.951642673,775.0186718,895.9848732,1362.570985,1206.007634,2709,69.42593542,5418,-1319936,67072,-1252864,6
2591,132,23,7,0.0484759456,0.951524054,779.2521027,906.5613655,1365.613277,1291.075758,2723,68.22851416,5446,-1326592,67584,-1259008,6
2605,148,22,8,0.0537595351,0.946240465,787.2054315,902.2509978,1386.053359,1217.648649,2753,70.64408519,5506,-1333760,75776,-1257984,6
2576,128,23,7,0.0473372781,0.952662722,773.2066762,904.3281956,1359.689829,1207.804688,2704,70.60052219,5408,-1318912,65536,-1253376,6
2564,137,23,7,0.0507219548,0.949278045,771.9020042,891.2957331,1361.453588,1155.357664,2701,67.525,5402,-1312768,70144,-1242624,6
2597,139,23,7,0.0508040936,0.949195906,783.8740108,875.7810551,1377.754332,1195.597122,2736,61.56615662,5472,-1329664,71168,-1258496,6
2564,139,23,7,0.0514243433,0.948575657,772.2271258,894.7205765,1362.453198,1159.179856,2703,67.8123432,5406,-1312768,71168,-1241600,6
4281,287,24,6,0.0628283713,0.937171629,1312.303608,1409.882035,2282.56926,2313.299652,4568,150.8088478,9136,-2191872,146944,-2044928,6
4357,291,24,6,0.0626075731,0.937392427,1331.862483,1480.995076,2328.194859,2269.178694,4648,167.9797615,9296,-2230784,148992,-2081792,6
4310,289,24,6,0.0628397478,0.937160252,1322.385642,1403.075296,2298.294432,2325.435986,4599,172.7648385,9198,-2206720,147968,-2058752,6
4399,297,24,6,0.0632453152,0.936754685,1346.430423,1483.788771,2352.521028,2288.942761,4696,124.9268422,9392,-2252288,152064,-2100224,6
4285,276,24,6,0.0605130454,0.939486955,1308.00711,1444.16471,2281.30035,2276.336957,4561,171.0802701,9122,-2193920,141312,-2052608,6
4284,278,24,6,0.060938185,0.939061815,1312.241362,1387.180573,2280.496499,2296.964029,4562,162.0603908,9124,-2193408,142336,-2051072,6
4378,296,24,6,0.0633290543,0.936670946,1345.605074,1398.839536,2331.038145,2433.074324,4674,137.9982285,9348,-2241536,151552,-2089984,6
4306,285,24,6,0.0620779787,0.937922021,1315.084646,1469.384422,2291.390618,2365.642105,4591,177.3271533,9182,-2204672,145920,-2058752,6
4278,270,24,6,0.0593667546,0.940633245,1302.41843,1468.618088,2272.602151,2304.57037,4548,166.8990826,9096,-2190336,138240,-2052096,6
4285,280,24,6,0.0613362541,0.938663746,1304.614567,1502.965534,2288.273046,2202.303571,4565,155.9617356,9130,-2193920,143360,-2050560,6
299,45,24,6,0.130813953,0.869186047,98.61793157,89.84346882,179.7792642,124.1333333,344,6.352723915,688,-153088,23040,-130048,6
4290,293,24,6,0.0639319223,0.936068078,1313.998811,1448.115846,2293.806061,2265.556314,4583,165.2722683,9166,-2196480,150016,-2046464,6
4294,296,24,6,0.0644880174,0.935511983,1318.712428,1412.976165,2293.353517,2326.638514,4590,94.87391484,9180,-2198528,151552,-2046976,6
4234,281,24,6,0.0622369878,0.937763012,1298.159079,1368.441799,2269.192253,2089.359431,4515,100.0664894,9030,-2167808,143872,-2023936,6
4281,278,24,6,0.0609782847,0.939021715,1302.836308,1504.035234,2276.214202,2338.298561,4559,173.5439665,9118,-2191872,142336,-2049536,6
4302,270,24,6,0.0590551181,0.940944882,1314.609334,1388.539834,2297.512552,2111.033333,4572,147.1989697,9144,-2202624,138240,-2064384,6
4301,282,24,6,0.0615317478,0.938468252,1313.825881,1452.341179,2298.320391,2195.602837,4583,107.1294998,9166,-2202112,144384,-2057728,6
4295,280,24,6,0.0612021858,0.938797814,1313.342529,1421.620834,2296.939464,2150.875,4575,159.7416201,9150,-2199040,143360,-2055680,6
4386,267,24,6,0.057382334,0.942617666,1342.844197,1348.924963,2328.371409,2304.47191,4653,147.761194,9306,-2245632,136704,-2108928,6
2955,220,24,6,0.0692913386,0.930708661,907.2589663,1032.888381,1586.187479,1612.345455,3175,36.91002093,6350,-1512960,112640,-1400320,6
4208,293,24,6,0.0650966452,0.934903355,1301.747015,1230.70239,2231.579373,2529.914676,4501,104.093432,9002,-2154496,150016,-2004480,6
4173,274,24,6,0.0616145716,0.938385428,1275.147868,1403.081222,2231.560748,2108.850365,4447,145.8032787,8894,-2136576,140288,-1996288,6
4220,298,24,6,0.0659583887,0.934041611,1302.034478,1333.253315,2264.153791,2193.597315,4518,157.972028,9036,-2160640,152576,-2008064,6
4196,290,24,6,0.064645564,0.935354436,1291.249987,1347.833442,2241.916111,2266.417241,4486,172.2734255,8972,-2148352,148480,-1999872,6
4187,290,24,6,0.0647755193,0.935224481,1291.731162,1301.974998,2239.496059,2231.837931,4477,121.295042,8954,-2143744,148480,-1995264,6
4211,288,24,6,0.0640142254,0.935985775,1290.783954,1408.379807,2254.589646,2182.892361,4499,157.5280112,8998,-2156032,147456,-2008576,6
4118,242,24,6,0.0555045872,0.944495413,1249.996933,1378.152741,2193.658329,1956.590909,4360,83.94301117,8720,-2108416,123904,-1984512,6
4268,285,24,6,0.0625960905,0.93740391,1312.15707,1346.542713,2277.59044,2268.157895,4553,151.3127285,9106,-2185216,145920,-2039296,6
4216,301,24,6,0.0666371485,0.933362851,1303.891042,1262.755722,2236.362666,2576.07309,4517,136.1772686,9034,-2158592,154112,-2004480,6
4196,284,24,6,0.0633928571,0.936607143,1284.942955,1403.886732,2231.56101,2372.570423,4480,165.49686,8960,-2148352,145408,-2002944,6
4207,275,24,6,0.0613565373,0.938643463,1287.621589,1385.318521,2239.986689,2264.650909,4482,173.4520124,8964,-2153984,140800,-2013184,6
4309,297,24,6,0.0644811116,0.935518888,1318.712464,1472.132452,2293.944535,2442.13468,4606,133.044483,9212,-2206208,152064,-2054144,6
4179,275,24,6,0.0617422542,0.938257746,1278.729555,1385.848066,2232.657095,2149.130909,4454,148.5657105,8908,-2139648,140800,-1998848,6
4198,278,24,6,0.0621090259,0.937890974,1290.413437,1315.405358,2233.781086,2309.758993,4476,158.0508475,8952,-2149376,142336,-2007040,6
4201,291,24,6,0.0647818344,0.935218166,1291.616414,1367.972463,2244.19543,2279.769759,4492,141.1247251,8984,-2150912,148992,-2001920,6
2817,223,24,6,0.0733552632,0.926644737,870.842157,958.3802823,1519.209088,1536.807175,3040,100.9296149,6080,-1442304,114176,-1328128,6
4499,282,24,6,0.0589834763,0.941016524,1374.477941,1464.264086,2397.166704,2292.617021,4781,103.7768613,9562,-2303488,144384,-2159104,6
4242,293,24,6,0.0646085998,0.9353914,1302.388564,1400.286576,2261.884488,2356.539249,4535,151.3179847,9070,-2171904,150016,-2021888,6
4243,289,24,6,0.0637687555,0.936231244,1304.830165,1356.494093,2262.493754,2325.318339,4532,145.9111397,9064,-2172416,147968,-2024448,6
4133,290,24,6,0.0655663577,0.934433642,1268.97357,1348.411786,2233.054198,1911.941379,4423,77.97954866,8846,-2116096,148480,-1967616,6
3607,175,23,7,0.0462718139,0.953728186,1082.014935,1270.855676,1897.092043,1776.24,3782,100.2119767,7564,-1846784,89600,-1757184,6
3579,175,22,8,0.0466169419,0.953383058,1074.791109,1168.065355,1898.993574,1437.925714,3754,102.9621503,7508,-1832448,89600,-1742848,6
3628,188,23,7,0.0492662474,0.950733753,1092.748278,1228.50803,1922.649669,1635.441489,3816,97.87124904,7632,-1857536,96256,-1761280,6
3321,164,23,7,0.0470588235,0.952941176,997.897975,1127.200665,1755.901837,1481.737805,3485,86.86440678,6970,-1700352,83968,-1616384,6
3599,172,22,8,0.0456112437,0.954388756,1080.397333,1229.199472,1896.025007,1676.232558,3771,103.0327869,7542,-1842688,88064,-1754624,6
3597,167,23,7,0.0443676939,0.955632306,1080.048673,1209.353571,1889.320267,1735.598802,3764,95.21882115,7528,-1841664,85504,-1756160,6
3606,175,23,7,0.0462840518,0.953715948,1083.748683,1215.559194,1902.638935,1651.171429,3781,99.92071882,7562,-1846272,89600,-1756672,6
3597,173,22,8,0.0458885942,0.954111406,1078.543087,1245.204037,1898.252711,1620.346821,3770,97.89665022,7540,-1841664,88576,-1753088,6
3593,167,22,8,0.0444148936,0.955585106,1077.545428,1221.743174,1890.846646,1657.892216,3760,86.6159871,7520,-1839616,85504,-1754112,6
3645,174,22,8,0.0455616654,0.954438335,1093.111759,1265.939772,1919.592044,1709.063218,3819,102.386059,7638,-1866240,89088,-1777152,6
3609,165,22,8,0.0437201908,0.956279809,1081.378242,1231.535614,1897.887226,1660.30303,3774,94.3971986,7548,-1847808,84480,-1763328,6
3303,164,23,7,0.0473031439,0.952696856,992.1655649,1131.673504,1746.734181,1477.530488,3467,90.56948798,6934,-1691136,83968,-1607168,6
3601,176,22,8,0.046597829,0.953402171,1083.523505,1189.216237,1902.253818,1617.823864,3777,95.81430746,7554,-1843712,90112,-1753600,6
3640,186,23,7,0.0486147412,0.951385259,1093.811041,1268.31004,1926.671703,1655.731183,3826,103.0156166,7652,-1863680,95232,-1768448,6
3596,175,22,8,0.0464067887,0.953593211,1079.011146,1243.881689,1898.080645,1637.76,3771,66.36747624,7542,-1841152,89600,-1751552,6
3614,172,23,7,0.0454305335,0.954569466,1084.829153,1230.762396,1903.909242,1674.784884,3786,102.992383,7572,-1850368,88064,-1762304,6
3597,173,22,8,0.0458885942,0.954111406,1081.048247,1199.915173,1898.100361,1623.514451,3770,97.69370303,7540,-1841664,88576,-1753088,6
3299,169,23,7,0.0487312572,0.951268743,991.832547,1140.64937,1747.010609,1490.284024,3468,84.11350958,6936,-1689088,86528,-1602560,6
3300,154,22,8,0.0445859873,0.955414013,989.2405665,1125.060675,1738.881515,1483.61039,3454,83.79427462,6908,-1689600,78848,-1610752,6
3626,182,22,8,0.0477941176,0.952205882,1091.947443,1187.064677,1921.407887,1567.642857,3808,95.36689206,7616,-1856512,93184,-1763328,6
5043,269,22,8,0.0506400602,0.94935994,1528.069455,1598.630477,2673.276819,2341.981413,5312,145.0573457,10624,-2582016,137728,-2444288,6
5065,277,22,8,0.0518532385,0.948146762,1538.400001,1545.355051,2695.226456,2237.65704,5342,146.2760131,10684,-2593280,141824,-2451456,6
5079,225,22,8,0.0424208145,0.957579186,1527.329125,1592.292174,2664.098445,2390.684444,5304,141.6666667,10608,-2600448,115200,-2485248,6
5023,239,22,8,0.0454199924,0.954580008,1513.659785,1578.931967,2649.818435,2246.506276,5262,133.2489238,10524,-2571776,122368,-2449408,6
5107,281,22,8,0.0521529324,0.947847068,1555.75594,1504.04813,2714.24672,2335.615658,5388,140.9364374,10776,-2614784,143872,-2470912,6
4581,231,22,8,0.0480049875,0.951995012,1381.109659,1419.470825,2435.770574,1826.030303,4812,85.86723769,9624,-2345472,118272,-2227200,6
5052,247,22,8,0.0466125684,0.953387432,1525.362315,1572.779617,2667.650633,2288.983806,5299,142.0643432,10598,-2586624,126464,-2460160,6
4760,234,22,8,0.0468562275,0.953143773,1435.715059,1540.752436,2508.383193,2276.115385,4994,132.2913907,9988,-2437120,119808,-2317312,6
5035,251,22,8,0.0474839198,0.95251608,1524.87454,1507.245988,2660.472691,2303.031873,5286,147.4476987,10572,-2577920,128512,-2449408,6
5058,272,22,8,0.0510318949,0.948968105,1529.271657,1572.02191,2699.872875,2026.316176,5330,113.2596685,10660,-2589696,139264,-2450432,6
5047,270,22,8,0.0507805153,0.949219485,1523.510345,1606.101409,2693.043987,2022.62963,5317,110.1512326,10634,-2584064,138240,-2445824,6
5037,242,22,8,0.0458420155,0.954157984,1520.335161,1576.429629,2651.880286,2392.72314,5279,145.3069089,10558,-2578944,123904,-2455040,6
5202,274,22,8,0.050036523,0.949963477,1576.643179,1577.991527,2764.53095,2244.291971,5476,143.6893204,10952,-2663424,140288,-2523136,6
4747,208,22,8,0.0419778002,0.9580222,1425.356309,1515.981764,2489.788919,2208.951923,4955,115.8251519,9910,-2430464,106496,-2323968,6
5026,266,22,8,0.0502645503,0.94973545,1520.962812,1575.638654,2671.631516,2171.646617,5292,144.2354865,10584,-2573312,136192,-2437120,6
5114,249,22,8,0.0464292374,0.953570763,1543.929737,1599.903533,2697.484943,2363.967871,5363,128.6091127,10726,-2618368,127488,-2490880,6
5064,244,22,8,0.0459683497,0.95403165,1528.458994,1575.227638,2670.092417,2330.893443,5308,95.0743328,10616,-2592768,124928,-2467840,6
5125,272,22,8,0.0503983695,0.949601631,1553.59616,1595.304902,2718.302829,2335.297794,5397,142.5891678,10794,-2624000,139264,-2484736,6
4767,215,22,8,0.0431553593,0.956844641,1432.313372,1524.722358,2506.586113,2157.009302,4982,123.5921608,9964,-2440704,110080,-2330624,6
5037,268,22,8,0.0505183789,0.949481621,1523.839993,1601.985181,2676.997618,2201.970149,5305,141.6177256,10610,-2578944,137216,-2441728,6
3384,239,23,7,0.0659674303,0.93403257,1027.752983,1156.134183,1848.701832,1292.338912,3623,99.69730325,7246,-1732608,122368,-1610240,6
3377,237,23,7,0.0655783066,0.934421693,1026.099463,1144.593664,1843.69618,1291.742616,3614,76.05218855,7228,-1729024,121344,-1607680,6
3425,249,23,7,0.0677735438,0.932226456,1046.437733,1137.433733,1871.983358,1363.180723,3674,93.48600509,7348,-1753600,127488,-1626112,6
3371,236,22,8,0.0654283338,0.934571666,1022.541126,1183.013214,1836.895283,1334.127119,3607,89.70405372,7214,-1725952,120832,-1605120,6
3377,245,22,8,0.0676421866,0.932357813,1028.491999,1154.077992,1846.519396,1328.804082,3622,103.6931005,7244,-1729024,125440,-1603584,6
3384,236,23,7,0.0651933702,0.93480663,1027.389209,1183.293117,1841.786348,1361.885593,3620,97.31182796,7240,-1732608,120832,-1611776,6
3381,237,23,7,0.0655058043,0.934494196,1025.494871,1167.666224,1845.765454,1292.14346,3618,91.27144299,7236,-1731072,121344,-1609728,6
3377,251,23,7,0.0691841235,0.930815877,1028.279606,1163.22495,1852.124963,1308.286853,3628,95.80142593,7256,-1729024,128512,-1600512,6
3379,238,23,7,0.0658003871,0.934199613,1027.745976,1120.70451,1847.295058,1265.306723,3617,138.3703137,7234,-1730048,121856,-1608192,6
3383,251,23,7,0.0690698954,0.930930105,1030.463688,1153.541659,1856.093113,1297.338645,3634,98.50908105,7268,-1732096,128512,-1603584,6
3380,228,22,8,0.0631929047,0.936807095,1024.367917,1168.056429,1836.906213,1324.092105,3608,93.64131845,7216,-1730560,116736,-1613824,6
3387,231,23,7,0.0638474295,0.93615257,1027.571877,1180.525592,1839.684972,1366.917749,3618,96.68626403,7236,-1734144,118272,-1615872,6
3389,247,23,7,0.0679317932,0.932068207,1030.747692,1178.611792,1853.776925,1334.477733,3636,99.80785067,7272,-1735168,126464,-1608704,6
3379,243,23,7,0.0670900055,0.932909994,1025.808331,1192.837256,1845.522048,1338.411523,3622,98.31704669,7244,-1730048,124416,-1605632,6
3386,241,23,7,0.0664460987,0.933553901,1028.425806,1189.478382,1846.528943,1356.975104,3627,98.96316508,7254,-1733632,123392,-1610240,6
3386,235,22,8,0.0648991991,0.935100801,1027.295757,1161.780147,1846.534849,1298.995745,3621,97.07774799,7242,-1733632,120320,-1613312,6
3378,243,23,7,0.0671085336,0.932891466,1027.770579,1170.834273,1844.084369,1351.08642,3621,101.8278965,7242,-1729536,124416,-1605120,6
3382,240,22,8,0.0662617338,0.933738266,1027.923403,1162.206306,1846.361916,1320.2375,3622,79.53447519,7244,-1731584,122880,-1608704,6
3400,247,22,8,0.0677268988,0.932273101,1040.269988,1030.217512,1868.803824,1207.267206,3647,93.89804325,7294,-1740800,126464,-1614336,6
1457,161,23,7,0.0995055624,0.900494438,463.0894285,436.8906602,835.3658202,575.4223602,1618,19.46583253,3236,-745984,82432,-663552,6
3388,277,23,7,0.075579809,0.924420191,1048.242641,1127.348051,1857.815525,1529.480144,3665,71.84865713,7330,-1734656,141824,-1592832,6
3345,267,22,8,0.0739202658,0.926079734,1031.429542,1125.150188,1832.431689,1481.625468,3612,81.55339806,7224,-1712640,136704,-1575936,6
1765,181,23,7,0.0930113052,0.906988695,552.0720373,639.2642401,984.270255,868.4751381,1946,37.96332423,3892,-903680,92672,-811008,6
3390,280,23,7,0.0762942779,0.923705722,1047.53118,1157.569664,1858.80236,1553.375,3670,78.11834823,7340,-1735680,143360,-1592320,6
3406,268,23,7,0.0729450191,0.927054981,1050.700951,1147.618136,1858.002936,1576.929104,3674,143.7402191,7348,-1743872,137216,-1606656,6
3440,281,23,7,0.075517334,0.924482666,1064.085938,1158.441422,1882.586628,1596.736655,3721,92.88567149,7442,-1761280,143872,-1617408,6
3407,285,23,7,0.0771939328,0.922806067,1054.491191,1164.817501,1867.058996,1600.729825,3692,90.20278524,7384,-1744384,145920,-1598464,6
3484,313,23,7,0.0824335001,0.9175665,1089.693492,1144.732407,1917.632606,1691.600639,3797,83.56073944,7594,-1783808,160256,-1623552,6
3398,277,23,7,0.0753741497,0.92462585,1049.746326,1166.131747,1856.198352,1614.758123,3675,84.85338259,7350,-1739776,141824,-1597952,6
3408,284,23,7,0.0769230769,0.923076923,1054.697766,1159.732554,1868.152876,1586.665493,3692,83.92816549,7384,-1744896,145408,-1599488,6
3376,279,23,7,0.0763337893,0.923666211,1043.453666,1158.320638,1848.631813,1578.34767,3655,89.23339844,7310,-1728512,142848,-1585664,6
3410,288,23,7,0.0778799351,0.922120065,1056.711789,1164.152918,1868.727566,1621.840278,3698,96.4779546,7396,-1745920,147456,-1598464,6
3382,285,23,7,0.0777202073,0.922279793,1048.056197,1144.451798,1855.966884,1573.326316,3667,90.36471168,7334,-1731584,145920,-1585664,6
3378,278,23,7,0.0760393873,0.923960613,1044.59635,1154.342016,1847.376258,1599.133094,3656,91.19481167,7312,-1729536,142336,-1587200,6
3376,276,23,7,0.0755750274,0.924424973,1044.012795,1124.617955,1852.473341,1508.797101,3652,65.24924066,7304,-1728512,141312,-1587200,6
3411,279,23,7,0.0756097561,0.924390244,1053.341353,1162.802464,1869.093228,1557.053763,3690,88.31977022,7380,-1746432,142848,-1603584,6
3379,277,23,7,0.0757658643,0.924234136,1044.351694,1147.140857,1850.905297,1555.187726,3656,82.64014467,7312,-1730048,141824,-1588224,6
1789,187,23,7,0.0946356275,0.905364372,557.5070155,679.8888471,993.4673002,940.9786096,1976,50.42102577,3952,-915968,95744,-820224,6
1031,123,23,7,0.106585789,0.893414211,322.3876321,404.1505622,586.7090204,500.3089431,1154,23.02474062,2308,-527872,62976,-464896,6
3386,280,23,7,0.0763775232,0.923622477,1046.87964,1157.501558,1854.594507,1578.407143,3666,81.46666667,7332,-1733632,143360,-1590272,6
3860,191,22,8,0.0471488521,0.952851148,1161.694857,1289.937179,2038.566321,1772.041885,4051,101.2243878,8102,-1976320,97792,-1878528,6
3880,186,22,8,0.0457452041,0.954254796,1167.12017,1265.042185,2048.401289,1722.655914,4066,101.1442786,8132,-1986560,95232,-1891328,6
3844,184,22,8,0.0456802383,0.954319762,1154.265682,1303.024231,2026.558793,1762.576087,4028,92.72559853,8056,-1968128,94208,-1873920,6
3645,170,23,7,0.0445609436,0.955439056,1095.323656,1207.447849,1916.672428,1722.052941,3815,96.99974574,7630,-1866240,87040,-1779200,6
3821,169,23,7,0.0423558897,0.95764411,1145.300379,1273.805788,2004.40984,1794.053254,3990,103.3143449,7980,-1956352,86528,-1869824,6
3825,178,23,7,0.04446665,0.95553335,1149.343051,1263.568339,2011.859346,1790.134831,4003,104.6262415,8006,-1958400,91136,-1867264,6
3820,185,22,8,0.0461922597,0.95380774,1146.643246,1264.710877,2023.558115,1578.502703,4005,75.49481621,8010,-1955840,94720,-1861120,6
3616,179,22,8,0.0471673254,0.952832675,1087.592317,1218.378852,1910.360619,1648.301676,3795,98.44357977,7590,-1851392,91648,-1759744,6
3813,191,23,7,0.0477022977,0.952297702,1146.933985,1278.993838,2018.73433,1678.408377,4004,101.7018034,8008,-1952256,97792,-1854464,6
3831,173,22,8,0.0432067932,0.956793207,1149.1669,1280.944003,2010.948055,1815.421965,4004,95.17470882,8008,-1961472,88576,-1872896,6
3702,170,22,8,0.0439049587,0.956095041,1113.691835,1184.156167,1945.955159,1730.6,3872,102.6239067,7744,-1895424,87040,-1808384,6
3525,167,23,7,0.0452329361,0.954767064,1060.941409,1140.642577,1857.099858,1622.760479,3692,106.3670412,7384,-1804800,85504,-1719296,6
3929,188,22,8,0.0456643187,0.954335681,1178.276459,1332.204917,2076.62535,1690.648936,4117,86.74673409,8234,-2011648,96256,-1915392,6
3623,179,23,7,0.047080484,0.952919516,1092.072166,1181.147212,1912.491858,1679.022346,3802,104.5654565,7604,-1854976,91648,-1763328,6
3821,183,22,8,0.0457042957,0.954295704,1147.439641,1294.251485,2014.486522,1752.224044,4004,102.1689206,8008,-1956352,93696,-1862656,6
3811,195,22,8,0.0486769845,0.951323015,1145.36435,1307.413169,2021.209131,1657.4,4006,94.45885404,8012,-1951232,99840,-1851392,6
3620,176,22,8,0.0463645943,0.953635406,1090.129053,1182.404188,1909.951657,1662.960227,3796,102.4561404,7592,-1853440,90112,-1763328,6
3960,184,23,7,0.0444015444,0.955598456,1190.140338,1305.256213,2081.827525,1871.755435,4144,109.3692267,8288,-2027520,94208,-1933312,6
3835,183,22,8,0.0455450473,0.954454953,1152.915265,1240.826406,2027.195828,1638.661202,4018,91.23524069,8036,-1963520,93696,-1869824,6
946,71,22,8,0.069813176,0.930186824,289.1591817,327.6476533,517.3107822,398.2676056,1017,39.47981366,2034,-484352,36352,-448000,6
184,20,21,9,0.0980392157,0.901960784,57.34331718,57.92874934,106.8369565,62.6,204,41.63265306,408,-94208,10240,-83968,7
180,25,21,9,0.12195122,0.87804878,57.53252945,60.95341172,107.45,70.96,205,38.60640301,410,-92160,12800,-79360,7
172,22,21,9,0.113402062,0.886597938,54.6696233,54.82943123,101.8139535,63.77272727,194,38.64541833,388,-88064,11264,-76800,7
179,19,21,9,0.095959596,0.904040404,55.42351081,57.93539242,103.7206704,59.73684211,198,31.52866242,396,-91648,9728,-81920,7
176,22,20,10,0.111111111,0.888888889,55.36371071,61.46294994,103.4147727,68.18181818,198,46.69811321,396,-90112,11264,-78848,7
180,24,22,8,0.117647059,0.882352941,57.46992208,60.92366296,106.45,72.875,204,38.34586466,408,-92160,12288,-79872,7
166,22,20,10,0.117021277,0.882978723,52.90564657,51.51845132,99.15060241,59.40909091,188,21.73410405,376,-84992,11264,-73728,7
177,20,21,9,0.101522843,0.898477157,55.15628963,57.5079125,103.3163842,60.8,197,40.36885246,394,-90624,10240,-80384,7
178,24,21,9,0.118811881,0.881188119,56.84258891,60.30269422,105.5393258,71.54166667,202,35.3765324,404,-91136,12288,-78848,7
181,21,22,8,0.103960396,0.896039604,57.12654765,56.85646486,105.5303867,66.76190476,202,36.72727273,404,-92672,10752,-81920,7
173,22,20,10,0.112820513,0.887179487,54.63492449,58.47433569,102.1387283,65.45454545,195,54.0166205,390,-88576,11264,-77312,7
179,21,22,8,0.105,0.895,56.30661101,54.72234596,105.1117318,61.19047619,200,10.03512293,400,-91648,10752,-80896,7
168,22,21,9,0.115789474,0.884210526,52.86244041,59.64343085,99.55357143,64.54545455,190,24.3902439,380,-86016,11264,-74752,7
176,25,19,11,0.124378109,0.875621891,56.1136844,60.01901032,105.7897727,67.28,201,33.83838384,402,-90112,12800,-77312,7
177,20,22,8,0.101522843,0.898477157,55.40695162,55.18006887,103.3389831,60.6,197,28.75912409,394,-90624,10240,-80384,7
167,26,21,9,0.134715026,0.865284974,53.38596351,64.95994442,100.2874251,75.88461538,193,3.454447825,386,-85504,13312,-72192,7
179,20,22,8,0.100502513,0.899497487,56.09723843,58.56654335,103.7318436,66.6,199,32.89256198,398,-91648,10240,-81408,7
172,23,21,9,0.117948718,0.882051282,54.73337551,59.08594874,101.9127907,68.73913043,195,37.07224335,390,-88064,11776,-76288,7
167,21,19,11,0.111702128,0.888297872,52.17784854,55.13179427,99.35329341,55.9047619,188,45.19230769,376,-85504,10752,-74752,7
187,21,22,8,0.100961538,0.899038462,58.2571307,64.18097287,108.4385027,69.42857143,208,41.10671937,416,-95744,10752,-84992,7
827,80,23,7,0.0882028666,0.911797133,258.2264475,288.9306837,460.1523579,390.4,907,118.2529335,1814,-423424,40960,-382464,7
841,89,22,8,0.0956989247,0.904301075,263.9848436,297.3580253,473.4292509,390.5730337,930,155.5183946,1860,-430592,45568,-385024,7
640,68,23,7,0.0960451977,0.903954802,198.1866089,255.3442461,353.8296875,360.8088235,708,12.50220731,1416,-327680,34816,-292864,7
798,78,23,7,0.0890410959,0.910958904,249.9379203,277.8001688,442.5726817,396.8333333,876,138.8272583,1752,-408576,39936,-368640,7
638,71,23,7,0.100141044,0.899858956,199.5852525,227.9580715,364.6739812,268.0704225,709,243.6426117,1418,-326656,36352,-290304,7
699,69,23,7,0.08984375,0.91015625,216.1655086,271.0609787,385.9527897,369.7826087,768,57.0155902,1536,-357888,35328,-322560,7
659,67,23,7,0.0922865014,0.907713499,204.6869063,243.4955793,370.0424886,299.1492537,726,111.179173,1452,-337408,34304,-303104,7
664,69,24,6,0.0941336971,0.905866303,206.9256175,225.8635221,378.0933735,260.2463768,733,112.4233129,1466,-339968,35328,-304640,7
637,70,23,7,0.099009901,0.900990099,198.7924149,245.6468861,356.8477237,328.0857143,707,162.9032258,1414,-326144,35840,-290304,7
625,73,23,7,0.104584527,0.895415473,195.2708945,248.2030968,350.8016,338.3561644,698,68.29745597,1396,-320000,37376,-282624,7
647,72,23,7,0.100139082,0.899860918,201.2253417,257.0237411,361.7604328,344.1805556,719,165.2873563,1438,-331264,36864,-294400,7
753,73,23,7,0.088377724,0.911622276,235.306916,263.0980851,418.5471448,361.4383562,826,183.5555556,1652,-385536,37376,-348160,7
667,67,23,7,0.091280654,0.908719346,208.0535659,233.7648372,375.0869565,291.9701493,734,108.4194978,1468,-341504,34304,-307200,7
689,69,24,6,0.0910290237,0.908970976,213.4726985,263.186085,383.4092888,340.4637681,758,136.8231047,1516,-352768,35328,-317440,7
738,78,23,7,0.0955882353,0.904411765,232.4122355,257.8397384,413.9485095,356.9487179,816,35.89969204,1632,-377856,39936,-337920,7
635,74,23,7,0.104372355,0.895627645,199.9176667,227.9775164,363.8346457,279.1891892,709,20.48540884,1418,-325120,37888,-287232,7
664,68,23,7,0.0928961749,0.907103825,206.4678334,246.9027636,372.2243976,310.6029412,732,93.72599232,1464,-339968,34816,-305152,7
745,78,23,7,0.0947752126,0.905224787,233.7562088,267.340018,416.6563758,367.525641,823,116.407355,1646,-381440,39936,-341504,7
745,76,23,7,0.0925700365,0.907429963,233.4722887,263.7602563,416.2147651,359.8815789,821,132.2061192,1642,-381440,38912,-342528,7
670,73,23,7,0.0982503365,0.901749664,208.807575,258.4334346,375.6940299,338.0958904,743,77.6384535,1486,-343040,37376,-305664,7
560,45,23,7,0.0743801653,0.925619835,170.4617311,215.2801379,306.5732143,258.5333333,605,164.8501362,1210,-286720,23040,-263680,7
556,44,23,7,0.0733333333,0.926666667,169.6952311,206.3431157,304.4064748,251.1363636,600,129.0322581,1200,-284672,22528,-262144,7
592,51,24,6,0.0793157076,0.920684292,182.0697815,215.5885857,326.6165541,268.4117647,643,73.73853211,1286,-303104,26112,-276992,7
557,40,24,6,0.067001675,0.932998325,168.769114,213.580143,301.2369838,267.85,597,85.89928058,1194,-285184,20480,-264704,7
704,53,22,8,0.07001321,0.92998679,215.5545567,251.3398811,382.0113636,339,757,92.2046285,1514,-360448,27136,-333312,7
551,41,24,6,0.0692567568,0.930743243,167.9451236,201.5512889,299.7241379,253.1707317,592,84.57142857,1184,-282112,20992,-261120,7
595,42,23,7,0.0659340659,0.934065934,180.0588575,229.5967035,320.9663866,291.1428571,637,98.30246914,1274,-304640,21504,-283136,7
597,41,23,7,0.0642633229,0.935736677,181.2893073,217.2113482,322.5393635,275.2439024,638,36.41552511,1276,-305664,20992,-284672,7
811,82,23,7,0.091825308,0.908174692,251.8395076,305.2130481,441.48582,501.5365854,893,110.931677,1786,-415232,41984,-373248,7
565,44,23,7,0.0722495895,0.927750411,171.6538726,214.3977101,309.4070796,248.4090909,609,135.9375,1218,-289280,22528,-266752,7
742,72,22,8,0.0884520885,0.911547912,229.7190651,283.525569,408.0134771,402.2083333,814,45.07198228,1628,-379904,36864,-343040,7
673,52,23,7,0.0717241379,0.928275862,206.9791418,235.1553119,365.2942051,333.3076923,725,151.0416667,1450,-344576,26624,-317952,7
561,41,23,7,0.0681063123,0.931893688,170.0765138,217.7061175,302.5918004,286.5609756,602,76.59033079,1204,-287232,20992,-266240,7
557,39,24,6,0.0654362416,0.934563758,168.6734001,212.8662571,300.3177738,272.5384615,596,127.8969957,1192,-285184,19968,-265216,7
585,48,22,8,0.0758293839,0.924170616,179.188482,214.7427684,321.2495726,265.2083333,633,90.68767908,1266,-299520,24576,-274944,7
582,48,23,7,0.0761904762,0.923809524,178.3465572,214.5707672,319.3848797,268.3958333,630,108.8082902,1260,-297984,24576,-273408,7
764,76,23,7,0.0904761905,0.90952381,236.3354137,293.4380863,415.9463351,466.2763158,840,100.2386635,1680,-391168,38912,-352256,7
627,50,22,8,0.0738552437,0.926144756,191.2079232,240.0119364,341.5135566,307.48,677,106.1128527,1354,-321024,25600,-295424,7
628,52,23,7,0.0764705882,0.923529412,192.8548796,233.5933564,341.4856688,328.5961538,680,169.1542289,1360,-321536,26624,-294912,7
678,53,23,7,0.07250342,0.92749658,208.4204157,238.1968546,369.1474926,325.7358491,731,157.5431034,1462,-347136,27136,-320000,7
966,80,23,7,0.0764818356,0.923518164,300.8610182,314.749414,524.1428571,515.7375,1046,118.3257919,2092,-494592,40960,-453632,7
748,70,23,7,0.0855745721,0.914425428,234.2742781,252.688667,412.6858289,375.4571429,818,101.6149068,1636,-382976,35840,-347136,7
729,69,23,7,0.0864661654,0.913533835,227.9150496,253.3769687,401.9231824,373.8985507,798,102.8350515,1596,-373248,35328,-337920,7
940,84,22,8,0.08203125,0.91796875,294.4211674,304.1801318,516.9159574,463.0833333,1024,140.4663923,2048,-481280,43008,-438272,7
748,72,22,8,0.087804878,0.912195122,233.7943467,262.3722426,414.0160428,373.9722222,820,181.8181818,1640,-382976,36864,-346112,7
731,64,23,7,0.0805031447,0.919496855,226.2444637,263.6410024,398.7989056,388.875,795,147.7695167,1590,-374272,32768,-341504,7
1031,82,23,7,0.0736747529,0.926325247,321.0775512,322.5275791,559.3782735,527.097561,1113,101.5510949,2226,-527872,41984,-485888,7
753,71,23,7,0.0861650485,0.913834951,235.4777988,260.327431,415.0664011,385.2816901,824,174.2071882,1648,-385536,36352,-349184,7
727,65,24,6,0.0820707071,0.917929293,226.6708063,246.213784,399.9587345,357.8153846,792,141.9354839,1584,-372224,33280,-338944,7
931,78,24,6,0.0773042616,0.922695738,289.9416288,303.4072216,508.6176155,461.8205128,1009,203.4274194,2018,-476672,39936,-436736,7
775,60,24,6,0.0718562874,0.928143713,238.4071473,270.5156106,420.6374194,383.9333333,835,96.86774942,1670,-396800,30720,-366080,7
934,87,22,8,0.0852105779,0.914789422,292.7682746,309.7192575,516.1659529,455.5402299,1021,175.4295533,2042,-478208,44544,-433664,7
858,70,22,8,0.0754310345,0.924568966,266.0222736,289.7121178,463.9055944,471.7857143,928,138.3010432,1856,-439296,35840,-403456,7
924,83,23,7,0.0824230387,0.917576961,288.8803065,306.4375478,508.1385281,457.9277108,1007,136.0810811,2014,-473088,42496,-430592,7
887,77,23,7,0.0798755187,0.920124481,275.8311267,304.9758728,481.7576099,491.0519481,964,17.2358305,1928,-454144,39424,-414720,7
758,72,22,8,0.086746988,0.913253012,235.2037358,281.5532532,416.4617414,405.375,830,14.73721591,1660,-388096,36864,-351232,7
1024,78,23,7,0.0707803993,0.929219601,316.7319972,335.0001109,553.2099609,529.0512821,1102,139.6704689,2204,-524288,39936,-484352,7
827,75,23,7,0.0831485588,0.916851441,258.5600926,279.5905215,452.2309553,443.44,902,128.8571429,1804,-423424,38400,-385024,7
928,77,23,7,0.0766169154,0.923383085,288.4180535,306.1597704,506.8157328,457.012987,1005,98.24046921,2010,-475136,39424,-435712,7
698,64,23,7,0.0839895013,0.916010499,217.9141568,236.0446859,385.8782235,333.75,762,12.43675535,1524,-357376,32768,-324608,7
1889,181,22,8,0.0874396135,0.912560386,594.9499427,584.0993942,1055.627845,825.4364641,2070,213.1822863,4140,-967168,92672,-874496,7
1936,196,23,7,0.0919324578,0.908067542,613.5167141,584.2238266,1090.327479,831.1428571,2132,276.1658031,4264,-991232,100352,-890880,7
1905,199,23,7,0.094581749,0.905418251,603.4767496,575.6773213,1081.07664,778.9396985,2104,316.8674699,4208,-975360,101888,-873472,7
809,51,23,7,0.0593023256,0.940697674,246.8427805,267.6315761,432.5648949,397.745098,860,146.0101868,1720,-414208,26112,-388096,7
1830,164,22,8,0.0822467402,0.91775326,570.6869471,611.8607467,1009.653005,861.8902439,1994,34.72052934,3988,-936960,83968,-852992,7
1862,199,22,8,0.0965550704,0.90344493,599.789258,540.3689329,1040.077336,946.0653266,2061,374.7272727,4122,-953344,101888,-851456,7
2212,162,24,6,0.0682392586,0.931760741,685.8675744,661.6997492,1197.855787,1046.098765,2374,313.1926121,4748,-1132544,82944,-1049600,7
1842,156,23,7,0.0780780781,0.921921922,573.134371,599.9169321,1011.607492,856.5384615,1998,391.7647059,3996,-943104,79872,-863232,7
1978,158,23,7,0.0739700375,0.926029963,612.8094384,629.5470858,1084.323054,870.4113924,2136,202.8490028,4272,-1012736,80896,-931840,7
1814,165,22,8,0.0833754421,0.916624558,568.7023108,570.3863139,1005.923925,814.9333333,1979,270.7250342,3958,-928768,84480,-844288,7
1648,135,23,7,0.0757150869,0.924284913,517.586299,454.250125,903.7621359,748.4148148,1783,65.93934911,3566,-843776,69120,-774656,7
1947,163,23,7,0.0772511848,0.922748815,605.8466269,618.4912463,1070.706728,873.8588957,2110,229.5973885,4220,-996864,83456,-913408,7
1803,150,22,8,0.0768049155,0.923195084,561.8191408,581.5271475,983.3144759,901.1,1953,383.6935167,3906,-923136,76800,-846336,7
1763,147,24,6,0.0769633508,0.923036649,549.2310671,537.8937049,972.0930233,756.4965986,1910,257.0659489,3820,-902656,75264,-827392,7
1858,191,24,6,0.093216203,0.906783797,590.9612315,561.2709156,1044.817546,832.2198953,2049,408.1673307,4098,-951296,97792,-853504,7
1773,155,24,6,0.0803941909,0.919605809,553.3180139,561.4209253,980.3626622,783.0516129,1928,236.8550369,3856,-907776,79360,-828416,7
1977,185,22,8,0.0855689177,0.914431082,620.3112513,611.2544671,1104.572079,834.9405405,2162,398.1583794,4324,-1012224,94720,-917504,7
1906,178,23,7,0.0854126679,0.914587332,600.7295768,580.8418938,1059.383526,861.7134831,2084,325.625,4168,-975872,91136,-884736,7
2059,168,23,7,0.0754378087,0.924562191,643.81613,625.6726447,1120.590578,1033.22619,2227,249.9438833,4454,-1054208,86016,-968192,7
1962,193,22,8,0.0895591647,0.910440835,624.5731209,583.8404338,1089.389399,962.2176166,2155,306.1079545,4310,-1004544,98816,-905728,7
2275,192,23,7,0.0778273206,0.922172679,709.0900876,647.3504377,1264.306374,874.9010417,2467,248.6895161,4934,-1164800,98304,-1066496,7
2217,181,24,6,0.0754795663,0.924520434,693.5334661,609.4323736,1222.505638,917.7127072,2398,62.01189553,4796,-1135104,92672,-1042432,7
2480,262,23,7,0.0955506929,0.904449307,794.5656989,681.1709464,1405.900806,1045.874046,2742,321.0772834,5484,-1269760,134144,-1135616,7
2049,197,23,7,0.0877114871,0.912288513,641.5665915,637.5754262,1153.267448,813.8883249,2246,435.2713178,4492,-1049088,100864,-948224,7
1666,206,23,7,0.110042735,0.889957265,548.8978671,432.9958846,956.5966387,773.9708738,1872,33.03335098,3744,-852992,105472,-747520,7
2202,241,22,8,0.0986492018,0.901350798,702.8496352,622.975572,1260.867847,866.8672199,2443,370.7132018,4886,-1127424,123392,-1004032,7
2068,164,22,8,0.0734767025,0.926523297,642.7866489,604.7569298,1137.314797,854.0304878,2232,196.3060686,4464,-1058816,83968,-974848,7
2067,229,23,7,0.099738676,0.900261324,657.5954402,568.1597024,1192.91195,747.628821,2296,499.1304348,4592,-1058304,117248,-941056,7
2424,175,23,7,0.0673335898,0.93266641,747.9456413,766.8205112,1310.585809,1153.371429,2599,392.0060332,5198,-1241088,89600,-1151488,7
2199,214,23,7,0.0886862826,0.911313717,688.47316,669.8878841,1243.189177,835.1308411,2413,208.9177489,4826,-1125888,109568,-1016320,7
2045,172,23,7,0.0775823184,0.922417682,633.3550246,637.4972332,1135.010269,799.75,2217,346.9483568,4434,-1047040,88064,-958976,7
2376,253,22,8,0.0962343096,0.90376569,748.2717501,712.0227656,1362.460017,869.2885375,2629,408.8646967,5258,-1216512,129536,-1086976,7
2226,154,23,7,0.0647058824,0.935294118,683.821169,687.6449248,1207.30593,947.5779221,2380,289.1859052,4760,-1139712,78848,-1060864,7
2197,208,23,7,0.0864864865,0.913513514,690.0219047,678.0782009,1229.262176,925.6057692,2405,522.826087,4810,-1124864,106496,-1018368,7
2391,228,22,8,0.0870561283,0.912943872,745.3552329,739.4658783,1350.029276,890.2192982,2619,465.1865009,5238,-1224192,116736,-1107456,7
2351,187,23,7,0.073680063,0.926319937,729.3834632,730.3526762,1288.798809,1026.871658,2538,250.295858,5076,-1203712,95744,-1107968,7
2407,186,23,7,0.071731585,0.928268415,748.5687892,732.0531958,1308.471126,1148.553763,2593,375.7971014,5186,-1232384,95232,-1137152,7
2018,187,23,7,0.0848072562,0.915192744,631.390484,603.2974287,1132.602081,783.5508021,2205,500,4410,-1033216,95744,-937472,7
2025,180,23,7,0.0816326531,0.918367347,631.5242898,592.0665202,1133.239012,762.8111111,2205,224.7706422,4410,-1036800,92160,-944640,7
2395,219,22,8,0.083779648,0.916220352,745.3864882,743.814448,1343.293946,916.0547945,2614,279.2735043,5228,-1226240,112128,-1114112,7
787,105,23,7,0.117713004,0.882286996,249.0483333,313.4259229,448.0368488,434.9809524,892,203.652968,1784,-402944,53760,-349184,7
810,103,23,7,0.112814896,0.887185104,259.9547604,253.0534658,474.0530864,322.8932039,913,120.2898551,1826,-414720,52736,-361984,7
768,106,23,7,0.121281465,0.878718535,243.8467153,305.6697652,440.7122396,414.2264151,874,67.28252502,1748,-393216,54272,-338944,7
778,99,23,7,0.112884835,0.887115165,247.3061602,291.5901343,444.5231362,395.5959596,877,181.9502075,1754,-398336,50688,-347648,7
770,97,23,7,0.111880046,0.888119954,243.3415285,293.4334948,441.2506494,376.443299,867,113.0378096,1734,-394240,49664,-344576,7
818,98,23,7,0.1069869,0.8930131,258.1502426,311.5524289,460.2237164,444.1122449,916,153.4338358,1832,-418816,50176,-368640,7
932,110,23,7,0.105566219,0.894433781,297.4953411,322.6805653,527.72103,468.7909091,1042,144.1217151,2084,-477184,56320,-420864,7
897,116,23,7,0.114511352,0.885488648,288.2093353,319.5733114,512.87068,461.6034483,1013,210.1659751,2026,-459264,59392,-399872,7
939,110,22,8,0.104861773,0.895138227,296.6443375,341.4316969,534.0905218,447.4,1049,18.91112313,2098,-480768,56320,-424448,7
982,114,24,6,0.104014599,0.895985401,313.6446045,310.2116956,563.5498982,418.8596491,1096,181.4569536,2192,-502784,58368,-444416,7
859,110,23,7,0.113519092,0.886480908,275.002733,311.8803193,489.572759,449.2909091,969,113.5990621,1938,-439808,56320,-383488,7
779,105,22,8,0.118778281,0.881221719,247.6161456,302.801679,447.6867779,404.0190476,884,145.3947368,1768,-398848,53760,-345088,7
768,103,22,8,0.118254879,0.881745121,244.5230856,295.1020174,441.1901042,397.3009709,871,203.5046729,1742,-393216,52736,-340480,7
986,116,23,7,0.105263158,0.894736842,314.3734396,338.498194,560.6501014,473.7241379,1102,176.32,2204,-504832,59392,-445440,7
829,106,23,7,0.113368984,0.886631016,264.3099663,308.2182879,472.26538,434.6415094,935,164.6126761,1870,-424448,54272,-370176,7
979,112,23,7,0.102658112,0.897341888,314.1906207,303.9727514,557.3329928,446.9375,1091,127.7517564,2182,-501248,57344,-443904,7
1022,117,23,7,0.102721686,0.897278314,326.5103403,337.647835,579.2113503,489.5384615,1139,137.3944511,2278,-523264,59904,-463360,7
898,112,23,7,0.110891089,0.889108911,287.5902544,319.6588901,509.688196,471.9196429,1010,106.3157895,2020,-459776,57344,-402432,7
988,118,24,6,0.106690778,0.893309222,316.6483123,311.7346977,568.9534413,424.1101695,1106,143.0789133,2212,-505856,60416,-445440,7
940,117,23,7,0.110690634,0.889309366,300.988556,334.8796372,532.9361702,497.3760684,1057,144.5964432,2114,-481280,59904,-421376,7
805,59,24,6,0.068287037,0.931712963,247.2742246,270.9700768,436.5590062,377.1186441,864,109.5057034,1728,-412160,30208,-381952,7
770,63,23,7,0.0756302521,0.924369748,238.1430486,260.2046707,421.7896104,358.4603175,833,38.05390589,1666,-394240,32256,-361984,7
785,67,22,8,0.0786384977,0.921361502,243.5584826,266.6597698,431.066242,373,852,154.0687161,1704,-401920,34304,-367616,7
850,65,23,7,0.0710382514,0.928961749,261.6377521,291.0036442,461.5141176,412.0461538,915,160.8084359,1830,-435200,33280,-401920,7
812,68,23,7,0.0772727273,0.922727273,250.8797009,279.2917215,446.4913793,368.9558824,880,90.81527348,1760,-415744,34816,-380928,7
626,49,23,7,0.0725925926,0.927407407,191.3083846,232.2522111,340.9456869,300.3673469,675,90.12016021,1350,-320512,25088,-295424,7
631,58,23,7,0.084179971,0.915820029,194.1028045,243.8406144,347.1537242,321.5689655,689,12.13669191,1378,-323072,29696,-293376,7
805,63,23,7,0.0725806452,0.927419355,248.109539,273.8912986,438.9242236,377.968254,868,130.5263158,1736,-412160,32256,-379904,7
805,59,23,7,0.068287037,0.931712963,247.4240108,270.7484779,435.9664596,385.2033898,864,192,1728,-412160,30208,-381952,7
811,64,23,7,0.0731428571,0.926857143,250.0326009,279.3895061,441.4278668,394.5625,875,118.724559,1750,-415232,32768,-382464,7
731,59,23,7,0.0746835443,0.925316456,224.7576982,262.3313526,398.6812585,356.0847458,790,152.2157996,1580,-374272,30208,-344064,7
809,63,23,7,0.0722477064,0.927752294,249.1848209,275.5030315,441.1236094,377.1269841,872,156.5529623,1744,-414208,32256,-381952,7
808,62,23,7,0.0712643678,0.928735632,248.5249747,276.996396,439.8267327,379.1129032,870,112.2580645,1740,-413696,31744,-381952,7
626,52,22,8,0.0766961652,0.923303835,191.684571,233.551193,343.5607029,290.6153846,678,60.48171276,1356,-320512,26624,-293888,7
785,66,23,7,0.0775558167,0.922444183,243.1252775,266.8497891,431.0369427,366.0909091,851,129.7256098,1702,-401920,33792,-368128,7
710,56,24,6,0.0731070496,0.92689295,217.5538854,258.4684952,386.8549296,340.9642857,766,90.75829384,1532,-363520,28672,-334848,7
773,67,23,7,0.0797619048,0.920238095,239.1029641,278.1240838,421.8124191,405.358209,840,14.59600348,1680,-395776,34304,-361472,7
663,58,23,7,0.080443828,0.919556172,204.7030769,235.6117168,366.306184,300.3448276,721,96.90860215,1442,-339456,29696,-309760,7
629,55,23,7,0.0804093567,0.919590643,193.2348183,233.5576139,347.3084261,287.5090909,684,87.02290076,1368,-322048,28160,-293888,7
567,51,23,7,0.0825242718,0.917475728,175.4578894,190.3826193,316.7901235,228.4509804,618,9.990300679,1236,-290304,26112,-264192,7
1023,117,23,7,0.102631579,0.897368421,325.6551798,349.099729,578.9550342,496.5726496,1140,84.19497784,2280,-523776,59904,-463872,7
805,94,24,6,0.104560623,0.895439377,254.5855304,296.0923238,454.1329193,414.606383,899,109.3673966,1798,-412160,48128,-364032,7
950,110,23,7,0.103773585,0.896226415,303.0989994,314.281601,541.5147368,435.3727273,1060,146.4088398,2120,-486400,56320,-430080,7
938,111,23,7,0.105815062,0.894184938,298.9052422,326.7172864,532.8027719,459.0630631,1049,176.8971332,2098,-480256,56832,-423424,7
817,104,23,7,0.112920738,0.887079262,259.3741029,311.3037031,458.1162791,483.6538462,921,151.2315271,1842,-418304,53248,-365056,7
1027,107,22,8,0.094356261,0.905643739,324.9352533,326.6836947,579.8860759,448.6168224,1134,140.1730532,2268,-525824,54784,-471040,7
839,105,24,6,0.111228814,0.888771186,266.9653919,310.2660639,477.6340882,431.4761905,944,282.6347305,1888,-429568,53760,-375808,7
1008,111,23,7,0.0991957105,0.90080429,321.1030369,338.3965235,563.4513889,528.6576577,1119,154.3448276,2238,-516096,56832,-459264,7
810,100,23,7,0.10989011,0.89010989,258.4911911,287.1722958,463.1234568,393.75,910,119.5795007,1820,-414720,51200,-363520,7
839,105,23,7,0.111228814,0.888771186,267.478203,305.6449519,478.4576877,424.8952381,944,134.8571429,1888,-429568,53760,-375808,7
1007,117,23,7,0.104092527,0.895907473,321.6172006,340.1965399,570.59285,492.8461538,1124,196.1605585,2248,-515584,59904,-455680,7
981,117,23,7,0.106557377,0.893442623,314.5120226,332.9740499,555.2303772,501.4529915,1098,190.9565217,2196,-502272,59904,-442368,7
933,103,24,6,0.0994208494,0.900579151,296.7838878,318.9613257,519.0675241,513.3592233,1036,112.4864278,2072,-477696,52736,-424960,7
1038,114,23,7,0.0989583333,0.901041667,333.1694505,310.2293189,587.2418112,478.6929825,1152,156.5217391,2304,-531456,58368,-473088,7
813,98,23,7,0.107574094,0.892425906,258.325348,292.6248665,462.901599,398.744898,911,211.3689095,1822,-416256,50176,-366080,7
816,97,23,7,0.106243154,0.893756846,260.1451608,271.4280962,468.6985294,358.5876289,913,140.0306748,1826,-417792,49664,-368128,7
1082,121,23,7,0.100581879,0.899418121,344.3764719,366.2005715,609.0600739,538.8677686,1203,117.7103718,2406,-553984,61952,-492032,7
1017,114,23,7,0.100795756,0.899204244,324.2137119,343.6944273,570.373648,526.9824561,1131,166.0792952,2262,-520704,58368,-462336,7
1080,119,23,7,0.0992493745,0.900750626,344.5956633,356.3747715,605.0814815,553.8823529,1199,161.155914,2398,-552960,60928,-492032,7
1007,111,22,8,0.0992844365,0.900715564,320.6228871,332.5978326,567.5273088,486.6756757,1118,96.88041594,2236,-515584,56832,-458752,7
2215,172,23,7,0.0720569753,0.927943025,686.6669168,638.0222971,1218.839729,874.1162791,2387,208.2897033,4774,-1134080,88064,-1046016,7
2368,189,23,7,0.0739147438,0.926085256,731.6161478,763.1404367,1301.081081,1002.343915,2557,298.3663944,5114,-1212416,96768,-1115648,7
2471,232,23,7,0.0858305586,0.914169441,772.005277,727.5364352,1393.768919,907.125,2703,186.2853205,5406,-1265152,118784,-1146368,7
2475,205,23,7,0.0764925373,0.923507463,764.5258369,797.6235407,1369.392727,991.6731707,2680,207.1097372,5360,-1267200,104960,-1162240,7
2480,181,23,7,0.0680195415,0.931980458,759.6920016,823.1675426,1352.118145,1041.646409,2661,350.5928854,5322,-1269760,92672,-1177088,7
2263,170,23,7,0.0698725853,0.930127415,694.8836171,744.8926172,1237.134335,948.9764706,2433,253.4375,4866,-1158656,87040,-1071616,7
2467,225,23,7,0.0835809807,0.916419019,766.2975571,760.4406401,1386.383056,909.2044444,2692,165.9679408,5384,-1263104,115200,-1147904,7
2239,208,22,8,0.0850020433,0.914997957,698.4337348,672.9844233,1260.244752,833.8461538,2447,526.2365591,4894,-1146368,106496,-1039872,7
2307,211,23,7,0.083796664,0.916203336,720.8051981,676.4873483,1295.269614,868.4075829,2518,608.2125604,5036,-1181184,108032,-1073152,7
2257,161,23,7,0.0665839537,0.933416046,694.795631,719.2685558,1221.975188,1034.614907,2418,42.30971129,4836,-1155584,82432,-1073152,7
2332,223,23,7,0.0872798434,0.912720157,728.5028906,720.8533709,1314.918525,891.9282511,2555,298.1330222,5110,-1193984,114176,-1079808,7
2146,215,23,7,0.0910631089,0.908936891,675.0555134,631.703936,1218.431966,807.3767442,2361,456.6731141,4722,-1098752,110080,-988672,7
2476,234,22,8,0.0863468635,0.913653137,772.2376257,772.3975276,1393.941034,948.7478632,2710,460.1018676,5420,-1267712,119808,-1147904,7
2364,172,23,7,0.0678233438,0.932176656,729.1019259,724.9254099,1287.116751,1012.627907,2536,345.5040872,5072,-1210368,88064,-1122304,7
2492,176,23,7,0.0659670165,0.934032984,767.9754039,774.2697319,1348.458266,1136.863636,2668,338.5786802,5336,-1275904,90112,-1185792,7
2262,208,24,6,0.0842105263,0.915789474,705.9630745,640.3862115,1275.568081,799.7596154,2470,229.7674419,4940,-1158144,106496,-1051648,7
2439,218,23,7,0.0820474219,0.917952578,771.906687,674.3942182,1347.9918,1116.518349,2657,416.4576803,5314,-1248768,111616,-1137152,7
2407,184,23,7,0.0710150521,0.928984948,740.8014494,771.9415328,1319.635646,986.8097826,2591,515.1093439,5182,-1232384,94208,-1138176,7
2133,201,23,7,0.0861182519,0.913881748,667.7643617,633.2021188,1201.023441,811.7512438,2334,376.4516129,4668,-1092096,102912,-989184,7
1745,173,23,7,0.090198123,0.909801877,552.2329939,543.9753472,974.9747851,803.4104046,1918,30.32890576,3836,-893440,88576,-804864,7
2765,183,25,5,0.0620759837,0.937924016,839.2040574,993.1559339,1487.235081,1282.081967,2948,551.0280374,5896,-1415680,93696,-1321984,8
2756,181,24,6,0.0616275111,0.938372489,836.1209431,998.8106797,1478.363933,1326.41989,2937,236.0932476,5874,-1411072,92672,-1318400,8
2764,184,24,6,0.0624151967,0.937584803,839.7982352,992.828684,1484.358538,1326.407609,2948,263.2142857,5896,-1415168,94208,-1320960,8
2713,153,23,7,0.053384508,0.946615492,820.6510879,937.9878794,1432.677847,1448.078431,2866,216.3018868,5732,-1389056,78336,-1310720,8
2798,193,23,7,0.0645269141,0.935473086,850.4827998,1015.485389,1508.646176,1312.663212,2991,319.2102455,5982,-1432576,98816,-1333760,8
2782,199,23,7,0.0667561221,0.933243878,846.293188,1017.75517,1505.604242,1286.834171,2981,565.654649,5962,-1424384,101888,-1322496,8
2777,198,23,7,0.0665546218,0.933445378,843.5970717,1031.483493,1501.21318,1302.681818,2975,189.0088945,5950,-1421824,101376,-1320448,8
2836,197,23,7,0.0649521925,0.935047807,862.1443474,1044.383311,1524.123766,1414.446701,3033,291.6346154,6066,-1452032,100864,-1351168,8
2801,189,24,6,0.0632107023,0.936789298,850.1551991,1012.454686,1510.046055,1279.925926,2990,331.8534961,5980,-1434112,96768,-1337344,8
2755,164,23,7,0.0561836245,0.943816375,832.7057449,986.3378881,1467.506352,1333.902439,2919,205.7082452,5838,-1410560,83968,-1326592,8
2828,197,23,7,0.0651239669,0.934876033,858.7683942,1047.712676,1523.59017,1360.974619,3025,564.3656716,6050,-1447936,100864,-1347072,8
2789,188,22,8,0.063150823,0.936849177,847.6457482,1001.036669,1500.990678,1311.117021,2977,264.8576512,5954,-1427968,96256,-1331712,8
2802,177,24,6,0.0594159114,0.940584089,853.1170556,927.6486088,1505.578872,1243.378531,2979,305.5384615,5958,-1434624,90624,-1344000,8
2782,188,23,7,0.0632996633,0.936700337,843.8170941,1016.809274,1498.940331,1286.611702,2970,207.8376487,5940,-1424384,96256,-1328128,8
2759,182,23,7,0.061883713,0.938116287,837.4273915,1000.63839,1478.877492,1351.582418,2941,253.0981067,5882,-1412608,93184,-1319424,8
2752,165,24,6,0.056564964,0.943435036,833.7129718,968.9361511,1462.534884,1400.042424,2917,256.1018437,5834,-1409024,84480,-1324544,8
2708,162,23,7,0.056445993,0.943554007,820.6752097,947.0431742,1439.675037,1365.709877,2870,294.057377,5740,-1386496,82944,-1303552,8
2542,150,23,7,0.0557206538,0.944279346,766.9515297,796.4283648,1374.327301,874.92,2692,50.24262785,5384,-1301504,76800,-1224704,8
2793,186,23,7,0.0624370594,0.937562941,848.8803337,994.4737031,1502.054422,1308.989247,2979,254.6153846,5958,-1430016,95232,-1334784,8
2012,170,23,7,0.0779101742,0.922089826,623.5679764,565.8355821,1124.988569,695.1529412,2182,39.40762146,4364,-1030144,87040,-943104,8
669,105,23,7,0.135658915,0.864341085,217.0267534,256.1388488,394.4947683,342.9333333,774,21.30470685,1548,-342528,53760,-288768,8
838,138,22,8,0.141393443,0.858606557,277.9237441,301.9385581,493.8019093,456.3043478,976,23.64341085,1952,-429056,70656,-358400,8
843,124,23,7,0.128231644,0.871768356,275.5283071,302.5722404,484.7034401,479.2177419,967,29.77216749,1934,-431616,63488,-368128,8
839,141,23,7,0.143877551,0.856122449,274.5289595,324.0708692,498.7020262,441.6950355,980,29.49142341,1960,-429568,72192,-357376,8
857,132,23,7,0.13346815,0.86653185,280.0998002,318.0092031,497.0711785,481.5530303,989,30.35604665,1978,-438784,67584,-371200,8
832,136,23,7,0.140495868,0.859504132,273.6471229,308.518331,492.0673077,438.2058824,968,28.91278375,1936,-425984,69632,-356352,8
856,133,23,7,0.134479272,0.865520728,282.727273,302.6720638,494.1051402,500.7593985,989,28.65005794,1978,-438272,68096,-370176,8
866,129,22,8,0.129648241,0.870351759,281.3757645,323.2522598,500.6466513,480.2325581,995,29.57788347,1990,-443392,66048,-377344,8
854,139,23,7,0.139979859,0.860020141,279.0270193,324.545557,505.735363,443.3309353,993,30.42279412,1986,-437248,71168,-366080,8
837,128,22,8,0.132642487,0.867357513,275.0384451,299.7301765,486.3500597,461.09375,965,28.18341121,1930,-428544,65536,-363008,8
825,134,23,7,0.139728884,0.860271116,268.9666925,315.2167171,489.2048485,423.3283582,959,28.38117786,1918,-422400,68608,-353792,8
830,126,23,7,0.131799163,0.868200837,271.3154146,304.7795151,477.3771084,485.8968254,956,27.31428571,1912,-424960,64512,-360448,8
838,125,22,8,0.1298027,0.8701973,268.6186377,321.9276275,494.4451074,398.568,963,28.48269743,1926,-429056,64000,-365056,8
835,137,22,8,0.140946502,0.859053498,274.1747348,314.8525152,491.9796407,453.1021898,972,28.99761337,1944,-427520,70144,-357376,8
854,119,23,7,0.122302158,0.877697842,280.2124743,285.625665,486.7763466,488.605042,973,27.22439843,1946,-437248,60928,-376320,8
860,139,23,7,0.139139139,0.860860861,282.9415695,314.4836008,508.8883721,445.0071942,999,28.156708,1998,-440320,71168,-369152,8
865,130,23,7,0.130653266,0.869346734,284.199259,306.1062375,500.5479769,481.0461538,995,26.84111141,1990,-442880,66560,-376320,8
834,131,23,7,0.135751295,0.864248705,274.6962019,300.4113286,487.6282974,453.5343511,965,28.81457151,1930,-427008,67072,-359936,8
832,132,23,7,0.136929461,0.863070539,271.3153506,312.4173664,491.7896635,423.9469697,964,28.27808742,1928,-425984,67584,-358400,8
851,121,23,7,0.124485597,0.875514403,276.0190226,310.0707252,489.4453584,465.785124,972,19.04761905,1944,-435712,61952,-373760,8
3110,361,23,7,0.10400461,0.89599539,994.168399,942.814784,1790.895498,1263.077562,3471,76.6902342,6942,-1592320,184832,-1407488,8
3123,381,23,7,0.108732877,0.891267123,986.1008269,1196.104288,1763.231508,1664.535433,3504,87.68768769,7008,-1598976,195072,-1403904,8
3106,367,22,8,0.105672329,0.894327671,983.6513579,1150.050238,1739.561172,1715.324251,3473,84.11237588,6946,-1590272,187904,-1402368,8
3147,359,22,8,0.102395893,0.897604107,988.6441828,1193.012758,1765.510327,1648.21727,3506,88.44601413,7012,-1611264,183808,-1427456,8
3144,386,23,7,0.109348442,0.890651558,1003.292496,1067.591035,1811.522901,1390.639896,3530,78.61915367,7060,-1609728,197632,-1412096,8
3108,356,24,6,0.102771363,0.897228637,979.2700953,1159.083799,1745.410553,1619.786517,3464,87.62964837,6928,-1591296,182272,-1409024,8
3149,377,22,8,0.106920023,0.893079977,994.5870319,1191.001134,1774.188314,1674.222812,3526,78.0952381,7052,-1612288,193024,-1419264,8
3121,374,23,7,0.107010014,0.892989986,987.9473077,1169.285446,1749.455944,1735.850267,3495,87.09195116,6990,-1597952,191488,-1406464,8
3116,395,23,7,0.11250356,0.88749644,989.0439799,1183.531352,1769.857831,1646.681013,3511,73.97808681,7022,-1595392,202240,-1393152,8
2325,206,24,6,0.0813907546,0.918609245,720.0379253,724.4560376,1302.28043,856.5242718,2531,124.9876543,5062,-1190400,105472,-1084928,8
3136,375,24,6,0.106807177,0.893192823,994.3720748,1161.03832,1759.714605,1724.936,3511,79.8317417,7022,-1605632,192000,-1413632,8
3142,378,22,8,0.107386364,0.892613636,992.7494029,1191.077396,1768.030236,1697.907407,3520,87.51864744,7040,-1608704,193536,-1415168,8
3150,373,22,8,0.105875674,0.894124326,992.7957773,1197.497321,1773.823175,1662.152815,3523,81.02575897,7046,-1612800,190976,-1421824,8
3134,398,22,8,0.112684032,0.887315968,997.4443999,1169.6719,1784.782706,1622.535176,3532,70.52715655,7064,-1604608,203776,-1400832,8
3106,356,24,6,0.102830734,0.897169266,981.354669,1143.31961,1737.774952,1676.752809,3462,76.98465644,6924,-1590272,182272,-1408000,8
3134,371,24,6,0.105848787,0.894151213,990.4091245,1176.015088,1758.755584,1704.380054,3505,78.69330938,7010,-1604608,189952,-1414656,8
3147,376,23,7,0.106727221,0.893272779,993.6886511,1187.327748,1776.6762,1639.164894,3523,85.09661836,7046,-1611264,192512,-1418752,8
3196,372,23,7,0.10426009,0.89573991,1007.571135,1202.260471,1794.327597,1700.067204,3568,84.05182568,7136,-1636352,190464,-1445888,8
3110,334,22,8,0.0969802555,0.903019744,977.5256571,1130.810605,1735.317685,1603.149701,3444,355.4179567,6888,-1592320,171008,-1421312,8
3109,383,23,7,0.109679267,0.890320733,985.7913189,1171.726815,1753.418463,1690.339426,3492,83.881816,6984,-1591808,196096,-1395712,8
1287,147,22,8,0.10251046,0.89748954,404.610929,484.4712328,724.039627,660.244898,1434,139.3586006,2868,-658944,75264,-583680,8
1246,146,21,9,0.104885057,0.895114943,392.2283285,474.4972243,700.6934189,660.7123288,1392,135.014549,2784,-637952,74752,-563200,8
1257,136,22,8,0.0976310122,0.902368988,394.7947685,463.761706,699.5513126,673.4191176,1393,34.05867971,2786,-643584,69632,-573952,8
1305,143,21,9,0.0987569061,0.901243094,409.601302,485.8699572,729.2659004,681.006993,1448,146.5587045,2896,-668160,73216,-594944,8
1276,147,22,8,0.103302881,0.896697119,402.6520916,474.0786708,716.1050157,676.3673469,1423,124.1710297,2846,-653312,75264,-578048,8
1298,141,22,8,0.0979847116,0.902015288,406.9171889,485.0443367,724.0392912,682.8156028,1439,105.5759354,2878,-664576,72192,-592384,8
2139,165,22,8,0.0716145833,0.928385417,652.0319125,810.7757322,1159.26087,1064.854545,2304,287.2817955,4608,-1095168,84480,-1010688,8
1267,145,21,9,0.102691218,0.897308782,398.6401973,475.671843,712.504341,654.0344828,1412,148.7881981,2824,-648704,74240,-574464,8
1274,147,21,9,0.103448276,0.896551724,400.7442245,482.5633166,715.7762951,669.6054422,1421,51.72915908,2842,-652288,75264,-577024,8
1265,143,21,9,0.1015625,0.8984375,397.9753898,474.4804144,706.6743083,685.2657343,1408,166.8246445,2816,-647680,73216,-574464,8
431,73,22,8,0.14484127,0.85515873,140.9064907,169.8860921,253.7169374,245.3150685,504,11.72365666,1008,-220672,37376,-183296,8
1275,140,21,9,0.0989399293,0.901060071,401.014474,470.4575628,710.3843137,686.2857143,1415,96.19306594,2830,-652800,71680,-581120,8
1295,141,22,8,0.098189415,0.901810585,407.2069531,476.0634975,720.8787645,696.6524823,1436,147.7366255,2872,-663040,72192,-590848,8
1251,144,21,9,0.103225806,0.896774194,393.9373886,470.8247834,701.6946443,665.9027778,1395,119.9484093,2790,-640512,73728,-566784,8
1270,146,22,8,0.103107345,0.896892655,399.2811844,480.558559,714.2653543,658.3493151,1416,123.7762238,2832,-650240,74752,-575488,8
1261,145,22,8,0.103129445,0.896870555,397.4138009,471.7287827,707.4742268,668.937931,1406,99.22371207,2812,-645632,74240,-571392,8
1260,139,21,9,0.0993566833,0.900643317,395.9438582,469.3646048,698.6642857,712.1079137,1399,74.06034939,2798,-645120,71168,-573952,8
1266,144,21,9,0.10212766,0.89787234,398.6846537,473.4947737,708.1524487,682.1805556,1410,138.5068762,2820,-648192,73728,-574464,8
647,73,21,9,0.101388889,0.898611111,202.4617775,233.0224846,370.3493045,273.2054795,720,11.2324493,1440,-331264,37376,-293888,8
1299,146,22,8,0.101038062,0.898961938,407.2230078,496.6183081,722.073903,731.239726,1445,149.4312306,2890,-665088,74752,-590336,8
799,125,23,7,0.135281385,0.864718615,257.8750737,311.7889785,471.2866083,406.336,924,23.78990731,1848,-409088,64000,-345088,8
813,128,23,7,0.136025505,0.863974495,268.6006916,289.8805147,473.0651907,457.8828125,941,26.97047865,1882,-416256,65536,-350720,8
798,124,23,7,0.134490239,0.865509761,261.2890507,293.6536992,466.3721805,430.1451613,922,26.48664177,1844,-408576,63488,-345088,8
805,131,22,8,0.139957265,0.860042735,265.3692695,295.5940988,474.4024845,432.2290076,936,45.23924601,1872,-412160,67072,-345088,8
792,126,22,8,0.137254902,0.862745098,260.3646209,291.0915946,463.7108586,433.031746,918,26.93661972,1836,-405504,64512,-340992,8
792,131,23,7,0.141928494,0.858071506,261.9289259,290.1094718,467.4457071,429.0763359,923,27.9781752,1846,-405504,67072,-338432,8
800,118,23,7,0.128540305,0.871459695,261.0198478,290.1393156,461.69125,444.6440678,918,28.52703543,1836,-409600,60416,-349184,8
792,125,23,7,0.136314068,0.863685932,259.0908809,294.3220923,465.7436869,416.272,917,27.61216501,1834,-405504,64000,-341504,8
776,114,22,8,0.128089888,0.871910112,254.3678627,273.6618597,445.7048969,444.1052632,890,25.61151079,1780,-397312,58368,-338944,8
785,137,23,7,0.148590022,0.851409978,259.3983848,297.2694174,470.0636943,412.4306569,922,27.50596659,1844,-401920,70144,-331776,8
789,127,22,8,0.138646288,0.861353712,260.6578838,285.9593881,461.6387833,439,916,26.10430322,1832,-403968,65024,-338944,8
807,133,23,7,0.141489362,0.858510638,266.8878694,294.5052404,476.3890954,434.7669173,940,27.63892973,1880,-413184,68096,-345088,8
795,126,23,7,0.136807818,0.863192182,260.7231268,292.8879832,467.5899371,419.4206349,921,26.42754663,1842,-407040,64512,-342528,8
430,64,23,7,0.129554656,0.870445344,135.2138934,178.138217,254.3023256,201.796875,494,50.05065856,988,-220160,32768,-187392,8
794,135,23,7,0.145317546,0.854682454,262.8239759,295.5377639,470.6712846,431.6444444,929,27.03725262,1858,-406528,69120,-337408,8
789,132,23,7,0.143322476,0.856677524,259.5748139,297.0165547,468.3257288,417.2121212,921,26.98505713,1842,-403968,67584,-336384,8
816,132,23,7,0.139240506,0.860759494,268.9125084,299.1562794,479.9816176,440.6136364,948,28.99082569,1896,-417792,67584,-350208,8
776,125,23,7,0.138734739,0.861265261,257.0242825,277.9413445,453.4110825,436.032,901,26.53121319,1802,-397312,64000,-333312,8
808,123,23,7,0.132116004,0.867883996,263.216329,301.125163,470.2871287,437.8373984,931,26.9933314,1862,-413696,62976,-350720,8
799,129,23,7,0.139008621,0.860991379,263.9086101,289.6393855,469.212766,435.3100775,928,27.77611494,1856,-409088,66048,-343040,8
9429,531,24,6,0.053313253,0.946686747,2855.225812,2946.07258,5050.249443,3741.954802,9960,971.7073171,19920,-4827648,271872,-4555776,8
9406,553,22,8,0.0555276634,0.944472337,2845.823728,2999.161821,5062.817351,3571.356239,9959,579.0116279,19918,-4815872,283136,-4532736,8
9413,546,24,6,0.0548247816,0.945175218,2848.604166,3135.609837,5037.213322,3993.64652,9959,298.1736527,19918,-4819456,279552,-4539904,8
9416,544,22,8,0.0546184739,0.945381526,2851.623847,3049.253613,5044.702315,3869.233456,9960,1234.200743,19920,-4820992,278528,-4542464,8
9392,534,22,8,0.053798106,0.946201894,2847.043388,2938.19284,5029.421529,3804.071161,9926,247.5311721,19852,-4808704,273408,-4535296,8
9434,526,23,7,0.052811245,0.947188755,2853.9303,2997.385817,5046.256837,3801.127376,9960,1462.555066,19920,-4830208,269312,-4560896,8
1545,229,23,7,0.129086809,0.870913191,505.0615376,480.6503843,926.5255663,624.2052402,1774,30.77189939,3548,-791040,117248,-673792,8
9405,555,22,8,0.0557228916,0.944277108,2855.247298,2911.52698,5055.875492,3703.190991,9960,558.2959641,19920,-4815360,284160,-4531200,8
9419,541,22,8,0.0543172691,0.945682731,2853.087596,3079.122898,5036.11859,4012.160813,9960,217.4672489,19920,-4822528,276992,-4545536,8
9430,530,24,6,0.0532128514,0.946787149,2853.140309,3120.267537,5028.784199,4121.40566,9960,241.8062637,19920,-4828160,271360,-4556800,8
9408,550,23,7,0.0552319743,0.944768026,2838.107498,3306.827158,5033.318134,4058.916364,9958,270.0840792,19916,-4816896,281600,-4535296,8
9434,526,24,6,0.052811245,0.947188755,2854.440374,2987.032599,5046.474454,3797.224335,9960,852.739726,19920,-4830208,269312,-4560896,8
9447,511,24,6,0.0513155252,0.948684475,2855.867802,2954.927266,5044.438658,3778.960861,9958,764.2363776,19916,-4836864,261632,-4575232,8
9438,523,24,6,0.0525047686,0.947495231,2856.203273,2934.093533,5050.386946,3728.85086,9961,827.3255814,19922,-4832256,267776,-4564480,8
9404,514,23,7,0.0518249647,0.948175035,2843.528685,2952.879309,5025.095704,3759.379377,9918,186.393535,19836,-4814848,263168,-4551680,8
9441,519,23,7,0.0521084337,0.947891566,2860.095189,2929.268761,5040.637644,3886.55106,9960,717.062635,19920,-4833792,265728,-4568064,8
9362,593,23,7,0.0595680563,0.940431944,2838.570727,2880.629579,5086.743431,3261.210793,9955,546.377607,19910,-4793344,303616,-4489728,8
9435,525,23,7,0.0527108434,0.947289157,2855.116284,2930.598529,5052.084261,3694.028571,9960,815.0572831,19920,-4830720,268800,-4561920,8
9417,543,24,6,0.0545180723,0.945481928,2856.538991,2929.106486,5050.135393,3772.845304,9960,923.0769231,19920,-4821504,278016,-4543488,8
9414,546,23,7,0.0548192771,0.945180723,2851.094062,2995.404307,5053.472063,3722.333333,9960,1234.200743,19920,-4819968,279552,-4540416,8
5972,432,24,6,0.0674578389,0.932542161,1816.31994,1970.24486,3278.222371,2155.708333,6404,143.6518618,12808,-3057664,221184,-2836480,8
5953,338,23,7,0.0537275473,0.946272453,1793.011545,2150.487548,3166.534016,2784.346154,6291,152.0299662,12582,-3047936,173056,-2874880,8
6876,363,23,7,0.0501450477,0.949854952,2076.938451,2125.038394,3667.710733,2716.256198,7239,131.5703381,14478,-3520512,185856,-3334656,8
6053,415,23,7,0.0641620284,0.935837972,1839.137349,1938.868838,3308.397984,2156.657831,6468,173.219068,12936,-3099136,212480,-2886656,8
5955,377,23,7,0.0595388503,0.94046115,1804.811381,2058.379511,3206.693199,2531.618037,6332,113.7416921,12664,-3048960,193024,-2855936,8
6029,460,23,7,0.0708891971,0.929110803,1840.938483,1811.345128,3343.643722,1952.123913,6489,168.5454545,12978,-3086848,235520,-2851328,8
6082,445,24,6,0.0681783361,0.931821664,1854.200376,1900.233297,3349.666557,2093.159551,6527,183.1883244,13054,-3113984,227840,-2886144,8
5969,371,24,6,0.0585173502,0.94148265,1809.196452,2002.624317,3215.991623,2438.587601,6340,160.9137056,12680,-3056128,189952,-2866176,8
81,41,24,6,0.336065574,0.663934426,35.1553263,31.23044778,54.67901235,74.97560976,122,8.56741573,244,-41472,20992,-20480,8
5919,333,23,7,0.0532629559,0.946737044,1785.520192,2072.438643,3150.515797,2699.624625,6252,167.0317927,12504,-3030528,170496,-2860032,8
5963,403,23,7,0.0633050581,0.936694942,1808.695271,1988.485832,3248.526413,2221.334988,6366,153.3236994,12732,-3053056,206336,-2846720,8
5933,393,23,7,0.0621245653,0.937875435,1792.894226,2121.645902,3215.255014,2382.170483,6326,165.819135,12652,-3037696,201216,-2836480,8
6034,475,22,8,0.0729758796,0.92702412,1851.516396,1700.956779,3360.544581,1914.250526,6509,163.66608,13018,-3089408,243200,-2846208,8
5944,334,24,6,0.0532016566,0.946798343,1794.977569,2025.360332,3169.174293,2611.404192,6278,156.9107723,12556,-3043328,171008,-2872320,8
6059,472,23,7,0.0722707089,0.927729291,1852.951743,1801.927259,3368.377125,1951.798729,6531,161.9390032,13062,-3102208,241664,-2860544,8
5963,387,24,6,0.0609448819,0.939055118,1806.62059,2039.393557,3227.565823,2373.255814,6350,161.4954222,12700,-3053056,198144,-2854912,8
6132,404,23,7,0.0618115055,0.938188494,1865.075603,1917.723816,3335.984508,2244.205446,6536,170.1640198,13072,-3139584,206848,-2932736,8
5960,339,24,6,0.0538180664,0.946181934,1795.145228,2118.496424,3179.976174,2622.985251,6299,175.1668521,12598,-3051520,173568,-2877952,8
4870,315,24,6,0.0607521697,0.93924783,1481.731978,1472.025787,2647.880287,1744.533333,5185,90.39400279,10370,-2493440,161280,-2332160,8
5948,372,23,7,0.0588607595,0.941139241,1791.350713,2209.424664,3196.864829,2579.053763,6320,165.792235,12640,-3045376,190464,-2854912,8
2385,515,23,7,0.177586207,0.822413793,810.6031167,935.809634,1483.109015,1299.485437,2900,59.13539967,5800,-1221120,263680,-957440,8
2303,506,23,7,0.180135279,0.819864721,782.3280203,915.4933489,1437.3934,1257.565217,2809,59.28661883,5618,-1179136,259072,-920064,8
2268,454,22,8,0.166789126,0.833210874,763.998348,877.9548849,1384.042769,1248.885463,2722,55.76726081,5444,-1161216,232448,-928768,8
2273,452,23,7,0.16587156,0.83412844,764.6338926,879.1869255,1387.025077,1242.183628,2725,57.4288725,5450,-1163776,231424,-932352,8
175,145,23,7,0.453125,0.546875,98.91416291,78.83479498,177.9257143,139.4689655,320,16.62337662,640,-89600,74240,-15360,8
2294,511,23,7,0.182174688,0.817825312,791.1057692,879.1859249,1428.931997,1286.585127,2805,58.4375,5610,-1174528,261632,-912896,8
2357,518,23,7,0.180173913,0.819826087,811.2293312,898.7318485,1466.708952,1307.368726,2875,58.91393443,5750,-1206784,265216,-941568,8
2347,490,23,7,0.172717659,0.827282341,795.5215327,913.2147255,1444.541968,1296.659184,2837,57.4291498,5674,-1201664,250880,-950784,8
2375,470,22,8,0.165202109,0.834797891,808.4525324,880.5092767,1435.592,1359.370213,2845,55.85001963,5690,-1216000,240640,-975360,8
2321,497,23,7,0.176366217,0.823633783,780.8230676,927.3916329,1450.678156,1217.197183,2818,56.90630048,5636,-1188352,254464,-933888,8
2322,486,23,7,0.173076923,0.826923077,793.9882366,881.605094,1420.643411,1327.37037,2808,55.74746873,5616,-1188864,248832,-940032,8
2331,422,23,7,0.153287323,0.846712677,774.099697,899.9182191,1373.493779,1396.367299,2753,48.0286113,5506,-1193472,216064,-977408,8
2307,499,22,8,0.177833215,0.822166785,790.0213605,890.2197508,1424.623754,1305.839679,2806,53.96153846,5612,-1181184,255488,-925696,8
2295,500,23,7,0.178890877,0.821109123,782.148718,898.0578484,1428.983007,1255.788,2795,58.55855856,5590,-1175040,256000,-919040,8
2377,448,23,7,0.158584071,0.841415929,805.0548263,868.5088762,1417.297434,1390.198661,2825,56.38722555,5650,-1217024,229376,-987648,8
2272,471,23,7,0.171709807,0.828290193,761.494533,903.9524309,1408.398768,1196.420382,2743,55.83146754,5486,-1163264,241152,-922112,8
717,139,23,7,0.162383178,0.837616822,230.9003456,305.337355,444.1576011,347.7338129,856,16.20905132,1712,-367104,71168,-295936,8
2360,478,23,7,0.168428471,0.831571529,798.0869796,907.1179431,1443.860169,1299.228033,2838,59.45945946,5676,-1208320,244736,-963584,8
1269,247,23,7,0.16292876,0.83707124,419.0631188,522.278977,754.6296296,778.3846154,1516,27.36462094,3032,-649728,126464,-523264,8
1351,315,23,7,0.18907563,0.81092437,449.7890373,575.2114534,866.5292376,691.8412698,1666,19.74869606,3332,-691712,161280,-530432,8
748,121,24,6,0.139240506,0.860759494,245.844929,278.155724,439.6350267,406.3471074,869,67.20804331,1738,-382976,61952,-321024,8
757,116,24,6,0.132875143,0.867124857,249.6016795,267.071988,438.2549538,428.8103448,873,87.82696177,1746,-387584,59392,-328192,8
400,53,22,8,0.116997792,0.883002208,125.2416508,153.2175594,235.17,165.3396226,453,82.66423358,906,-204800,27136,-177664,8
775,122,23,7,0.136008919,0.863991081,254.3866907,284.2115046,453.9122581,417.795082,897,80.16085791,1794,-396800,62464,-334336,8
745,107,22,8,0.125586854,0.874413146,243.2481301,263.7112583,428.1704698,414.8691589,852,77.73722628,1704,-381440,54784,-326656,8
743,109,25,5,0.127934272,0.872065728,245.5350414,248.6327572,425.3755047,434.1651376,852,52.91925466,1704,-380416,55808,-324608,8
742,106,24,6,0.125,0.875,243.8321685,251.1273563,422.819407,436.2641509,848,72.17021277,1696,-379904,54272,-325632,8
751,104,24,6,0.121637427,0.878362573,245.0306896,259.1588534,426.701731,437.375,855,51.5992758,1710,-384512,53248,-331264,8
797,130,22,8,0.140237325,0.859762675,264.7404609,283.4374372,467.7415307,441.0615385,927,98.72204473,1854,-408064,66560,-341504,8
747,105,24,6,0.123239437,0.876760563,244.4744916,255.9238772,424.9062918,437.8380952,852,83.04093567,1704,-382464,53760,-328704,8
748,111,22,8,0.129220023,0.870779977,245.3766493,264.7890827,430.2887701,428.0540541,859,85.72854291,1718,-382976,56832,-326144,8
736,110,24,6,0.130023641,0.869976359,242.2154193,257.2131213,423.1779891,425.6545455,846,61.52727273,1692,-376832,56320,-320512,8
741,120,23,7,0.139372822,0.860627178,245.362581,267.3018725,432.0080972,424.775,861,39.80582524,1722,-379392,61440,-317952,8
740,114,22,8,0.133489461,0.866510539,244.1837301,261.1616032,428.4,421.6578947,854,38.67753623,1708,-378880,58368,-320512,8
741,107,23,7,0.126179245,0.873820755,242.4844634,260.2372041,424.2523617,426.2149533,848,74.91166078,1696,-379392,54784,-324608,8
802,112,22,8,0.122538293,0.877461707,262.2029341,274.9368614,455.532419,471.5892857,914,117.7835052,1828,-410624,57344,-353280,8
770,117,24,6,0.131905299,0.868094701,253.7744291,270.5653769,443.5688312,446.8376068,887,68.60015468,1774,-394240,59904,-334336,8
725,109,24,6,0.130695444,0.869304556,238.6888534,253.3805665,414.8786207,434.9357798,834,61.14369501,1668,-371200,55808,-315392,8
767,106,25,5,0.121420389,0.878579611,249.2393395,270.6377106,434.6584094,453.9433962,873,60.45706371,1746,-392704,54272,-338432,8
747,115,24,6,0.133410673,0.866589327,245.6693417,268.3420609,432.8621151,422.6521739,862,73.54948805,1724,-382464,58880,-323584,8
847,128,23,7,0.131282051,0.868717949,272.6906014,322.6719714,499.9940968,408.6328125,975,28.87177969,1950,-433664,65536,-368128,8
834,141,22,8,0.144615385,0.855384615,276.7640968,304.8679931,494.5839329,449.0567376,975,29.05244338,1950,-427008,72192,-354816,8
829,128,22,8,0.133751306,0.866248694,269.9916054,312.8873209,482.5367913,456.09375,957,27.42906277,1914,-424448,65536,-358912,8
315,47,22,8,0.129834254,0.870165746,100.7202955,86.93838324,194.3777778,95.19148936,362,12.64407964,724,-161280,24064,-137216,8
835,136,23,7,0.140061792,0.859938208,275.6941456,306.7894296,488.0526946,473.3970588,971,27.82234957,1942,-427520,69632,-357888,8
829,141,23,7,0.145360825,0.854639175,271.8560476,315.9401619,496.6875754,419.7234043,970,29.69084787,1940,-424448,72192,-352256,8
847,134,23,7,0.136595311,0.863404689,277.8439991,313.4850331,495.3671783,463.3955224,981,29.14438503,1962,-433664,68608,-365056,8
825,137,23,7,0.142411642,0.857588358,270.8633051,310.2441649,490.56,426.9416058,962,29.17804064,1924,-422400,70144,-352256,8
836,124,23,7,0.129166667,0.870833333,273.600804,299.7213537,481.6016746,473.0725806,960,27.89076119,1920,-428032,63488,-364544,8
821,122,23,7,0.129374337,0.870625663,267.4772722,302.0871766,473.1948843,463.9590164,943,27.80890593,1886,-420352,62464,-357888,8
836,133,23,7,0.137254902,0.862745098,274.7317988,305.4527616,492.1650718,439.962406,969,27.61470504,1938,-428032,68096,-359936,8
859,135,23,7,0.135814889,0.864185111,282.9926619,307.2347797,504.4586729,453.2222222,994,26.44320298,1988,-439808,69120,-370688,8
831,140,23,7,0.144181256,0.855818744,276.202903,302.8099353,489.198556,467.0142857,971,28.09606481,1942,-425472,71680,-353792,8
827,130,23,7,0.13584117,0.86415883,270.0267791,307.9970276,487.171705,427.0153846,957,27.9252991,1914,-423424,66560,-356864,8
839,133,23,7,0.136831276,0.863168724,276.6586935,303.3192846,489.9737783,464.5864662,972,27.15842414,1944,-429568,68096,-361472,8
838,145,23,7,0.14750763,0.85249237,280.8822358,297.0440233,498.5954654,453.8827586,983,27.56590017,1966,-429056,74240,-354816,8
856,145,23,7,0.144855145,0.855144855,282.0583763,322.6841937,509.067757,453.3724138,1001,31.14499067,2002,-438272,74240,-364032,8
827,127,23,7,0.13312369,0.86687631,271.0280034,301.1169183,481.3192261,452.6299213,954,26.40464988,1908,-423424,65024,-358400,8
826,142,23,7,0.146694215,0.853305785,272.583067,312.1984584,492.6392252,437.1549296,968,26.98633956,1936,-422912,72704,-350208,8
835,133,23,7,0.137396694,0.862603306,276.9902986,293.6065316,487.5640719,465.2631579,968,25.91006424,1936,-427520,68096,-359424,8
9376,593,21,9,0.0594844016,0.940515598,2852.627057,2952.92599,5068.268345,3668.43339,9969,780.0469484,19938,-4800512,303616,-4496896,9
9385,582,20,10,0.0583926959,0.941607304,2849.724124,2969.267454,5069.135216,3611.158076,9967,1024.357657,19934,-4805120,297984,-4507136,9
9393,574,20,10,0.0575900472,0.942409953,2855.881009,2952.842386,5058.132758,3770.883275,9967,619.8383085,19934,-4809216,293888,-4515328,9
9399,570,20,10,0.0571772495,0.942822751,2854.346867,2907.303153,5069.236195,3595.989474,9969,948.5252141,19938,-4812288,291840,-4520448,9
7428,520,20,10,0.0654252642,0.934574736,2277.580414,2207.823896,4057.041869,2795.421154,7948,139.7327707,15896,-3803136,266240,-3536896,9
9385,584,20,10,0.058581603,0.941418397,2852.352057,2896.067343,5075.325946,3533.443493,9969,1046.065058,19938,-4805120,299008,-4506112,9
9401,568,20,10,0.0569766275,0.943023372,2851.610243,3009.281138,5061.718115,3715.234155,9969,887.7114871,19938,-4813312,290816,-4522496,9
9384,585,21,9,0.0586819139,0.941318086,2855.318008,2928.451016,5065.552003,3692.863248,9969,637.8119002,19938,-4804608,299520,-4505088,9
9392,577,20,10,0.0578794262,0.942120574,2850.42389,2895.326972,5078.367547,3465.228769,9969,1063.927428,19938,-4808704,295424,-4513280,9
9410,559,21,9,0.0560738289,0.943926171,2850.565729,2969.864067,5068.399469,3581.084079,9969,1063.927428,19938,-4817920,286208,-4531712,9
9421,548,21,9,0.0549704083,0.945029592,2858.487329,3011.876133,5044.712875,3958.439781,9969,490.8419498,19938,-4823552,280576,-4542976,9
9434,537,20,10,0.0538561829,0.946143817,2854.333361,2970.180667,5062.014522,3650.579143,9971,736.4106352,19942,-4830208,274944,-4555264,9
9347,620,19,11,0.0622052774,0.937794723,2846.491901,3131.925129,5052.023323,3958.493548,9967,702.3960536,19934,-4785664,317440,-4468224,9
9397,572,21,9,0.0573778714,0.942622129,2851.28741,2905.692321,5075.292434,3501.646853,9969,1483.482143,19938,-4811264,292864,-4518400,9
9494,476,20,10,0.0477432297,0.95225677,2854.09339,3064.689607,5048.054877,3737.819328,9970,712.6518942,19940,-4860928,243712,-4617216,9
9403,566,19,11,0.0567760056,0.943223994,2851.023106,2919.537915,5073.788153,3509.95583,9969,1296.358908,19938,-4814336,289792,-4524544,9
9399,568,20,10,0.0569880606,0.943011939,2854.134021,3085.26342,5041.184488,4037.737676,9967,604.4269254,19934,-4812288,290816,-4521472,9
1268,120,21,9,0.0864553314,0.913544669,390.1835132,457.0136759,712.4566246,504.7583333,1388,21.50604276,2776,-649216,61440,-587776,9
1282,126,20,10,0.0894886364,0.910511364,395.790694,439.4663385,727.3026521,472.4920635,1408,21.83622829,2816,-656384,64512,-591872,9
9349,618,20,10,0.0620046152,0.937995385,2850.494277,2987.725095,5066.686277,3733.135922,9967,343.5711824,19934,-4786688,316416,-4470272,9
7814,430,19,11,0.052159146,0.947840854,2354.509008,2725.22239,4157.050806,3494.639535,8244,231.8335208,16488,-4000768,220160,-3780608,9
7742,424,20,10,0.0519226059,0.948077394,2331.650699,2733.368674,4111.893438,3565.051887,8166,233.6480687,16332,-3963904,217088,-3746816,9
7733,391,21,9,0.0481290005,0.951871,2324.84565,2672.73446,4086.470063,3588.432225,8124,228.7162162,16248,-3959296,200192,-3759104,9
9516,459,21,9,0.0460150376,0.953984962,2864.941725,3065.7836,5025.411728,4212.379085,9975,601.2658228,19950,-4872192,235008,-4637184,9
9519,456,21,9,0.0457142857,0.954285714,2868.90449,3015.675106,5020.184368,4316.151316,9975,501.7605634,19950,-4873728,233472,-4640256,9
1685,138,21,9,0.0756993966,0.924300603,517.8006467,538.5072132,936.2338279,616.1014493,1823,31.81500873,3646,-862720,70656,-792064,9
7793,419,20,10,0.0510228933,0.948977107,2344.286765,2765.197893,4134.260234,3590.186158,8212,271.9205298,16424,-3990016,214528,-3775488,9
7769,431,20,10,0.0525609756,0.947439024,2339.205298,2776.656991,4128.19256,3601.327146,8200,203.3730159,16400,-3977728,220672,-3757056,9
8782,460,19,11,0.0497727765,0.950227224,2655.617934,2703.550449,4674.08358,3617.61087,9242,161.7430872,18484,-4496384,235520,-4260864,9
7769,412,19,11,0.0503605916,0.949639408,2338.010682,2718.75704,4118.384734,3574.61165,8181,228.5195531,16362,-3977728,210944,-3766784,9
7799,424,21,9,0.05156269,0.94843731,2349.826364,2737.776133,4136.846775,3654.971698,8223,219.0463506,16446,-3993088,217088,-3776000,9
7792,427,19,11,0.0519527923,0.948047208,2347.947395,2726.863992,4140.134882,3560.091335,8219,191.4511996,16438,-3989504,218624,-3770880,9
7827,396,21,9,0.0481576067,0.951842393,2361.698873,2531.94841,4141.385205,3531.19697,8223,188.040247,16446,-4007424,202752,-3804672,9
42,13,20,10,0.236363636,0.763636364,16.07707132,14.57687234,29.16666667,24.23076923,55,2.019831069,110,-21504,6656,-14848,9
7746,408,21,9,0.0500367918,0.949963208,2333.209841,2690.617317,4096.606894,3714.75,8154,225.1864126,16308,-3965952,208896,-3757056,9
9517,458,21,9,0.045914787,0.954085213,2869.493866,3016.687185,5017.3851,4377.393013,9975,383.8014621,19950,-4872704,234496,-4638208,9
7669,418,20,10,0.0516878942,0.948312106,2307.03984,2751.520519,4068.833355,3588.385167,8087,478.5207101,16174,-3926528,214016,-3712512,9
9484,490,20,10,0.0491277321,0.950872268,2861.274232,3095.386567,5029.814741,4168.493878,9974,395.3230281,19948,-4855808,250880,-4604928,9
9478,497,19,11,0.0498245614,0.950175439,2858.855776,3073.030773,5041.879827,3960.488934,9975,495.7753479,19950,-4852736,254464,-4598272,9
9501,474,20,10,0.047518797,0.952481203,2859.398153,3162.951083,5025.834017,4229.64346,9975,634.9458943,19950,-4864512,242688,-4621824,9
4733,371,23,7,0.0726880878,0.927311912,1456.250854,1675.760674,2557.024086,2494.784367,5104,114.5936237,10208,-2423296,189952,-2233344,9
4736,462,23,7,0.0888803386,0.911119661,1484.178271,1648.546889,2616.745355,2422.71645,5198,150.492183,10396,-2424832,236544,-2188288,9
4799,438,24,6,0.0836356693,0.916364331,1497.285058,1653.936302,2633.692853,2458.015982,5237,143.4008762,10474,-2457088,224256,-2232832,9
4929,449,23,7,0.0834882856,0.916511714,1541.961998,1654.715109,2704.594847,2523.792873,5378,149.846754,10756,-2523648,229888,-2293760,9
4815,457,23,7,0.0866843703,0.91331563,1507.552135,1659.77867,2649.039875,2504.378556,5272,137.0774831,10544,-2465280,233984,-2231296,9
4012,301,23,7,0.06978901,0.93021099,1231.951508,1363.667773,2182.400548,1818.438538,4313,164.4300419,8626,-2054144,154112,-1900032,9
4810,435,23,7,0.0829361296,0.91706387,1499.560902,1661.377217,2634.244075,2498.668966,5245,135.7401656,10490,-2462720,222720,-2240000,9
4801,420,23,7,0.0804443593,0.919555641,1495.797543,1620.194986,2627.139971,2426.504762,5221,145.0277778,10442,-2458112,215040,-2243072,9
4869,445,23,7,0.0837410613,0.916258939,1516.43299,1709.452513,2669.228589,2529.170787,5314,146.6335541,10628,-2492928,227840,-2265088,9
4857,425,23,7,0.0804619462,0.919538054,1509.667656,1686.654296,2647.002265,2578.618824,5282,137.6596299,10564,-2486784,217600,-2269184,9
4824,444,23,7,0.0842824601,0.91571754,1502.271171,1701.247652,2648.43408,2483.108108,5268,150.0854701,10536,-2469888,227328,-2242560,9
4865,433,23,7,0.0817289543,0.918271046,1512.122436,1704.388151,2662.873381,2499.242494,5298,153.7434707,10596,-2490880,221696,-2269184,9
4756,352,23,7,0.0689115114,0.931088489,1465.9934,1568.185557,2537.726871,2781.127841,5108,124.5853659,10216,-2435072,180224,-2254848,9
4760,409,23,7,0.0791255562,0.920874444,1479.200785,1624.01639,2600.929412,2399.611247,5169,142.5144748,10338,-2437120,209408,-2227712,9
4764,393,24,6,0.0762070971,0.923792903,1472.714935,1670.319272,2578.72775,2582.300254,5157,185.5035971,10314,-2439168,201216,-2237952,9
5608,453,23,7,0.0747401419,0.925259858,1726.245787,1999.467534,3051.699001,2774.752759,6061,178.6851415,12122,-2871296,231936,-2639360,9
4957,459,23,7,0.0847488922,0.915251108,1551.759959,1664.80287,2731.366351,2461.553377,5416,132.097561,10832,-2537984,235008,-2302976,9
4767,458,22,8,0.0876555024,0.912344498,1490.262548,1679.371873,2625.507237,2482.820961,5225,138.9258176,10450,-2440704,234496,-2206208,9
4854,409,23,7,0.0777123314,0.922287669,1508.804514,1638.484503,2634.160486,2606.359413,5263,127.0028958,10526,-2485248,209408,-2275840,9
4813,461,22,8,0.0874099355,0.912590064,1508.632671,1656.444448,2647.561396,2532.455531,5274,137.0226033,10548,-2464256,236032,-2228224,9
4277,362,23,7,0.0780340591,0.921965941,1314.274078,1603.458584,2324.128595,2271.220994,4639,132.5049986,9278,-2189824,185344,-2004480,9
4177,343,23,7,0.0758849558,0.924115044,1286.44098,1510.641863,2261.60091,2247.093294,4520,168.4681327,9040,-2138624,175616,-1963008,9
4479,368,22,8,0.0759232515,0.924076749,1377.948579,1635.057381,2428.31123,2371.527174,4847,84.69334265,9694,-2293248,188416,-2104832,9
4170,367,23,7,0.0808904562,0.919109544,1282.038231,1573.911218,2249.515348,2490.392371,4537,137.7352763,9074,-2135040,187904,-1947136,9
4242,356,23,7,0.0774249674,0.922575033,1311.590274,1500.879782,2294.379774,2360.511236,4598,126.7015707,9196,-2171904,182272,-1989632,9
4304,378,23,7,0.0807347287,0.919265271,1325.034946,1621.460032,2348.307853,2263.984127,4682,124.488168,9364,-2203648,193536,-2010112,9
4232,327,23,7,0.0717262558,0.928273744,1292.941879,1580.646612,2271.027174,2396.125382,4559,129.2966534,9118,-2166784,167424,-1999360,9
4334,358,22,8,0.0763000853,0.923699915,1333.7755,1581.927197,2340.688048,2416.860335,4692,114.7468819,9384,-2219008,183296,-2035712,9
4418,383,23,7,0.0797750469,0.920224953,1366.587419,1590.409467,2407.17904,2329.723238,4801,131.4622125,9602,-2262016,196096,-2065920,9
4491,375,23,7,0.0770653514,0.922934649,1381.653923,1652.070697,2442.514807,2325.538667,4866,119.6459307,9732,-2299392,192000,-2107392,9
4302,366,23,7,0.0784061697,0.92159383,1325.912482,1577.661938,2340.990702,2258.20765,4668,120.2782788,9336,-2202624,187392,-2015232,9
4239,328,23,7,0.0718195752,0.928180425,1298.656112,1548.831852,2278.072895,2360.60061,4567,120.7242929,9134,-2170368,167936,-2002432,9
4486,388,22,8,0.079606073,0.920393927,1387.18396,1613.089245,2448.588943,2309.291237,4874,117.6442192,9748,-2296832,198656,-2098176,9
4178,321,23,7,0.0713491887,0.928650811,1277.696686,1546.729037,2251.403782,2231.728972,4499,85.28909953,8998,-2139136,164352,-1974784,9
4353,363,23,7,0.0769720102,0.92302799,1340.04845,1595.152649,2359.878934,2341.964187,4716,176.6292135,9432,-2228736,185856,-2042880,9
4618,350,22,8,0.0704508857,0.929549114,1423.67906,1565.607532,2484.466219,2484.945714,4968,124.8868778,9936,-2364416,179200,-2185216,9
4151,338,23,7,0.075295166,0.924704834,1273.141154,1547.189246,2241.219706,2291.426036,4489,127.8189066,8978,-2125312,173056,-1952256,9
4434,356,23,7,0.0743215031,0.925678497,1371.092086,1520.48367,2394.624041,2406.410112,4790,295.496607,9580,-2270208,182272,-2087936,9
4145,336,23,7,0.0749832627,0.925016737,1275.565352,1497.230673,2237.80579,2280.404762,4481,120.1018494,8962,-2122240,172032,-1950208,9
4294,366,23,7,0.0785407725,0.921459227,1322.398295,1587.599622,2335.414066,2272.846995,4660,113.271755,9320,-2198528,187392,-2011136,9
4833,397,23,7,0.0759082218,0.924091778,1483.486362,1798.69605,2618.935237,2573.680101,5230,135.3519669,10460,-2474496,203264,-2271232,9
4686,361,23,7,0.0715276402,0.92847236,1430.203424,1764.903733,2516.60286,2620.019391,5047,134.5507865,10094,-2399232,184832,-2214400,9
3025,214,23,7,0.0660697746,0.933930225,924.3837311,985.1315152,1649.270413,1206.247664,3239,87.32812079,6478,-1548800,109568,-1439232,9
3017,230,23,7,0.0708346166,0.929165383,924.1587522,965.4812744,1662.042095,1124.986957,3247,99.81555487,6494,-1544704,117760,-1426944,9
4709,364,23,7,0.0717524147,0.928247585,1446.62334,1676.607612,2531.781907,2604.505495,5073,139.8291069,10146,-2411008,186368,-2224640,9
3075,223,23,7,0.0676167374,0.932383263,940.4709149,969.8399534,1685.75122,1149.623318,3298,112.5213238,6596,-1574400,114176,-1460224,9
3074,200,23,7,0.0610873549,0.938912645,933.2720882,1034.996094,1663.043591,1244.895,3274,105.8861578,6548,-1573888,102400,-1471488,9
2997,165,23,7,0.0521821632,0.947817837,903.2867675,1004.938787,1601.323657,1221.430303,3162,105.2596538,6324,-1534464,84480,-1449984,9
4442,350,22,8,0.0730383973,0.926961603,1369.487315,1540.59742,2384.788834,2545.131429,4792,123.3779609,9584,-2274304,179200,-2095104,9
4434,317,23,7,0.0667227952,0.933277205,1351.634696,1610.894913,2361.760487,2575.173502,4751,237.7877878,9502,-2270208,162304,-2107904,9
3315,269,23,7,0.0750558036,0.924944196,1027.696432,1008.76715,1829.809955,1332.713755,3584,99.41747573,7168,-1697280,137728,-1559552,9
3143,253,23,7,0.0744994111,0.925500589,965.6962386,996.5587465,1742.441616,1152.616601,3396,124.3956044,6792,-1609216,129536,-1479680,9
3057,225,23,7,0.0685557587,0.931444241,935.2191341,1000.561314,1673.965653,1200.4,3282,118.5693642,6564,-1565184,115200,-1449984,9
4402,370,23,7,0.0775356245,0.922464376,1352.81386,1639.599921,2377.239891,2496.67027,4772,116.3334959,9544,-2253824,189440,-2064384,9
3013,205,23,7,0.0637041641,0.936295836,919.0926382,975.3392915,1637.400266,1199.434146,3218,109.1957923,6436,-1542656,104960,-1437696,9
3111,232,22,8,0.0693987436,0.930601256,951.5815464,1007.679393,1708.809386,1178.405172,3343,85.41134389,6686,-1592832,118784,-1474048,9
4828,395,22,8,0.0756270343,0.924372966,1494.466776,1656.882153,2621.791011,2492.326582,5223,142.7439191,10446,-2471936,202240,-2269696,9
3051,229,23,7,0.0698170732,0.930182927,935.2805525,987.0337721,1673.871845,1195.882096,3280,81.55146693,6560,-1562112,117248,-1444864,9
4337,333,23,7,0.0713062099,0.92869379,1323.276474,1635.019766,2328.786719,2422.933934,4670,135.3623188,9340,-2220544,170496,-2050048,9
252,20,23,7,0.0735294118,0.926470588,77.43664042,72.25114186,140.734127,83.15,272,11.6938951,544,-129024,10240,-118784,9
4860,391,23,7,0.0744620072,0.925537993,1496.644813,1728.195972,2612.688889,2791.452685,5251,139.6171231,10502,-2488320,200192,-2288128,9
5243,426,22,8,0.0751455283,0.924854472,1625.853863,1752.845496,2820.785428,3009.946009,5669,131.7759182,11338,-2684416,218112,-2466304,9
4751,418,23,7,0.0808667054,0.919133295,1481.775073,1595.550283,2569.945485,2756.110048,5169,96.9248078,10338,-2432512,214016,-2218496,9
4942,401,23,7,0.0750514692,0.924948531,1524.535802,1740.941603,2660.169972,2817.795511,5343,157.1008527,10686,-2530304,205312,-2324992,9
4883,378,23,7,0.0718494583,0.928150542,1501.227647,1724.685937,2622.060414,2746.481481,5261,149.0368272,10522,-2500096,193536,-2306560,9
4915,401,23,7,0.0754326561,0.924567344,1526.1296,1634.449913,2655.766022,2692.009975,5316,134.3781598,10632,-2516480,205312,-2311168,9
4988,422,22,8,0.0780036969,0.921996303,1539.924034,1779.388455,2683.655172,2963.703791,5410,159.1176471,10820,-2553856,216064,-2337792,9
4849,419,23,7,0.0795368261,0.920463174,1504.861893,1687.839764,2622.824087,2769.622912,5268,162.6930204,10536,-2482688,214528,-2268160,9
5131,410,22,8,0.0739938639,0.926006136,1593.694611,1666.924702,2761.944455,2884.326829,5541,143.6236392,11082,-2627072,209920,-2417152,9
4800,387,23,7,0.0746096009,0.925390399,1491.937857,1562.500165,2597.131458,2555.160207,5187,94.37772926,10374,-2457600,198144,-2259456,9
4826,390,23,7,0.0747699387,0.925230061,1486.781442,1715.649758,2596.106506,2761.861538,5216,152.8722157,10432,-2470912,199680,-2271232,9
5019,382,23,7,0.070727643,0.929272357,1542.020063,1742.473437,2678.744172,2993.413613,5401,152.7864215,10802,-2569728,195584,-2374144,9
4975,392,23,7,0.0730389417,0.926961058,1531.973714,1736.047701,2664.68201,2929.170918,5367,212.0505729,10734,-2547200,200704,-2346496,9
4899,379,23,7,0.0718075028,0.928192497,1504.371341,1748.563198,2629.597469,2767.501319,5278,198.8696307,10556,-2508288,194048,-2314240,9
5155,407,23,7,0.0731751169,0.926824883,1590.542638,1770.672227,2764.049855,3002.520885,5562,158.0113636,11124,-2639360,208384,-2430976,9
4810,396,23,7,0.0760660776,0.923933922,1483.60973,1711.577188,2590.565904,2760.603535,5206,144.651292,10412,-2462720,202752,-2259968,9
4875,382,23,7,0.0726650181,0.927334982,1501.314509,1698.587754,2613.193231,2830.722513,5257,148.5867722,10514,-2496000,195584,-2300416,9
5042,417,23,7,0.0763876168,0.923612383,1570.063937,1642.807563,2736.006545,2657.374101,5459,102.1901909,10918,-2581504,213504,-2368000,9
5280,407,23,7,0.0715667311,0.928433269,1626.42702,1827.251598,2839.509091,2902.260442,5687,139.7640698,11374,-2703360,208384,-2494976,9
5129,410,23,7,0.0740205813,0.925979419,1583.273846,1780.751688,2762.100994,2868.814634,5539,161.3457617,11078,-2626048,209920,-2416128,9
2643,152,23,7,0.0543828265,0.945617174,794.9812735,990.6980921,1397.805524,1401.381579,2795,103.5952557,5590,-1353216,77824,-1275392,9
2840,186,24,6,0.0614672835,0.938532716,857.6316375,1067.694586,1500.290141,1715.198925,3026,82.51977093,6052,-1454080,95232,-1358848,9
2644,154,22,8,0.0550393138,0.944960686,795.7495465,988.5570689,1395.700454,1464.733766,2798,115.763343,5596,-1353728,78848,-1274880,9
2829,186,22,8,0.0616915423,0.938308458,855.4177838,1062.424393,1498.800636,1647.919355,3015,99.90059642,6030,-1448448,95232,-1353216,9
2839,186,23,7,0.0614876033,0.938512397,857.6864991,1072.249441,1503.205354,1662.5,3025,106.5140845,6050,-1453568,95232,-1358336,9
2632,149,23,7,0.0535778497,0.94642215,792.4945977,966.9386456,1390.482903,1400.134228,2781,101.5704894,5562,-1347584,76288,-1271296,9
2639,155,23,7,0.05547602,0.94452398,793.853174,993.4738511,1391.866995,1493.406452,2794,112.7067366,5588,-1351168,79360,-1271808,9
2829,185,23,7,0.0613802256,0.938619774,853.9131482,1071.055571,1495.527041,1690.589189,3014,159.0501319,6028,-1448448,94720,-1353728,9
47,15,23,7,0.241935484,0.758064516,17.20586086,19.86219189,31.14893617,32.6,62,2.696824706,124,-24064,7680,-16384,9
2645,155,23,7,0.0553571429,0.944642857,797.4356696,973.9602322,1397.851418,1445.696774,2800,105.1840721,5600,-1354240,79360,-1274880,9
47,15,23,7,0.241935484,0.758064516,17.20586086,19.86219189,31.14893617,32.6,62,2.780269058,124,-24064,7680,-16384,9
46,15,23,7,0.245901639,0.754098361,16.89979363,19.58729747,30.69565217,31.93333333,61,2.622527945,122,-23552,7680,-15872,9
2661,156,24,6,0.0553780618,0.944621938,801.4142186,992.8890592,1409.026682,1408.544872,2817,138.8368655,5634,-1362432,79872,-1282560,9
2990,194,23,7,0.0609296482,0.939070352,902.0385608,1131.93672,1579.371237,1794.845361,3184,84.12153236,6368,-1530880,99328,-1431552,9
2622,148,22,8,0.0534296029,0.946570397,789.2395084,964.8868154,1387.13196,1356.587838,2770,111.8288252,5540,-1342464,75776,-1266688,9
46,15,23,7,0.245901639,0.754098361,16.89979363,19.58729747,30.69565217,31.93333333,61,2.837209302,122,-23552,7680,-15872,9
2656,157,23,7,0.0558123,0.9441877,800.7169332,982.6790919,1403.975904,1458.159236,2813,88.57052897,5626,-1359872,80384,-1279488,9
2640,156,23,7,0.0557939914,0.944206009,796.2168707,973.2665982,1397.23447,1419.916667,2796,92.36868186,5592,-1351680,79872,-1271808,9
2445,142,22,8,0.0548898338,0.945110166,744.1316728,775.7712783,1302.829857,1141.964789,2587,48.32804035,5174,-1251840,72704,-1179136,9
1295,84,22,8,0.0609137056,0.939086294,389.7473973,507.6156242,692.8370656,646.2619048,1379,16.24455177,2758,-663040,43008,-620032,9
9552,425,23,7,0.0425979753,0.957402025,2860.287332,3049.636235,5043.244033,3769.849412,9977,1279.102564,19954,-4890624,217600,-4673024,9
9539,438,22,8,0.0439009722,0.956099028,2857.32144,3154.219438,5038.052836,3920.700913,9977,968.6407767,19954,-4883968,224256,-4659712,9
9549,428,24,6,0.0428986669,0.957101333,2862.517793,3063.213471,5036.348413,3932.621495,9977,917.8472861,19954,-4889088,219136,-4669952,9
9541,436,22,8,0.0437005112,0.956299489,2859.101072,3107.072685,5039.556755,3882.665138,9977,951.0962822,19954,-4884992,223232,-4661760,9
9539,438,24,6,0.0439009722,0.956099028,2860.334693,3078.40008,5040.013628,3877.997717,9977,979.0971541,19954,-4883968,224256,-4659712,9
9550,427,24,6,0.0427984364,0.957201564,2863.937727,3013.143163,5038.758743,3876.128806,9977,524.2774566,19954,-4889600,218624,-4670976,9
9556,421,24,6,0.0421970532,0.957802947,2861.13836,3045.609005,5041.663458,3793.627078,9977,1405.211268,19954,-4892672,215552,-4677120,9
9550,427,24,6,0.0427984364,0.957201564,2861.073926,3036.580743,5042.910052,3783.283372,9977,1191.995221,19954,-4889600,218624,-4670976,9
9538,439,24,6,0.0440012028,0.955998797,2862.42824,3015.742036,5042.373978,3829.362187,9977,605.7680631,19954,-4883456,224768,-4658688,9
9541,436,22,8,0.0437005112,0.956299489,2856.708325,3137.741403,5041.642071,3837.03211,9977,858.605852,19954,-4884992,223232,-4661760,9
9585,397,23,7,0.0397715889,0.960228411,2861.271812,3130.956819,5038.003547,3868.738035,9982,1099.339207,19964,-4907520,203264,-4704256,9
9534,443,24,6,0.0444021249,0.955597875,2858.494069,3121.207328,5039.231173,3907.952596,9977,943.0056711,19954,-4881408,226816,-4654592,9
9519,458,23,7,0.0459055828,0.954094417,2861.230161,2994.719415,5048.070386,3761.290393,9977,295.5272512,19954,-4873728,234496,-4639232,9
9536,441,23,7,0.0442016638,0.955798336,2859.151275,3085.625699,5042.020449,3842.507937,9977,981.988189,19954,-4882432,225792,-4656640,9
9562,415,24,6,0.04159567,0.95840433,2863.836579,3058.095548,5033.502928,3963.609639,9977,1033.88601,19954,-4895744,212480,-4683264,9
9544,433,22,8,0.0433998196,0.95660018,2861.75207,3013.97915,5043.968881,3777.399538,9977,1028.556701,19954,-4886528,221696,-4664832,9
9561,416,23,7,0.0416959006,0.958304099,2858.001923,3104.866193,5042.381236,3762.129808,9977,881.360424,19954,-4895232,212992,-4682240,9
9556,421,23,7,0.0421970532,0.957802947,2861.668208,3035.03348,5041.583612,3795.43943,9977,830.7243963,19954,-4892672,215552,-4677120,9
9549,428,24,6,0.0428986669,0.957101333,2860.933862,3042.206578,5042.641219,3792.224299,9977,1389.554318,19954,-4889088,219136,-4669952,9
2275,185,24,6,0.075203252,0.924796748,699.7746317,740.4683018,1259.311209,876.2,2460,39.79294727,4920,-1164800,94720,-1070080,9
4391,403,23,7,0.0840634126,0.915936587,1358.900158,1629.151575,2389.427921,2485.451613,4794,119.820045,9588,-2248192,206336,-2041856,9
4598,346,23,7,0.0699838188,0.930016181,1417.761514,1544.977758,2466.3495,2554.234104,4944,158.2586428,9888,-2354176,177152,-2177024,9
4321,379,23,7,0.0806382979,0.919361702,1327.062933,1658.078519,2352.720898,2325.17942,4700,94.15064103,9400,-2212352,194048,-2018304,9
4517,357,23,7,0.073245794,0.926754206,1387.055953,1636.823507,2443.205667,2365.308123,4874,102.1802935,9748,-2312704,182784,-2129920,9
4191,352,23,7,0.0774818402,0.92251816,1286.486555,1575.757961,2279.689812,2180.443182,4543,231.9040327,9086,-2145792,180224,-1965568,9
4275,340,23,7,0.0736728061,0.926327194,1308.165043,1603.914627,2310.900585,2271.529412,4615,125.9208731,9230,-2188800,174080,-2014720,9
2986,251,23,7,0.077540933,0.922459067,921.0782575,1046.094358,1640.939049,1358.003984,3237,56.63051085,6474,-1528832,128512,-1400320,9
4289,365,22,8,0.0784271594,0.921572841,1316.178453,1630.386393,2325.655164,2349.178082,4654,116.5539694,9308,-2195968,186880,-2009088,9
3767,305,23,7,0.0749017682,0.925098232,1173.505919,1136.471252,2066.420494,1666.957377,4072,72.14741318,8144,-1928704,156160,-1772544,9
4228,374,22,8,0.0812690135,0.918730987,1299.807408,1612.303289,2312.671949,2175.203209,4602,125.7033597,9204,-2164736,191488,-1973248,9
4354,369,23,7,0.0781283083,0.921871692,1349.85643,1510.569937,2353.43638,2463.04607,4723,144.6997549,9446,-2229248,188928,-2040320,9
4221,360,24,6,0.0785854617,0.921414538,1292.955042,1620.441487,2304.337361,2134.619444,4581,115.5942468,9162,-2161152,184320,-1976832,9
4624,353,23,7,0.0709262608,0.929073739,1416.367693,1671.568107,2475.980753,2659.541076,4977,136.8811881,9954,-2367488,180736,-2186752,9
4200,391,23,7,0.0851666304,0.91483337,1291.41537,1645.457794,2299.505238,2258.347826,4591,117.5973361,9182,-2150400,200192,-1950208,9
4401,350,22,8,0.0736687013,0.926331299,1349.976117,1611.676399,2365.200863,2511.791429,4751,130.8454971,9502,-2253312,179200,-2074112,9
4459,382,23,7,0.0789093163,0.921090684,1375.760447,1627.505862,2427.945728,2339.924084,4841,154.0248171,9682,-2283008,195584,-2087424,9
4593,380,23,7,0.0764126282,0.923587372,1418.874119,1619.937399,2496.107773,2376.915789,4973,108.7945745,9946,-2351616,194560,-2157056,9
4520,401,22,8,0.0814875025,0.918512497,1392.875066,1698.473554,2470.116814,2358.236908,4921,112.582933,9842,-2314240,205312,-2108928,9
4560,365,22,8,0.0741116751,0.925888325,1410.697899,1550.854524,2469.14057,2386.284932,4925,145.8395025,9850,-2334720,186880,-2147840,9
4676,353,23,7,0.0701928813,0.929807119,1432.10281,1690.517327,2514.098161,2526.946176,5029,188.7054409,10058,-2394112,180736,-2213376,9
4911,368,23,7,0.0697101724,0.930289828,1504.878718,1756.719297,2634.525759,2713.054348,5279,149.4620612,10558,-2514432,188416,-2326016,9
4916,337,23,7,0.0641538169,0.935846183,1493.703773,1810.045445,2617.553702,2764.79822,5253,193.480663,10506,-2516992,172544,-2344448,9
4792,345,23,7,0.0671598209,0.932840179,1458.25961,1786.964076,2560.940526,2680.944928,5137,174.3720299,10274,-2453504,176640,-2276864,9
5040,391,23,7,0.0719941079,0.928005892,1550.862081,1771.138835,2712.893056,2756.048593,5431,151.8736018,10862,-2580480,200192,-2380288,9
4824,364,23,7,0.0701619121,0.929838088,1480.421353,1706.202628,2586.644693,2698.604396,5188,197.3373906,10376,-2469888,186368,-2283520,9
5155,383,23,7,0.069158541,0.930841459,1583.035549,1795.669444,2766.774394,2806.185379,5538,128.5813792,11076,-2639360,196096,-2443264,9
5226,415,22,8,0.0735685162,0.926431484,1603.432027,1913.4203,2827.564103,2738.339759,5641,115.9030203,11282,-2675712,212480,-2463232,9
5130,390,23,7,0.0706521739,0.929347826,1563.737197,1941.634181,2765.547563,2694.105128,5520,150,11040,-2626560,199680,-2426880,9
4951,362,23,7,0.0681347638,0.931865236,1506.501127,1847.51189,2638.157948,2914.698895,5313,133.8624339,10626,-2534912,185344,-2349568,9
5064,393,23,7,0.0720175921,0.927982408,1542.96706,1939.303364,2718.471959,2864.659033,5457,145.3262317,10914,-2592768,201216,-2391552,9
4995,376,22,8,0.0700055856,0.929994414,1524.111635,1865.671216,2686.164565,2683.81383,5371,154.7838617,10742,-2557440,192512,-2364928,9
5102,410,23,7,0.074383164,0.925616836,1563.316117,1904.007751,2755.23187,2772.280488,5512,122.0819491,11024,-2612224,209920,-2402304,9
4945,357,23,7,0.0673330819,0.932666918,1504.835969,1835.354979,2635.082508,2878.907563,5302,158.3159152,10604,-2531840,182784,-2349056,9
5124,387,22,8,0.07022319,0.92977681,1563.60774,1904.508097,2771.137393,2555.576227,5511,226.4174199,11022,-2623488,198144,-2425344,9
5197,372,23,7,0.066798348,0.933201652,1584.169879,1886.957658,2766.69771,3040.69086,5569,155.9943978,11138,-2660864,190464,-2470400,9
5029,369,22,8,0.0683586514,0.931641349,1538.113006,1810.393728,2701.978723,2665.718157,5398,146.2080173,10796,-2574848,188928,-2385920,9
5456,434,23,7,0.0736842105,0.926315789,1678.536227,1952.516853,2949.688233,2892.847926,5890,120.00815,11780,-2793472,222208,-2571264,9
5175,389,22,8,0.0699137311,0.930086269,1590.322031,1802.506733,2777.115169,2854.136247,5564,171.8344657,11128,-2649600,199168,-2450432,9
5158,400,23,7,0.0719683339,0.928031666,1578.441989,1907.480972,2775.069407,2836.6325,5558,153.0286344,11116,-2640896,204800,-2436096,9
4848,370,23,7,0.070908394,0.929091606,1476.810192,1849.815603,2610.134076,2601.191892,5218,154.4243859,10436,-2482176,189440,-2292736,9
3183,549,24,6,0.147106109,0.852893891,1063.124156,1122.656537,1822.397738,2122.196721,3732,65.18777293,7464,-1629696,281088,-1348608,10
3008,517,24,6,0.146666667,0.853333333,1004.057427,1070.602652,1728.094747,1966.085106,3525,104.2899408,7050,-1540096,264704,-1275392,10
2916,494,24,6,0.144868035,0.855131965,969.0353918,1037.506803,1664.186214,1949.368421,3410,87.79608651,6820,-1492992,252928,-1240064,10
479,77,24,6,0.138489209,0.861510791,160.1882903,159.5437467,273.9373695,306.8831169,556,75.7493188,1112,-245248,39424,-205824,10
162,11,23,7,0.063583815,0.936416185,48.13157676,62.84389685,89.2345679,54.09090909,173,75.54585153,346,-82944,5632,-77312,10
3145,536,25,5,0.145612605,0.854387395,1048.505394,1110.542905,1799.144038,2086.591418,3681,87.55946717,7362,-1610240,274432,-1335808,10
3062,514,24,6,0.143736018,0.856263982,1013.340151,1118.923973,1755.64631,1984.215953,3576,88.49294729,7152,-1567744,263168,-1304576,10
740,98,24,6,0.116945107,0.883054893,245.2092026,212.4661141,423.8851351,386.3877551,838,108.690013,1676,-378880,50176,-328704,10
2963,515,22,8,0.148073606,0.851926394,987.8587174,1069.537087,1703.898076,1944.332039,3478,97.58698092,6956,-1517056,263680,-1253376,10
2978,528,22,8,0.150598973,0.849401027,995.6335846,1071.287265,1712.457354,1984.986742,3506,103.5134337,7012,-1524736,270336,-1254400,10
3127,538,24,6,0.146793997,0.853206003,1040.347869,1096.819859,1775.358171,2168.02974,3665,91.05590062,7330,-1601024,275456,-1325568,10
481,94,22,8,0.163478261,0.836521739,164.1856062,168.4022019,279.5446985,331.2659574,575,10.1842012,1150,-246272,48128,-198144,10
2978,528,24,6,0.150598973,0.849401027,1001.597429,1048.271865,1718.956682,1948.329545,3506,63.18255542,7012,-1524736,270336,-1254400,10
3142,521,22,8,0.142233142,0.857766858,1039.70396,1126.436402,1790.424252,2082.731286,3663,106.761877,7326,-1608704,266752,-1341952,10
3012,537,24,6,0.151310228,0.848689772,1002.439086,1112.612456,1733.901726,2005.517691,3549,89.10369069,7098,-1542144,274944,-1267200,10
2991,520,24,6,0.148105953,0.851894047,997.3253237,1072.475668,1715.221331,1990.555769,3511,65.35740879,7022,-1531392,266240,-1265152,10
3043,539,22,8,0.150474595,0.849525405,1012.010911,1123.784708,1751.266842,2018.641929,3582,65.17467249,7164,-1558016,275968,-1282048,10
3017,529,22,8,0.149182177,0.850817823,1006.587764,1090.335238,1735.063308,1992.712665,3546,93.68560106,7092,-1544704,270848,-1273856,10
3157,520,25,5,0.141419636,0.858580364,1048.235762,1095.174113,1791.552423,2127.061538,3677,83.72040073,7354,-1616384,266240,-1350144,10
3170,532,24,6,0.143706105,0.856293895,1054.117197,1108.208184,1802.862776,2141.31203,3702,66.13076099,7404,-1623040,272384,-1350656,10
2757,490,24,6,0.150908531,0.849091469,909.0969782,1006.947624,1558.916213,1990.195918,3247,60.87364079,6494,-1411584,250880,-1160704,10
2753,472,24,6,0.146356589,0.853643411,906.0413305,1010.354011,1559.731202,1923.697034,3225,83.67929424,6450,-1409536,241664,-1167872,10
2765,468,24,6,0.144757191,0.855242809,907.1952371,1012.694029,1560.739241,1949.395299,3233,58.52643012,6466,-1415680,239616,-1176064,10
2753,482,24,6,0.148995363,0.851004637,909.7160974,1003.524091,1562.210316,1936.649378,3235,61.85468451,6470,-1409536,246784,-1162752,10
2823,466,24,6,0.141684403,0.858315597,924.7105733,1028.046518,1590.824655,1973.190987,3289,95.7496361,6578,-1445376,238592,-1206784,10
2745,491,22,8,0.151730532,0.848269468,904.6005481,1019.863632,1557.676867,1958.539715,3236,60.24948799,6472,-1405440,251392,-1154048,10
2730,452,24,6,0.142049026,0.857950974,891.2871972,1012.033193,1538.882418,1909.300885,3182,91.6738692,6364,-1397760,231424,-1166336,10
2782,531,24,6,0.160277694,0.839722306,916.1167235,1047.839019,1576.524083,2078.627119,3313,58.6995039,6626,-1424384,271872,-1152512,10
2873,504,22,8,0.149244892,0.850755108,943.9656616,1061.626702,1624.040724,2059.293651,3377,88.56543404,6754,-1470976,258048,-1212928,10
2797,465,24,6,0.142550582,0.857449418,914.2550723,1029.037715,1575.207008,1970.105376,3262,58.52170793,6524,-1432064,238080,-1193984,10
2793,493,24,6,0.150030432,0.849969568,921.0781187,1026.024937,1582.945578,1986.559838,3286,93.45847554,6572,-1430016,252416,-1177600,10
2884,475,22,8,0.141411134,0.858588866,947.912255,1032.54834,1625.552705,2010.581053,3359,93.85303157,6718,-1476608,243200,-1233408,10
2829,464,24,6,0.14090495,0.85909505,927.4035852,1020.948049,1592.822906,1977.31681,3293,63.07220839,6586,-1448448,237568,-1210880,10
2761,482,24,6,0.148627814,0.851372186,910.2082598,1014.635345,1565.839913,1943.697095,3243,60.12235818,6486,-1413632,246784,-1166848,10
2686,451,24,6,0.143767931,0.856232069,877.454935,999.3845136,1515.202532,1889.399113,3137,93.27980969,6274,-1375232,230912,-1144320,10
2740,472,22,8,0.146948941,0.853051059,900.4515891,1018.290568,1554.483942,1908.457627,3212,92.27233554,6424,-1402880,241664,-1161216,10
2773,471,24,6,0.145191122,0.854808878,905.533392,1031.871481,1562.164803,1977.721868,3244,73.77757562,6488,-1419776,241152,-1178624,10
2788,478,24,6,0.146356399,0.853643601,916.1577174,1012.375802,1571.537661,1994.903766,3266,57.77463294,6532,-1427456,244736,-1182720,10
2898,466,24,6,0.138525565,0.861474435,945.2376975,1064.771321,1631.328502,2000.729614,3364,86.83531234,6728,-1483776,238592,-1245184,10
2763,451,24,6,0.140323584,0.859676416,907.1187532,1002.27056,1562.406442,1883.760532,3214,59.73977695,6428,-1414656,230912,-1183744,10
821,73,24,6,0.081655481,0.918344519,252.8176764,309.0444203,450.5773447,412.890411,894,114.6153846,1788,-420352,37376,-382976,10
5082,777,24,6,0.132616487,0.867383513,1671.831524,1676.210607,2831.318772,3575.428571,5859,141.1807229,11718,-2601984,397824,-2204160,10
2315,206,22,8,0.0817136057,0.918286394,703.1126634,955.085627,1270.942549,1149.26699,2521,111.4007954,5042,-1185280,105472,-1079808,10
5019,791,22,8,0.136144578,0.863855422,1654.866023,1672.999858,2803.348675,3553.663717,5810,101.7156863,11620,-2569728,404992,-2164736,10
5001,691,24,6,0.121398454,0.878601546,1605.068051,1733.349204,2746.985603,3566.719247,5692,133.4583822,11384,-2560512,353792,-2206720,10
2336,153,25,5,0.0614704701,0.93852953,703.5338975,915.3993065,1241.239298,1302.418301,2489,105.1097973,4978,-1196032,78336,-1117696,10
4985,696,24,6,0.122513642,0.877486358,1600.953874,1717.417092,2735.924173,3593.590517,5681,135.2941176,11362,-2552320,356352,-2195968,10
4996,672,24,6,0.118560339,0.881439661,1606.371722,1703.073573,2745.557846,3495.74256,5668,99.42115418,11336,-2557952,344064,-2213888,10
5092,800,22,8,0.135777325,0.864222675,1682.378806,1696.491234,2852.618814,3544.05375,5892,131.9006044,11784,-2607104,409600,-2197504,10
5142,793,24,6,0.133614153,0.866385847,1694.024761,1654.109264,2854.529172,3703.771753,5935,116.0086005,11870,-2632704,406016,-2226688,10
1996,120,24,6,0.056710775,0.943289225,603.1976486,641.225319,1078.40481,727.4166667,2116,123.2382062,4232,-1021952,61440,-960512,10
5042,671,24,6,0.117451427,0.882548573,1611.804049,1782.030997,2772.150734,3494.57079,5713,100,11426,-2581504,343552,-2237952,10
896,79,25,5,0.081025641,0.918974359,276.0832198,332.8083996,492.1796875,440.5949367,975,75.17347726,1950,-458752,40448,-418304,10
4843,637,15,15,0.116240876,0.883759124,1542.443571,1738.393232,2660.488334,3348.814757,5480,103.4352586,10960,-2479616,326144,-2153472,10
5054,788,22,8,0.134885313,0.865114687,1660.380027,1703.575397,2818.821725,3580.048223,5842,115.6144864,11684,-2587648,403456,-2184192,10
5034,655,25,5,0.11513447,0.88486553,1613.233715,1715.123589,2760.027414,3498.056489,5689,122.9522369,11378,-2577408,335360,-2242048,10
5017,739,24,6,0.128387769,0.871612231,1642.528878,1563.220152,2759.769982,3684.546685,5756,116.3063245,11512,-2568704,378368,-2190336,10
5061,758,24,6,0.130262932,0.869737068,1658.19065,1587.64041,2786.422841,3735.097625,5819,116.4032807,11638,-2591232,388096,-2203136,10
4932,672,24,6,0.119914347,0.880085653,1585.151328,1698.482087,2712.280414,3464.647321,5604,127.0460213,11208,-2525184,344064,-2181120,10
5137,777,25,5,0.131383159,0.868616841,1684.905222,1663.767941,2844.105704,3707.186615,5914,126.6652388,11828,-2630144,397824,-2232320,10
1388,212,22,8,0.1325,0.8675,449.9507949,510.479337,822.5208934,656.3254717,1600,76.55502392,3200,-710656,108544,-602112,10
1369,212,22,8,0.134092347,0.865907653,442.1846192,532.2092041,803.4872169,710.3632075,1581,27.63502884,3162,-700928,108544,-592384,10
1425,183,24,6,0.11380597,0.88619403,457.9861572,502.0846922,815.2645614,720.6775956,1608,77.08533078,3216,-729600,93696,-635904,10
1343,181,24,6,0.118766404,0.881233596,430.9806666,490.4921852,775.6887565,664.640884,1524,66.34740966,3048,-687616,92672,-594944,10
1379,199,22,8,0.126108999,0.873891001,445.1979531,498.6536562,810.1080493,646.6934673,1578,53.61875637,3156,-706048,101888,-604160,10
1079,158,24,6,0.127728375,0.872271625,347.368068,412.0363974,628.1899907,556.2405063,1237,67.89242591,2474,-552448,80896,-471552,10
1346,170,25,5,0.112137203,0.887862797,429.2234046,490.4211777,769.6106984,670.5294118,1516,65.91304348,3032,-689152,87040,-602112,10
1082,153,24,6,0.12388664,0.87611336,346.0953523,417.1938848,627.1866913,553.0326797,1235,66.36217088,2470,-553984,78336,-475648,10
1346,182,24,6,0.119109948,0.880890052,434.6681997,471.7571654,779.320951,654.8901099,1528,64.85568761,3056,-689152,93184,-595968,10
1366,206,22,8,0.131043257,0.868956743,443.6843203,493.6262543,807.5629575,646.8300971,1572,81.57758173,3144,-699392,105472,-593920,10
1353,167,24,6,0.109868421,0.890131579,430.4009616,491.3866515,772.2150776,665.5868263,1520,82.51900109,3040,-692736,85504,-607232,10
221,78,22,8,0.260869565,0.739130435,90.31084888,72.34177684,154.4615385,137.3589744,299,16.09257266,598,-113152,39936,-73216,10
1339,178,24,6,0.117336849,0.882663151,429.6985363,484.5671774,771.8752801,662.1460674,1517,75.73639541,3034,-685568,91136,-594432,10
1365,200,22,8,0.127795527,0.872204473,440.5988291,502.2139106,802.3326007,651.055,1565,72.96037296,3130,-698880,102400,-596480,10
1335,134,24,6,0.091218516,0.908781484,417.9535736,480.2482649,732.9752809,755.1716418,1469,72.93942403,2938,-683520,68608,-614912,10
1081,151,24,6,0.122564935,0.877435065,346.1581448,410.1275366,626.599445,544.1986755,1232,69.48674563,2464,-553472,77312,-476160,10
1091,150,24,6,0.120870266,0.879129734,347.8814422,422.3907748,628.2419798,568.3266667,1241,71.19908204,2482,-558592,76800,-481792,10
1418,207,22,8,0.127384615,0.872615385,460.7087256,505.4146588,831.3138223,687.5458937,1625,84.32797094,3250,-726016,105984,-620032,10
1155,147,25,5,0.112903226,0.887096774,368.134835,427.1112108,659.0545455,592.1428571,1302,64.7439085,2604,-591360,75264,-516096,10
1323,132,24,6,0.0907216495,0.909278351,412.987259,484.7995219,729.0559335,717.4166667,1455,79.07608696,2910,-677376,67584,-609792,10
9422,532,22,8,0.0534458509,0.946554149,2835.44515,3468.303401,4962.702611,5239.569549,9954,612.1771218,19908,-4824064,272384,-4551680,10
9461,493,22,8,0.049527828,0.950472172,2847.990505,3324.766768,4976.220695,5002.05071,9954,699.5080815,19908,-4844032,252416,-4591616,10
1700,215,22,8,0.11227154,0.88772846,519.1496621,734.3061325,930.8994118,1172.283721,1915,34.54807866,3830,-870400,110080,-760320,10
9610,371,21,9,0.0371706242,0.962829376,2862.921005,3162.086141,5029.493132,3993.913747,9981,672.574124,19962,-4920320,189952,-4730368,10
9436,513,21,9,0.0515629712,0.948437029,2846.465659,3301.892506,4965.106613,5156.976608,9949,453.6707706,19898,-4831232,262656,-4568576,10
9561,413,21,9,0.0414076599,0.95859234,2861.32283,3153.943002,5023.500052,4154.094431,9974,988.5034688,19948,-4895232,211456,-4683776,10
9592,384,21,9,0.0384923817,0.961507618,2862.633991,3139.436754,5025.802023,4056.726563,9976,510.2813299,19952,-4911104,196608,-4714496,10
888,79,22,8,0.0816959669,0.918304033,274.0892796,327.3597007,488.0191441,438.8227848,967,108.5297419,1934,-454656,40448,-414208,10
9533,433,21,9,0.0434477223,0.956552278,2856.995529,3185.723086,5019.184202,4197.87067,9966,879.6116505,19932,-4880896,221696,-4659200,10
9491,466,21,9,0.0468012454,0.953198755,2850.705233,3312.435713,4989.196607,4771.32618,9957,805.5825243,19914,-4859392,238592,-4620800,10
9508,449,21,9,0.0450939038,0.954906096,2850.066954,3335.303402,4992.030711,4703.062361,9957,916.8508287,19914,-4868096,229888,-4638208,10
9429,525,21,9,0.052742616,0.947257384,2841.336525,3386.665721,4961.637077,5262.398095,9954,750.678733,19908,-4827648,268800,-4558848,10
9447,519,21,9,0.052077062,0.947922938,2838.302474,3502.910826,4974.961046,5138.928709,9966,1282.625483,19932,-4836864,265728,-4571136,10
9550,419,21,9,0.0420302939,0.957969706,2863.094355,3156.831257,5006.067644,4504.818616,9969,1044.968553,19938,-4889600,214528,-4675072,10
9367,583,21,9,0.0585929648,0.941407035,2844.518806,3242.285726,4942.914701,5499.044597,9950,328.5997358,19900,-4795904,298496,-4497408,10
7134,483,22,8,0.0634107917,0.936589208,2168.613567,2589.035448,3790.2903,4085.345756,7617,135.8722797,15234,-3652608,247296,-3405312,10
9608,372,22,8,0.0372745491,0.962725451,2865.600396,3141.714668,5022.555787,4162.564516,9980,593.6942296,19960,-4919296,190464,-4728832,10
8119,806,21,9,0.0903081232,0.909691877,2512.095456,2880.79622,4341.877817,5683.088089,8925,209.8518693,17850,-4156928,412672,-3744256,10
9549,421,21,9,0.04222668,0.95777332,2861.897994,3171.210982,5010.475338,4419.016627,9970,1082.519001,19940,-4889088,215552,-4673536,10
9464,508,21,9,0.0509426394,0.949057361,2839.875785,3508.096402,4968.936919,5313.698819,9972,702.2535211,19944,-4845568,260096,-4585472,10
9223,703,22,8,0.0708240983,0.929175902,2843.189604,2897.297143,5052.846796,3791.315789,9926,1114.029181,19852,-4722176,359936,-4362240,10
9186,739,21,9,0.0744584383,0.925541562,2843.733241,2779.21945,5072.482038,3602.104195,9925,790.8366534,19850,-4703232,378368,-4324864,10
9279,652,22,8,0.0656530057,0.934346994,2857.058126,2838.205687,5032.532924,4019.130368,9931,730.7579102,19862,-4750848,333824,-4417024,10
9236,694,21,9,0.0698892246,0.930110775,2854.914252,2876.970413,5031.347661,4089.175793,9930,910.1741522,19860,-4728832,355328,-4373504,10
9204,718,21,9,0.0723644427,0.927635557,2847.421949,2817.979585,5053.330074,3784.335655,9922,776.3693271,19844,-4712448,367616,-4344832,10
9201,722,21,9,0.072760254,0.927239746,2838.850889,2899.485149,5059.4831,3719.698061,9923,836.6779089,19846,-4710912,369664,-4341248,10
9262,668,22,8,0.0672708963,0.932729104,2855.185714,2850.706618,5034.862881,4003.76497,9930,1078.175896,19860,-4742144,342016,-4400128,10
9245,684,21,9,0.0688891127,0.931110887,2853.335528,2852.362232,5039.132288,3963.02193,9929,723.6880466,19858,-4733440,350208,-4383232,10
9253,675,21,9,0.0679895246,0.932010475,2851.185652,2958.728848,5019.868475,4205.500741,9928,703.6144578,19856,-4737536,345600,-4391936,10
989,157,21,9,0.136998255,0.863001745,323.9729754,260.0002547,612.5429727,327.5541401,1146,24.5081266,2292,-506368,80384,-425984,10
9214,710,21,9,0.0715437324,0.928456268,2839.947384,2918.054075,5054.428587,3769.5,9924,500.7063572,19848,-4717568,363520,-4354048,10
9227,698,21,9,0.0703274559,0.929672544,2841.871501,2879.801231,5057.201366,3717.733524,9925,822.2866611,19850,-4724224,357376,-4366848,10
9196,729,21,9,0.0734508816,0.926549118,2847.13104,2796.059654,5062.072314,3713.248285,9925,823.6514523,19850,-4708352,373248,-4335104,10
9200,724,21,9,0.0729544538,0.927045546,2842.31227,2900.894509,5052.907935,3813.66989,9924,741.150112,19848,-4710400,370688,-4339712,10
9239,688,21,9,0.0693059333,0.930694067,2839.168868,3011.597906,5041.814266,3919.049419,9927,675.3061224,19854,-4730368,352256,-4378112,10
9205,720,21,9,0.0725440806,0.927455919,2842.784153,2867.132358,5058.784139,3738.426389,9925,679.3292266,19850,-4712960,368640,-4344320,10
1255,230,21,9,0.154882155,0.845117845,425.8376771,373.1412308,783.5043825,521.9869565,1485,28.7456446,2970,-642560,117760,-524800,10
9235,693,22,8,0.0698025786,0.930197421,2855.667992,2826.247635,5037.283378,3994.580087,9928,638.4565916,19856,-4728320,354816,-4373504,10
9192,732,21,9,0.0737605804,0.92623942,2840.363667,2928.905186,5052.539382,3831.84153,9924,766.3320463,19848,-4706304,374784,-4331520,10
1932,291,21,9,0.130904184,0.869095816,630.3778951,620.860582,1161.080745,786.1443299,2223,31.36286682,4446,-989184,148992,-840192,10
970,148,24,6,0.132379249,0.867620751,313.8046887,371.7753979,567.5587629,506.6824324,1118,66.86602871,2236,-496640,75776,-420864,10
1258,175,24,6,0.122121424,0.877878576,406.8454746,453.0150249,727.2321145,643.4457143,1433,57.78225806,2866,-644096,89600,-554496,10
1224,127,24,6,0.0940044412,0.905995559,385.966526,426.8909137,676.5310458,670.8818898,1351,69.89136058,2702,-626688,65024,-561664,10
1253,180,22,8,0.125610607,0.874389393,406.0502788,451.2538949,731.0766161,619.0111111,1433,62.85087719,2866,-641536,92160,-549376,10
987,159,22,8,0.138743455,0.861256545,321.9149433,369.8234077,587.4944276,486.6289308,1146,54.78011472,2292,-505344,81408,-423936,10
989,144,24,6,0.127096205,0.872903795,318.2610767,377.7980978,574.7906977,513.4930556,1133,58.91835673,2266,-506368,73728,-432640,10
1264,175,24,6,0.121612231,0.878387769,409.0904426,450.9389513,730.7072785,642.6628571,1439,82.51146789,2878,-647168,89600,-557568,10
1227,121,24,6,0.0897626113,0.910237389,384.528762,433.0561933,674.1124694,678.4297521,1348,67.87512588,2696,-628224,61952,-566272,10
1220,125,24,6,0.092936803,0.907063197,382.0189247,444.6704355,673.0590164,672.424,1345,54.60820138,2690,-624640,64000,-560640,10
1249,175,22,8,0.122893258,0.877106742,402.2540352,451.0884724,729.4547638,591.4914286,1424,75.98719317,2848,-639488,89600,-549888,10
1258,170,24,6,0.119047619,0.880952381,405.5933217,453.511312,722.9244833,652.1588235,1428,73.874806,2856,-644096,87040,-557056,10
1252,178,22,8,0.124475524,0.875524476,404.6638134,453.4889559,729.8083067,614.8595506,1430,80.47270681,2860,-641024,91136,-549888,10
1025,141,24,6,0.120926244,0.879073756,330.4664575,376.5759843,587.9785366,550.9432624,1166,54.87058824,2332,-524800,72192,-452608,10
1048,149,24,6,0.124477861,0.875522139,339.7778834,381.2489904,604.7127863,558.8187919,1197,54.90825688,2394,-536576,76288,-460288,10
1246,173,24,6,0.121916843,0.878083157,401.8753892,451.5919133,722.4686998,620.1965318,1419,82.5,2838,-637952,88576,-549376,10
992,145,24,6,0.127528584,0.872471416,320.2367081,373.8688573,576.9435484,514.6551724,1137,58.24795082,2274,-507904,74240,-433664,10
967,156,22,8,0.138913624,0.861086376,315.7736331,362.4867657,574.5718718,484.0705128,1123,61.63556531,2246,-495104,79872,-415232,10
1337,167,24,6,0.111037234,0.888962766,429.6258614,464.9457122,759.6955871,694.8922156,1504,68.11594203,3008,-684544,85504,-599040,10
1271,130,24,6,0.0927908637,0.907209136,400.1327487,444.2947569,701.1148702,699.8769231,1401,74.75987193,2802,-650752,66560,-584192,10
1268,188,22,8,0.129120879,0.870879121,410.9440756,460.5829496,746.5615142,606.6808511,1456,67.62656758,2912,-649216,96256,-552960,10
2718,455,24,6,0.143397416,0.856602584,894.526229,985.0894057,1537.889993,1880.364835,3173,55.98094566,6346,-1391616,232960,-1158656,10
2717,472,25,5,0.14800878,0.85199122,898.9591905,983.0175611,1542.386456,1897.862288,3189,58.8593577,6378,-1391104,241664,-1149440,10
1040,108,24,6,0.0940766551,0.905923345,321.002868,394.3345947,588.3509615,441.1203704,1148,120.8421053,2296,-532480,55296,-477184,10
284,17,24,6,0.0564784053,0.943521595,85.80495913,88.81172497,154.0739437,99.64705882,301,61.68032787,602,-145408,8704,-136704,10
2696,457,24,6,0.144941326,0.855058674,886.265534,994.8345066,1529.37092,1857.980306,3153,56.23327983,6306,-1380352,233984,-1146368,10
2780,470,22,8,0.144615385,0.855384615,912.8411657,1018.936673,1571.434173,1945.293617,3250,86.62046908,6500,-1423360,240640,-1182720,10
2843,498,22,8,0.149057169,0.850942831,940.5155623,1037.443398,1616.360886,1982.925703,3341,61.80170181,6682,-1455616,254976,-1200640,10
2785,488,24,6,0.149098686,0.850901314,918.4822392,1017.500999,1577.038061,1979.20082,3273,87.63052209,6546,-1425920,249856,-1176064,10
2786,485,24,6,0.148272699,0.851727301,919.1714526,1015.503038,1578.321608,1967.323711,3271,57.94508415,6542,-1426432,248320,-1178112,10
2709,468,24,6,0.147308782,0.852691218,888.3812846,1008.247436,1532.619786,1915.354701,3177,90.56442417,6354,-1387008,239616,-1147392,10
2748,467,25,5,0.14525661,0.85474339,904.170245,1002.797189,1555.033115,1919.67666,3215,59.64749536,6430,-1406976,239104,-1167872,10
2788,491,24,6,0.149740775,0.850259225,917.5143741,1029.176629,1578.316714,1990.250509,3279,59.68329086,6558,-1427456,251392,-1176064,10
2794,462,24,6,0.141891892,0.858108108,913.7385061,1029.302709,1575.979241,1946.125541,3256,58.37217641,6512,-1430528,236544,-1193984,10
2938,488,25,5,0.142440163,0.857559837,967.7697625,1046.002267,1657.168822,2052.641393,3426,100.9725906,6852,-1504256,249856,-1254400,10
2864,543,24,6,0.159377752,0.840622248,958.2098718,1042.621484,1639.093925,2046.3407,3407,60.1306036,6814,-1466368,278016,-1188352,10
2739,469,22,8,0.146197007,0.853802993,901.0966248,1010.596671,1553.7751,1900.73774,3208,60.68861143,6416,-1402368,240128,-1162240,10
2794,477,24,6,0.145826964,0.854173036,916.7362411,1017.955515,1573.805297,2000.301887,3271,98.08095952,6542,-1430528,244224,-1186304,10
2842,511,24,6,0.152400835,0.847599165,936.9371139,1055.386166,1612.597467,2035.183953,3353,60.51254286,6706,-1455104,261632,-1193472,10
1274,115,25,5,0.0827933765,0.917206623,395.4140322,404.6569427,713.5502355,489.4956522,1389,37.38896366,2778,-652288,58880,-593408,10
2732,464,22,8,0.145181477,0.854818523,897.6663921,1013.629202,1551.118594,1877.478448,3196,60.15433842,6392,-1398784,237568,-1161216,10
895,75,24,6,0.0773195876,0.922680412,275.2911117,330.0648249,487.7296089,458.8933333,970,109.8527746,1940,-458240,38400,-419840,10
4052,517,24,6,0.113153863,0.886846137,1300.732174,1399.707575,2237.748272,2655.336557,4569,125.109529,9138,-2074624,264704,-1809920,10
1728,149,24,6,0.0793819925,0.920618007,528.2453052,654.0021395,954.3952546,760.4563758,1877,103.4729879,3754,-884736,76288,-808448,10
1730,153,24,6,0.0812533192,0.918746681,530.0244777,657.2014234,956.199422,781.4444444,1883,118.8012618,3766,-885760,78336,-807424,10
1728,150,24,6,0.0798722045,0.920127796,531.450647,649.3209194,945.0173611,875.94,1878,79.3409379,3756,-884736,76800,-807936,10
811,98,22,8,0.107810781,0.892189219,257.4538058,246.4032978,474.5856967,292.9183673,909,18.15095847,1818,-415232,50176,-365056,10
4057,556,24,6,0.12052894,0.87947106,1304.700695,1457.400952,2254.340399,2691.244604,4613,83.40263967,9226,-2077184,284672,-1792512,10
892,76,24,6,0.0785123967,0.921487603,274.3610852,330.4643023,488.0403587,442.9473684,968,130.282638,1936,-456704,38912,-417792,10
4088,585,22,8,0.125187246,0.874812754,1314.883614,1477.334392,2267.205724,2824.724786,4673,82.4598553,9346,-2093056,299520,-1793536,10
1783,163,24,6,0.0837615622,0.916238438,547.6695969,681.1300957,986.6713404,829.4233129,1946,112.7462341,3892,-912896,83456,-829440,10
4137,525,22,8,0.112612613,0.887387387,1325.904572,1465.024864,2296.889533,2604.230476,4662,126.7192172,9324,-2118144,268800,-1849344,10
91,17,22,8,0.157407407,0.842592593,30.76413223,30.17411985,56.91208791,41.58823529,108,16,216,-46592,8704,-37888,10
4028,520,22,8,0.114335972,0.885664028,1292.285178,1427.316176,2235.630338,2575.590385,4548,90.04157593,9096,-2062336,266240,-1796096,10
4119,582,24,6,0.123803446,0.876196554,1351.816463,1275.687773,2276.792425,2876.190722,4701,134.5449342,9402,-2108928,297984,-1810944,10
4118,602,24,6,0.127542373,0.872457627,1357.51953,1281.063916,2284.603205,2879.674419,4720,136.6136035,9440,-2108416,308224,-1800192,10
4296,663,24,6,0.13369631,0.86630369,1420.874865,1414.69767,2408.892225,2940.75264,4959,107.1752756,9918,-2199552,339456,-1860096,10
1847,227,24,6,0.109450338,0.890549662,565.0919495,798.5082223,1014.536004,1224.348018,2074,39.82334869,4148,-945664,116224,-829440,10
4075,673,25,5,0.141743892,0.858256108,1349.589878,1396.514184,2294.277791,2860.243685,4748,84.28901118,9496,-2086400,344576,-1741824,10
4071,521,24,6,0.113458188,0.886541812,1306.945856,1407.332917,2248.26087,2673.431862,4592,107.039627,9184,-2084352,266752,-1817600,10
1736,151,25,5,0.0800211977,0.919978802,533.8030496,648.913169,952.8018433,842.807947,1887,79.88992379,3774,-888832,77312,-811520,10
2627,456,24,6,0.147907882,0.852092118,865.0431609,963.9098327,1487.631138,1855.217105,3083,66.47261751,6166,-1345024,233472,-1111552,10
2779,471,23,7,0.144923077,0.855076923,910.47466,1028.557403,1570.172004,1951.946921,3250,84.72367049,6500,-1422848,241152,-1181696,10
2781,467,24,6,0.143780788,0.856219212,912.8387815,1019.380463,1572.259619,1935.593148,3248,58.30192066,6496,-1423872,239104,-1184768,10
2744,463,25,5,0.144371687,0.855628313,897.3302551,1009.266484,1544.392128,1957.269978,3207,91.2116041,6414,-1404928,237056,-1167872,10
2519,391,24,6,0.134364261,0.865635739,832.1737394,872.2658521,1430.6447,1615.629156,2910,51.89941145,5820,-1289728,200192,-1089536,10
2793,447,24,6,0.137962963,0.862037037,911.9645121,1017.17864,1571.311493,1927.845638,3240,57.58976182,6480,-1430016,228864,-1201152,10
2742,491,24,6,0.151871327,0.848128673,906.5583155,1003.096946,1555.419037,1960.900204,3233,59.34287812,6466,-1403904,251392,-1152512,10
2309,258,24,6,0.100506428,0.899493572,738.3033875,764.55143,1286.744911,1259.434109,2567,69.49106659,5134,-1182208,132096,-1050112,10
2853,488,25,5,0.146064053,0.853935947,939.5181892,1033.816302,1612.051174,2015.633197,3341,66.21086009,6682,-1460736,249856,-1210880,10
2773,476,25,5,0.146506617,0.853493383,911.8791744,1017.757899,1569.089794,1950.712185,3249,60.21126761,6498,-1419776,243712,-1176064,10
2787,465,24,6,0.14298893,0.85701107,936.1057411,935.0863177,1596.845353,1804.236559,3252,59.98893193,6504,-1426944,238080,-1188864,10
2747,461,24,6,0.143703242,0.856296758,900.5651594,1007.370631,1550.611576,1925.609544,3208,58.57221106,6416,-1406464,236032,-1170432,10
2792,481,24,6,0.146959976,0.853040024,917.0181676,1031.640199,1579.842407,1968.775468,3273,61.4994363,6546,-1429504,246272,-1183232,10
2744,457,25,5,0.142767885,0.857232115,898.4833385,1003.364214,1546.070335,1930.818381,3201,88.7687188,6402,-1404928,233984,-1170944,10
1062,113,22,8,0.0961702128,0.903829787,329.2961972,388.2257841,604.4708098,433.2035398,1175,125,2350,-543744,57856,-485888,10
2863,483,24,6,0.144351464,0.855648536,957.4955634,976.4354529,1630.635348,1927.581781,3346,89.51310861,6692,-1465856,247296,-1218560,10
2882,483,25,5,0.143536404,0.856463596,942.4233482,1062.560845,1623.864677,2035.853002,3365,100.6882107,6730,-1475584,247296,-1228288,10
1072,102,24,6,0.0868824532,0.913117547,329.0449157,405.5411246,600.2313433,453.6960784,1174,98.24267782,2348,-548864,52224,-496640,10
2834,488,22,8,0.146899458,0.853100542,937.7819792,1019.002693,1607.621383,1974.393443,3322,59.13136347,6644,-1451008,249856,-1201152,10
2736,460,24,6,0.143929912,0.856070088,899.0231511,998.6872833,1547.062865,1904.43913,3196,60.24505184,6392,-1400832,235520,-1165312,10
5839,750,19,11,0.113826074,0.886173926,1887.039075,1875.925332,3205.937832,3988.378667,6589,158.9242644,13178,-2989568,384000,-2605568,11
3353,310,19,11,0.0846300846,0.915369915,1054.974054,1077.431726,1821.880704,1941.451613,3663,97.52396166,7326,-1716736,158720,-1558016,11
3300,289,19,11,0.0805238228,0.919476177,1026.831801,1105.817687,1773.128485,2044.743945,3589,84.01217228,7178,-1689600,147968,-1541632,11
5395,737,19,11,0.120189172,0.879810828,1753.122077,1732.382265,2969.621687,3775.670285,6132,135.6037152,12264,-2762240,377344,-2384896,11
5563,777,20,10,0.122555205,0.877444795,1808.352143,1805.127072,3064.184972,3931.671815,6340,149.352179,12680,-2848256,397824,-2450432,11
3425,313,19,11,0.0837346174,0.916265383,1062.21283,1195.125259,1837.840292,2215.936102,3738,85.87181254,7476,-1753600,160256,-1593344,11
3322,302,19,11,0.0833333333,0.916666667,1037.446791,1131.861285,1802.571945,1921.708609,3624,66.88815061,7248,-1700864,154624,-1546240,11
3567,310,20,10,0.079958731,0.920041269,1110.258413,1198.456959,1921.217269,2143.616129,3877,84.91020587,7754,-1826304,158720,-1667584,11
2928,270,19,11,0.0844277674,0.915572233,902.6971888,1081.964798,1573.436817,1882.140741,3198,68.14404432,6396,-1499136,138240,-1360896,11
6036,811,19,11,0.118446035,0.881553965,1959.924418,1954.57676,3328.443174,4135.197287,6847,165.3465347,13694,-3090432,415232,-2675200,11
3311,322,20,10,0.0886319846,0.911368015,1030.118377,1153.590193,1778.99849,2207.754658,3633,83.23024055,7266,-1695232,164864,-1530368,11
2950,278,21,9,0.0861214374,0.913878563,914.474129,1047.33814,1584.389153,1934.021583,3228,75.05231342,6456,-1510400,142336,-1368064,11
5706,755,20,10,0.116854976,0.883145024,1850.247835,1810.517513,3133.199089,3970.141722,6461,150.6060606,12922,-2921472,386560,-2534912,11
3332,335,19,11,0.0913553313,0.908644669,1039.878813,1174.575887,1799.29952,2179.140299,3667,86.38398115,7334,-1705984,171520,-1534464,11
3316,307,19,11,0.0847364063,0.915263594,1033.306415,1129.965875,1784.107358,2113.276873,3623,81.5990991,7246,-1697792,157184,-1540608,11
3333,312,19,11,0.0855967078,0.914403292,1034.682397,1191.474302,1797.911491,2091.012821,3645,83.16221766,7290,-1706496,159744,-1546752,11
3328,293,20,10,0.0809168738,0.919083126,1035.829905,1126.432417,1792.610877,2019.870307,3621,80.55617353,7242,-1703936,150016,-1553920,11
5849,784,19,11,0.118196894,0.881803106,1901.9117,1848.825512,3218.3139,4053.243622,6633,153.7195829,13266,-2994688,401408,-2593280,11
1302,100,20,10,0.0713266762,0.928673324,400.6895133,443.7653293,708.5852535,609.25,1402,22.84876141,2804,-666624,51200,-615424,11
1272,94,20,10,0.0688140556,0.931185944,390.6073102,427.7416367,691.336478,577.4574468,1366,21.83852918,2732,-651264,48128,-603136,11
4121,339,21,9,0.0760089686,0.923991031,1277.700363,1365.975745,2205.866295,2529.955752,4460,88.59753675,8920,-2109952,173568,-1936384,11
4348,344,21,9,0.073316283,0.926683717,1351.067176,1371.040895,2326.210672,2602.947674,4692,90.91261383,9384,-2226176,176128,-2050048,11
4053,334,21,9,0.0761340324,0.923865968,1252.577851,1387.386021,2168.699729,2501.011976,4387,93.43982961,8774,-2075136,171008,-1904128,11
4333,319,21,9,0.0685726569,0.931427343,1335.28461,1427.605675,2311.764828,2526.648903,4652,103.03433,9304,-2218496,163328,-2055168,11
4122,346,21,9,0.0774395703,0.92256043,1281.800967,1337.314772,2206.54197,2567.572254,4468,102.689037,8936,-2110464,177152,-1933312,11
4118,340,21,9,0.0762673845,0.923732616,1280.433555,1313.164263,2200.533511,2580.335294,4458,101.6415869,8916,-2108416,174080,-1934336,11
4204,363,21,9,0.0794832494,0.920516751,1304.775688,1381.175162,2243.099191,2757.683196,4567,107.080891,9134,-2152448,185856,-1966592,11
4112,338,21,9,0.0759550562,0.924044944,1276.836392,1349.537581,2204.443093,2481.671598,4450,95.76070583,8900,-2105344,173056,-1932288,11
4159,349,20,10,0.0774179237,0.922582076,1288.500947,1443.379048,2261.069969,2176.206304,4508,120.2133333,9016,-2129408,178688,-1950720,11
3769,326,21,9,0.0796092796,0.92039072,1165.198283,1310.547474,2017.036349,2405.981595,4095,97.59294566,8190,-1929728,166912,-1762816,11
4396,380,21,9,0.0795644891,0.920435511,1365.665337,1479.256107,2358.960646,2730.223684,4776,112.4029183,9552,-2250752,194560,-2056192,11
3689,294,22,8,0.0738137083,0.926186292,1134.33145,1258.95527,1959.442396,2400.520408,3983,102.1806054,7966,-1888768,150528,-1738240,11
3775,324,21,9,0.0790436692,0.920956331,1169.031118,1255.701929,2011.909139,2493.805556,4099,71.23740007,8198,-1932800,165888,-1766912,11
4407,371,21,9,0.0776475513,0.922352449,1363.925074,1507.928945,2360.43204,2734.789757,4778,114.9663138,9556,-2256384,189952,-2066432,11
4098,324,20,10,0.0732700136,0.926729986,1269.654356,1313.026688,2184.417033,2554.049383,4422,93.70629371,8844,-2098176,165888,-1932288,11
3850,296,22,8,0.0713941148,0.928605885,1182.201835,1332.988621,2049.066494,2391.300676,4146,96.66588948,8292,-1971200,151552,-1819648,11
4384,349,20,10,0.0737375872,0.926262413,1362.826123,1367.934073,2341.063184,2692.808023,4733,106.7192785,9466,-2244608,178688,-2065920,11
4417,349,21,9,0.0732270248,0.926772975,1372.213787,1404.503259,2367.206022,2589.719198,4766,109.5128676,9532,-2261504,178688,-2082816,11
6539,823,20,10,0.111790274,0.888209726,2100.12034,2101.547841,3566.317327,4596.663426,7362,142.4260012,14724,-3347968,421376,-2926592,11
4009,314,21,9,0.0726347444,0.927365256,1240.903695,1275.331209,2132.346969,2540.595541,4323,92.62909792,8646,-2052608,160768,-1891840,11
98,32,22,8,0.246153846,0.753846154,38.18198957,35.42327757,65.84693878,64.4375,130,20.73365231,260,-50176,16384,-33792,11
7002,580,23,7,0.0764969665,0.923503034,2204.970372,1912.923456,3832.870894,3292.053448,7582,132.9708874,15164,-3585024,296960,-3288064,11
8645,1251,23,7,0.126414713,0.873585287,2912.636708,2417.187837,4908.122614,5227.526779,9896,253.4836066,19792,-4426240,640512,-3785728,11
6987,573,23,7,0.0757936508,0.924206349,2196.647118,1956.73363,3813.234435,3381.34555,7560,131.7991632,15120,-3577344,293376,-3283968,11
8594,1300,23,7,0.131392763,0.868607237,2915.186025,2416.291579,4911.061205,5188.388462,9894,208.6021505,19788,-4400128,665600,-3734528,11
6711,502,23,7,0.0695965618,0.930403438,2094.443275,1829.830971,3646.814037,3074.74502,7213,170.8432023,14426,-3436032,257024,-3179008,11
7147,584,23,7,0.0755400336,0.924459966,2249.540484,1931.829344,3907.044494,3363.696918,7731,185.5291577,15462,-3659264,299008,-3360256,11
8674,1224,23,7,0.123661346,0.876338654,2909.079282,2429.692416,4899.172931,5306.147876,9898,235.2186312,19796,-4441088,626688,-3814400,11
6660,530,22,8,0.073713491,0.926286509,2092.250088,1767.22783,3638.25,3058.301887,7190,154.4907606,14380,-3409920,271360,-3138560,11
7275,578,22,8,0.0736024449,0.926397555,2280.441079,2010.668425,3970.6,3378.228374,7853,139.5840739,15706,-3724800,295936,-3428864,11
7266,559,23,7,0.0714376997,0.9285623,2273.926993,1973.575688,3955.014038,3366.892665,7825,197.202621,15650,-3720192,286208,-3433984,11
7316,583,22,8,0.073806811,0.926193189,2302.382711,1910.479579,3990.327228,3443.93825,7899,179.9726589,15798,-3745792,298496,-3447296,11
6844,495,23,7,0.0674478812,0.932552119,2127.354001,1880.667722,3716.161601,3031.757576,7339,167.4423911,14678,-3504128,253440,-3250688,11
8637,1260,23,7,0.127311306,0.872688694,2909.729692,2449.054955,4910.214542,5214.865079,9897,245.3396133,19794,-4422144,645120,-3777024,11
7428,563,23,7,0.070454261,0.929545739,2324.494424,1978.43015,4037.732768,3445.394316,7991,185.0196805,15982,-3803136,288256,-3514880,11
7107,569,23,7,0.0741271496,0.92587285,2237.307688,1869.087394,3874.977909,3382.878735,7676,182.6749167,15352,-3638784,291328,-3347456,11
6719,512,23,7,0.0708062509,0.929193749,2100.394291,1806.937103,3661.201518,3022.818359,7231,130.2179002,14462,-3440128,262144,-3177984,11
7061,551,23,7,0.0723857068,0.927614293,2215.868133,1857.458955,3849.91191,3250.181488,7612,183.0247656,15224,-3615232,282112,-3333120,11
8817,1075,23,7,0.108673676,0.891326324,2912.890267,2322.366137,4972.028354,4737.12,9892,187.5260664,19784,-4514304,550400,-3963904,11
7074,565,23,7,0.0739625605,0.926037439,2227.097486,1862.459824,3852.457733,3413.617699,7639,177.7338297,15278,-3621888,289280,-3332608,11
5039,439,20,10,0.0801387368,0.919861263,1548.746297,1916.358202,2738.566382,2750.216401,5478,128.1703322,10956,-2579968,224768,-2355200,11
4719,480,20,10,0.0923254472,0.907674553,1453.487058,1891.172771,2621.831956,2385.364583,5199,115.3283052,10398,-2416128,245760,-2170368,11
4730,450,20,10,0.0868725869,0.913127413,1453.124463,1882.556439,2589.05074,2605.733333,5180,94.49106166,10360,-2421760,230400,-2191360,11
4873,481,20,10,0.0898393724,0.910160628,1499.313499,1946.742495,2692.616663,2524.35343,5354,129.7310395,10708,-2494976,246272,-2248704,11
7344,880,20,10,0.107003891,0.892996109,2345.916104,2436.112833,4010.570806,4963.145455,8224,168.3176422,16448,-3760128,450560,-3309568,11
5046,503,20,10,0.0906469634,0.909353037,1556.982925,1992.091934,2788.298058,2641.596421,5549,128.4193474,11098,-2583552,257536,-2326016,11
7449,996,20,10,0.117939609,0.882060391,2381.422671,2705.888676,4121.324339,4983.423695,8445,198.6124177,16890,-3813888,509952,-3303936,11
5073,472,20,10,0.0851217313,0.914878269,1565.820723,1931.878741,2761.3014,2898.735169,5545,123.249611,11090,-2597376,241664,-2355712,11
4879,428,21,9,0.0806482005,0.9193518,1494.155638,1905.895675,2665.910637,2518.224299,5307,125.9074733,10614,-2498048,219136,-2278912,11
5038,475,20,10,0.0861599855,0.913840015,1550.656943,1973.00301,2757.567487,2750.981053,5513,113.9520463,11026,-2579456,243200,-2336256,11
5049,509,20,10,0.0915797049,0.908420295,1560.528539,1987.751322,2784.042781,2734.438114,5558,119.2447973,11116,-2585088,260608,-2324480,11
5073,526,19,11,0.0939453474,0.906054653,1567.153265,2026.835944,2811.26572,2691.347909,5599,97.67969295,11198,-2597376,269312,-2328064,11
4956,475,20,10,0.0874608728,0.912539127,1527.08954,1932.945675,2733.398305,2534.471579,5431,115.0635593,10862,-2537472,243200,-2294272,11
5249,486,20,10,0.0847428073,0.915257193,1617.170849,2005.317614,2892.451324,2603.915638,5735,121.9434404,11470,-2687488,248832,-2438656,11
7323,976,20,10,0.117604531,0.882395469,2339.675844,2651.826722,4045.377851,4934.987705,8299,162.6617013,16598,-3749376,499712,-3249664,11
5279,502,20,10,0.0868361875,0.913163812,1628.510155,2034.918924,2909.669445,2694.673307,5781,136.7636622,11562,-2702848,257024,-2445824,11
4908,468,20,10,0.0870535714,0.912946429,1508.614686,1940.837396,2704.660147,2519.025641,5376,128.4894837,10752,-2512896,239616,-2273280,11
70,66,20,10,0.485294118,0.514705882,40.88404709,33.77443679,57.54285714,80.12121212,136,2.625482625,272,-35840,33792,-2048,11
5050,520,19,11,0.0933572711,0.906642729,1565.516468,1960.455122,2807.174851,2575.003846,5570,129.1145109,11140,-2585600,266240,-2319360,11
3152,257,20,10,0.075388677,0.924611323,961.298151,1078.368256,1751.346447,1136.579767,3409,54.38736439,6818,-1613824,131584,-1482240,11
8787,1109,23,7,0.112065481,0.887934519,2921.738578,2267.037557,4973.726528,4748.62128,9896,258.9220304,19792,-4498944,567808,-3931136,11
7254,557,22,8,0.0713096915,0.928690309,2264.382206,2039.106627,3950.694927,3323.922801,7811,169.0692641,15622,-3714048,285184,-3428864,11
8634,1267,23,7,0.127966872,0.872033128,2914.470589,2403.708459,4893.39773,5343.531965,9901,238.6933462,19802,-4420608,648704,-3771904,11
6965,539,23,7,0.0718283582,0.928171642,2178.886491,1891.281278,3799.903661,3139.946197,7504,170.1201542,15008,-3566080,275968,-3290112,11
6614,508,23,7,0.0713282786,0.928671721,2073.006253,1742.879016,3600.107348,3058.844488,7122,173.7920937,14244,-3386368,260096,-3126272,11
8572,1316,23,7,0.133090615,0.866909385,2920.544859,2354.716893,4895.891274,5261.121581,9888,249.7600404,19776,-4388864,673792,-3715072,11
6648,504,23,7,0.0704697987,0.929530201,2075.55823,1831.904264,3617.099428,3040.974206,7152,172.7536232,14304,-3403776,258048,-3145728,11
6966,524,22,8,0.0699599466,0.930040053,2176.149218,1877.285964,3788.107666,3179.078244,7490,169.8027658,14980,-3566592,268288,-3298304,11
6629,493,23,7,0.0692221286,0.930777871,2069.851528,1780.149505,3599.901343,3045.146045,7122,169.1686461,14244,-3394048,252416,-3141632,11
5738,465,23,7,0.0749637272,0.925036273,1806.548484,1543.897249,3128.681248,2772.75914,6203,109.4389555,12406,-2937856,238080,-2699776,11
8626,1270,22,8,0.128334681,0.871665319,2916.92507,2389.263343,4906.871783,5231.244094,9896,226.9204311,19792,-4416512,650240,-3766272,11
3811,408,23,7,0.0967053804,0.90329462,1221.984802,1176.921939,2102.416689,2180.833333,4219,74.06952247,8438,-1951232,208896,-1742336,11
6970,508,23,7,0.0679326023,0.932067398,2175.75786,1829.833535,3777.915065,3212.427165,7478,164.3516484,14956,-3568640,260096,-3308544,11
8742,1157,23,7,0.116880493,0.883119507,2918.709949,2343.677083,4940.597918,5021.039758,9899,180.6716554,19798,-4475904,592384,-3883520,11
7063,510,22,8,0.0673445134,0.932655487,2195.310619,1959.643209,3830.118505,3189.85098,7573,149.8417095,15146,-3616256,261120,-3355136,11
7309,609,23,7,0.076913362,0.923086638,2306.82708,1941.902536,4002.663976,3441.461412,7918,183.5419564,15836,-3742208,311808,-3430400,11
6670,495,23,7,0.0690858339,0.930914166,2082.842553,1794.377672,3618.662519,3102.456566,7165,146.8237705,14330,-3415040,253440,-3161600,11
6800,489,22,8,0.067087392,0.932912608,2120.868398,1802.451804,3675.793529,3216.787321,7289,127.496939,14578,-3481600,250368,-3231232,11
7043,540,22,8,0.0712119214,0.928788079,2202.335831,1896.956669,3840.50575,3159.359259,7583,176.8423507,15166,-3606016,276480,-3329536,11
1569,110,23,7,0.0655151876,0.934484812,478.5496746,547.8161649,849.3709369,706.3363636,1679,27.30081301,3358,-803328,56320,-747008,11
6872,514,23,7,0.0695911183,0.930408882,2141.423362,1903.943809,3738.64188,3089.968872,7386,132.2707736,14772,-3518464,263168,-3255296,11
7034,538,23,7,0.0710512414,0.928948759,2201.851066,1877.714235,3829.10961,3229.407063,7572,174.6309963,15144,-3601408,275456,-3325952,11
7298,547,23,7,0.0697259401,0.93027406,2278.184211,1965.995279,3971.149356,3280.597806,7845,167.9511882,15690,-3736576,280064,-3456512,11
7245,585,23,7,0.0747126437,0.925287356,2275.684343,1979.903656,3959.866805,3366.034188,7830,181.5441688,15660,-3709440,299520,-3409920,11
6963,543,23,7,0.0723421263,0.927657874,2180.267573,1886.27078,3800.16559,3155.097606,7506,165.6953642,15012,-3565056,278016,-3287040,11
6929,575,23,7,0.0766257996,0.9233742,2184.540788,1846.48296,3797.77587,3206.906087,7504,182.6235094,15008,-3547648,294400,-3253248,11
6980,530,23,7,0.0705725699,0.92942743,2181.664627,1866.66911,3803.499284,3123.358491,7510,154.3044997,15020,-3573760,271360,-3302400,11
7000,561,23,7,0.0741965348,0.925803465,2198.21164,1885.968605,3827.123857,3205.479501,7561,134.4655878,15122,-3584000,287232,-3296768,11
6996,557,23,7,0.0737455316,0.926254468,2199.527113,1862.830126,3813.716552,3315.834829,7553,137.4522293,15106,-3581952,285184,-3296768,11
7002,566,23,7,0.0747885835,0.925211416,2198.333066,1949.646288,3821.965724,3321.010601,7568,131.5716273,15136,-3585024,289792,-3295232,11
6965,537,23,7,0.0715809118,0.928419088,2177.756187,1907.952473,3796.517157,3167.61825,7502,164.8066784,15004,-3566080,274944,-3291136,11
7243,553,23,7,0.0709338122,0.929066188,2262.257592,2037.641797,3932.902527,3447.907776,7796,137.3260525,15592,-3708416,283136,-3425280,11
7213,562,22,8,0.0722829582,0.927717042,2257.721303,1945.461698,3940.307916,3216.653025,7775,167.2043011,15550,-3693056,287744,-3405312,11
6916,549,22,8,0.0735432016,0.926456798,2169.148064,1880.704174,3777.152979,3176.785064,7465,184.3209877,14930,-3540992,281088,-3259904,11
6447,504,23,7,0.0725075529,0.927492447,2018.197316,1767.010863,3517.646192,2943.275794,6951,161.0145935,13902,-3300864,258048,-3042816,11
7004,547,23,7,0.0724407363,0.927559264,2197.385914,1857.793333,3818.124072,3236.627057,7551,154.4803601,15102,-3586048,280064,-3305984,11
6980,548,23,7,0.072794899,0.927205101,2190.549533,1853.615561,3807.223782,3220.317518,7528,181.6164053,15056,-3573760,280576,-3293184,11
7365,580,23,7,0.073001888,0.926998112,2303.226161,2105.129975,4011.836253,3479.846552,7945,145.6195015,15890,-3770880,296960,-3473920,11
6565,537,23,7,0.0756125035,0.924387496,2068.866908,1743.628676,3588.511805,3099.018622,7102,124.9472203,14204,-3361280,274944,-3086336,11
4896,459,23,7,0.0857142857,0.914285714,1555.908064,1433.376587,2682.482435,2630.187364,5355,96.29563028,10710,-2506752,235008,-2271744,11
3163,314,20,10,0.0903077366,0.909692263,992.2659632,1065.924099,1708.815049,2043.06051,3477,95.70602808,6954,-1619456,160768,-1458688,11
1058,55,22,8,0.0494159928,0.950584007,317.5443529,339.1879003,566.3837429,376.4909091,1113,24.86039759,2226,-541696,28160,-513536,11
2321,214,20,10,0.084418146,0.915581854,736.0925782,682.789538,1270.55838,1240.252336,2535,44.4191344,5070,-1188352,109568,-1078784,11
4133,419,21,9,0.0920474517,0.907952548,1312.962822,1271.85696,2240.711348,2629.5179,4552,91.64485605,9104,-2116096,214528,-1901568,11
3164,305,21,9,0.0879215912,0.912078409,991.4162103,1058.639241,1707.566372,2019.590164,3469,133.3205227,6938,-1619968,156160,-1463808,11
5261,539,21,9,0.0929310345,0.907068966,1653.400886,1795.501663,2850.857442,3385.044527,5800,118.4156799,11600,-2693632,275968,-2417664,11
4562,345,20,10,0.0703077237,0.929692276,1412.442729,1469.049707,2456.629987,2419.223188,4907,184.8210923,9814,-2335744,176640,-2159104,11
3370,296,22,8,0.0807419531,0.919258047,1051.768034,1111.734112,1816.548071,2026.5,3666,130.0461156,7332,-1725440,151552,-1573888,11
3174,306,20,10,0.0879310345,0.912068966,994.5193875,1079.697723,1719.451166,1958.830065,3480,286.8920033,6960,-1625088,156672,-1468416,11
5903,678,21,9,0.103023857,0.896976143,1856.719969,1976.282591,3176.318313,4289.474926,6581,429.0091265,13162,-3022336,347136,-2675200,11
3839,423,21,9,0.0992491788,0.900750821,1226.03359,1211.162812,2092.001823,2489.971631,4262,75.50044287,8524,-1965568,216576,-1748992,11
3406,303,21,9,0.0816931788,0.918306821,1061.507703,1124.846552,1827.862302,2160.052805,3709,94.23272358,7418,-1743872,155136,-1588736,11
4280,493,21,9,0.103289336,0.896710664,1375.060217,1355.843313,2348.168692,2724.115619,4773,217.1519563,9546,-2191360,252416,-1938944,11
3969,476,20,10,0.107086614,0.892913386,1275.992517,1287.654013,2180.383472,2578.346639,4445,236.6879659,8890,-2032128,243712,-1788416,11
3819,430,20,10,0.101200282,0.898799718,1224.929355,1200.962809,2091.559309,2422,4249,89.66026588,8498,-1955328,220160,-1735168,11
4970,505,21,9,0.0922374429,0.907762557,1550.571358,1761.528923,2683.483501,3274.528713,5475,116.0941476,10950,-2544640,258560,-2286080,11
3914,426,21,9,0.098156682,0.901843318,1244.899727,1255.267496,2127.090189,2569.340376,4340,274.6835443,8680,-2003968,218112,-1785856,11
3196,303,21,9,0.0865961703,0.91340383,1003.213175,1045.032204,1725.375469,2009.735974,3499,122.2571628,6998,-1636352,155136,-1481216,11
3175,328,21,9,0.093634028,0.906365972,998.0543166,1079.349377,1718.817323,2073.204268,3503,89.93581515,7006,-1625600,167936,-1457664,11
1220,88,21,9,0.0672782875,0.932721713,369.332166,477.3702579,655.4032787,641.9772727,1308,20.60166955,2616,-624640,45056,-579584,11
9007,909,22,8,0.0916700282,0.908329972,2846.772411,2952.38363,4900.21239,5536.053905,9916,541.2663755,19832,-4611584,465408,-4146176,11
7818,795,22,8,0.0923023337,0.907697666,2468.664253,2599.519468,4255.125608,4817.130818,8613,150.8406305,17226,-4002816,407040,-3595776,11
8010,756,22,8,0.0862422998,0.9137577,2520.759892,2605.878944,4350.271536,4735.563492,8766,171.2109375,17532,-4101120,387072,-3714048,11
8129,784,22,8,0.0879614047,0.912038595,2569.537951,2590.978453,4429.444458,4742.71301,8913,190.4894208,17826,-4162048,401408,-3760640,11
7859,765,22,8,0.0887059369,0.911294063,2494.850543,2407.491319,4279.05446,4656.09281,8624,169.3969751,17248,-4023808,391680,-3632128,11
7996,818,22,8,0.0928068981,0.907193102,2558.330605,2400.356375,4395.0005,4529.683374,8814,183.5867528,17628,-4093952,418816,-3675136,11
7955,800,22,8,0.0913763564,0.908623644,2532.901269,2445.28086,4343.59472,4720.1175,8755,220.640121,17510,-4072960,409600,-3663360,11
7996,809,22,8,0.0918796139,0.908120386,2555.567568,2376.051633,4369.511506,4733.99382,8805,188.1812353,17610,-4093952,414208,-3679744,11
8934,979,22,8,0.0987592051,0.901240795,2859.924618,2814.184245,4894.693418,5525.587334,9913,558.7936866,19826,-4574208,501248,-4072960,11
7898,764,22,8,0.0882013392,0.911798661,2491.736985,2560.938169,4296.137503,4697.066754,8662,169.1796875,17324,-4043776,391168,-3652608,11
8106,787,21,9,0.0884965703,0.91150343,2574.594957,2476.806041,4423.621268,4687.797967,8893,198.9485459,17786,-4150272,402944,-3747328,11
7966,805,22,8,0.0917797287,0.908220271,2517.830896,2630.235882,4343.011172,4811.402484,8771,195.3452116,17542,-4078592,412160,-3666432,11
7487,520,22,8,0.0649431747,0.935056825,2325.587496,2057.267645,4031.244424,3611.732692,8007,221.3101161,16014,-3833344,266240,-3567104,11
8210,786,22,8,0.0873721654,0.912627835,2609.260397,2451.040282,4475.108648,4742.829517,8996,181.1883182,17992,-4203520,402432,-3801088,11
8003,782,22,8,0.0890153671,0.910984633,2551.50566,2357.082474,4368.541672,4643.306905,8785,206.6572571,17570,-4097536,400384,-3697152,11
7986,796,22,8,0.0906399453,0.909360055,2539.450763,2470.441829,4360.749562,4700.008794,8782,182.1991701,17564,-4088832,407552,-3681280,11
8036,793,22,8,0.0898176464,0.910182354,2551.128145,2504.567787,4385.490543,4714.039092,8829,551.1235955,17658,-4114432,406016,-3708416,11
7957,794,22,8,0.0907324877,0.909267512,2503.531212,2673.900501,4317.782581,4959.420655,8751,152.4033438,17502,-4073984,406528,-3667456,11
8977,939,22,8,0.0946954417,0.905304558,2840.372126,2976.989024,4885.498496,5656.406816,9916,522.1695629,19832,-4596224,480768,-4115456,11
1578,79,22,8,0.0476765238,0.952323476,473.3860647,558.2237581,834.1850444,725.4303797,1657,24.37123106,3314,-807936,40448,-767488,11
2544,290,21,9,0.102328864,0.897671136,812.5279424,858.3263369,1405.495676,1522.806897,2834,69.03775883,5668,-1302528,148480,-1154048,11
2252,261,21,9,0.103859928,0.896140072,720.9789097,754.440501,1244.603908,1363.957854,2513,49.89080802,5026,-1153024,133632,-1019392,11
2253,234,22,8,0.0940892642,0.905910736,709.9128955,777.4170517,1229.559698,1383.034188,2487,59.14387634,4974,-1153536,119808,-1033728,11
2629,306,21,9,0.104258944,0.895741056,841.2830202,893.0526954,1458.757703,1547.405229,2935,68.96146617,5870,-1346048,156672,-1189376,11
629,49,20,10,0.0722713864,0.927728614,189.3766676,261.7148363,342.0747218,306.4489796,678,25.12041497,1356,-322048,25088,-296960,11
4867,793,20,10,0.140106007,0.859893993,1611.211076,1653.382089,2736.402096,3408.021438,5660,128.9000228,11320,-2491904,406016,-2085888,11
2524,293,21,9,0.10401136,0.89598864,817.2638147,776.3777739,1404.859746,1444.665529,2817,49.13657771,5634,-1292288,150016,-1142272,11
5094,794,21,9,0.134850543,0.865149457,1684.996317,1681.803347,2855.094425,3518.09194,5888,141.9821558,11776,-2608128,406528,-2201600,11
2919,292,20,10,0.0909374027,0.909062597,928.4396255,911.7014263,1604.960946,1616.386986,3211,74.69178879,6422,-1494528,149504,-1345024,11
2865,306,21,9,0.096499527,0.903500473,912.1448399,945.2167607,1586.297382,1583.215686,3171,75.53596951,6342,-1466880,156672,-1310208,11
2610,276,20,10,0.0956340956,0.904365904,833.1275316,829.901795,1436.268966,1511.880435,2886,70.82208589,5772,-1336320,141312,-1195008,11
1080,85,21,9,0.0729613734,0.927038627,332.9088568,367.6966318,589.2444444,503.6588235,1165,22.42972661,2330,-552960,43520,-509440,11
654,61,20,10,0.0853146853,0.914685315,199.526379,266.9709553,361.1590214,324.1311475,715,17.34174145,1430,-334848,31232,-303616,11
2397,250,22,8,0.0944465433,0.905553457,760.8921472,792.9308278,1319.151856,1370.484,2647,53.35617819,5294,-1227264,128000,-1099264,11
2632,276,21,9,0.0949105915,0.905089409,835.7141752,872.2066275,1448.257219,1514.032609,2908,61.63628656,5816,-1347584,141312,-1206272,11
4725,854,20,10,0.153074028,0.846925972,1593.825855,1589.037818,2689.554497,3345.74356,5579,127.9880707,11158,-2419200,437248,-1981952,11
2247,235,22,8,0.0946817083,0.905318292,710.1073004,769.8470692,1232.721406,1325.438298,2482,50.78780438,4964,-1150464,120320,-1030144,11
2622,301,20,10,0.102976394,0.897023606,845.9714164,824.4899083,1460.426392,1475.707641,2923,58.30839816,5846,-1342464,154112,-1188352,11
2663,305,21,9,0.102762803,0.897237197,853.6322554,880.7351446,1476.443485,1554.842623,2968,66.35367762,5936,-1363456,156160,-1207296,11
2651,291,20,10,0.0989123046,0.901087695,849.0192632,850.8991843,1467.715956,1505.972509,2942,60.23751024,5884,-1357312,148992,-1208320,11
6975,525,22,8,0.07,0.93,2181.058336,1842.593369,3794.580215,3164.862857,7500,180.3751804,15000,-3571200,268800,-3302400,11
7216,527,23,7,0.0680614749,0.931938525,2249.702902,1935.949695,3914.204961,3294.104364,7743,177.3883162,15486,-3694592,269824,-3424768,11
6883,517,23,7,0.0698648649,0.930135135,2151.305386,1848.947092,3738.987215,3188.106383,7400,166.6291376,14800,-3524096,264704,-3259392,11
7004,559,23,7,0.0739124686,0.926087531,2202.087776,1871.372707,3818.793118,3321,7563,137.7093955,15126,-3586048,286208,-3299840,11
1546,110,23,7,0.0664251208,0.933574879,471.3397635,532.9735915,841.1668823,650.4727273,1656,30.11456628,3312,-791552,56320,-735232,11
7024,566,22,8,0.074571805,0.925428195,2209.057891,1876.470618,3837.667426,3272.206714,7590,188.7590152,15180,-3596288,289792,-3306496,11
8722,1178,23,7,0.118989899,0.881010101,2912.831508,2411.588381,4942.48028,5009.878608,9900,220.9821429,19800,-4465664,603136,-3862528,11
6572,506,23,7,0.0714891212,0.928510879,2054.334924,1792.619777,3584.690353,2952.561265,7078,163.8046748,14156,-3364864,259072,-3105792,11
7328,542,23,7,0.0688691233,0.931130877,2289.289454,1944.521048,3974.994541,3401.52214,7870,164.3349342,15740,-3751936,277504,-3474432,11
6894,523,23,7,0.0705136848,0.929486315,2156.15428,1853.181866,3748.89208,3183.156788,7417,163.010989,14834,-3529728,267776,-3261952,11
8868,1034,23,7,0.104423349,0.895576651,2915.9317,2299.381493,4972.868516,4768.23501,9902,257.7303488,19804,-4540416,529408,-4011008,11
8716,1186,23,7,0.119773783,0.880226217,2917.261702,2381.390741,4943.508261,5010.231872,9902,240.1649285,19804,-4462592,607232,-3855360,11
8758,1146,23,7,0.115710824,0.884289176,2918.7555,2348.673887,4934.662708,5088.816754,9904,271.1938664,19808,-4484096,586752,-3897344,11
6643,503,23,7,0.0703890288,0.929610971,2079.356506,1747.812529,3613.40855,3046.437376,7146,171.6962999,14292,-3401216,257536,-3143680,11
6856,489,22,8,0.066575902,0.933424098,2134.017528,1837.37448,3710.913361,3141.437628,7345,131.4894379,14690,-3510272,250368,-3259904,11
6725,530,23,7,0.0730530669,0.926946933,2105.171269,1852.838776,3674.525799,3037.649057,7255,159.0659943,14510,-3443200,271360,-3171840,11
8765,1141,22,8,0.115182718,0.884817282,2918.614129,2357.381547,4948.972048,4988.283085,9906,249.4585747,19812,-4487680,584192,-3903488,11
6648,527,23,7,0.0734494774,0.926550523,2089.534515,1744.282537,3628.915012,3071.865275,7175,156.625191,14350,-3403776,269824,-3133952,11
8676,1224,23,7,0.123636364,0.876363636,2918.355946,2361.370287,4905.615837,5268.64951,9900,230.7692308,19800,-4442112,626688,-3815424,11
7068,542,23,7,0.0712220762,0.928777924,2215.03867,1858.451229,3847.556876,3257.053506,7610,155.0213893,15220,-3618816,277504,-3341312,11
4708,296,21,9,0.0591526779,0.940847322,1429.495272,1623.295843,2525.225786,2141.037162,5004,592.8909953,10008,-2410496,151552,-2258944,12
4697,292,21,9,0.0585287633,0.941471237,1433.820693,1379.616469,2536.166915,1832.804795,4989,636.3520408,9978,-2404864,149504,-2255360,12
4726,334,21,9,0.0660079051,0.933992095,1454.241015,1343.935701,2583.127592,1785.835329,5060,901.9607843,10120,-2419712,171008,-2248704,12
4703,360,20,10,0.0711040885,0.928895912,1459.953213,1316.847548,2582.226026,1875.852778,5063,256.8746829,10126,-2407936,184320,-2223616,12
4721,329,22,8,0.0651485149,0.934851485,1451.575804,1355.33599,2575.403093,1809.413374,5050,833.3333333,10100,-2417152,168448,-2248704,12
4604,349,21,9,0.0704623461,0.929537654,1422.215071,1298.540283,2535.641399,1703.404011,4953,661.2817089,9906,-2357248,178688,-2178560,12
4744,350,22,8,0.0687082843,0.931291716,1467.075092,1307.38314,2602.186341,1806.265714,5094,439.137931,10188,-2428928,179200,-2249728,12
4722,302,22,8,0.060111465,0.939888535,1445.031054,1366.018992,2555.28166,1843.576159,5024,870.7105719,10048,-2417664,154624,-2263040,12
1048,212,21,9,0.168253968,0.831746032,355.5433132,397.6112869,619.8759542,683.0188679,1260,23.18307268,2520,-536576,108544,-428032,12
4729,346,21,9,0.0681773399,0.93182266,1461.394198,1342.071503,2587.460351,1861.99422,5075,739.7959184,10150,-2421248,177152,-2244096,12
4715,332,22,8,0.0657816525,0.934218348,1453.875307,1369.979084,2565.547402,1933.951807,5047,298.1098641,10094,-2414080,169984,-2244096,12
4815,317,21,9,0.0617692907,0.938230709,1477.740842,1369.390164,2611.032399,1890.085174,5132,417.9153094,10264,-2465280,162304,-2302976,12
4834,340,22,8,0.0657131813,0.934286819,1472.379876,1621.984385,2635.335333,1907.394118,5174,785.1289833,10348,-2475008,174080,-2300928,12
4735,311,22,8,0.0616329766,0.938367023,1453.371611,1379.873401,2561.846885,1939.665595,5046,716.7613636,10092,-2424320,159232,-2265088,12
4704,314,21,9,0.062574731,0.937425269,1440.924147,1373.252558,2557.150085,1795.659236,5018,804.1666667,10036,-2408448,160768,-2247680,12
4711,319,20,10,0.0634194831,0.936580517,1444.299936,1386.328745,2562.636807,1819.382445,5030,849.6621622,10060,-2412032,163328,-2248704,12
4754,365,22,8,0.0713029889,0.928697011,1475.917301,1361.494946,2606.775768,1950.761644,5119,412.8225806,10238,-2434048,186880,-2247168,12
4727,364,23,7,0.0714987232,0.928501277,1471.032604,1297.443679,2594.28792,1918.92033,5091,507.5772682,10182,-2420224,186368,-2233856,12
4719,312,21,9,0.0620155039,0.937984496,1447.927435,1360.582074,2558.999788,1865.628205,5031,446.4063886,10062,-2416128,159744,-2256384,12
4705,317,22,8,0.063122262,0.936877738,1447.682855,1323.551802,2554.649947,1871.056782,5022,750.6726457,10044,-2408960,162304,-2246656,12
853,101,21,9,0.105870021,0.894129979,266.0830256,316.5656256,492.6119578,349.8712871,954,88.99253731,1908,-436736,51712,-385024,12
851,92,21,9,0.0975609756,0.902439024,263.9563075,323.8896029,482.3654524,376.1195652,943,108.5155351,1886,-435712,47104,-388608,12
852,94,21,9,0.0993657505,0.900634249,264.6681283,326.4246769,483.463615,383.1914894,946,106.0538117,1892,-436224,48128,-388096,12
848,99,21,9,0.104540655,0.895459345,263.9131231,321.420633,487.5165094,358.2222222,947,115.7701711,1894,-434176,50688,-383488,12
844,84,21,9,0.0905172414,0.909482759,260.2849963,318.3954902,474.3412322,365.6190476,928,100.4329004,1856,-432128,43008,-389120,12
830,86,21,9,0.0938864629,0.906113537,257.0717624,310.4359563,468.6385542,360.6511628,916,123.7837838,1832,-424960,44032,-380928,12
849,92,21,9,0.0977683316,0.902231668,263.5255166,325.7951932,480.0541814,387.4456522,941,123.1675393,1882,-434688,47104,-387584,12
858,90,21,9,0.0949367089,0.905063291,265.6851797,328.5519425,483.4090909,389.5666667,948,160.950764,1896,-439296,46080,-393216,12
847,94,21,9,0.0998937301,0.90010627,263.8899829,321.7144623,480.2408501,387.7340426,941,181.3102119,1882,-433664,48128,-385536,12
850,91,21,9,0.0967056323,0.903294368,264.1179145,319.002887,481.0141176,377.4615385,941,79.74576271,1882,-435200,46592,-388608,12
847,86,21,9,0.0921757771,0.907824223,261.0058272,319.8510776,478.3376623,355.3372093,933,102.3026316,1866,-433664,44032,-389632,12
848,91,21,9,0.0969116081,0.903088392,263.0346895,327.1605934,478.1674528,393.8901099,939,124.535809,1878,-434176,46592,-387584,12
855,93,21,9,0.0981012658,0.901898734,265.566917,326.0390635,484.1520468,385.7634409,948,171.1191336,1896,-437760,47616,-390144,12
855,98,21,9,0.102833158,0.897166842,265.229075,332.522345,488.7333333,374.6326531,953,116.7892157,1906,-437760,50176,-387584,12
850,95,21,9,0.100529101,0.899470899,263.3105384,330.0782974,484.1047059,373.6421053,945,164.6341463,1890,-435200,48640,-386560,12
857,100,21,9,0.104493208,0.895506792,267.1053145,328.9381316,490.453909,380.84,957,155.8631922,1914,-438784,51200,-387584,12
847,102,21,9,0.10748156,0.89251844,265.5303674,315.1419201,488.201889,365.372549,949,190.1803607,1898,-433664,52224,-381440,12
870,99,21,9,0.102167183,0.897832817,270.7246266,313.1779916,501.6022989,339.1010101,969,105.5555556,1938,-445440,50688,-394752,12
846,99,21,9,0.104761905,0.895238095,264.0288701,297.7572852,490.8486998,320.4747475,945,87.5,1890,-433152,50688,-382464,12
822,90,21,9,0.0986842105,0.901315789,253.9478307,310.7151178,469.9781022,333.4,912,14.19676214,1824,-420864,46080,-374784,12
711,36,24,6,0.0481927711,0.951807229,212.3719071,271.214124,375.1800281,350.6944444,747,186.75,1494,-364032,18432,-345600,12
706,46,23,7,0.0611702128,0.938829787,212.4525374,254.9402095,383.6033994,267.4782609,752,114.1122914,1504,-361472,23552,-337920,12
699,39,24,6,0.0528455285,0.947154472,209.5403545,257.4498081,373.5736767,296.4871795,738,102.5,1476,-357888,19968,-337920,12
709,40,24,6,0.0534045394,0.946595461,212.4406126,265.8694405,378.787024,307.875,749,196.0732984,1498,-363008,20480,-342528,12
700,44,23,7,0.0591397849,0.940860215,210.426537,254.9704518,378.7557143,272.9772727,744,12.90098838,1488,-358400,22528,-335872,12
777,44,23,7,0.053593179,0.946406821,233.5331405,269.3807254,417.1415701,302.5454545,821,118.813314,1642,-397824,22528,-375296,12
708,40,23,7,0.0534759358,0.946524064,212.134623,261.016398,379.1779661,291.7,748,169.6145125,1496,-362496,20480,-342016,12
708,39,23,7,0.0522088353,0.947791165,211.6347819,275.2079388,376.2937853,332.3589744,747,160.6451613,1494,-362496,19968,-342528,12
748,46,23,7,0.0579345088,0.942065491,225.747654,265.2159595,402.7700535,311.8043478,794,87.73480663,1588,-382976,23552,-359424,12
701,48,22,8,0.0640854473,0.935914553,211.2753575,250.9857571,383.0071327,258.0625,749,140.5253283,1498,-358912,24576,-334336,12
709,40,23,7,0.0534045394,0.946595461,211.9720967,273.1049146,378.6346968,310.575,749,25.84541063,1498,-363008,20480,-342528,12
709,47,23,7,0.0621693122,0.937830688,213.1893292,263.3243666,385.2778561,276.2553191,756,197.9057592,1512,-363008,24064,-338944,12
698,41,23,7,0.0554803789,0.944519621,209.5935116,242.1225814,376.7048711,255.8536585,739,131.7290553,1478,-357376,20992,-336384,12
25,25,22,8,0.5,0.5,13.22276824,13.68070174,20.28,30.72,50,1.900418092,100,-12800,12800,0,12
721,36,23,7,0.0475561427,0.952443857,215.2015924,271.9703256,381.518724,328.5555556,757,92.54278729,1514,-369152,18432,-350720,12
774,40,22,8,0.0491400491,0.950859951,231.869979,267.1248666,413.0129199,300.825,814,139.3835616,1628,-396288,20480,-375808,12
747,40,22,8,0.0508259212,0.949174079,223.9814852,256.0140511,399.9665328,282.575,787,137.3472949,1574,-382464,20480,-361984,12
706,49,24,6,0.0649006623,0.935099338,212.6976206,270.7733445,383.5226629,298.4285714,755,13.75227687,1510,-361472,25088,-336384,12
753,46,22,8,0.057571965,0.942428035,227.4861592,235.976117,408.6454183,258.4782609,799,102.173913,1598,-385536,23552,-361984,12
708,41,23,7,0.0547396529,0.945260347,212.243927,260.6247562,380.1059322,286.8292683,749,150.1002004,1498,-362496,20992,-341504,12
717,41,23,7,0.0540897098,0.94591029,215.160274,265.9201931,383.3960948,311.3658537,758,173.4553776,1516,-367104,20992,-346112,12
744,37,23,7,0.0473751601,0.95262484,222.7633312,256.5442905,395.6747312,297,781,153.1372549,1562,-380928,18944,-361984,12
742,46,23,7,0.0583756345,0.941624365,222.6458713,254.4519445,403.4366577,250.3478261,788,63.96103896,1576,-379904,23552,-356352,12
718,37,23,7,0.0490066225,0.950993377,214.9336392,257.1384503,382.1183844,298.0810811,755,105.5944056,1510,-367616,18944,-348672,12
720,38,22,8,0.0501319261,0.949868074,215.5278693,258.6049619,384.1180556,292,758,160.2536998,1516,-368640,19456,-349184,12
726,38,23,7,0.0497382199,0.95026178,217.330467,268.0718368,385.600551,323.2631579,764,120.6951027,1528,-371712,19456,-352256,12
727,46,23,7,0.0595084088,0.940491591,218.8237421,263.0358039,393.3755158,286.2391304,773,240.0621118,1546,-372224,23552,-348672,12
729,40,23,7,0.0520156047,0.947984395,218.8791141,253.027438,390.4115226,286.375,769,171.2694878,1538,-373248,20480,-352768,12
726,44,23,7,0.0571428571,0.942857143,218.332019,257.38529,391.9090909,279.75,770,131.1754685,1540,-371712,22528,-349184,12
722,37,23,7,0.0487483531,0.951251647,215.9479112,268.1639818,382.6869806,327.5675676,759,207.3770492,1518,-369664,18944,-350720,12
733,48,23,7,0.0614596671,0.938540333,221.3360608,258.4961819,397.9822647,284.375,781,167.9569892,1562,-375296,24576,-350720,12
724,40,23,7,0.0523560209,0.947643979,217.4123693,252.5260383,387.8038674,286.5,764,168.2819383,1528,-370688,20480,-350208,12
720,42,23,7,0.0551181102,0.94488189,215.9158026,267.4813703,386.2902778,299.3809524,762,156.7901235,1524,-368640,21504,-347136,12
730,40,22,8,0.0519480519,0.948051948,218.3353818,272.9093428,389.8493151,306.125,770,172.2595078,1540,-373760,20480,-353280,12
733,40,23,7,0.0517464424,0.948253558,219.9210161,260.6591632,391.7626194,299.725,773,174.0990991,1546,-375296,20480,-354816,12
733,49,22,8,0.0626598465,0.937340153,221.3327782,259.0553242,398.9781719,279.6326531,782,194.5273632,1564,-375296,25088,-350208,12
728,47,22,8,0.0606451613,0.939354839,218.8644159,250.5822157,396.9739011,249,775,90.11627907,1550,-372736,24064,-348672,12
814,52,22,8,0.0600461894,0.939953811,247.1068121,271.2565245,440.1044226,330.1153846,866,100.6976744,1732,-416768,26624,-390144,12
729,42,22,8,0.0544747082,0.945525292,218.9454907,260.0768332,391.5061728,290.4285714,771,115.7657658,1542,-373248,21504,-351744,12
724,39,23,7,0.0511140236,0.948885976,217.2176003,252.3836606,387.1187845,286.974359,763,163.7339056,1526,-370688,19968,-350720,12
737,35,22,8,0.0453367876,0.954663212,220.2139562,260.1085017,390.2890095,306.7142857,772,148.7475915,1544,-377344,17920,-359424,12
738,38,22,8,0.0489690722,0.951030928,220.9225369,265.4685765,392.5176152,310.4736842,776,135.6643357,1552,-377856,19456,-358400,12
752,45,22,8,0.0564617315,0.943538269,226.4633367,257.3298791,405.9414894,283,797,170.6638116,1594,-385024,23040,-361984,12
740,36,22,8,0.0463917526,0.953608247,221.0346916,261.7396926,392.9837838,296.3333333,776,143.4380776,1552,-378880,18432,-360448,12
659,41,22,8,0.0585714286,0.941428571,197.7278865,219.0575644,359.198786,210.6829268,700,19.3637621,1400,-337408,20992,-316416,12
733,47,22,8,0.0602564103,0.93974359,220.570972,249.3530897,399.3929059,251.8085106,780,158.8594705,1560,-375296,24064,-351232,12
743,41,22,8,0.0522959184,0.947704082,222.9586715,267.9729913,396.9259758,312.2926829,784,125.2396166,1568,-380416,20992,-359424,12
731,46,21,9,0.0592020592,0.940797941,218.5707687,275.3408817,396.4309166,270.9130435,777,58.90826384,1554,-374272,23552,-350720,12
744,45,22,8,0.0570342205,0.942965779,223.5985775,273.6659079,400.2768817,307.7555556,789,13.73368146,1578,-380928,23040,-357888,12
737,48,21,9,0.0611464968,0.938853503,222.0288284,255.9893992,401.3188602,265.2708333,785,151.2524085,1570,-377344,24576,-352768,12
735,36,22,8,0.046692607,0.953307393,219.6220904,266.985277,389.3319728,317.9722222,771,135.7394366,1542,-376320,18432,-357888,12
725,48,21,9,0.0620957309,0.937904269,217.3918544,276.8972362,393.8482759,283.5625,773,13.54476958,1546,-371200,24576,-346624,12
723,42,22,8,0.0549019608,0.945098039,216.2647082,273.0736488,388.2365145,292.8571429,765,96.22641509,1530,-370176,21504,-348672,12
744,48,22,8,0.0606060606,0.939393939,223.6143247,260.1630065,405.2876344,260.2916667,792,164.3153527,1584,-380928,24576,-356352,12
736,49,21,9,0.0624203822,0.937579618,222.1063708,253.9612287,401.4565217,265.9795918,785,148.1132075,1570,-376832,25088,-351744,12
738,48,21,9,0.0610687023,0.938931298,221.5164446,262.5373485,402.3373984,257.625,786,144.2201835,1572,-377856,24576,-353280,12
737,45,22,8,0.057544757,0.942455243,221.3841445,267.4218049,397.8208955,287.9777778,782,131.4285714,1564,-377344,23040,-354304,12
733,46,22,8,0.0590500642,0.940949936,220.9445211,261.8258316,396.0750341,293.1956522,779,127.4959083,1558,-375296,23552,-351744,12
735,39,22,8,0.0503875969,0.949612403,219.9326026,276.664825,390.1564626,337.4358974,774,13.66043064,1548,-376320,19968,-356352,12
743,47,22,8,0.0594936709,0.940506329,223.0951617,269.8648053,402.897712,278.5531915,790,159.5959596,1580,-380416,24064,-356352,12
1677,77,23,7,0.0438996579,0.956100342,499.9673763,581.9430841,888.2468694,643.4415584,1754,368.487395,3508,-858624,39424,-819200,12
1683,66,23,7,0.0377358491,0.962264151,500.9098792,589.9635714,878.6518122,781.8787879,1749,159.144677,3498,-861696,33792,-827904,12
1680,71,23,7,0.0405482581,0.959451742,500.8351541,581.4959861,882.8928571,712.9014085,1751,30.67624387,3502,-860160,36352,-823808,12
1687,79,23,7,0.0447338618,0.955266138,504.1720811,558.2394051,895.6206283,624.6708861,1766,205.3488372,3532,-863744,40448,-823296,12
1720,83,23,7,0.0460343871,0.953965613,513.2030204,607.7695327,913.294186,667.9518072,1803,478.2493369,3606,-880640,42496,-838144,12
1700,78,23,7,0.0438695163,0.956130484,506.7954224,601.703382,899.0394118,681.5897436,1778,232.7225131,3556,-870400,39936,-830464,12
1683,76,22,8,0.0432063673,0.956793633,502.2872356,580.465788,889.2388592,675.4078947,1759,214.7741148,3518,-861696,38912,-822784,12
1689,76,23,7,0.0430594901,0.95694051,503.4309842,583.9576223,893.3676732,652.5921053,1765,435.8024691,3530,-864768,38912,-825856,12
1690,84,23,7,0.0473506201,0.95264938,505.2635099,574.3784035,900.560355,624.7380952,1774,393.3481153,3548,-865280,43008,-822272,12
1687,79,23,7,0.0447338618,0.955266138,503.7100702,573.0196469,895.0201541,637.4936709,1766,264.7676162,3532,-863744,40448,-823296,12
1679,84,23,7,0.0476460579,0.952353942,501.9786011,570.6975546,895.2692079,616.7738095,1763,265.112782,3526,-859648,43008,-816640,12
1690,84,23,7,0.0473506201,0.95264938,504.253096,600.3338848,899.6289941,643.4761905,1774,316.7857143,3548,-865280,43008,-822272,12
1744,80,22,8,0.0438596491,0.956140351,521.0987771,585.8553948,923.3365826,676.2625,1824,340.9345794,3648,-892928,40960,-851968,12
1689,85,23,7,0.0479143179,0.952085682,504.100102,598.7192485,900.0698638,637.7294118,1774,332.2097378,3548,-864768,43520,-821248,12
770,44,22,8,0.0540540541,0.945945946,231.5446357,274.579343,412.4337662,321.1590909,814,15.58789736,1628,-394240,22528,-371712,12
1737,73,22,8,0.0403314917,0.959668508,517.6998616,604.8954709,912.1341393,747.6438356,1810,232.6478149,3620,-889344,37376,-851968,12
1684,68,23,7,0.0388127854,0.961187215,501.4295398,591.2278927,881.2214964,759.5735294,1752,313.4168157,3504,-862208,34816,-827392,12
1742,79,23,7,0.0433827567,0.956617243,520.0631938,588.9630561,921.7663605,673.5949367,1821,280.5855162,3642,-891904,40448,-851456,12
1716,69,23,7,0.0386554622,0.961344538,511.591659,589.7550113,897.3240093,785.4637681,1785,353.4653465,3570,-878592,35328,-843264,12
1690,70,23,7,0.0397727273,0.960227273,503.2505185,596.1921783,886.2852071,740.8285714,1760,400,3520,-865280,35840,-829440,12
718,48,23,7,0.0626631854,0.937336815,216.5926015,260.4633658,390.2047354,283.2083333,766,138.517179,1532,-367616,24576,-343040,12
719,34,23,7,0.0451527224,0.954847278,214.6929804,259.2389664,380.108484,311.2647059,753,174.3055556,1506,-368128,17408,-350720,12
728,47,23,7,0.0606451613,0.939354839,219.5942293,254.1841617,395.3489011,274.1702128,775,160.1239669,1550,-372736,24064,-348672,12
734,35,23,7,0.0455136541,0.954486346,219.2438506,265.7315878,387.9782016,322.5428571,769,147.8846154,1538,-375808,17920,-357888,12
718,37,23,7,0.0490066225,0.950993377,214.714017,268.5367623,380.54039,328.7027027,755,123.1647635,1510,-367616,18944,-348672,12
775,48,23,7,0.0583232078,0.941676792,234.8894118,254.9049251,418.5806452,305.75,823,111.5176152,1646,-396800,24576,-372224,12
294,18,23,7,0.0576923077,0.942307692,89.01924942,81.37157571,160.5102041,91,312,39.94878361,624,-150528,9216,-141312,12
717,46,23,7,0.0602883355,0.939711664,216.1577396,252.7737179,388.958159,273.5434783,763,228.4431138,1526,-367104,23552,-343552,12
719,38,23,7,0.0501981506,0.949801849,215.2547553,263.0138606,382.7969402,307.1578947,757,159.7046414,1514,-368128,19456,-348672,12
740,39,23,7,0.0500641849,0.949935815,221.620108,269.7871784,393.7689189,318.4871795,779,138.6120996,1558,-378880,19968,-358912,12
721,47,23,7,0.0611979167,0.938802083,217.3273984,261.7408845,390.850208,287.0851064,768,105.6396149,1536,-369152,24064,-345088,12
730,41,23,7,0.0531776913,0.946822309,219.009289,266.6930472,390.369863,308.195122,771,92.11469534,1542,-373760,20992,-352768,12
715,46,23,7,0.0604467806,0.939553219,215.0585282,249.3471978,389.2083916,253.4130435,761,248.6928105,1522,-366080,23552,-342528,12
786,50,22,8,0.0598086124,0.940191388,237.6886568,261.4483995,426.6183206,290.88,836,120.984081,1672,-402432,25600,-376832,12
784,50,23,7,0.0599520384,0.940047962,238.340667,242.9119849,425.5841837,290.74,834,60.34732272,1668,-401408,25600,-375808,12
722,48,22,8,0.0623376623,0.937662338,217.8225373,253.9406637,393.232687,269.1875,770,128.5475793,1540,-369664,24576,-345088,12
724,36,23,7,0.0473684211,0.952631579,216.2523439,271.4918149,382.6381215,337.5,760,161.7021277,1520,-370688,18432,-352256,12
782,50,23,7,0.0600961538,0.939903846,237.4008314,260.3247272,422.898977,316.42,832,95.74223245,1664,-400384,25600,-374784,12
713,50,23,7,0.0655307995,0.934469201,214.8834697,254.8427405,390.8190743,256.24,763,11.93306225,1526,-365056,25600,-339456,12
702,44,23,7,0.0589812332,0.941018767,210.4856709,236.8402396,382.7891738,225.2954545,746,11.97816313,1492,-359424,22528,-336896,12
809,48,23,7,0.0560093349,0.943990665,242.5462458,301.218832,434.908529,329.4166667,857,215.3266332,1714,-414208,24576,-389632,12
799,44,22,8,0.0521945433,0.947805457,239.2046284,288.7722801,427.9173967,314.5454545,843,154.9632353,1686,-409088,22528,-386560,12
814,50,22,8,0.0578703704,0.94212963,243.5040124,306.5267629,439.9668305,310.94,864,75.32693984,1728,-416768,25600,-391168,12
784,44,23,7,0.0531400966,0.946859903,235.2511043,281.1251559,419.9540816,317.3181818,828,140.8163265,1656,-401408,22528,-378880,12
820,50,23,7,0.0574712644,0.942528736,245.6541947,297.5934011,443.7170732,300.74,870,88.68501529,1740,-419840,25600,-394240,12
794,47,23,7,0.0558858502,0.94411415,238.5423498,280.4754274,427.9722922,303.212766,841,70.02497918,1682,-406528,24064,-382464,12
941,50,22,8,0.0504540868,0.949545913,284.3988772,299.6585931,501.1934113,398.26,991,192.8015564,1982,-481792,25600,-456192,12
788,47,23,7,0.0562874251,0.943712575,235.523375,282.8572656,426.6332487,273.2553191,835,106.3694268,1670,-403456,24064,-379392,12
941,50,23,7,0.0504540868,0.949545913,283.826076,310.3095126,501.0967056,400.08,991,147.6900149,1982,-481792,25600,-456192,12
809,42,23,7,0.0493537015,0.950646298,241.4991364,307.1405952,429.6081582,356.5,851,227.540107,1702,-414208,21504,-392704,12
871,54,23,7,0.0583783784,0.941621622,263.7545467,287.579361,470.749713,338,925,138.4730539,1850,-445952,27648,-418304,12
804,48,22,8,0.0563380282,0.943661972,242.7441994,284.4807335,430.9216418,352.4375,852,150.2645503,1704,-411648,24576,-387072,12
800,38,23,7,0.0453460621,0.954653938,239.5346216,281.0134016,422.29375,360.6842105,838,215.4241645,1676,-409600,19456,-390144,12
805,41,23,7,0.048463357,0.951536643,240.5657359,297.5516552,427.3093168,348.7073171,846,104.5735476,1692,-412160,20992,-391168,12
795,39,23,7,0.0467625899,0.95323741,237.3985019,275.6531208,423.3056604,299.1538462,834,152.189781,1668,-407040,19968,-387072,12
954,55,23,7,0.0545094153,0.945490585,290.3106334,294.465511,509.9633124,418.9090909,1009,114.5289444,2018,-488448,28160,-460288,12
945,55,23,7,0.055,0.945,286.6550385,300.66096,506.9269841,390.0727273,1000,180.5054152,2000,-483840,28160,-455680,12
797,41,23,7,0.0489260143,0.951073986,238.673551,277.9643325,424.8770389,314.9756098,838,148.8454707,1676,-408064,20992,-387072,12
945,50,23,7,0.0502512563,0.949748744,285.1358364,302.5761266,504.0179894,384.26,995,135.9289617,1990,-483840,25600,-458240,12
796,49,21,9,0.0579881657,0.942011834,237.9353432,287.7231897,432.1871859,273.755102,845,12.38821287,1690,-407552,25088,-382464,12
793,50,22,8,0.059311981,0.940688019,240.7384598,262.0859126,428.297604,322.12,843,131.1041991,1686,-406016,25600,-380416,12
805,49,22,8,0.0573770492,0.942622951,241.3108784,294.9034432,434.8869565,306.1428571,854,181.7021277,1708,-412160,25088,-387072,12
806,40,21,9,0.0472813239,0.952718676,240.95914,290.2375536,427.6315136,340.25,846,126.4573991,1692,-412672,20480,-392192,12
812,49,22,8,0.0569105691,0.943089431,245.5166759,270.6296344,437.7746305,318.7346939,861,147.9381443,1722,-415744,25088,-390656,12
791,39,22,8,0.0469879518,0.953012048,237.15613,272.944988,419.3931732,336.5384615,830,87.83068783,1660,-404992,19968,-385024,12
803,39,22,8,0.0463182898,0.95368171,239.5924563,286.5573183,426.5790785,316.9230769,842,113.3243607,1684,-411136,19968,-391168,12
809,50,22,8,0.0582072177,0.941792782,245.3689416,264.6881403,436.6266996,322.78,859,190.4656319,1718,-414208,25600,-388608,12
802,43,22,8,0.050887574,0.949112426,239.9952195,288.8939689,428.6159601,318.255814,845,135.6340289,1690,-410624,22016,-388608,12
822,48,22,8,0.0551724138,0.944827586,246.4491097,302.490099,441.6155718,330.7708333,870,73.54184277,1740,-420864,24576,-396288,12
809,49,22,8,0.0571095571,0.942890443,242.6403499,300.1878754,435.9579728,322.877551,858,195,1716,-414208,25088,-389120,12
795,48,21,9,0.0569395018,0.943060498,237.7878595,289.9063898,430.1924528,286.3125,843,115.3214774,1686,-407040,24576,-382464,12
811,42,22,8,0.0492379836,0.950762016,242.7695196,298.8715331,430.2244143,364.7380952,853,87.04081633,1706,-415232,21504,-393728,12
793,40,21,9,0.0480192077,0.951980792,237.4458565,284.906115,420.5725095,346.175,833,131.1811024,1666,-406016,20480,-385536,12
810,50,22,8,0.0581395349,0.941860465,242.2274619,301.210361,438.7234568,297.28,860,183.3688699,1720,-414720,25600,-389120,12
801,36,22,8,0.0430107527,0.956989247,239.2721694,273.1361077,423.1498127,326.6666667,837,177.3305085,1674,-410112,18432,-391680,12
810,48,22,8,0.0559440559,0.944055944,242.5463552,303.8571142,435.6777778,325.25,858,125.0728863,1716,-414720,24576,-390144,12
802,50,22,8,0.058685446,0.941314554,243.3862426,263.8685703,432.8428928,324.76,852,147.1502591,1704,-410624,25600,-385024,12
796,43,22,8,0.0512514899,0.94874851,239.954586,255.5366023,426.0879397,307.3023256,839,200.2386635,1678,-407552,22016,-385536,12
797,41,22,8,0.0489260143,0.951073986,237.9773858,285.7976262,425.3337516,306.097561,838,143.003413,1676,-408064,20992,-387072,12
799,41,22,8,0.0488095238,0.951190476,239.8755064,277.953135,424.4055069,344.3902439,840,111.7021277,1680,-409088,20992,-388096,12
780,53,24,6,0.0636254502,0.93637455,235.9385334,299.2784404,417.0679487,416,833,176.1099366,1666,-399360,27136,-372224,12
779,53,23,7,0.0637019231,0.936298077,235.68587,297.6977126,417.9383825,395.3584906,832,162.5,1664,-398848,27136,-371712,12
774,52,23,7,0.0629539952,0.937046005,234.0106097,296.7215488,413.4819121,413.7692308,826,147.763864,1652,-396288,26624,-369664,12
778,52,23,7,0.0626506024,0.937349398,235.1509884,297.3853833,413.9511568,438.6730769,830,84.86707566,1660,-398336,26624,-371712,12
782,54,24,6,0.0645933014,0.935406699,236.6542628,300.2396671,419.9603581,397.3518519,836,96.87137891,1672,-400384,27648,-372736,12
768,60,22,8,0.0724637681,0.927536232,233.1805314,302.7683653,416.5950521,387.6833333,828,138,1656,-393216,30720,-362496,12
772,61,23,7,0.0732292917,0.926770708,233.2781325,309.8362642,422.3367876,349.4590164,833,52.29127433,1666,-395264,31232,-364032,12
774,51,24,6,0.0618181818,0.938181818,233.7700849,296.6093915,412.1925065,425.254902,825,177.0386266,1650,-396288,26112,-370176,12
773,59,22,8,0.0709134615,0.929086538,234.5327309,300.3047375,420.2587322,367.2542373,832,150.4520796,1664,-395776,30208,-365568,12
826,59,24,6,0.0666666667,0.933333333,250.2301834,319.5254129,444.2372881,425.6779661,885,103.5087719,1770,-422912,30208,-392704,12
769,51,24,6,0.062195122,0.937804878,232.3090889,294.9032293,409.5617685,424.6470588,820,134.2062193,1640,-393728,26112,-367616,12
764,53,24,6,0.064871481,0.935128519,231.103985,295.7429187,408.367801,418.1132075,817,58.14946619,1634,-391168,27136,-364032,12
814,57,24,6,0.0654420207,0.934557979,246.680821,311.5038949,435.7837838,439.0877193,871,115.5172414,1742,-416768,29184,-387584,12
768,58,23,7,0.0702179177,0.929782082,232.5877189,302.9978421,416.3984375,375.1206897,826,111.9241192,1652,-393216,29696,-363520,12
706,46,23,7,0.0611702128,0.938829787,211.9341626,269.9854929,382.1954674,289.0869565,752,23.46333853,1504,-361472,23552,-337920,12
771,53,24,6,0.0643203883,0.935679612,233.0079719,299.7111093,412.9520104,405.9245283,824,127.5541796,1648,-394752,27136,-367616,12
818,68,23,7,0.0767494357,0.923250564,248.9182977,326.9771057,444.1919315,435.1764706,886,15.8468968,1772,-418816,34816,-384000,12
783,59,23,7,0.0700712589,0.929928741,237.4290588,307.196922,423.3448276,397.0169492,842,112.7175368,1684,-400896,30208,-370688,12
795,62,24,6,0.0723453909,0.927654609,240.7135062,286.6892777,439.8402516,290,857,67.48031496,1714,-407040,31744,-375296,12
669,42,23,7,0.05907173,0.94092827,200.3553609,238.4988163,363.9058296,230.0714286,711,11.52163345,1422,-342528,21504,-321024,12
1714,171,20,10,0.0907161804,0.90928382,535.2140653,605.9685648,958.2240373,790.4035088,1885,248.6807388,3770,-877568,87552,-790016,13
1795,183,20,10,0.0925176946,0.907482305,561.5843496,629.1261181,1007.626184,811.704918,1978,244.499382,3956,-919040,93696,-825344,13
7433,1095,20,10,0.128400563,0.871599437,2426.897818,2563.118734,4153.622091,5017.153425,8528,150.1144165,17056,-3805696,560640,-3245056,13
1689,172,20,10,0.0924234283,0.907576572,530.3996035,567.1237099,950.0432208,744,1861,287.191358,3722,-864768,88064,-776704,13
7828,1185,20,10,0.131476756,0.868523244,2556.843778,2676.341046,4356.389755,5501.9173,9013,170.8625592,18026,-4007936,606720,-3401216,13
8612,1245,20,10,0.126306178,0.873693822,2846.264407,2791.72823,4858.563284,5416.229719,9857,482.00489,19714,-4409344,637440,-3771904,13
8562,1216,20,10,0.12436081,0.87563919,2806.431754,2831.281617,4787.011913,5611.130757,9778,184.490566,19556,-4383744,622592,-3761152,13
1635,175,20,10,0.0966850829,0.903314917,513.570242,576.2569437,922.3370031,748.1942857,1810,301.6666667,3620,-837120,89600,-747520,13
1670,188,20,10,0.101184069,0.898815931,528.0428867,593.8148829,941.9862275,818.5851064,1858,32.56221521,3716,-855040,96256,-758784,13
1701,171,20,10,0.0913461538,0.908653846,533.3023532,571.6719793,955.9100529,743.4210526,1872,307.3891626,3744,-870912,87552,-783360,13
1693,172,20,10,0.0922252011,0.907774799,530.046461,579.7193409,952.6969876,739.122093,1865,218.8967136,3730,-866816,88064,-778752,13
1717,184,21,9,0.0967911625,0.903208837,538.6849137,614.2788296,967.4740827,797.2717391,1901,199.2662474,3802,-879104,94208,-784896,13
1722,198,20,10,0.103125,0.896875,543.3918253,632.7115871,971.7055749,863.0454545,1920,360.9022556,3840,-881664,101376,-780288,13
7455,985,20,10,0.116706161,0.883293839,2463.215791,2222.202796,4212.443327,4281.477157,8440,247.3622509,16880,-3816960,504320,-3312640,13
1729,177,20,10,0.092864638,0.907135362,540.5848032,618.9545767,968.0410642,811.4576271,1906,191.750503,3812,-885248,90624,-794624,13
8281,1379,20,10,0.142753623,0.857246377,2777.962122,2768.570597,4725.138631,5463.203046,9660,186.9195046,19320,-4239872,706048,-3533824,13
1738,175,20,10,0.0914793518,0.908520648,542.6241086,612.0997064,974.9056387,779.1714286,1913,180.8128544,3826,-889856,89600,-800256,13
2441,194,20,10,0.0736242884,0.926375712,750.9160552,760.8040273,1350.908644,903.9278351,2635,40.12486676,5270,-1249792,99328,-1150464,13
1561,193,21,9,0.110034208,0.889965792,500.2528262,510.1007487,902.434337,675.8290155,1754,26.14788312,3508,-799232,98816,-700416,13
333,57,20,10,0.146153846,0.853846154,109.797366,124.2513165,200.1261261,168.4736842,390,18.65136298,780,-170496,29184,-141312,13
2756,210,23,7,0.0708024275,0.929197572,841.9231819,978.059858,1506.126996,1186.547619,2966,383.6998706,5932,-1411072,107520,-1303552,13
8601,1246,21,9,0.126536001,0.873463999,2849.273967,2680.39147,4816.28613,5667.536918,9847,650.3963012,19694,-4403712,637952,-3765760,13
2822,211,23,7,0.0695680844,0.930431916,859.5722792,1017.213021,1540.111623,1207.895735,3033,349.0218642,6066,-1444864,108032,-1336832,13
2749,206,23,7,0.0697123519,0.930287648,839.3381058,983.5855516,1497.062568,1223.616505,2955,359.4890511,5910,-1407488,105472,-1302016,13
8647,1211,23,7,0.12284439,0.87715561,2851.52891,2718.420863,4839.212444,5574.187448,9858,696.1864407,19716,-4427264,620032,-3807232,13
2753,212,23,7,0.0715008432,0.928499157,840.8482892,997.2114066,1502.674174,1227.514151,2965,316.098081,5930,-1409536,108544,-1300992,13
8536,1316,21,9,0.133576939,0.866423061,2831.878006,2771.839347,4793.986059,5786.028116,9852,602.9375765,19704,-4370432,673792,-3696640,13
2746,216,23,7,0.0729237002,0.9270763,840.3338911,969.349913,1506.480335,1163.925926,2962,367.4937965,5924,-1405952,110592,-1295360,13
2759,217,23,7,0.0729166667,0.927083333,846.3480125,951.5645053,1513.504531,1170.585253,2976,276.5799257,5952,-1412608,111104,-1301504,13
2740,213,23,7,0.0721300373,0.927869963,837.4896299,979.8508002,1499.708759,1184.877934,2953,361.002445,5906,-1402880,109056,-1293824,13
2805,231,23,7,0.0760869565,0.923913043,864.2724336,973.6579386,1540.438503,1252.103896,3036,266.5496049,6072,-1436160,118272,-1317888,13
2758,238,21,9,0.0794392523,0.920560748,847.8965124,991.4845421,1524.924946,1192.281513,2996,354.1371158,5992,-1412096,121856,-1290240,13
2757,220,22,8,0.0738998992,0.926100101,847.7943412,940.9336432,1513.426188,1182.895455,2977,250.3784693,5954,-1411584,112640,-1298944,13
2738,210,23,7,0.0712347354,0.928765265,835.6942903,990.7688384,1495.342586,1202.752381,2948,401.6348774,5896,-1401856,107520,-1294336,13
3280,257,23,7,0.0726604467,0.927339553,1006.6639,1135.673876,1795.667683,1428.649805,3537,443.2330827,7074,-1679360,131584,-1547776,13
1175,161,23,7,0.120508982,0.879491018,381.8149718,411.3916396,672.7429787,637.5341615,1336,23.41395023,2672,-601600,82432,-519168,13
8497,1058,21,9,0.110727368,0.889272632,2756.98788,2740.663925,4731.824997,5148.840265,9555,171.4208827,19110,-4350464,541696,-3808768,13
3318,232,23,7,0.0653521127,0.934647887,1008.866434,1189.35472,1796.766426,1471.353448,3550,344.3258972,7100,-1698816,118784,-1580032,13
2601,210,23,7,0.0747065101,0.92529349,799.6128147,808.4108091,1444.163399,933.3190476,2811,44.05265632,5622,-1331712,107520,-1224192,13
3641,293,23,7,0.0744789019,0.925521098,1131.041069,1144.51821,1993.122494,1649.098976,3934,59.00704965,7868,-1864192,150016,-1714176,13
951,106,23,7,0.100283822,0.899716178,300.1979291,339.6359337,536.1188223,465.1320755,1057,120.1136364,2114,-486912,54272,-432640,13
946,100,23,7,0.0956022945,0.904397706,297.2447088,339.6843857,528.5116279,476.09,1046,166.5605096,2092,-484352,51200,-433152,13
7974,1589,23,7,0.166161246,0.833838754,2751.521056,2636.472024,4607.363306,5658.370673,9563,170.4330779,19126,-4082688,813568,-3269120,13
908,93,23,7,0.0929070929,0.907092907,283.3370385,338.2347854,503.2599119,478.9354839,1001,156.40625,2002,-464896,47616,-417280,13
941,99,23,7,0.0951923077,0.904807692,294.2534455,348.7494317,525.2284803,475.5555556,1040,187.7256318,2080,-481792,50688,-431104,13
958,113,23,7,0.10550887,0.89449113,305.4418393,337.3696676,539.8632568,503.2477876,1071,19.07051282,2142,-490496,57856,-432640,13
7078,1407,23,7,0.165822039,0.834177961,2424.895699,2379.063247,4066.906047,5128.851457,8485,149.8322444,16970,-3623936,720384,-2903552,13
929,99,23,7,0.0963035019,0.903696498,291.3214791,341.6839905,518.1776103,479.989899,1028,178.4722222,2056,-475648,50688,-424960,13
5212,974,23,7,0.157452312,0.842547688,1753.616726,1768.634996,2953.166539,3844.442505,6186,111.3390929,12372,-2668544,498688,-2169856,13
928,109,23,7,0.105110897,0.894889103,292.8204817,349.390722,521.4590517,498.0642202,1037,18.11670161,2074,-475136,55808,-419328,13
911,100,23,7,0.0989119683,0.901088032,287.4465961,324.1150314,512.0461032,450.92,1011,140.0277008,2022,-466432,51200,-415232,13
6647,1401,22,8,0.174080517,0.825919483,2297.430498,2243.246737,3839.620731,4901.653819,8048,144.7482014,16096,-3403264,717312,-2685952,13
931,105,21,9,0.101351351,0.898648649,293.8180038,335.5138044,525.6455424,455.1428571,1036,142.5034388,2072,-476672,53760,-422912,13
926,103,23,7,0.100097182,0.899902818,292.4586284,328.2591514,522.3088553,449.2912621,1029,202.9585799,2058,-474112,52736,-421376,13
949,115,21,9,0.108082707,0.891917293,303.0579875,334.2843176,538.975764,479.0608696,1064,100.0940734,2128,-485888,58880,-427008,13
927,107,23,7,0.103481625,0.896518375,293.7596369,330.9078039,524.2966559,458.6168224,1034,102.173913,2068,-474624,54784,-419840,13
918,101,23,7,0.0991167812,0.900883219,289.5133677,329.3317153,515.4466231,460.4950495,1019,92.30072464,2038,-470016,51712,-418304,13
928,100,21,9,0.0972762646,0.902723735,290.9862669,341.7345555,519.8814655,464.56,1028,106.9719043,2056,-475136,51200,-423936,13
942,103,22,8,0.0985645933,0.901435407,295.5388258,351.1444771,526.5382166,490.6407767,1045,190.3460838,2090,-482304,52736,-429568,13
1881,180,23,7,0.0873362445,0.912663755,584.64475,685.1820349,1040.867092,927.8888889,2061,32.35478807,4122,-963072,92160,-870912,13
9229,542,23,7,0.0554702692,0.944529731,2803.146602,2900.145533,4949.063387,3812.177122,9771,172.6630147,19542,-4725248,277504,-4447744,13
9073,458,23,7,0.0480537194,0.951946281,2724.081902,3235.018557,4778.437011,4519.622271,9531,328.2024793,19062,-4645376,234496,-4410880,13
9144,475,23,7,0.0493814326,0.950618567,2771.853927,2705.963633,4858.391295,3878.442105,9619,287.0486422,19238,-4681728,243200,-4438528,13
9021,475,23,7,0.0500210615,0.949978939,2722.440623,3045.62744,4770.948897,4322.16,9496,164.0069085,18992,-4618752,243200,-4375552,13
9133,466,23,7,0.0485467236,0.951453276,2762.287607,2822.278959,4840.345998,4009.270386,9599,372.0542636,19198,-4676096,238592,-4437504,13
9232,507,21,9,0.0520587329,0.947941267,2796.113628,2871.950046,4928.997942,3795.70217,9739,329.6885579,19478,-4726784,259584,-4467200,13
9232,514,23,7,0.0527395855,0.947260415,2797.696566,2917.347276,4927.413237,3905.159533,9746,364.064251,19492,-4726784,263168,-4463616,13
9139,448,23,7,0.0467299468,0.953270053,2742.675256,3226.516266,4803.861473,4592.830357,9587,365.0799695,19174,-4679168,229376,-4449792,13
9418,536,23,7,0.0538476994,0.946152301,2854.007072,2939.87824,5046.927904,3757.589552,9954,838.5846672,19908,-4822016,274432,-4547584,13
9089,466,21,9,0.0487702773,0.951229723,2747.82718,2871.80462,4812.81131,4099.030043,9555,366.6538757,19110,-4653568,238592,-4414976,13
9250,523,21,9,0.0535147856,0.946485214,2799.648708,3058.69151,4934.58573,4045.378585,9773,355.2526354,19546,-4736000,267776,-4468224,13
9227,461,23,7,0.0475846408,0.952415359,2791.672022,2790.291906,4882.154763,4090.832972,9688,332.5780982,19376,-4724224,236032,-4488192,13
9190,522,23,7,0.0537479407,0.946252059,2790.907963,2772.626598,4922.437867,3695.639847,9712,335.359116,19424,-4705280,267264,-4438016,13
9120,448,23,7,0.0468227425,0.953177258,2751.553267,2867.804302,4821.088596,4039.660714,9568,328.3459163,19136,-4669440,229376,-4440064,13
9256,503,23,7,0.0515421662,0.948457834,2797.876221,3043.630751,4923.238224,4084.347913,9759,368.403171,19518,-4739072,257536,-4481536,13
9156,455,23,7,0.0473415878,0.952658412,2759.472527,3025.999319,4828.204456,4359.178022,9611,310.5331179,19222,-4687872,232960,-4454912,13
9454,509,23,7,0.0510890294,0.948910971,2857.376194,3105.162584,5023.313201,4214.662083,9963,991.3432836,19926,-4840448,260608,-4579840,13
1707,194,23,7,0.102051552,0.897948448,546.8801179,553.2676127,963.4094903,841.8092784,1901,28.94336175,3802,-873984,99328,-774656,13
2749,298,23,7,0.0978011159,0.902198884,872.8928319,935.8379648,1532.114223,1449.147651,3047,44.75616921,6094,-1407488,152576,-1254912,13
1589,138,23,7,0.0799073538,0.920092646,492.5978135,523.1484418,881.2133417,665.7971014,1727,26.04826546,3454,-813568,70656,-742912,13
1390,152,23,7,0.0985732815,0.901426719,435.2254661,525.9661598,775.2446043,737.2565789,1542,184.6706587,3084,-711680,77824,-633856,13
1311,131,23,7,0.0908460472,0.909153953,409.4737407,475.9420871,726.6460717,670,1442,189.2388451,2884,-671232,67072,-604160,13
1362,151,23,7,0.0998017184,0.900198282,428.4274748,499.2681886,765.5220264,680.1324503,1513,121.7216412,3026,-697344,77312,-620032,13
5610,815,23,7,0.126848249,0.873151751,1850.057804,1810.112066,3140.797861,3709.998773,6425,167.2306091,12850,-2872320,417280,-2455040,13
5398,721,23,7,0.117829711,0.882170289,1771.426369,1702.65592,3022.765469,3338.768377,6119,184.0854392,12238,-2763776,369152,-2394624,13
5666,861,23,7,0.13191359,0.86808641,1886.066443,1812.690718,3197.962054,3698.577236,6527,184.1704289,13054,-2900992,440832,-2460160,13
1372,137,23,7,0.0907886017,0.909211398,428.1055297,502.0888618,759.8374636,706.5547445,1509,164.0217391,3018,-702464,70144,-632320,13
7112,1139,21,9,0.138043873,0.861956127,2394.454472,2246.712144,4051.674494,4590.093942,8251,205.2998258,16502,-3641344,583168,-3058176,13
1362,147,23,7,0.097415507,0.902584493,426.9589773,505.3393863,761.0947137,698.5306122,1509,256.196944,3018,-697344,75264,-622080,13
1343,146,23,7,0.0980523842,0.901947616,421.0595663,500.3001657,750.8064036,691.5890411,1489,248.9966555,2978,-687616,74752,-612864,13
1357,141,21,9,0.0941255007,0.905874499,425.1046967,488.5671265,758.7781872,660.2056738,1498,150.7042254,2996,-694784,72192,-622592,13
1330,146,23,7,0.0989159892,0.901084011,419.5920099,472.5694112,747.9601504,652.3219178,1476,204.1493776,2952,-680960,74752,-606208,13
5457,843,23,7,0.133809524,0.866190476,1809.162822,1795.333168,3070.818398,3666.303677,6300,212.0498149,12600,-2793984,431616,-2362368,13
1372,152,23,7,0.0997375328,0.900262467,429.4989925,524.48768,764.6188047,743.375,1524,26.78853929,3048,-702464,77824,-624640,13
1862,152,21,9,0.0754716981,0.924528302,570.4536483,691.8386768,1016.691192,894.9078947,2014,116.6184134,4028,-953344,77824,-875520,13
5733,891,23,7,0.13451087,0.86548913,1915.026161,1817.204291,3235.41671,3808.480359,6624,146.4838567,13248,-2935296,456192,-2479104,13
1486,161,23,7,0.0977534912,0.902246509,470.5782398,515.2753692,829.6944818,771.4409938,1647,214.1742523,3294,-760832,82432,-678400,13
5540,811,23,7,0.127696426,0.872303574,1847.35508,1705.86225,3132.804332,3471.07275,6351,118.6437512,12702,-2836480,415232,-2421248,13
5736,851,23,7,0.129193867,0.870806133,1901.848106,1842.367459,3230.171722,3724.222092,6587,161.130137,13174,-2936832,435712,-2501120,13
1352,138,23,7,0.0926174497,0.90738255,423.7621847,482.9573388,752.3727811,678.1666667,1490,248.3333333,2980,-692224,70656,-621568,13
1152,137,22,8,0.106283941,0.893716059,365.6503342,421.3851063,648.4079861,616.3430657,1289,126.9950739,2578,-589824,70144,-519680,13
1159,138,22,8,0.106399383,0.893600617,367.9613249,422.1382309,654.2786885,604.6666667,1297,126.1673152,2594,-593408,70656,-522752,13
5502,844,22,8,0.132997164,0.867002836,1832.201139,1786.921673,3117.000545,3541.817536,6346,149.5992456,12692,-2817024,432128,-2384896,13
1006,117,20,10,0.104185218,0.895814782,315.4115309,384.9404657,569.8976143,494.0940171,1123,46.81117132,2246,-515072,59904,-455168,13
5566,867,22,8,0.134773822,0.865226178,1856.408232,1823.880174,3163.309019,3561.687428,6433,117.1553451,12866,-2849792,443904,-2405888,13
1134,137,22,8,0.107789142,0.892210858,360.4963232,414.8206935,639.8465608,604.1605839,1271,179.2665726,2542,-580608,70144,-510464,13
1217,142,22,8,0.104488595,0.895511405,388.3905036,422.7182137,684.1857025,644.1267606,1359,129.9235182,2718,-623104,72704,-550400,13
1135,140,22,8,0.109803922,0.890196078,362.0451585,409.1483012,645.0528634,580.8214286,1275,133.6477987,2550,-581120,71680,-509440,13
8175,1445,20,10,0.1502079,0.8497921,2767.732676,2750.73646,4702.672661,5420.526644,9620,167.7419355,19240,-4185600,739840,-3445760,13
7335,1330,21,9,0.153491056,0.846508944,2517.380523,2348.040293,4241.562372,4837.281955,8665,153.4443067,17330,-3755520,680960,-3074560,13
1170,134,22,8,0.102760736,0.897239264,370.565946,424.0379423,653.8504274,640.7089552,1304,213.4206219,2608,-599040,68608,-530432,13
1200,165,20,10,0.120879121,0.879120879,390.7205902,407.3979508,694.7091667,597.8424242,1365,144.2917548,2730,-614400,84480,-529920,13
1170,139,20,10,0.10618793,0.89381207,372.7482189,411.8180372,663.3991453,584.3021583,1309,115.840708,2618,-599040,71168,-527872,13
5830,998,20,10,0.146162859,0.853837141,1975.562105,1871.008409,3330.65283,3904.308617,6828,226.0178749,13656,-2984960,510976,-2473984,13
69,11,21,9,0.1375,0.8625,22.32506971,17.51599033,43.62318841,20.90909091,80,2.538876547,160,-35328,5632,-29696,13
1255,148,22,8,0.105488239,0.894511761,401.1289956,435.4968247,705.3721116,673.4054054,1403,116.7221298,2806,-642560,75776,-566784,13
5506,821,20,10,0.12976134,0.87023866,1830.64234,1757.24161,3111.008536,3519.384896,6327,174.6824959,12654,-2819072,420352,-2398720,13
1160,134,22,8,0.103554869,0.896445131,367.6719613,417.0768435,653.7551724,593.3507463,1294,104.947283,2588,-593920,68608,-525312,13
2005,196,22,8,0.0890504316,0.910949568,625.6727842,723.0714074,1108.234414,1026.994898,2201,29.76335362,4402,-1026560,100352,-926208,13
1009,115,22,8,0.102313167,0.897686833,321.9128521,330.6193757,573.5540139,465.5130435,1124,17.62031666,2248,-516608,58880,-457728,13
8528,796,23,7,0.0853710854,0.914628915,2637.750626,2890.309402,4537.340174,6003.408291,9324,254.8933844,18648,-4366336,407552,-3958784,13
8537,790,23,7,0.0847003324,0.915299668,2635.41446,3071.13619,4571.033501,5668.626582,9327,338.9171512,18654,-4370944,404480,-3966464,13
8372,760,21,9,0.0832238283,0.916776172,2584.921976,2900.217879,4460.531653,5733.825,9132,278.2449726,18264,-4286464,389120,-3897344,13
8480,795,23,7,0.0857142857,0.914285714,2623.382007,2933.626247,4523.888679,5855.187421,9275,175.9294385,18550,-4341760,407040,-3934720,13
8481,808,23,7,0.0869846054,0.913015395,2624.156546,3004.09789,4538.857328,5759.10396,9289,183.6133623,18578,-4342272,413696,-3928576,13
8429,805,23,7,0.0871778211,0.912822179,2609.411095,2939.53001,4503.180093,5814.521739,9234,283.9483395,18468,-4315648,412160,-3903488,13
8446,814,21,9,0.0879049676,0.912095032,2609.345635,3087.422436,4533.543216,5636.515971,9260,258.7314892,18520,-4324352,416768,-3907584,13
8464,805,23,7,0.0868486352,0.913151365,2612.067545,3085.309333,4536.279891,5672.971429,9269,271.9776995,18538,-4333568,412160,-3921408,13
8543,751,21,9,0.0808048203,0.91919518,2626.096451,3085.653353,4558.69156,5657.740346,9294,295.7047407,18588,-4374016,384512,-3989504,13
8468,777,23,7,0.08404543,0.91595457,2615.455177,3012.162767,4529.998229,5636.563707,9245,301.6313214,18490,-4335616,397824,-3937792,13
8412,731,23,7,0.0799518758,0.920048124,2595.584455,2934.573287,4489.006657,5527.04788,9143,272.5186289,18286,-4306944,374272,-3932672,13
8444,778,22,8,0.0843634786,0.915636521,2603.742715,3054.889867,4519.301161,5612.177378,9222,272.437223,18444,-4323328,398336,-3924992,13
8418,838,23,7,0.0905358686,0.909464131,2599.740385,3058.209937,4507.958541,5839.380668,9256,161.903096,18512,-4310016,429056,-3880960,13
8460,802,22,8,0.0865903693,0.913409631,2618.059028,2963.848379,4521.622813,5790.553616,9262,353.7815126,18524,-4331520,410624,-3920896,13
8451,786,23,7,0.0850925625,0.914907437,2615.218926,2934.39818,4513.318187,5755.28117,9237,302.9517875,18474,-4326912,402432,-3924480,13
8454,801,23,7,0.086547812,0.913452188,2613.368857,3000.543681,4521.324462,5753.886392,9255,293.0652312,18510,-4328448,410112,-3918336,13
8461,779,22,8,0.0843073593,0.915692641,2609.638507,3075.48412,4533.978371,5560.242619,9240,336.1222263,18480,-4332032,398848,-3933184,13
8531,810,21,9,0.0867144845,0.913285515,2636.506851,3019.64794,4559.005275,5850.539506,9341,293.557511,18682,-4367872,414720,-3953152,13
8486,810,21,9,0.0871342513,0.912865749,2627.905468,2952.860741,4533.980792,5848.265432,9296,312.1558093,18592,-4344832,414720,-3930112,13
8488,767,23,7,0.0828741221,0.917125878,2621.336066,2896.775555,4515.301484,5875.177314,9255,286.7988844,18510,-4345856,392704,-3953152,13
1393,151,20,10,0.0977979275,0.902202073,440.2667297,490.5296197,777.7164393,724.3774834,1544,191.3258984,3088,-713216,77312,-635904,13
1399,160,20,10,0.102629891,0.897370109,443.7793051,498.8328728,785.5982845,731.05,1559,27.33648957,3118,-716288,81920,-634368,13
1489,150,20,10,0.091519219,0.908480781,467.604988,518.0297248,828.1356615,739.24,1639,190.5813953,3278,-762368,76800,-685568,13
1396,154,21,9,0.0993548387,0.900645161,442.7475222,478.9012286,785.3094556,686.5779221,1550,123.2114467,3100,-714752,78848,-635904,13
1418,154,20,10,0.0979643766,0.902035623,447.9688851,500.4269226,792.9407616,727.1948052,1572,217.1270718,3144,-726016,78848,-647168,13
1391,153,20,10,0.0990932642,0.900906736,440.438193,488.0205327,778.2221423,720.4771242,1544,235.0076104,3088,-712192,78336,-633856,13
1535,153,20,10,0.0906398104,0.90936019,479.6017439,542.5003678,857.1296417,717.7908497,1688,221.231979,3376,-785920,78336,-707584,13
1464,150,20,10,0.092936803,0.907063197,460.9411803,510.3043885,811.5539617,767.9333333,1614,212.3684211,3228,-749568,76800,-672768,13
1485,152,20,10,0.0928527795,0.907147221,464.7953237,537.1508303,826.4882155,745.8421053,1637,233.1908832,3274,-760320,77824,-682496,13
5105,915,20,10,0.151993355,0.848006645,1675.860279,1850.902766,2865.258178,3820.838251,6020,481.215028,12040,-2613760,468480,-2145280,13
1505,155,20,10,0.093373494,0.906626506,473.5900324,522.6373068,839.4817276,743.2903226,1660,200.2412545,3320,-770560,79360,-691200,13
1346,144,20,10,0.0966442953,0.903355705,421.1963061,496.747145,755.3098068,653.8055556,1490,179.73462,2980,-689152,73728,-615424,13
1457,182,21,9,0.111043319,0.888956681,467.9912742,504.573286,830.564173,735.4285714,1639,124.2608036,3278,-745984,93184,-652800,13
1480,154,20,10,0.094247246,0.905752754,464.7237802,524.9892037,827.2128378,724.1558442,1634,164.2211055,3268,-757760,78848,-678912,13
1545,182,20,10,0.105385061,0.894614939,493.6143968,525.3991458,877.1838188,752.0824176,1727,155.1662174,3454,-791040,93184,-697856,13
1354,135,20,10,0.0906648758,0.909335124,423.8366482,483.148107,749.9446086,695.4074074,1489,159.9355532,2978,-693248,69120,-624128,13
1473,168,20,10,0.1023766,0.8976234,468.0231552,519.1424513,825.712831,779.6785714,1641,137.7833753,3282,-754176,86016,-668160,13
5845,1088,20,10,0.156930622,0.843069378,1970.748887,1997.345767,3327.112233,4218.511029,6933,139.4689197,13866,-2992640,557056,-2435584,13
5618,925,20,10,0.141372459,0.858627541,1873.783903,1879.142482,3178.00356,3842.888649,6543,171.9579501,13086,-2876416,473600,-2402816,13
1570,169,21,9,0.0971822887,0.902817711,497.9013498,535.1313558,876.2821656,811.6390533,1739,143.3635614,3478,-803840,86528,-717312,13
2944,262,23,7,0.0817217717,0.918278228,917.899077,1004.489188,1609.422554,1536.950382,3206,178.5077951,6412,-1507328,134144,-1373184,13
2952,276,23,7,0.0855018587,0.914498141,924.6916554,1003.995667,1618.819106,1568.304348,3228,200.4968944,6456,-1511424,141312,-1370112,13
2907,286,23,7,0.0895709364,0.910429064,913.1039879,1001.915007,1604.755418,1518.171329,3193,237.928465,6386,-1488384,146432,-1341952,13
2938,269,23,7,0.0838790147,0.916120985,918.3241892,1003.244554,1606.419673,1577.572491,3207,119.8430493,6414,-1504256,137728,-1366528,13
7604,1040,23,7,0.120314669,0.879685331,2478.692571,2553.518436,4251.035639,4845.014423,8644,173.5046166,17288,-3893248,532480,-3360768,13
3408,299,21,9,0.0806582142,0.919341786,1057.755781,1200.853236,1858.568369,1801.929766,3707,185.6284427,7414,-1744896,153088,-1591808,13
1600,162,23,7,0.0919409762,0.908059024,500.2564051,580.5068017,888.540625,811.962963,1762,197.5336323,3524,-819200,82944,-736256,13
2981,283,23,7,0.0867034314,0.913296569,936.9895412,995.2099397,1635.656491,1599.250883,3264,154.6186641,6528,-1526272,144896,-1381376,13
2994,293,23,7,0.0891390326,0.910860967,940.3757971,1026.71458,1653.47996,1547.129693,3287,223.3016304,6574,-1532928,150016,-1382912,13
1330,118,20,10,0.0814917127,0.918508287,412.1880716,451.8800641,737.924812,573.1864407,1448,257.6512456,2896,-680960,60416,-620544,13
2972,296,21,9,0.0905752754,0.909424725,932.5726522,1041.698244,1643.311911,1546.023649,3268,185.4710556,6536,-1521664,151552,-1370112,13
6735,939,21,9,0.12236122,0.87763878,2191.252903,2306.696031,3760.617075,4388.944622,7674,179.5507721,15348,-3448320,480768,-2967552,13
2941,279,23,7,0.0866459627,0.913354037,922.1975294,998.4403212,1619.724583,1513.261649,3220,194.9152542,6440,-1505792,142848,-1362944,13
6843,940,23,7,0.12077605,0.87922395,2227.370587,2317.153207,3820.260997,4414.244681,7783,197.0379747,15566,-3503616,481280,-3022336,13
2956,275,23,7,0.0851129681,0.914887032,923.4616882,1024.507648,1622.191137,1549.450909,3231,149.8608534,6462,-1513472,140800,-1372672,13
6726,920,21,9,0.120324353,0.879675647,2193.803708,2248.151563,3759.490782,4291.463043,7646,208.9071038,15292,-3443712,471040,-2972672,13
6951,851,23,7,0.109074596,0.890925404,2254.025788,2224.69718,3873.737736,4128.26322,7802,154.4338876,15604,-3558912,435712,-3123200,13
6677,929,23,7,0.122140415,0.877859585,2175.402327,2271.41519,3732.322151,4315.076426,7606,223.5086688,15212,-3418624,475648,-2942976,13
2964,289,21,9,0.0888410698,0.91115893,928.7612673,1035.244296,1635.003036,1544.920415,3253,232.1912919,6506,-1517568,147968,-1369600,13
3032,268,23,7,0.0812121212,0.918787879,946.7253032,1015.829557,1654.673483,1603.283582,3300,141.8134938,6600,-1552384,137216,-1415168,13
6513,912,23,7,0.122828283,0.877171717,2110.785948,2228.37369,3609.75096,4450.347588,7425,222.438586,14850,-3334656,466944,-2867712,13
3296,228,23,7,0.0646992054,0.935300795,1005.027702,1116.833084,1788.069782,1392.859649,3524,484.7317744,7048,-1687552,116736,-1570816,13
2820,187,23,7,0.0621882275,0.937811773,855.5370056,994.5576364,1523.210993,1214.294118,3007,196.2793734,6014,-1443840,95744,-1348096,13
2546,202,23,7,0.0735080058,0.926491994,781.0470831,904.2998894,1392.287903,1150.30198,2748,377.4725275,5496,-1303552,103424,-1200128,13
4334,263,23,7,0.0572112247,0.942788775,1310.535729,1485.252968,2329.751961,1792.235741,4597,642.9370629,9194,-2219008,134656,-2084352,13
4712,268,23,7,0.053815261,0.946184739,1426.233296,1479.042846,2527.677844,1836.835821,4980,322.7478937,9960,-2412544,137216,-2275328,13
3963,247,23,7,0.0586698337,0.941330166,1203.106787,1288.307916,2138.135251,1581.882591,4210,449.7863248,8420,-2029056,126464,-1902592,13
3141,250,23,7,0.073724565,0.926275435,966.6514538,1083.937342,1718.023241,1419.3,3391,428.6978508,6782,-1608192,128000,-1480192,13
6887,316,23,7,0.0438706095,0.956129391,2070.059614,2151.16144,3634.791346,2887.335443,7203,505.8286517,14406,-3526144,161792,-3364352,13
2403,204,23,7,0.0782508631,0.921749137,742.9576484,797.1396115,1329.823138,999.8186275,2607,49.0960452,5214,-1230336,104448,-1125888,13
3339,253,23,7,0.0704342984,0.929565702,1023.79658,1125.455524,1826.219227,1404.27668,3592,370.3092784,7184,-1709568,129536,-1580032,13
4198,252,23,7,0.0566292135,0.943370787,1272.265893,1372.981672,2256.934254,1701.845238,4450,350.6698188,8900,-2149376,129024,-2020352,13
8984,912,23,7,0.0921584479,0.907841552,2824.925568,3091.401036,4888.5502,5539.058114,9896,507.227063,19792,-4599808,466944,-4132864,13
9053,849,23,7,0.0857402545,0.914259746,2819.12765,3185.960473,4894.663979,5557.550059,9902,561.9750284,19804,-4635136,434688,-4200448,13
7456,1054,23,7,0.123854289,0.876145711,2428.989115,2511.453161,4146.166845,5028.92315,8510,191.2359551,17020,-3817472,539648,-3277824,13
4460,261,23,7,0.0552848973,0.944715103,1352.803717,1388.694005,2396.719507,1750.62069,4721,306.3595068,9442,-2283520,133632,-2149888,13
2671,226,23,7,0.0780117363,0.921988264,826.8540496,902.0934033,1470.666791,1192.929204,2897,298.6597938,5794,-1367552,115712,-1251840,13
2840,204,23,7,0.0670170828,0.932982917,871.2130911,880.3568822,1551.951761,1112.485294,3044,54.14443259,6088,-1454080,104448,-1349632,13
5031,310,23,7,0.0580415652,0.941958435,1521.566303,1728.224222,2708.683164,2059.43871,5341,480.7380738,10682,-2575872,158720,-2417152,13
8582,1084,21,9,0.112145665,0.887854335,2757.316376,2868.138898,4713.895246,5780.407749,9666,176.1297376,19332,-4393984,555008,-3838976,13
381,71,22,8,0.157079646,0.842920354,125.2677474,144.8673377,216.832021,278.3802817,452,8.103262818,904,-195072,36352,-158720,14
9374,602,21,9,0.0603448276,0.939655172,2839.553119,3267.744761,5056.740239,3925.901993,9976,606.8126521,19952,-4799488,308224,-4491264,14
7494,576,21,9,0.0713754647,0.928624535,2305.260896,2496.685176,4095.756072,3251.543403,8070,184.7104601,16140,-3836928,294912,-3542016,14
7716,509,21,9,0.0618844985,0.938115502,2348.361743,2583.57152,4170.980301,3234.068762,8225,517.6211454,16450,-3950592,260608,-3689984,14
7468,512,21,9,0.064160401,0.935839599,2278.681126,2574.484849,4029.517006,3421.400391,7980,565.1558074,15960,-3823616,262144,-3561472,14
7484,472,21,9,0.0593262946,0.940673705,2274.618008,2540.852616,4018.113709,3350.387712,7956,346.5156794,15912,-3831808,241664,-3590144,14
219,43,21,9,0.164122137,0.835877863,73.51142247,79.15421619,137.3607306,101.6511628,262,40.74650078,524,-112128,22016,-90112,14
7355,461,22,8,0.0589815763,0.941018424,2224.177916,2669.32307,3939.5414,3413.251627,7816,245.3232894,15632,-3765760,236032,-3529728,14
7989,544,21,9,0.0637524903,0.93624751,2460.416594,2438.379322,4304.730755,3712.898897,8533,448.1617647,17066,-4090368,278528,-3811840,14
9382,592,21,9,0.0593543212,0.940645679,2836.082846,3272.877244,5062.148689,3804.469595,9974,514.3888602,19948,-4803584,303104,-4500480,14
7501,548,21,9,0.0680829917,0.931917008,2313.216566,2300.335185,4086.601253,3181.804745,8049,210.8171818,16098,-3840512,280576,-3559936,14
8806,536,21,9,0.0573752944,0.942624706,2666.262389,3088.671374,4709.97161,4039.445896,9342,864.199815,18684,-4508672,274432,-4234240,14
7675,558,21,9,0.0677760233,0.932223977,2361.071365,2407.486841,4182.419283,3217.191756,8233,392.4213537,16466,-3929600,285696,-3643904,14
7357,520,21,9,0.0660149803,0.93398502,2243.996844,2585.582056,3982.005437,3330.555769,7877,410.0468506,15754,-3766784,266240,-3500544,14
8661,584,21,9,0.0631692807,0.936830719,2646.66171,2870.300794,4674.768272,3855.251712,9245,617.9812834,18490,-4434432,299008,-4135424,14
7478,479,22,8,0.0601985673,0.939801433,2278.462037,2557.572958,3993.992913,3744.935282,7957,512.3631681,15914,-3828736,245248,-3583488,14
8573,584,21,9,0.063776346,0.936223654,2623.591251,2846.550293,4621.519888,3954.816781,9157,300.8212878,18314,-4389376,299008,-4090368,14
9390,584,21,9,0.0585522358,0.941447764,2845.431854,3192.928897,5053.81672,3921.208904,9974,738.8148148,19948,-4807680,299008,-4508672,14
8161,468,21,9,0.0542357168,0.945764283,2478.720434,2615.237457,4351.474084,3678.963675,8629,363.6325327,17258,-4178432,239616,-3938816,14
2462,250,21,9,0.0921828909,0.907817109,781.7602055,758.9943778,1379.02437,1134.68,2712,38.50631833,5424,-1260544,128000,-1132544,14
379,70,22,8,0.155902004,0.844097996,127.1594044,142.1710561,224.828496,225.9285714,449,27.42822236,898,-194048,35840,-158208,14
384,66,21,9,0.146666667,0.853333333,127.1908834,144.1326741,227.4973958,213.8787879,450,17.1624714,900,-196608,33792,-162816,14
379,68,21,9,0.15212528,0.84787472,125.5886883,146.7482574,223.4775726,226.9117647,447,31.08484006,894,-194048,34816,-159232,14
360,69,21,9,0.160839161,0.839160839,121.3855072,135.9360572,215.0555556,214.7101449,429,30.12640449,858,-184320,35328,-148992,14
356,68,22,8,0.160377358,0.839622642,120.6499552,131.1209722,211.8764045,215.7647059,424,24.11831627,848,-182272,34816,-147456,14
364,72,21,9,0.165137615,0.834862385,124.2178656,133.6407654,219.9010989,211.4166667,436,28.49673203,872,-186368,36864,-149504,14
353,69,21,9,0.163507109,0.836492891,119.6202262,132.5057254,211.6033994,210.9710145,422,32.5617284,844,-180736,35328,-145408,14
359,72,21,9,0.167053364,0.832946636,122.1375352,135.2186323,216.086351,215.5694444,431,15.14406184,862,-183808,36864,-146944,14
351,67,22,8,0.160287081,0.839712919,118.9234148,129.336346,208.7293447,213.5373134,418,29.94269341,836,-179712,34304,-145408,14
364,68,22,8,0.157407407,0.842592593,122.3521774,136.6233678,216.6373626,215.7647059,432,31.07913669,864,-186368,34816,-151552,14
362,67,22,8,0.156177156,0.843822844,121.7824709,134.3169846,215.8977901,210.1492537,429,28.29815303,858,-185344,34304,-151040,14
353,69,22,8,0.163507109,0.836492891,119.7812775,131.7499796,211.2011331,213.0289855,422,25.17899761,844,-180736,35328,-145408,14
351,68,21,9,0.162291169,0.837708831,118.6195515,132.3317532,210.4273504,207.7941176,419,27.01482914,838,-179712,34816,-144896,14
371,69,22,8,0.156818182,0.843181818,124.9412497,137.5710208,221.2479784,216.4782609,440,30.81232493,880,-189952,35328,-154624,14
388,75,21,9,0.161987041,0.838012959,131.3189477,145.124856,232.4613402,229.6133333,463,31.86510668,926,-198656,38400,-160256,14
360,66,21,9,0.154929577,0.845070423,120.4609064,135.8275768,212.9055556,216.7424242,426,30.55954089,852,-184320,33792,-150528,14
357,69,21,9,0.161971831,0.838028169,120.8987399,133.1415918,214.2156863,209.7971014,426,20.55984556,852,-182784,35328,-147456,14
380,65,21,9,0.146067416,0.853932584,125.7721685,142.7182386,224.7921053,212.5230769,445,31.18430273,890,-194560,33280,-161280,14
367,68,21,9,0.156321839,0.843678161,123.4097643,136.5959332,218.7138965,214.1470588,435,29.53156823,870,-187904,34816,-153088,14
386,76,21,9,0.164502165,0.835497835,128.8104754,154.2149917,229.9637306,239.3026316,462,8.159660897,924,-197632,38912,-158720,14
232,44,21,9,0.15942029,0.84057971,76.95186359,83.93022424,145.3491379,102.3863636,276,49.02309059,552,-118784,22528,-96256,14
2436,180,21,9,0.0688073394,0.931192661,750.2228058,794.1252446,1322.854269,1114.238889,2616,330.7206068,5232,-1247232,92160,-1155072,14
2479,193,21,9,0.0722305389,0.927769461,768.5493232,779.8175986,1351.876563,1138.994819,2672,302.6047565,5344,-1269248,98816,-1170432,14
2753,190,21,9,0.0645599728,0.935440027,845.0938627,888.4188177,1485.747185,1272.810526,2943,186.2658228,5886,-1409536,97280,-1312256,14
2750,194,21,9,0.0658967391,0.934103261,846.0589131,860.318583,1490.982182,1210.510309,2944,296.1770624,5888,-1408000,99328,-1308672,14
2853,213,21,9,0.0694716243,0.930528376,879.4321846,920.0703609,1552.590606,1277.793427,3066,241.22738,6132,-1460736,109056,-1351680,14
2487,170,21,9,0.0639819345,0.936018065,762.6168499,768.6312447,1349.470446,1029.529412,2657,203.289977,5314,-1273344,87040,-1186304,14
2806,188,21,9,0.0627922512,0.937207749,860.9313412,863.8640751,1516.665716,1211.441489,2994,107.4273412,5988,-1436672,96256,-1340416,14
3153,239,21,9,0.0704599057,0.929540094,976.4519454,994.7565514,1711.080241,1504.150628,3392,397.6553341,6784,-1614336,122368,-1491968,14
2438,171,21,9,0.0655423534,0.934457647,747.9710101,778.8868744,1323.128384,1046.538012,2609,94.32393348,5218,-1248256,87552,-1160704,14
3174,234,21,9,0.0686619718,0.931338028,981.0377163,999.6156606,1719.148078,1505.811966,3408,332.8125,6816,-1625088,119808,-1505280,14
2226,198,21,9,0.0816831683,0.918316832,690.2021721,799.2356891,1213.069182,1206.10101,2424,366.7170953,4848,-1139712,101376,-1038336,14
2809,196,21,9,0.0652246256,0.934775374,865.5779195,848.8311885,1521.9555,1231.336735,3005,249.5847176,6010,-1438208,100352,-1337856,14
3101,210,21,9,0.0634249471,0.936575053,949.3952413,1025.891984,1669.332796,1459.119048,3311,319.5945946,6622,-1587712,107520,-1480192,14
2506,175,21,9,0.0652741514,0.934725849,768.6196727,813.0055099,1356.902634,1113.274286,2681,341.9642857,5362,-1283072,89600,-1193472,14
3171,226,21,9,0.0665292906,0.933470709,977.8900755,989.1668975,1715.649007,1465.39823,3397,275.7305195,6794,-1623552,115712,-1507840,14
2862,214,21,9,0.0695708713,0.930429129,882.5224665,951.7823965,1546.218728,1435.271028,3076,250.2847844,6152,-1465344,109568,-1355776,14
3332,241,21,9,0.0674503219,0.932549678,1027.411063,1051.178894,1805.930972,1525.26556,3573,345.8857696,7146,-1705984,123392,-1582592,14
288,55,21,9,0.160349854,0.839650146,97.14762987,103.8796443,166.6597222,199.9636364,343,30.11413521,686,-147456,28160,-119296,14
41,13,21,9,0.240740741,0.759259259,15.56540957,15.41650541,28.24390244,25.15384615,54,9.507042254,108,-20992,6656,-14336,14
331,60,21,9,0.153452685,0.846547315,109.5924954,129.4727116,196.1782477,195.0166667,391,27.69121813,782,-169472,30720,-138752,14
365,67,21,9,0.155092593,0.844907407,121.83674,139.2990184,216.8027397,214.8507463,432,15.17386723,864,-186880,34304,-152576,14
352,66,21,9,0.157894737,0.842105263,117.3205505,137.058195,208.7045455,213.7424242,418,29.62437987,836,-180224,33792,-146432,14
388,73,21,9,0.15835141,0.84164859,130.1722218,147.5632411,231.2525773,229.6575342,461,29.76113622,922,-198656,37376,-161280,14
342,71,21,9,0.171912833,0.828087167,116.7755771,130.3618284,206.7777778,208.0704225,413,29.18727915,826,-175104,36352,-138752,14
346,68,21,9,0.164251208,0.835748792,117.4134765,129.597674,208.2225434,203.8235294,414,28.57142857,828,-177152,34816,-142336,14
352,72,21,9,0.169811321,0.830188679,120.2505844,132.3892437,212.2585227,213.6805556,424,27.73054284,848,-180224,36864,-143360,14
229,39,21,9,0.145522388,0.854477612,74.88456669,79.38487213,141.3624454,94.20512821,268,48.72727273,536,-117248,19968,-97280,14
367,68,21,9,0.156321839,0.843678161,121.5565999,144.9705882,216.2179837,227.6176471,435,31.16045845,870,-187904,34816,-153088,14
353,71,21,9,0.16745283,0.83254717,119.6622712,135.1042755,213.3286119,208.3802817,424,25.28324389,848,-180736,36352,-144384,14
358,69,21,9,0.161592506,0.838407494,121.072525,134.0336837,214.4692737,211.5652174,427,27.85388128,854,-183296,35328,-147968,14
370,73,21,9,0.164785553,0.835214447,126.0063531,136.992982,221.7756757,223.1369863,443,34.93690852,886,-189440,37376,-152064,14
184,38,21,9,0.171171171,0.828828829,63.10083972,58.83335426,118.1521739,79.28947368,222,8.74015748,444,-94208,19456,-74752,14
365,72,21,9,0.164759725,0.835240275,124.5050896,133.8809818,220.6219178,210.7777778,437,28.75,874,-186880,36864,-150016,14
349,69,21,9,0.16507177,0.83492823,118.3730646,131.6518931,209.5673352,209.1594203,418,23.24805339,836,-178688,35328,-143360,14
358,69,21,9,0.161592506,0.838407494,121.0812305,134.002475,213.6256983,215.942029,427,30.52180129,854,-183296,35328,-147968,14
362,72,21,9,0.165898618,0.834101382,123.8138047,132.146582,219.0801105,209.5555556,434,23.78082192,868,-185344,36864,-148480,14
356,69,21,9,0.162352941,0.837647059,120.5334523,133.1035686,214.0842697,207.4057971,425,30.05657709,850,-182272,35328,-146944,14
354,68,21,9,0.161137441,0.838862559,119.7948084,131.809744,212.1694915,208.0147059,422,24.70725995,844,-181248,34816,-146432,14
360,70,21,9,0.162790698,0.837209302,121.6102837,136.3316963,215.9472222,213.2,430,31.04693141,860,-184320,35840,-148480,14
358,75,21,9,0.173210162,0.826789838,120.5930533,143.4971157,214.3463687,229.6666667,433,7.624581793,866,-183296,38400,-144896,14
137,33,21,9,0.194117647,0.805882353,45.38700453,60.42099016,82.41605839,98.3030303,170,12.47248716,340,-70144,16896,-53248,14
387,75,21,9,0.162337662,0.837662338,130.7896716,145.9358118,231.8320413,229.7866667,462,33.30930065,924,-198144,38400,-159744,14
368,61,21,9,0.142191142,0.857808858,119.5080083,147.2850294,214.6440217,217.147541,429,29.34336525,858,-188416,31232,-157184,14
348,66,21,9,0.15942029,0.84057971,116.0821484,136.1051026,208.2356322,203.6212121,414,27.47179827,828,-178176,33792,-144384,14
367,72,21,9,0.164009112,0.835990888,124.5568336,137.1933442,220.7820163,216.0138889,439,17.80933063,878,-187904,36864,-151040,14
363,70,21,9,0.161662818,0.838337182,122.5299378,136.8305253,218.4435262,209.5142857,433,16.20508982,866,-185856,35840,-150016,14
374,74,21,9,0.165178571,0.834821429,126.7380005,141.613454,225.315508,220.3783784,448,28.14070352,896,-191488,37888,-153600,14
362,67,21,9,0.156177156,0.843822844,120.8556142,138.8437743,215.4309392,212.6716418,429,30.90778098,858,-185344,34304,-151040,14
370,69,21,9,0.157175399,0.842824601,123.5425042,142.5341548,220.7486486,215.9855072,439,32.13762811,878,-189440,35328,-154112,14
360,73,21,9,0.168591224,0.831408776,123.0067402,134.3760139,216.9861111,217.0684932,433,32.53193088,866,-184320,37376,-146944,14
382,74,21,9,0.162280702,0.837719298,130.0543348,139.1858383,230.1937173,219.7567568,456,16.57579062,912,-195584,37888,-157696,14
348,69,21,9,0.165467626,0.834532374,118.1771026,130.9109665,209,209,417,28.44474761,834,-178176,35328,-142848,14
376,69,21,9,0.15505618,0.84494382,125.8775003,141.7086494,223.0345745,222.8115942,445,16.61687827,890,-192512,35328,-157184,14
340,72,21,9,0.174757282,0.825242718,116.9348366,127.949667,206.3470588,207.2222222,412,27.8943805,824,-174080,36864,-137216,14
372,71,21,9,0.16027088,0.83972912,124.6412082,143.6126193,222.7473118,218.084507,443,26.79975802,886,-190464,36352,-154112,14
354,72,21,9,0.169014085,0.830985915,120.8261154,133.0242765,213.1468927,215.2361111,426,27.15105163,852,-181248,36864,-144384,14
388,70,21,9,0.152838428,0.847161572,129.8661198,144.4641958,230.2319588,225.4428571,458,35.58663559,916,-198656,35840,-162816,14
356,78,21,9,0.179723502,0.820276498,120.4966845,144.5240488,214.8370787,229.6538462,434,7.699130743,868,-182272,39936,-142336,14
396,69,21,9,0.148387097,0.851612903,131.4782593,149.0148719,233.6237374,229.4202899,465,17.59364359,930,-202752,35328,-167424,14
8488,439,21,9,0.0491766551,0.950823345,2556.912327,2770.117625,4513.455938,3507.776765,8927,168.2117957,17854,-4345856,224768,-4121088,14
71,15,21,9,0.174418605,0.825581395,24.09522042,25.81420797,45.5915493,33.6,86,7.239057239,172,-36352,7680,-28672,14
8677,439,21,9,0.0481570864,0.951842914,2616.828485,2815.960545,4594.228881,3852.305239,9116,314.8877375,18232,-4442624,224768,-4217856,14
8745,449,21,9,0.0488361975,0.951163802,2632.900533,2894.216842,4643.624357,3699.153675,9194,284.1161928,18388,-4477440,229888,-4247552,14
8771,451,21,9,0.0489047929,0.951095207,2644.564888,2858.516019,4654.406795,3777.053215,9222,292.668994,18444,-4490752,230912,-4259840,14
8773,460,21,9,0.0498212932,0.950178707,2644.81978,2876.377507,4665.713325,3687.952174,9233,299.481025,18466,-4491776,235520,-4256256,14
8699,453,21,9,0.0494973776,0.950502622,2624.110339,2890.905581,4609.679848,3939.344371,9152,632.9183956,18304,-4453888,231936,-4221952,14
8609,453,21,9,0.0499889649,0.950011035,2600.655172,2806.341836,4567.271344,3851.686534,9062,282.1295143,18124,-4407808,231936,-4175872,14
8614,444,21,9,0.0490174431,0.950982557,2597.183844,2770.781045,4578.319364,3582.36036,9058,208.902214,18116,-4410368,227328,-4183040,14
226,40,21,9,0.15037594,0.84962406,75.22255244,77.92335978,139.0752212,102,266,7.971231645,532,-115712,20480,-95232,14
8722,439,21,9,0.0479205327,0.952079467,2629.904335,2837.816471,4614.8662,3908.150342,9161,513.5089686,18322,-4465664,224768,-4240896,14
8695,438,21,9,0.0479579547,0.952042045,2618.188982,2853.706698,4608.540196,3742.360731,9133,570.8125,18266,-4451840,224256,-4227584,14
8658,430,21,9,0.0473151408,0.952684859,2605.298432,2845.971341,4584.977246,3729.495349,9088,249.6017578,18176,-4432896,220160,-4212736,14
8602,447,21,9,0.0493977235,0.950602276,2594.086826,2873.274302,4556.431644,3920.134228,9049,161.5315959,18098,-4404224,228864,-4175360,14
8650,433,21,9,0.0476714742,0.952328526,2603.896076,2825.416009,4585.305896,3676.882217,9083,559.6426371,18166,-4428800,221696,-4207104,14
2999,246,21,9,0.0758089368,0.924191063,940.746086,833.5041257,1646.83061,1332.479675,3245,59.72759065,6490,-1535488,125952,-1409536,14
8661,453,21,9,0.0497037525,0.950296248,2611.358343,2826.339797,4605.899319,3632.143488,9114,540.2489627,18228,-4434432,231936,-4202496,14
8919,457,21,9,0.0487414676,0.951258532,2687.413174,2903.749239,4736.323355,3755.159737,9376,389.6924356,18752,-4566528,233984,-4332544,14
8988,456,21,9,0.0482846252,0.951715375,2709.803637,2913.469398,4764.089675,3902.745614,9444,520.904578,18888,-4601856,233472,-4368384,14
8867,452,21,9,0.0485030583,0.951496942,2674.08154,2843.556437,4705.667757,3764.123894,9319,527.6896942,18638,-4539904,231424,-4308480,14
647,34,21,9,0.0499265786,0.950073421,193.9081958,209.9770378,347.1607419,223.7647059,681,20.80659945,1362,-331264,17408,-313856,14
9375,591,21,9,0.0593016255,0.940698374,2874.123075,2852.289137,5022.066347,4371.724196,9966,483.5516739,19932,-4800000,302592,-4497408,14
4153,293,21,9,0.0659019343,0.934098066,1281.123419,1199.038991,2260.478931,1699.358362,4446,410.1476015,8892,-2126336,150016,-1976320,14
710,46,21,9,0.0608465608,0.939153439,212.6379506,291.1875731,379.0690141,369.7173913,756,67.08074534,1512,-363520,23552,-339968,14
9417,552,21,9,0.0553716521,0.944628348,2866.906133,2887.702707,5042.278008,4007.849638,9969,464.7552448,19938,-4821504,282624,-4538880,14
2178,170,21,9,0.0724020443,0.927597956,679.5200101,613.4541913,1191.863177,952.0470588,2348,231.3300493,4696,-1115136,87040,-1028096,14
3481,237,21,9,0.0637439484,0.936256052,1068.19144,1015.843189,1894.391841,1347.016878,3718,647.7351916,7436,-1782272,121344,-1660928,14
3600,269,21,9,0.0695270096,0.93047299,1117.220802,1011.865057,1968.303611,1489.301115,3869,667.0689655,7738,-1843200,137728,-1705472,14
2300,190,21,9,0.0763052209,0.923694779,717.0936972,710.0209669,1261.813913,1048.015789,2490,393.3649289,4980,-1177600,97280,-1080320,14
2207,182,21,9,0.0761825031,0.923817497,691.3001616,618.6293593,1215.236973,949.5989011,2389,332.729805,4778,-1129984,93184,-1036800,14
4087,312,21,9,0.0709252103,0.92907479,1267.64883,1142.317118,2245.47492,1604.307692,4399,146.6822274,8798,-2092544,159744,-1932800,14
1803,169,21,9,0.0856997972,0.914300203,572.5865908,500.8171737,1002.734886,813.295858,1972,318.0645161,3944,-923136,86528,-836608,14
2350,231,21,9,0.0895001937,0.910499806,751.0404014,678.6548607,1296.700851,1233.004329,2581,380.6784661,5162,-1203200,118272,-1084928,14
9008,601,21,9,0.0625455302,0.93745447,2773.074829,2660.739982,4858.337922,4005.552413,9609,194.0820036,19218,-4612096,307712,-4304384,14
3037,208,21,9,0.0640986133,0.935901387,933.6976426,888.9070615,1650.377017,1223.269231,3245,373.4177215,6490,-1554944,106496,-1448448,14
9366,597,21,9,0.0599217103,0.94007829,2868.267043,2960.229616,5010.459321,4535.517588,9963,699.6488764,19926,-4795392,305664,-4489728,14
3259,227,21,9,0.0651176133,0.934882387,1003.4464,923.3962505,1776.697453,1266.889868,3486,119.5063421,6972,-1668608,116224,-1552384,14
8789,570,21,9,0.0609039427,0.939096057,2695.170941,2662.082495,4734.672545,3836.987719,9359,280.2095808,18718,-4499968,291840,-4208128,14
8400,541,21,9,0.0605077732,0.939492227,2572.076423,2591.049416,4521.937024,3680.110906,8941,384.3938091,17882,-4300800,276992,-4023808,14
1573,167,21,9,0.0959770115,0.904022989,506.5249122,448.8029784,880.9313414,772.245509,1740,26.52843421,3480,-805376,85504,-719872,14
3675,257,21,9,0.0653611394,0.934638861,1132.075406,1044.243763,2003.223129,1441.373541,3932,455.0925926,7864,-1881600,131584,-1750016,14
1634,153,21,9,0.0856183548,0.914381645,516.6284265,497.1331427,903.1860465,795.8954248,1787,191.7381974,3574,-836608,78336,-758272,14
217,39,21,9,0.15234375,0.84765625,71.85247929,79.89925445,132.9953917,103.4871795,256,33.72859025,512,-111104,19968,-91136,14
639,43,21,9,0.0630498534,0.936950147,193.9530378,230.8452758,344.7230047,293.6046512,682,79.21022067,1364,-327168,22016,-305152,14
2791,217,21,9,0.0721409574,0.927859043,867.5441411,790.4808005,1533.194554,1135.437788,3008,437.2093023,6016,-1428992,111104,-1317888,14
2066,171,21,9,0.0764416629,0.923558337,650.9961348,560.0257991,1130.648596,978.2631579,2237,271.1515152,4474,-1057792,87552,-970240,14
8701,554,21,9,0.0598595354,0.940140465,2659.723696,2773.253493,4669.359844,3978.411552,9255,162.9975343,18510,-4454912,283648,-4171264,14
8641,549,21,9,0.0597388466,0.940261153,2645.206219,2681.237987,4638.739266,3914.934426,9190,479.8955614,18380,-4424192,281088,-4143104,14
1951,144,21,9,0.0687350835,0.931264916,606.3575079,569.7936273,1056.754997,929.3819444,2095,64.78045764,4190,-998912,73728,-925184,14
218,43,21,9,0.164750958,0.835249042,73.29125839,79.51838534,136.4082569,103.5813953,261,29.35883015,522,-111616,22016,-89600,14
650,39,21,9,0.0566037736,0.943396226,194.1665287,265.2908741,345.76,332.3333333,689,23.17524386,1378,-332800,19968,-312832,14
8558,535,21,9,0.0588364676,0.941163532,2620.302453,2618.374824,4586.398341,3916.773832,9093,224.4076999,18186,-4381696,273920,-4107776,14
9266,621,21,9,0.0628097502,0.93719025,2846.177461,2864.881184,4994.880855,4184.801932,9887,466.8083097,19774,-4744192,317952,-4426240,14
4069,275,21,9,0.063305709,0.936694291,1242.753835,1351.242194,2198.852544,1782.578182,4344,148.4113427,8688,-2083328,140800,-1942528,14
3408,243,21,9,0.0665571076,0.933442892,1052.17125,941.0825154,1862.309566,1316.769547,3651,381.9037657,7302,-1744896,124416,-1620480,14
8554,529,21,9,0.0582406694,0.941759331,2613.15263,2664.140545,4585.668927,3835.867675,9083,561.3720643,18166,-4379648,270848,-4108800,14
4612,333,21,9,0.0673407482,0.932659252,1409.27567,1659.425222,2472.72745,2476.774775,4945,165.8839316,9890,-2361344,170496,-2190848,14
3490,250,21,9,0.0668449198,0.93315508,1077.846533,966.132728,1907.531232,1353.544,3740,363.4596696,7480,-1786880,128000,-1658880,14
1612,170,21,9,0.0953984287,0.904601571,516.5229862,493.861772,892.7667494,879.4882353,1782,173.8536585,3564,-825344,87040,-738304,14
1110,120,21,9,0.0975609756,0.902439024,356.797015,337.2592685,618.6837838,586.05,1230,19.29714465,2460,-568320,61440,-506880,14
1761,179,22,8,0.0922680412,0.907731959,555.6128012,574.229223,987.9244747,799.0782123,1940,100.3102378,3880,-901632,91648,-809984,14
1785,184,23,7,0.093448451,0.906551549,563.8851896,585.3911036,1002.00056,820.076087,1969,99.04426559,3938,-913920,94208,-819712,14
1798,183,21,9,0.0923775871,0.907622413,568.2558417,571.0879895,1010.71079,797.3387978,1981,102.1134021,3962,-920576,93696,-826880,14
1748,179,21,9,0.0928905034,0.907109497,551.6166645,574.4548508,980.8546911,799.4078212,1927,59.11042945,3854,-894976,91648,-803328,14
1744,176,21,9,0.0916666667,0.908333333,549.3125518,579.9314614,975.6892202,809.9886364,1920,71.77570093,3840,-892928,90112,-802816,14
1668,181,21,9,0.0978907518,0.902109248,523.4390499,580.8149531,947.6061151,716.6740331,1849,57.10315009,3698,-854016,92672,-761344,14
1657,185,21,9,0.100434311,0.899565689,520.2604884,586.1839994,944.5292698,715.2324324,1842,62.99589603,3684,-848384,94720,-753664,14
1727,180,21,9,0.0943890928,0.905610907,540.9850833,595.9595467,975.6317313,746.4555556,1907,71.71869124,3814,-884224,92160,-792064,14
1648,181,21,9,0.098961181,0.901038819,518.8240604,574.545875,934.7803398,734.9005525,1829,65.25151623,3658,-843776,92672,-751104,14
1647,179,21,9,0.0980284775,0.901971522,516.8019352,573.3745342,936.1639344,704.9664804,1826,63.07426598,3652,-843264,91648,-751616,14
1807,173,21,9,0.0873737374,0.912626263,566.6573717,596.7486447,1006.095739,827.6011561,1980,100.814664,3960,-925184,88576,-836608,14
1759,176,23,7,0.0909560724,0.909043928,553.7983738,575.8499633,985.4985787,793.1136364,1935,101.4682748,3870,-900608,90112,-810496,14
1758,193,21,9,0.0989236289,0.901076371,556.3767024,604.0755679,991.4323094,835.4300518,1951,34.15616246,3902,-900096,98816,-801280,14
1772,179,20,10,0.0917478216,0.908252178,558.9016083,575.4112967,993.7268623,800.5139665,1951,77.82209813,3902,-907264,91648,-815616,14
1647,172,21,9,0.0945574491,0.905442551,515.970303,563.8328787,931.9599271,699.7209302,1819,66.29008746,3638,-843264,88064,-755200,14
208,38,22,8,0.154471545,0.845528455,69.27491631,76.76988315,127.1971154,103.2631579,246,23.49570201,492,-106496,19456,-87040,14
1778,179,21,9,0.0914665304,0.90853347,559.3928794,594.9558951,994.7969629,822.0893855,1957,113.6469222,3914,-910336,91648,-818688,14
211,38,23,7,0.152610442,0.847389558,69.88181245,77.98466093,129.2511848,101.3947368,249,26.34920635,498,-108032,19456,-88576,14
1805,187,21,9,0.093875502,0.906124498,569.1753948,607.4033923,1012.557895,841.5026738,1992,115.6794425,3984,-924160,95744,-828416,14
1306,153,21,9,0.104866347,0.895133653,421.5371785,393.0342219,745.8009188,595.124183,1459,20.90557386,2918,-668672,78336,-590336,14
1736,171,21,9,0.0896696382,0.910330362,552.2757663,497.9805065,971.6394009,774.9239766,1907,63.95036888,3814,-888832,87552,-801280,14
1769,179,21,9,0.091889117,0.908110883,564.9995645,501.419316,992.5816846,795.8044693,1948,219.3693694,3896,-905728,91648,-814080,14
1580,153,21,9,0.0882862089,0.911713791,503.6741445,428.8479416,883.3088608,698.5816993,1733,245.4674221,3466,-808960,78336,-730624,14
1709,163,21,9,0.0870726496,0.91292735,543.6699784,500.9170286,942.2235225,876.4907975,1872,50.52631579,3744,-875008,83456,-791552,14
1706,174,21,9,0.0925531915,0.907446809,544.39153,506.7936521,954.1582649,806.5862069,1880,258.5969739,3760,-873472,89088,-784384,14
1993,196,21,9,0.0895386021,0.910461398,634.5064116,544.6484509,1119.690416,843.9387755,2189,312.7142857,4378,-1020416,100352,-920064,14
1747,167,21,9,0.0872518286,0.912748171,554.3325631,502.8849652,973.6960504,788.0718563,1914,46.24305388,3828,-894464,85504,-808960,14
1728,154,21,9,0.0818278427,0.918172157,543.5952646,525.1680514,952.1637731,821.8441558,1882,147.9559748,3764,-884736,78848,-805888,14
1554,165,21,9,0.0959860384,0.904013962,501.0836359,410.7729403,878.043758,690.0606061,1719,258.8855422,3438,-795648,84480,-711168,14
2266,212,21,9,0.0855528652,0.914447135,715.69536,638.4718664,1267.589585,939.259434,2478,93.43891403,4956,-1160192,108544,-1051648,14
228,43,21,9,0.158671587,0.841328413,75.91877207,84.79416748,140.9517544,109.744186,271,43.29073482,542,-116736,22016,-94720,14
1536,152,21,9,0.0900473934,0.909952607,490.4461115,416.4913745,861.578776,671.9144737,1688,215.8567775,3376,-786432,77824,-708608,14
9413,558,21,9,0.0559622906,0.944037709,2849.118201,3300.620403,5012.903006,4532.168459,9971,889.4736842,19942,-4819456,285696,-4533760,14
1658,181,21,9,0.098423056,0.901576944,537.5101367,439.4158909,935.9879373,773.5469613,1839,67.70986745,3678,-848896,92672,-756224,14
1574,148,21,9,0.0859465738,0.914053426,499.9871815,440.2003748,875.0438374,717.4594595,1722,187.5816993,3444,-805888,75776,-730112,14
1710,148,21,9,0.0796555436,0.920344456,539.8389021,477.3938971,940.1643275,806.2837838,1858,149.8387097,3716,-875520,75776,-799744,14
1893,149,21,9,0.0729676787,0.927032321,590.532569,519.6752548,1040.302694,782.6174497,2042,328.8244767,4084,-969216,76288,-892928,14
1856,186,21,9,0.0910871694,0.908912831,593.1084999,524.4571753,1037.921875,857.6344086,2042,168.4818482,4084,-950272,95232,-855040,14
1390,153,21,9,0.0991574854,0.900842515,450.6782805,373.8788749,785.1553957,652.4836601,1543,295.5938697,3086,-711680,78336,-633344,14
202,45,21,9,0.182186235,0.817813765,68.43577248,82.06487647,126.4455446,113.0222222,247,3.80409672,494,-103424,23040,-80384,14
2805,179,21,9,0.0599865952,0.940013405,853.2561397,959.5587922,1504.915152,1297.949721,2984,271.0263397,5968,-1436160,91648,-1344512,15
2792,184,21,9,0.061827957,0.938172043,848.7115202,983.0958968,1501.378582,1293.081522,2976,426.3610315,5952,-1429504,94208,-1335296,15
2807,206,20,10,0.068370395,0.931629605,856.0310127,991.0517332,1529.130745,1205.441748,3013,249.8341625,6026,-1437184,105472,-1331712,15
2865,201,21,9,0.0655577299,0.93444227,871.4822366,1041.134714,1547.030366,1340.641791,3066,433.0508475,6132,-1466880,102912,-1363968,15
2866,205,20,10,0.0667535005,0.9332465,872.4294845,1014.250894,1558.256804,1224.839024,3071,250.2852486,6142,-1467392,104960,-1362432,15
2929,214,20,10,0.0680878142,0.931912186,891.4085121,1006.44716,1603.671902,1138.509346,3143,56.125,6286,-1499648,109568,-1390080,15
2771,211,21,9,0.0707578806,0.929242119,846.2582954,989.4595169,1513.355828,1204.473934,2982,301.8218623,5964,-1418752,108032,-1310720,15
2786,207,21,9,0.0691613765,0.930838623,849.7784186,994.7235845,1517.919957,1215.439614,2993,183.7323511,5986,-1426432,105984,-1320448,15
2840,202,21,9,0.0664036818,0.933596318,873.5713566,916.6074763,1535.872183,1319.435644,3042,171.7673631,6084,-1454080,103424,-1350656,15
2794,204,21,9,0.0680453636,0.931954636,851.2423361,1001.051865,1519.54796,1224.921569,2998,231.6846986,5996,-1430528,104448,-1326080,15
2781,197,21,9,0.0661517797,0.93384822,845.850594,991.6071534,1509.874506,1201.878173,2978,236.9132856,5956,-1423872,100864,-1323008,15
2768,195,20,10,0.0658116774,0.934188323,842.6068847,1006.626241,1492.834538,1328.205128,2963,52.90126763,5926,-1417216,99840,-1317376,15
2775,204,20,10,0.0684793555,0.931520645,844.407836,1005.473328,1511.190991,1201.740196,2979,327.7227723,5958,-1420800,104448,-1316352,15
2795,198,21,9,0.0661543602,0.93384564,850.6624951,1007.798436,1512.876565,1272.883838,2993,281.5616181,5986,-1431040,101376,-1329664,15
2768,200,20,10,0.0673854447,0.932614555,842.0663254,1001.617869,1503.859827,1216.56,2968,248.3682008,5936,-1417216,102400,-1314816,15
2688,196,21,9,0.067961165,0.932038835,820.0253278,899.5754973,1471.309896,1047.392857,2884,51.11662531,5768,-1376256,100352,-1275904,15
2770,194,21,9,0.0654520918,0.934547908,844.5701915,977.0921253,1497.015162,1275.247423,2964,243.1501231,5928,-1418240,99328,-1318912,15
2833,191,20,10,0.0631613757,0.936838624,861.4237561,1018.884898,1521.849276,1373.827225,3024,206.9815195,6048,-1450496,97792,-1352704,15
2830,208,20,10,0.0684660961,0.931533904,861.1534462,1018.395705,1542.663604,1204.341346,3038,222.5641026,6076,-1448960,106496,-1342464,15
2782,202,21,9,0.06769437,0.93230563,849.7144876,963.1532861,1513.520129,1203.00495,2984,321.8985976,5968,-1424384,103424,-1320960,15
1027,85,23,7,0.0764388489,0.923561151,311.6688297,411.2427542,562.2930867,486.5058824,1112,79.77044476,2224,-525824,43520,-482304,15
1041,68,23,7,0.0613165014,0.938683499,314.2413701,399.7154968,554.8136407,557.8529412,1109,106.5321806,2218,-532992,34816,-498176,15
1012,81,23,7,0.0741079597,0.92589204,306.7556705,403.5888933,552.3488142,480.1728395,1093,114.4502618,2186,-518144,41472,-476672,15
1025,71,24,6,0.0647810219,0.935218978,309.8129425,398.47594,550.342439,521.9014085,1096,95.13888889,2192,-524800,36352,-488448,15
1010,67,24,6,0.0622098422,0.937790158,304.6802934,392.529013,537.839604,556.4925373,1077,172.32,2154,-517120,34304,-482816,15
1029,66,24,6,0.0602739726,0.939726027,310.3659678,394.20412,546.5840622,570.0757576,1095,118.8925081,2190,-526848,33792,-493056,15
1032,82,24,6,0.0736086176,0.926391382,314.0150591,403.0186572,560.499031,519.7560976,1114,155.3695955,2228,-528384,41984,-486400,15
1021,74,24,6,0.0675799087,0.932420091,310.0012737,390.6339814,548.0264447,547.6351351,1095,144.2687747,2190,-522752,37888,-484864,15
1015,73,23,7,0.0670955882,0.932904412,306.5896459,401.3040303,547.7783251,498.9178082,1088,193.594306,2176,-519680,37376,-482304,15
1012,74,23,7,0.0681399632,0.931860037,306.1394581,400.01023,545.3092885,518.7567568,1086,188.2149047,2172,-518144,37888,-480256,15
1020,69,24,6,0.0633608815,0.936639118,308.0520242,395.6264928,546.327451,525.3768116,1089,153.596615,2178,-522240,35328,-486912,15
1047,88,23,7,0.0775330396,0.92246696,318.1573065,412.9337539,575.9694365,473.1818182,1135,134.478673,2270,-536064,45056,-491008,15
1059,73,24,6,0.0644876325,0.935512367,320.085559,410.9970485,568.2492918,541.1232877,1132,106.6918002,2264,-542208,37376,-504832,15
1017,74,24,6,0.067827681,0.932172319,309.1416828,385.551588,547.2369715,529,1091,147.4324324,2182,-520704,37888,-482816,15
1027,78,22,8,0.0705882353,0.929411765,311.3872135,404.5294937,555.5111977,519.9358974,1105,149.526387,2210,-525824,39936,-485888,15
1019,84,22,8,0.0761559383,0.923844062,308.9029502,407.7648104,558.8380765,469.047619,1103,186.6328257,2206,-521728,43008,-478720,15
1042,79,23,7,0.0704727921,0.929527208,316.0299981,407.9171503,564.4510557,515.4810127,1121,118.75,2242,-533504,40448,-493056,15
1070,83,23,7,0.0719861232,0.928013877,324.7701676,418.9646263,581.5364486,518.5180723,1153,103.4080717,2306,-547840,42496,-505344,15
1026,66,23,7,0.0604395604,0.93956044,309.7136631,390.9362455,545.7046784,558.8636364,1092,160.5882353,2184,-525312,33792,-491520,15
1040,86,24,6,0.0763765542,0.923623446,316.884891,403.3414633,569.8288462,486.9651163,1126,146.2337662,2252,-532480,44032,-488448,15
731,74,21,9,0.0919254658,0.908074534,226.3514499,262.8700696,392.3296854,508.4054054,805,108.490566,1610,-374272,37888,-336384,15
724,77,22,8,0.0961298377,0.903870162,224.8296007,273.9762736,393.2707182,473.6753247,801,99.25650558,1602,-370688,39424,-331264,15
731,82,21,9,0.100861009,0.899138991,228.0021347,267.8022591,395.8645691,506.2682927,813,78.55072464,1626,-374272,41984,-332288,15
723,75,22,8,0.0939849624,0.906015038,224.7399806,257.0971476,388.8492393,502.1733333,798,71.05966162,1596,-370176,38400,-331776,15
738,80,22,8,0.097799511,0.902200489,229.5100043,275.2430741,400.0271003,496.8875,818,78.35249042,1636,-377856,40960,-336896,15
715,72,22,8,0.0914866582,0.908513342,220.2077837,277.3103536,386.7398601,466.0972222,787,136.6319444,1574,-366080,36864,-329216,15
721,74,21,9,0.093081761,0.906918239,223.5097273,271.004189,390.6532594,469.5810811,795,124.21875,1590,-369152,37888,-331264,15
722,73,21,9,0.0918238994,0.908176101,222.4183812,280.6441923,390.8254848,468.9589041,795,150.8538899,1590,-369664,37376,-332288,15
741,73,22,8,0.0896805897,0.91031941,229.1707466,274.0232303,399.3576248,490.1506849,814,129.2063492,1628,-379392,37376,-342016,15
721,73,22,8,0.0919395466,0.908060453,223.2450469,264.5775986,388.2552011,488.8082192,794,71.08325873,1588,-369152,37376,-331776,15
734,76,21,9,0.0938271605,0.90617284,227.411418,276.7291745,397.4482289,483.2631579,810,53.1147541,1620,-375808,38912,-336896,15
643,61,21,9,0.0866477273,0.913352273,193.8648866,274.3404835,345.9455677,421.5901639,704,51.42439737,1408,-329216,31232,-297984,15
723,74,22,8,0.0928481807,0.907151819,223.9758506,266.5502052,389.7842324,489.0405405,797,92.56678281,1594,-370176,37888,-332288,15
716,77,21,9,0.0970996217,0.902900378,222.2593366,270.0084867,388.1857542,478.961039,793,142.8828829,1586,-366592,39424,-327168,15
724,71,22,8,0.0893081761,0.910691824,223.786134,270.3037283,390.7513812,471.915493,795,105.5776892,1590,-370688,36352,-334336,15
729,72,22,8,0.0898876404,0.91011236,223.522286,297.3664798,398.8463649,422.8055556,801,45.66704675,1602,-373248,36864,-336384,15
714,76,21,9,0.0962025316,0.903797468,220.231336,286.7280423,390.2058824,445.2368421,790,168.0851064,1580,-365568,38912,-326656,15
737,76,22,8,0.0934809348,0.906519065,228.8021522,280.8883547,401.9375848,456.0921053,813,114.5070423,1626,-377344,38912,-338432,15
727,74,21,9,0.0923845194,0.907615481,224.3937055,283.2567039,395.0013755,459.9324324,801,69.29065744,1602,-372224,37888,-334336,15
746,79,21,9,0.0957575758,0.904242424,230.9850525,295.787247,409.8150134,443.0759494,825,87.57961783,1650,-381952,40448,-341504,15
789,73,20,10,0.0846867749,0.915313225,242.0466793,241.7788816,449.0912548,241.369863,862,31.67952958,1724,-403968,37376,-366592,15
978,97,20,10,0.0902325581,0.909767442,299.4883025,381.7108783,550.4182004,412.7938144,1075,121.8820862,2150,-500736,49664,-451072,15
998,90,20,10,0.0827205882,0.917279412,304.9125433,382.4945955,555.1683367,426.2,1088,147.6255088,2176,-510976,46080,-464896,15
1013,92,20,10,0.0832579186,0.916742081,308.5523722,396.3385661,564.2576505,429.0434783,1105,147.9250335,2210,-518656,47104,-471552,15
988,90,20,10,0.0834879406,0.916512059,301.2920291,390.7457991,548.5293522,440.3777778,1078,36.34524612,2156,-505856,46080,-459776,15
991,82,21,9,0.0764212488,0.923578751,300.9296578,387.3276526,545.3420787,436.1829268,1073,139.7135417,2146,-507392,41984,-465408,15
988,74,20,10,0.0696798493,0.930320151,299.5423819,385.4198047,534.9888664,484.9189189,1062,94.90616622,2124,-505856,37888,-467968,15
985,82,20,10,0.0768509841,0.923149016,299.7611487,383.0021669,541.3532995,445.6707317,1067,35.08714239,2134,-504320,41984,-462336,15
985,75,21,9,0.070754717,0.929245283,298.3443921,390.2224437,533.8527919,486.4666667,1060,126.1904762,2120,-504320,38400,-465920,15
979,72,21,9,0.0685061846,0.931493815,296.320438,383.0072101,529.9295199,472.5694444,1051,134.398977,2102,-501248,36864,-464384,15
1002,84,21,9,0.0773480663,0.922651934,306.0476338,384.4734942,549.497006,471.9642857,1086,127.4647887,2172,-513024,43008,-470016,15
969,87,20,10,0.0823863636,0.917613636,295.203032,383.9432237,537.0691434,433.0574713,1056,123.943662,2112,-496128,44544,-451584,15
985,85,20,10,0.0794392523,0.920560748,299.7891728,388.6732941,543.1238579,447.1529412,1070,176.276771,2140,-504320,43520,-460800,15
991,87,20,10,0.0807050093,0.919294991,302.1625562,381.0320539,549.7184662,423.1034483,1078,166.6151468,2156,-507392,44544,-462848,15
978,94,22,8,0.0876865672,0.912313433,299.8890271,377.9003015,547.2188139,424.9787234,1072,139.2207792,2144,-500736,48128,-452608,15
989,77,20,10,0.0722326454,0.927767355,300.0426976,389.0023506,537.8493428,477.6363636,1066,121.4123007,2132,-506368,39424,-466944,15
981,89,20,10,0.0831775701,0.91682243,299.8911156,378.168861,545.3007136,427.4719101,1070,169.0363349,2140,-502272,45568,-456704,15
1000,95,20,10,0.0867579909,0.913242009,306.5134351,392.4234569,556.49,458.6315789,1095,130.6682578,2190,-512000,48640,-463360,15
980,90,20,10,0.0841121495,0.91588785,298.7091856,384.4417799,546.2346939,418.6111111,1070,141.7218543,2140,-501760,46080,-455680,15
528,73,20,10,0.121464226,0.878535774,168.1222513,183.3954574,313.7878788,208.5068493,601,7.810266407,1202,-270336,37376,-232960,15
2135,158,22,8,0.0689053642,0.931094636,647.5005606,829.8663607,1151.960187,1079.974684,2293,106.0592044,4586,-1093120,80896,-1012224,15
1975,134,22,8,0.0635372214,0.936462779,601.2610889,684.2794844,1067.656203,868.4626866,2109,81.61764706,4218,-1011200,68608,-942592,15
2178,169,22,8,0.0720068172,0.927993183,665.2083415,816.9879888,1179.080808,1108.52071,2347,142.848448,4694,-1115136,86528,-1028608,15
1576,155,22,8,0.0895436164,0.910456384,488.450324,599.9607249,870.9098985,816.0774194,1731,122.7659574,3462,-806912,79360,-727552,15
2142,163,22,8,0.0707158351,0.929284165,651.1537839,825.3055956,1159.572829,1066.625767,2305,147.4728087,4610,-1096704,83456,-1013248,15
2151,171,22,8,0.0736434109,0.926356589,654.9970781,834.3447414,1168.491399,1073.555556,2322,124.0384615,4644,-1101312,87552,-1013760,15
2157,167,22,8,0.071858864,0.928141136,657.1987578,824.8024841,1167.493741,1098,2324,146.9955724,4648,-1104384,85504,-1018880,15
2004,136,22,8,0.0635514019,0.936448598,610.7401589,654.0043894,1089.199102,794.9632353,2140,304.4096728,4280,-1026048,69632,-956416,15
1599,149,22,8,0.0852402746,0.914759725,491.2156844,624.5052906,882.318324,790.5973154,1748,104.047619,3496,-818688,76288,-742400,15
1605,148,22,8,0.0844266971,0.915573303,493.6009272,620.0118961,884.1676012,799.2702703,1753,104.5319022,3506,-821760,75776,-745984,15
2142,165,22,8,0.0715214564,0.928478544,651.3637951,830.3273028,1158.649393,1093.642424,2307,147.8846154,4614,-1096704,84480,-1012224,15
2131,163,22,8,0.0710549259,0.928945074,646.681785,832.1681797,1155.5542,1042.202454,2294,157.3388203,4588,-1091072,83456,-1007616,15
1555,146,22,8,0.0858318636,0.914168136,480.7796766,587.7245792,854.8694534,809.7876712,1701,107.5221239,3402,-796160,74752,-721408,15
1946,106,23,7,0.0516569201,0.94834308,584.7480945,696.8559372,1035.65776,858.3773585,2052,81.33174792,4104,-996352,54272,-942080,15
2158,168,22,8,0.0722269991,0.927773001,655.5488557,843.294014,1171.328545,1062.940476,2326,111.0792741,4652,-1104896,86016,-1018880,15
2170,138,22,8,0.0597920277,0.940207972,654.142984,833.9834066,1154.648848,1152.15942,2308,120.8376963,4616,-1111040,70656,-1040384,15
2161,165,22,8,0.0709372313,0.929062769,657.2487671,830.0449067,1170.542342,1071.266667,2326,156.6329966,4652,-1106432,84480,-1021952,15
2146,170,22,8,0.073402418,0.926597582,653.9838476,825.7666491,1165.589469,1069.005882,2316,132.1163719,4632,-1098752,87040,-1011712,15
1670,156,22,8,0.0854326396,0.91456736,514.7499202,639.3126097,921.0335329,832.8525641,1826,76.27401838,3652,-855040,79872,-775168,15
2147,167,22,8,0.0721694036,0.927830596,655.7088559,807.7358241,1161.499767,1106.077844,2314,158.2763338,4628,-1099264,85504,-1013760,15
1026,79,22,8,0.0714932127,0.928506787,310.4688554,408.6648576,557.9054581,489.2911392,1105,131.547619,2210,-525312,40448,-484864,15
1031,74,22,8,0.0669683258,0.933031674,312.9046605,393.3775514,554.6168768,530.472973,1105,158.0829757,2210,-527872,37888,-489984,15
1019,81,22,8,0.0736363636,0.926363636,308.1112864,409.3775231,557.1148184,467.2839506,1100,57.62179151,2200,-521728,41472,-480256,15
1012,77,21,9,0.0707070707,0.929292929,307.3755903,392.399597,548.263834,502.1038961,1089,130.2631579,2178,-518144,39424,-478720,15
1017,86,22,8,0.077969175,0.922030825,308.844829,399.598868,561.1307768,444.0232558,1103,176.1980831,2206,-520704,44032,-476672,15
1020,87,22,8,0.0785907859,0.921409214,310.4840027,410.6268952,555.9588235,531.0344828,1107,19.10597169,2214,-522240,44544,-477696,15
1030,83,21,9,0.0745732255,0.925426774,312.4758797,410.2604036,562.0718447,494.060241,1113,171.4946071,2226,-527360,42496,-484864,15
1030,77,22,8,0.0695573622,0.930442638,311.768899,405.1179968,558.4592233,494.3506494,1107,150.4076087,2214,-527360,39424,-487936,15
1031,79,22,8,0.0711711712,0.928828829,312.3716894,402.8435075,561.6498545,475.2405063,1110,37.08653525,2220,-527872,40448,-487424,15
1014,76,22,8,0.0697247706,0.930275229,306.6706749,404.7694387,548.1706114,509.8684211,1090,154.6099291,2180,-519168,38912,-480256,15
1020,77,22,8,0.0701914312,0.929808569,309.1149791,402.8149299,550.9352941,523.3636364,1097,160.8504399,2194,-522240,39424,-482816,15
821,57,22,8,0.0649202733,0.935079727,248.3721384,274.6960995,450.227771,284.9824561,878,19.02904205,1756,-420352,29184,-391168,15
1025,85,22,8,0.0765765766,0.923423423,310.2206277,419.8592376,560.5580488,494.5058824,1110,19.50105411,2220,-524800,43520,-481280,15
1008,71,21,9,0.0658016682,0.934198332,304.9298785,388.0756761,544.1646825,480.8732394,1079,148.0109739,2158,-516096,36352,-479744,15
1031,89,22,8,0.0794642857,0.920535714,313.1573783,415.4035782,567.3666343,480.9550562,1120,122.5382932,2240,-527872,45568,-482304,15
1019,72,22,8,0.0659945005,0.9340055,307.7285614,402.9705647,547.357213,526.7916667,1091,141.8725618,2182,-521728,36864,-484864,15
1023,81,21,9,0.0733695652,0.926630435,310.5739409,398.3280229,559.0840665,469.345679,1104,107.184466,2208,-523776,41472,-482304,15
1023,76,22,8,0.0691537762,0.930846224,310.0257019,398.3349006,553.9325513,497.0657895,1099,166.5151515,2198,-523776,38912,-484864,15
1069,88,22,8,0.0760587727,0.923941227,323.9326786,419.6293399,588.9784846,457.7840909,1157,78.60054348,2314,-547328,45056,-502272,15
1052,82,22,8,0.0723104056,0.927689594,318.5330532,413.9544352,574.5931559,476.5,1134,90.72,2268,-538624,41984,-496640,15
1380,105,21,9,0.0707070707,0.929292929,417.1102921,558.8009317,742.1072464,754.7333333,1485,26.80505415,2970,-706560,53760,-652800,15
1369,97,20,10,0.0661664393,0.933833561,414.2248108,532.0455396,736.6172389,689.5051546,1466,98.72053872,2932,-700928,49664,-651264,15
1157,75,20,10,0.0608766234,0.939123377,349.1962838,374.2185614,631.4442524,385.96,1232,66.63061114,2464,-592384,38400,-553984,15
1367,104,19,11,0.0707002039,0.929299796,413.2554036,546.8802591,741.975128,657.4615385,1471,87.55952381,2942,-699904,53248,-646656,15
1376,97,20,10,0.0658520027,0.934147997,414.988042,547.7561343,740.5450581,686.7113402,1473,229.7971919,2946,-704512,49664,-654848,15
1366,115,20,10,0.0776502363,0.922349764,413.8014798,549.0217596,752.0058565,610.2695652,1481,165.2901786,2962,-699392,58880,-640512,15
1352,109,20,10,0.0746064339,0.925393566,409.7044389,539.3809181,739.2137574,629.1192661,1461,113.5198135,2922,-692224,55808,-636416,15
1374,118,21,9,0.0790884718,0.920911528,417.5599189,543.2446488,758.2161572,610.0762712,1492,38.81373569,2984,-703488,60416,-643072,15
1361,96,20,10,0.0658888126,0.934111187,410.9739357,536.7366381,732.2674504,682.6770833,1457,156.3304721,2914,-696832,49152,-647680,15
1375,93,20,10,0.0633514986,0.936648501,414.3201984,544.6381255,735.1890909,724.311828,1468,172.5029377,2936,-704000,47616,-656384,15
1359,122,20,10,0.0823767725,0.917623228,413.1800231,536.7533749,755.6548933,577.7540984,1481,90.47037263,2962,-695808,62464,-633344,15
1365,97,20,10,0.0663474692,0.933652531,412.5625589,537.5930958,732.9699634,710.814433,1462,125.2784919,2924,-698880,49664,-649216,15
1349,108,20,10,0.0741249142,0.925875086,409.0235427,537.0081486,736.0956264,640.3703704,1457,112.5965997,2914,-690688,55296,-635392,15
1362,114,21,9,0.0772357724,0.922764228,412.1267929,551.2224891,749.1299559,611.5,1476,199.4594595,2952,-697344,58368,-638976,15
1363,98,21,9,0.0670773443,0.932922656,411.084735,547.2716057,734.0733676,688.255102,1461,154.6031746,2922,-697856,50176,-647680,15
1367,120,20,10,0.0806993948,0.919300605,415.4139214,543.9783337,756.3643014,603.15,1487,166.7040359,2974,-699904,61440,-638464,15
1375,117,21,9,0.0784182306,0.921581769,417.3408549,548.808118,757.3025455,619.5470085,1492,216.5457184,2984,-704000,59904,-644096,15
1364,100,20,10,0.0683060109,0.931693989,411.7807368,548.0697104,735.3262463,693.95,1464,129.9023957,2928,-698368,51200,-647168,15
1362,105,20,10,0.0715746421,0.928425358,412.2549855,541.4171087,740.6292217,648.0095238,1467,115.4209284,2934,-697344,53760,-643584,15
839,90,20,10,0.0968783638,0.903121636,258.5269464,306.7253897,481.193087,314.0444444,929,12.0539769,1858,-429568,46080,-383488,15
2169,115,24,6,0.0503502627,0.949649737,649.7497302,814.8991999,1146.914246,1059.243478,2284,288.0201765,4568,-1110528,58880,-1051648,15
2167,101,24,6,0.0445326279,0.955467372,649.0461842,765.3620555,1132.765575,1171.712871,2268,425.5159475,4536,-1109504,51712,-1057792,15
2169,117,22,8,0.0511811024,0.948818898,650.0743075,807.2022723,1151.43384,996.4188034,2286,346.3636364,4572,-1110528,59904,-1050624,15
2232,122,22,8,0.051826678,0.948173322,669.3725997,835.2599624,1184.032258,1057.991803,2354,312.2015915,4708,-1142784,62464,-1080320,15
2157,125,23,7,0.0547765118,0.945223488,646.3890618,822.6190798,1152.159481,957.56,2282,185.2272727,4564,-1104384,64000,-1040384,15
1572,78,23,7,0.0472727273,0.952727273,470.992957,524.984483,836.6342239,601.1025641,1650,34.38216295,3300,-804864,39936,-764928,15
2227,122,22,8,0.0519369945,0.948063006,666.9454852,831.8481651,1185.887741,976.2540984,2349,348.5163205,4698,-1140224,62464,-1077760,15
2171,135,23,7,0.0585429315,0.941457069,651.7299871,824.3058798,1168.192999,917.2148148,2306,370.1444623,4612,-1111552,69120,-1042432,15
2169,121,24,6,0.0528384279,0.947161572,648.7666607,828.033737,1156.378976,950.4876033,2290,302.1108179,4580,-1110528,61952,-1048576,15
2177,130,24,6,0.0563502384,0.943649762,652.7580067,831.9392313,1166.062931,951.9923077,2307,351.1415525,4614,-1114624,66560,-1048064,15
2168,114,24,6,0.0499561788,0.950043821,648.6955914,821.8410421,1146.280443,1050.587719,2282,181.1111111,4564,-1110016,58368,-1051648,15
1440,87,24,6,0.0569744597,0.94302554,432.0036054,459.1889402,783.5145833,441,1527,28.23594675,3054,-737280,44544,-692736,15
2169,108,23,7,0.04743083,0.95256917,648.8343112,805.6178321,1142.590134,1066.898148,2277,189.9082569,4554,-1110528,55296,-1055232,15
2183,118,24,6,0.0512820513,0.948717949,658.4468118,762.9639158,1152.575355,1121.855932,2301,118.8533058,4602,-1117696,60416,-1057280,15
2176,121,23,7,0.0526774053,0.947322595,651.5023426,828.5243998,1157.909007,988.785124,2297,322.1598878,4594,-1114112,61952,-1052160,15
2188,109,23,7,0.0474531998,0.9525468,654.4801701,816.0579276,1150.792962,1113.009174,2297,366.3476874,4594,-1120256,55808,-1064448,15
2180,122,24,6,0.0529973936,0.947002606,652.1582701,842.1072509,1159.855046,1002.204918,2302,268.6114352,4604,-1116160,62464,-1053696,15
2200,116,24,6,0.0500863558,0.949913644,659.1416706,812.3756828,1166.541364,1005.991379,2316,323.4636872,4632,-1126400,59392,-1067008,15
2170,115,23,7,0.0503282276,0.949671772,650.0453952,813.8439052,1148.017972,1048.313043,2285,348.3231707,4570,-1111040,58880,-1052160,15
2187,104,24,6,0.045395024,0.954604976,654.510738,791.4490301,1145.096936,1164.990385,2291,256.838565,4582,-1119744,53248,-1066496,15
1381,104,23,7,0.07003367,0.92996633,419.1016722,521.866814,753.0839971,609.0961538,1485,172.8754366,2970,-707072,53248,-653824,15
1368,92,23,7,0.0630136986,0.936986301,416.1863248,491.196343,733.494152,685.9782609,1460,149.2842536,2920,-700416,47104,-653312,15
1189,66,23,7,0.0525896414,0.947410359,359.3291376,380.7091433,636.5029437,474.8181818,1255,57.07139609,2510,-608768,33792,-574976,15
1373,102,23,7,0.0691525424,0.930847458,416.4384854,534.6540468,740.804807,700.245098,1475,25.77319588,2950,-702976,52224,-650752,15
1417,88,22,8,0.0584717608,0.941528239,430.189179,497.123435,754.9301341,721.9204545,1505,124.5860927,3010,-725504,45056,-680448,15
1369,90,23,7,0.0616860864,0.938313914,414.4032372,508.7342633,734.3535427,663.7777778,1459,217.4366617,2918,-700928,46080,-654848,15
1389,99,23,7,0.0665322581,0.933467742,421.0467721,524.7353944,751.5982721,644.9090909,1488,172.2222222,2976,-711168,50688,-660480,15
1371,94,23,7,0.0641638225,0.935836177,416.5303885,503.2925679,737.003647,674.606383,1465,223.3231707,2930,-701952,48128,-653824,15
1401,91,23,7,0.0609919571,0.939008043,424.2035819,518.3998722,749.5274804,699.8901099,1492,134.2934293,2984,-717312,46592,-670720,15
1371,95,23,7,0.0648021828,0.935197817,415.8133855,514.3101133,737.733771,672.4,1466,230.8661417,2932,-701952,48640,-653312,15
1361,103,23,7,0.0703551913,0.929644809,412.6165907,523.8874004,741.3034533,616.1747573,1464,207.0721358,2928,-696832,52736,-644096,15
1370,101,23,7,0.068660775,0.931339225,416.0300177,513.8674557,744.5532847,619.980198,1471,249.3220339,2942,-701440,51712,-649728,15
1395,102,23,7,0.0681362725,0.931863727,423.4260498,519.7291924,758.6451613,617.0882353,1497,154.1709578,2994,-714240,52224,-662016,15
1381,90,23,7,0.0611828688,0.938817131,418.8874082,504.365854,737.2737147,716.4555556,1471,208.6524823,2942,-707072,46080,-660992,15
1415,90,23,7,0.0598006645,0.940199336,429.1409917,508.6416168,755.8932862,707.5111111,1505,180.0239234,3010,-724480,46080,-678400,15
1410,98,22,8,0.0649867374,0.935013263,427.4911458,525.2174477,761.5049645,653.7142857,1508,184.1269841,3016,-721920,50176,-671744,15
1032,74,22,8,0.0669077758,0.933092224,312.3783197,403.2508667,552.9040698,561.8108108,1106,72.09908735,2212,-528384,37888,-490496,15
1436,106,23,7,0.0687418936,0.931258106,436.5469649,533.3694063,780.5849582,648.4245283,1542,192.2693267,3084,-735232,54272,-680960,15
1429,105,23,7,0.0684485007,0.931551499,434.1310759,546.4659985,770.0209937,733.1904762,1534,27.31481481,3068,-731648,53760,-677888,15
476,59,23,7,0.110280374,0.889719626,150.5131127,160.3809903,278.3214286,184.7288136,535,8.294573643,1070,-243712,30208,-213504,15
1934,175,22,8,0.0829777146,0.917022285,591.6474958,732.6167219,1076.523268,817.1371429,2109,118.9509306,4218,-990208,89600,-900608,15
2072,218,22,8,0.0951965066,0.904803493,650.3802526,742.2322422,1159.401544,1013.37156,2290,151.354924,4580,-1060864,111616,-949248,15
2278,168,22,8,0.068683565,0.931316435,692.4806498,694.5236226,1260.787094,717.9047619,2446,42.87467134,4892,-1166336,86016,-1080320,15
2424,193,22,8,0.0737485671,0.926251433,735.7046536,935.9793001,1328.492162,1064.186528,2617,278.7007455,5234,-1241088,98816,-1142272,15
1980,168,22,8,0.0782122905,0.921787709,603.3488738,772.6678075,1088.285354,912.0297619,2148,161.0194903,4296,-1013760,86016,-927744,15
2426,185,22,8,0.0708540789,0.929145921,734.1742738,955.4282438,1320.109646,1120.972973,2611,340.8616188,5222,-1242112,94720,-1147392,15
2451,182,22,8,0.0691226738,0.930877326,740.9586183,965.2749792,1329.921665,1142.983516,2633,303.3410138,5266,-1254912,93184,-1161728,15
2408,187,22,8,0.072061657,0.927938343,731.0057444,927.1608346,1314.1549,1089.973262,2595,245.2741021,5190,-1232896,95744,-1137152,15
2427,175,22,8,0.067255957,0.932744043,733.2785239,949.7288077,1313.515863,1134.857143,2602,205.2050473,5204,-1242624,89600,-1153024,15
1951,165,22,8,0.0779773157,0.922022684,593.6253991,761.636522,1074.361353,870.9515152,2116,153.7790698,4232,-998912,84480,-914432,15
2261,166,22,8,0.0683971982,0.931602802,688.2395393,767.5849313,1240.111013,858.3554217,2427,84.6824843,4854,-1157632,84992,-1072640,15
2500,226,22,8,0.0829053558,0.917094644,774.4265019,905.9885686,1373.8772,1248.707965,2726,327.6442308,5452,-1280000,115712,-1164288,15
2435,187,22,8,0.0713196034,0.928680397,737.4930529,945.2070611,1329.208214,1080.914439,2622,219.2307692,5244,-1246720,95744,-1150976,15
2114,134,22,8,0.0596085409,0.940391459,638.0962109,680.939443,1150.408704,715.761194,2248,359.68,4496,-1082368,68608,-1013760,15
2424,187,22,8,0.0716200689,0.928379931,744.4745631,864.7730754,1306.455446,1300.096257,2611,280.7526882,5222,-1241088,95744,-1145344,15
2448,175,22,8,0.066717499,0.933282501,740.4945384,935.5430305,1327.127859,1100.382857,2623,374.1797432,5246,-1253376,89600,-1163776,15
2444,192,22,8,0.0728376328,0.927162367,741.1884637,946.1631061,1337.279051,1079.458333,2636,267.0719352,5272,-1251328,98304,-1153024,15
1446,126,22,8,0.0801526718,0.919847328,444.8768501,516.6928248,801.2047026,617.7460317,1572,23.68896926,3144,-740352,64512,-675840,15
1944,165,22,8,0.0782361309,0.921763869,595.1019403,686.2773197,1080.010802,760.3272727,2109,33.0667921,4218,-995328,84480,-910848,15
2423,186,22,8,0.0712916826,0.928708317,732.925204,958.8870171,1319.67891,1113.77957,2609,225.8874459,5218,-1240576,95232,-1145344,15
602,165,21,9,0.215123859,0.784876141,216.6821789,237.8499441,384.9119601,380.6727273,767,52.21238938,1534,-308224,84480,-223744,16
5929,1098,20,10,0.156254447,0.843745553,1998.135128,2001.054507,3364.600101,4320.73224,7027,157.6267384,14054,-3035648,562176,-2473472,16
5806,823,20,10,0.124151456,0.875848544,1939.593059,1712.162756,3335.823458,3168.097205,6629,117.1822521,13258,-2972672,421376,-2551296,16
628,176,19,11,0.218905473,0.781094527,224.5926673,257.0824057,402.7850318,401.4829545,804,81.54158215,1608,-321536,90112,-231424,16
5077,943,20,10,0.156644518,0.843355482,1738.238066,1685.872588,2940.145558,3389.279958,6020,130.5856833,12040,-2599424,482816,-2116608,16
657,188,20,10,0.222485207,0.777514793,240.2538715,255.5331213,417.7945205,441.1914894,845,69.26229508,1690,-336384,96256,-240128,16
609,173,19,11,0.221227621,0.778772379,221.8564518,238.4091481,395.4351396,377.6473988,782,65.43933054,1564,-311808,88576,-223232,16
3963,625,19,11,0.136224935,0.863775065,1333.536578,1249.322808,2323.833712,2108.5008,4588,86.27303498,9176,-2029056,320000,-1709056,16
5556,1014,21,9,0.1543379,0.8456621,1912.028956,1749.311252,3207.695284,3711.814596,6570,123.7055169,13140,-2844672,519168,-2325504,16
628,174,20,10,0.216957606,0.783042394,226.2194212,249.3840511,404.6035032,390.2988506,802,77.33847637,1604,-321536,89088,-232448,16
4911,721,20,10,0.128018466,0.871981534,1645.975789,1478.028891,2803.138668,2907.509015,5632,115.7418824,11264,-2514432,369152,-2145280,16
634,178,19,11,0.219211823,0.780788177,228.2147042,254.9369684,409.5473186,395.6460674,812,51.10132159,1624,-324608,91136,-233472,16
6151,1107,21,9,0.152521356,0.847478644,2066.76717,2107.329459,3500.45456,4346.535682,7258,127.9393619,14516,-3149312,566784,-2582528,16
443,96,20,10,0.178107607,0.821892393,153.6946299,135.8563631,288.0767494,186.5833333,539,34.86416559,1078,-226816,49152,-177664,16
4979,902,20,10,0.153375276,0.846624724,1699.468064,1625.144991,2864.995983,3360.538803,5881,110.3377111,11762,-2549248,461824,-2087424,16
606,177,21,9,0.22605364,0.77394636,221.179467,241.8455741,393.4521452,387.0282486,783,74.92822967,1566,-310272,90624,-219648,16
5639,954,19,11,0.144698923,0.855301077,1888.956858,1875.075006,3194.82621,3900.939203,6593,137.2969596,13186,-2887168,488448,-2398720,16
601,193,21,9,0.243073048,0.756926952,225.8241596,239.4328832,397.9633943,396.0569948,794,70.14134276,1588,-307712,98816,-208896,16
619,173,20,10,0.218434343,0.781565657,223.4902055,246.145138,396.4959612,396.5144509,792,56.45046329,1584,-316928,88576,-228352,16
2938,483,19,11,0.141186787,0.858813213,959.3279362,1095.526307,1660.608237,2017.52381,3421,90.31151003,6842,-1504256,247296,-1256960,16
6531,1256,23,7,0.161294465,0.838705535,2245.860129,2150.036784,3772.17838,4527.453025,7787,136.6380067,15574,-3343872,643072,-2700800,16
7295,1180,23,7,0.139233038,0.860766962,2463.240993,2292.518937,4167.236052,4675.477119,8475,150.7738837,16950,-3735040,604160,-3130880,16
684,173,23,7,0.201866978,0.798133022,240.2303087,273.8898624,429.1418129,428.4393064,857,79.35185185,1714,-350208,88576,-261632,16
547,95,22,8,0.147975078,0.852024922,181.4024391,166.2176439,341.1407678,208.4105263,642,54.17721519,1284,-280064,48640,-231424,16
6710,1256,23,7,0.157670098,0.842329902,2308.526664,2151.08241,3869.435917,4592.871019,7966,141.9458304,15932,-3435520,643072,-2792448,16
4620,786,23,7,0.145394007,0.854605993,1538.717926,1549.618058,2600.090043,3311.329517,5406,109.1680129,10812,-2365440,402432,-1963008,16
694,173,22,8,0.199538639,0.800461361,244.7434472,268.3033127,424.9380403,470.3526012,867,94.34167573,1734,-355328,88576,-266752,16
623,178,22,8,0.222222222,0.777777778,226.2614497,247.5084178,397.8154093,412.1460674,801,65.33442088,1602,-318976,91136,-227840,16
8103,1522,22,8,0.15812987,0.84187013,2804.412714,2569.985773,4711.776626,5351.904731,9625,168.0929095,19250,-4148736,779264,-3369472,16
542,92,23,7,0.14511041,0.85488959,178.9756643,168.9706392,335.7822878,209.7934783,634,21.40445645,1268,-277504,47104,-230400,16
689,184,22,8,0.210767468,0.789232532,246.1087055,271.0572268,429.3047896,465.8152174,873,61.04895105,1746,-352768,94208,-258560,16
516,88,22,8,0.145695364,0.854304636,170.3868137,164.3216459,319.3527132,203.6818182,604,29.4921875,1208,-264192,45056,-219136,16
531,102,22,8,0.161137441,0.838862559,175.9557178,206.3156253,327.3728814,263,633,23.17832296,1266,-271872,52224,-219648,16
657,171,22,8,0.206521739,0.793478261,233.0939701,260.5499362,414.4094368,414.8479532,828,101.9704433,1656,-336384,87552,-248832,16
699,171,23,7,0.196551724,0.803448276,243.966269,278.4795748,437.1616595,428.7076023,870,131.0240964,1740,-357888,87552,-270336,16
4268,814,22,8,0.16017316,0.83982684,1452.066848,1397.762158,2427.186036,3140.875921,5082,96.59760502,10164,-2185216,416768,-1768448,16
6106,1297,22,8,0.175199244,0.824800756,2104.992259,2138.158105,3548.181952,4426.142637,7403,133.4835918,14806,-3126272,664064,-2462208,16
520,94,23,7,0.153094463,0.846905537,173.6956418,162.9783752,325.5307692,207.7553191,614,46.0960961,1228,-266240,48128,-218112,16
708,194,21,9,0.215077605,0.784922395,253.2985941,282.6436626,443.1002825,482.1546392,902,111.91067,1804,-362496,99328,-263168,16
689,173,23,7,0.200696056,0.799303944,240.5783032,279.2719445,432.658926,426.8843931,862,95.14348786,1724,-352768,88576,-264192,16
6679,1194,23,7,0.151657564,0.848342436,2260.679479,2076.834444,3759.818087,4928.120603,7873,138.2926401,15746,-3419648,611328,-2808320,16
6077,1089,22,8,0.151967625,0.848032375,2043.411947,2037.744958,3444.848116,4357.225895,7166,160.5646426,14332,-3111424,557568,-2553856,16
7357,1463,23,7,0.165873016,0.834126984,2556.533013,2320.782541,4245.103983,5242.228298,8820,153.6050157,17640,-3766784,749056,-3017728,16
685,172,23,7,0.200700117,0.799299883,239.4117619,276.8875335,428.1737226,432.2906977,857,80.46948357,1714,-350720,88064,-262656,16
374,26,22,8,0.065,0.935,113.1058297,145.1549723,200.9010695,194.7307692,400,8.154943935,800,-191488,13312,-178176,16
704,167,22,8,0.191733639,0.808266361,243.4997142,282.2274495,433.6065341,446.0898204,871,107.6637824,1742,-360448,85504,-274944,16
715,187,23,7,0.207317073,0.792682927,255.0987371,276.5847254,441.8433566,488.4224599,902,100,1804,-366080,95744,-270336,16
6075,967,23,7,0.137318943,0.862681057,2040.667573,1879.993731,3428.223045,4107.495346,7042,139.1699605,14084,-3110400,495104,-2615296,16
744,206,22,8,0.216842105,0.783157895,267.0355,293.7064426,462.0094086,524.223301,950,127.0053476,1900,-380928,105472,-275456,16
723,206,22,8,0.221743811,0.778256189,261.9970227,286.1928657,455.2102351,499.3592233,929,110.5952381,1858,-370176,105472,-264704,16
386,39,22,8,0.0917647059,0.908235294,119.3519477,149.8335039,215.3393782,189.8461538,425,9.073441503,850,-197632,19968,-177664,16
667,174,23,7,0.206896552,0.793103448,234.9564797,270.6642837,421.065967,420.7471264,841,103.5714286,1682,-341504,89088,-252416,16
726,182,23,7,0.200440529,0.799559471,256.7583521,281.8579365,450.292011,471.2857143,908,83.76383764,1816,-371712,93184,-278528,16
707,163,22,8,0.187356322,0.812643678,245.8874118,272.7740591,434.8925035,438.1349693,870,98.08342728,1740,-361984,83456,-278528,16
3790,630,23,7,0.142533937,0.857466063,1248.639304,1267.761036,2108.920053,2821.592063,4420,116.1019175,8840,-1940480,322560,-1617920,16
625,164,22,8,0.207858048,0.792141952,222.2405363,247.6893824,395.0048,394.9817073,789,69.57671958,1578,-320000,83968,-236032,16
666,173,22,8,0.206197855,0.793802145,234.4059013,270.0945537,419.4204204,422.2312139,839,74.57777778,1678,-340992,88576,-252416,16
671,206,22,8,0.234891676,0.765108324,243.6007561,277.4248093,425.2801788,483.6893204,877,15.46737213,1754,-343552,105472,-238080,16
7247,1221,23,7,0.144189891,0.855810109,2450.807912,2351.59065,4154.664827,4708.345618,8468,153.0453642,16936,-3710464,625152,-3085312,16
490,88,23,7,0.152249135,0.847750865,163.176435,155.4360286,306.3938776,195.4318182,578,9.069512004,1156,-250880,45056,-205824,16
643,163,23,7,0.202233251,0.797766749,227.4442787,252.1454537,401.9393468,409.6564417,806,20.58748404,1612,-329216,83456,-245760,16
271,130,22,8,0.324189526,0.675810474,121.4982582,102.2439191,205.0848708,192.4846154,401,33.61274099,802,-138752,66560,-72192,16
728,185,23,7,0.202628697,0.797371303,256.723,287.8426253,451.3997253,479.0378378,913,96.20653319,1826,-372736,94720,-278016,16
514,92,23,7,0.151815182,0.848184818,171.5532848,154.3775396,322.5252918,197.2065217,606,22.72215973,1212,-263168,47104,-216064,16
673,177,22,8,0.208235294,0.791764706,237.6887414,272.623225,425.48737,425.5480226,850,106.918239,1700,-344576,90624,-253952,16
670,171,22,8,0.20332937,0.79667063,235.2309688,270.3122075,421.2895522,419.8654971,841,102.4360536,1682,-343040,87552,-255488,16
703,172,23,7,0.196571429,0.803428571,244.3162613,283.8544506,436.7311522,443.1860465,875,82.93838863,1750,-359936,88064,-271872,16
602,173,22,8,0.223225806,0.776774194,219.0801914,239.1698839,387.5116279,389.699422,775,74.23371648,1550,-308224,88576,-219648,16
570,171,22,8,0.230769231,0.769230769,210.720562,224.203124,371.3035088,369.9883041,741,54.84826055,1482,-291840,87552,-204288,16
7765,1335,23,7,0.146703297,0.853296703,2663.566043,2340.41468,4464.045332,5053.361798,9100,161.0334454,18200,-3975680,683520,-3292160,16
691,199,22,8,0.223595506,0.776404494,251.0277148,273.919046,436.105644,478.120603,890,110.9725686,1780,-353792,101888,-251904,16
622,161,22,8,0.205619413,0.794380587,220.9526665,244.5713505,390.4083601,398.1490683,783,70.41366906,1566,-318464,82432,-236032,16
5963,1217,23,7,0.169498607,0.830501393,2069.128611,1982.359458,3467.335905,4193.973706,7180,126.7655367,14360,-3053056,623104,-2429952,16
719,174,23,7,0.194848824,0.805151176,251.6979447,281.105181,443.5493741,461.2586207,893,85.45454545,1786,-368128,89088,-279040,16
633,179,22,8,0.22044335,0.77955665,227.8192715,256.316453,405.6966825,409.3407821,812,65.16853933,1624,-324096,91648,-232448,16
641,174,22,8,0.213496933,0.786503067,227.5917109,261.6144417,407.6162246,409.4137931,815,86.97972252,1630,-328192,89088,-239104,16
682,178,23,7,0.206976744,0.793023256,241.1018338,273.905221,429.1979472,435.488764,860,81.43939394,1720,-349184,91136,-258048,16
696,172,22,8,0.198156682,0.801843318,243.8275083,276.1742937,434.216954,435.6453488,868,97.85794814,1736,-356352,88064,-268288,16
7019,1261,23,7,0.152294686,0.847705314,2426.207753,2165.428957,4100.124947,4365.23632,8280,146.4968153,16560,-3593728,645632,-2948096,16
521,88,23,7,0.144499179,0.855500821,171.2186351,166.147015,322.6199616,200.6818182,609,9.327615255,1218,-266752,45056,-221696,16
6517,1087,23,7,0.142951078,0.857048922,2172.337303,2118.753463,3653.994936,4692.847286,7604,135.3988604,15208,-3336704,556544,-2780160,16
649,169,22,8,0.206601467,0.793398533,229.0548693,261.5466741,409.0493066,411.2307692,818,98.31730769,1636,-332288,86528,-245760,16
7515,1246,22,8,0.142221208,0.857778792,2541.887152,2374.301987,4287.930273,4942.331461,8761,153.6747939,17522,-3847680,637952,-3209728,16
704,186,23,7,0.208988764,0.791011236,251.3320304,274.630141,436.90625,478.0268817,890,71.60096541,1780,-360448,95232,-265216,16
673,168,22,8,0.199762188,0.800237812,236.5355917,266.2639428,419.884101,425.4702381,841,94.28251121,1682,-344576,86016,-258560,16
4794,637,24,6,0.117289634,0.882710366,1542.138671,1656.271811,2645.90947,3243.494505,5431,110.9046355,10862,-2454528,326144,-2128384,16
4090,435,23,7,0.0961325967,0.903867403,1301.29574,1309.67589,2229.064303,2582.073563,4525,94.29047718,9050,-2094080,222720,-1871360,16
684,173,23,7,0.201866978,0.798133022,240.005608,274.6637675,428.6418129,430.416185,857,92.05155747,1714,-350208,88576,-261632,16
649,165,23,7,0.202702703,0.797297297,227.6152062,261.9264979,406.6548536,410.8242424,814,103.562341,1628,-332288,84480,-247808,16
6145,1044,24,6,0.145221867,0.854778133,2056.729227,2040.216072,3473.7738,4308.539272,7189,125.4405863,14378,-3146240,534528,-2611712,16
664,168,22,8,0.201923077,0.798076923,233.3709776,265.3762522,416.5888554,416.1488095,832,91.32821076,1664,-339968,86016,-253952,16
616,170,23,7,0.216284987,0.783715013,220.9953592,246.9399325,391.2597403,401.6176471,786,105.0802139,1572,-315392,87040,-228352,16
6303,1198,23,7,0.159712038,0.840287962,2139.335012,2085.69634,3583.171823,4633.989149,7501,130.6794425,15002,-3227136,613376,-2613760,16
495,136,22,8,0.215530903,0.784469097,170.2194013,218.0709525,308.5737374,343.0294118,631,57.67824497,1262,-253440,69632,-183808,16
526,107,22,8,0.169036335,0.830963665,175.0379181,213.3757379,323.918251,282.9906542,633,27.52173913,1266,-269312,54784,-214528,16
658,173,23,7,0.208182912,0.791817088,232.5867051,265.5890162,413.3176292,426.2023121,831,78.76777251,1662,-336896,88576,-248320,16
4807,788,24,6,0.140840036,0.859159964,1575.342942,1638.468242,2671.000208,3572.730964,5595,97.6269412,11190,-2461184,403456,-2057728,16
666,172,22,8,0.205250597,0.794749403,235.2409746,266.1596114,419.4459459,419.7093023,838,72.1791559,1676,-340992,88064,-252928,16
5690,1026,22,8,0.152769506,0.847230494,1910.359536,1927.616168,3224.803691,4099.954191,6716,127.1488073,13432,-2913280,525312,-2387968,16
4930,823,22,8,0.143055797,0.856944203,1629.648766,1721.109372,2778.188235,3468.910085,5753,112.0787064,11506,-2524160,421376,-2102784,16
646,170,23,7,0.208333333,0.791666667,230.4966731,253.1101231,403.8869969,426.0294118,816,89.67032967,1632,-330752,87040,-243712,16
659,175,22,8,0.209832134,0.790167866,233.4376509,266.5125978,417.4081942,417.8457143,834,86.42487047,1668,-337408,89600,-247808,16
653,174,22,8,0.210399033,0.789600967,233.0103779,259.0814981,413.517611,415.8103448,827,97.29411765,1654,-334336,89088,-245248,16
6364,1463,21,9,0.186917082,0.813082918,2284.941028,2079.97054,3805.259899,4387.015721,7827,136.0744089,15654,-3258368,749056,-2509312,16
685,183,23,7,0.210829493,0.789170507,243.4205711,275.6499787,433.3868613,438.6666667,868,88.21138211,1736,-350720,93696,-257024,16
673,174,23,7,0.205430933,0.794569067,237.533851,269.7522914,422.9687964,427.9885057,847,74.4288225,1694,-344576,89088,-255488,16
5291,977,23,7,0.155871091,0.844128909,1820.531272,1688.294314,3057.660934,3550.626407,6268,126.3454949,12536,-2708992,500224,-2208768,16
2580,499,23,7,0.162065606,0.837934394,869.6065932,921.1367404,1479.620543,1852.182365,3079,91.28372369,6158,-1320960,255488,-1065472,16
5677,1211,23,7,0.175813008,0.824186992,1956.26317,1968.024999,3285.421173,4190.239472,6888,122.4098098,13776,-2906624,620032,-2286592,16
3951,503,23,7,0.112932196,0.887067804,1256.768892,1323.662798,2144.421665,2880.069583,4454,98.583444,8908,-2022912,257536,-1765376,16
660,168,22,8,0.202898551,0.797101449,231.9530828,264.9717302,414.880303,413.0059524,828,82.224429,1656,-337920,86016,-251904,16
657,167,22,8,0.202669903,0.797330097,231.6022634,260.9923746,413.8812785,407.0658683,824,77.00934579,1648,-336384,85504,-250880,16
627,171,23,7,0.214285714,0.785714286,224.4849775,250.4220875,396.4593301,410.6491228,798,38.01810386,1596,-321024,87552,-233472,16
7161,1482,23,7,0.17146824,0.82853176,2482.396119,2434.077804,4175.600196,5029.401484,8643,152.1922874,17286,-3666432,758784,-2907648,16
656,174,23,7,0.209638554,0.790361446,232.3829778,265.0215558,414.6067073,418.8678161,830,120.1157742,1660,-335872,89088,-246784,16
2938,462,23,7,0.135882353,0.864117647,963.7048502,1012.558924,1642.372362,2070.151515,3400,77.34303913,6800,-1504256,236544,-1267712,16
662,166,22,8,0.200483092,0.799516908,231.5335367,266.8066106,414.3897281,414.939759,828,100.3636364,1656,-338944,84992,-253952,16
615,168,23,7,0.214559387,0.785440613,221.1117232,243.1265941,390.5739837,397.2202381,783,55.17970402,1566,-314880,86016,-228864,16
651,163,22,8,0.2002457,0.7997543,227.248875,263.3401975,404.8218126,418.196319,814,69.10016978,1628,-333312,83456,-249856,16
682,201,23,7,0.227633069,0.772366931,251.1366285,265.7545997,434.627566,467.0149254,883,79.69314079,1766,-349184,102912,-246272,16
4543,574,23,7,0.112175103,0.887824897,1460.122691,1588.063233,2530.856262,2781.747387,5117,91.29348796,10234,-2326016,293888,-2032128,16
709,193,23,7,0.213968958,0.786031042,253.2403255,282.804206,442.7898449,483.4974093,902,89.30693069,1804,-363008,98816,-264192,16
668,158,22,8,0.191283293,0.808716707,231.6458983,265.1372112,411.6886228,421.1582278,826,59.46724262,1652,-342016,80896,-261120,16
652,178,23,7,0.214457831,0.785542169,233.7483965,259.8375784,413.993865,421.0168539,830,80.89668616,1660,-333824,91136,-242688,16
116,56,23,7,0.325581395,0.674418605,49.47299781,48.99489444,82.50862069,94.76785714,172,22.48366013,344,-59392,28672,-30720,16
8067,1423,24,6,0.149947313,0.850052687,2738.547198,2618.105985,4611.292798,5506.321855,9490,165.9671214,18980,-4130304,728576,-3401728,16
670,173,23,7,0.205219454,0.794780546,237.0289852,266.4178867,422.6328358,419.5491329,843,95.46998867,1686,-343040,88576,-254464,16
498,90,23,7,0.153061224,0.846938776,166.9308946,147.5744671,312.9216867,192.5666667,588,40.57971014,1176,-254976,46080,-208896,16
577,177,22,8,0.234748011,0.765251989,214.2217178,228.4951013,378.2668977,375,754,89.33649289,1508,-295424,90624,-204800,16
8113,1375,24,6,0.144919899,0.855080101,2713.608837,2671.481589,4574.236904,5749.114182,9488,169.2774309,18976,-4153856,704000,-3449856,16
625,180,23,7,0.223602484,0.776397516,227.8560861,247.3033187,400.7616,410.7722222,805,78.46003899,1610,-320000,92160,-227840,16
677,174,22,8,0.204465335,0.795534665,238.0523348,273.2546086,426.4756278,424.1494253,851,106.7754078,1702,-346624,89088,-257536,16
7530,1172,23,7,0.134681682,0.865318318,2489.168738,2482.68943,4215.532802,5225.077645,8702,151.8143754,17404,-3855360,600064,-3255296,16
669,164,22,8,0.196878752,0.803121248,233.5600615,266.4252366,413.9252616,429.5426829,833,61.2950699,1666,-342528,83968,-258560,16
654,172,23,7,0.208232446,0.791767554,231.5329116,262.3507902,408.9311927,430.872093,826,42.82011405,1652,-334848,88064,-246784,16
2156,252,23,7,0.104651163,0.895348837,693.954745,696.0911754,1216.92718,1098.178571,2408,42.37198663,4816,-1103872,129024,-974848,16
7929,1202,24,6,0.13163947,0.86836053,2641.189555,2388.647783,4420.702106,5524.458403,9131,168.9987044,18262,-4059648,615424,-3444224,16
657,177,22,8,0.212230216,0.787769784,233.1505352,267.0436602,416.2526636,422.1299435,834,80.42430087,1668,-336384,90624,-245760,16
4871,658,24,6,0.119008862,0.880991138,1570.407468,1667.360323,2687.949086,3335.387538,5529,101.6360294,11058,-2493952,336896,-2157056,16
472,91,24,6,0.161634103,0.838365897,160.252205,142.9668607,299.4555085,191.4615385,563,23.79543533,1126,-241664,46592,-195072,16
8253,1450,23,7,0.149438318,0.850561682,2773.26757,2773.317176,4687.174361,5790.142069,9703,178.9891164,19406,-4225536,742400,-3483136,16
636,171,22,8,0.211895911,0.788104089,226.7653024,254.6833966,403.8915094,404.4035088,807,89.46784922,1614,-325632,87552,-238080,16
658,179,22,8,0.21385902,0.78614098,233.9542175,267.7949335,416.9893617,426.3910615,837,55.91182365,1674,-336896,91648,-245248,16
629,167,22,8,0.209798995,0.790201005,222.9839716,253.6454963,396.6168521,405.5928144,796,71.32616487,1592,-322048,85504,-236544,16
6785,983,23,7,0.126544799,0.873455201,2219.458325,2330.972312,3810.032277,4398.501526,7768,137.0017637,15536,-3473920,503296,-2970624,16
622,178,23,7,0.2225,0.7775,226.9874131,244.2235357,401.403537,397.3426966,800,89.58566629,1600,-318464,91136,-227328,16
703,177,23,7,0.201136364,0.798863636,246.6812481,281.3449189,440.3072546,441.2655367,880,86.95652174,1760,-359936,90624,-269312,16
659,168,22,8,0.203143894,0.796856106,231.1024838,266.569139,414.0091047,413.9642857,827,63.95978345,1654,-337408,86016,-251392,16
675,172,22,8,0.203069658,0.796930342,236.737812,272.8442771,423.1422222,427.3662791,847,93.69469027,1694,-345600,88064,-257536,16
3043,383,23,7,0.111792177,0.888207823,984.6036377,1022.943331,1710.44627,1737.762402,3426,129.8219022,6852,-1558016,196096,-1361920,16
8353,1523,23,7,0.154212232,0.845787768,2796.689814,2928.063321,4752.132886,5960.643467,9876,183.7053571,19752,-4276736,779776,-3496960,16
7972,1398,23,7,0.149199573,0.850800427,2669.620743,2467.50303,4439.728424,6086.995708,9370,166.1347518,18740,-4081664,715776,-3365888,16
7752,1350,23,7,0.148319051,0.851680949,2601.710345,2513.368848,4363.94582,5628.477778,9102,165.3405995,18204,-3969024,691200,-3277824,16
671,197,23,7,0.226958525,0.773041475,245.6715757,264.5370526,425.9985097,463.4568528,868,85.01469148,1736,-343552,100864,-242688,16
8535,1327,23,7,0.134556885,0.865443115,2864.049905,2583.301348,4801.965085,5764.642803,9862,355.0035997,19724,-4369920,679424,-3690496,16
523,116,22,8,0.181533646,0.818466354,171.8895191,231.0894363,314.2332696,346,639,23.64914878,1278,-267776,59392,-208384,16
8601,1273,23,7,0.128924448,0.871075552,2863.611475,2677.0149,4845.107662,5561.747054,9874,326.521164,19748,-4403712,651776,-3751936,16
609,179,22,8,0.22715736,0.77284264,221.105541,247.5991546,391.2101806,405.6927374,788,69.30518909,1576,-311808,91648,-220160,16
8446,1437,23,7,0.145401194,0.854598806,2867.721415,2557.368105,4776.771489,5913.134308,9883,201.0783316,19766,-4324352,735744,-3588608,16
476,89,23,7,0.157522124,0.842477876,159.9638772,146.507322,300.6344538,188.6853933,565,8.581409478,1130,-243712,45568,-198144,16
589,165,20,10,0.218832891,0.781167109,215.9942118,223.3542534,375.4414261,384.8484848,754,66.25659051,1508,-301568,84480,-217088,16
606,185,20,10,0.233881163,0.766118837,227.0700584,231.8823157,391.6270627,410.3243243,791,70.06200177,1582,-310272,94720,-215552,16
639,177,20,10,0.216911765,0.783088235,229.3013574,256.864916,407.7402191,411.2429379,816,90.46563193,1632,-327168,90624,-236544,16
9234,711,23,7,0.0714932127,0.928506787,2833.508648,3257.768132,4926.246589,5580.202532,9945,619.6261682,19890,-4727808,364032,-4363776,16
625,170,21,9,0.213836478,0.786163522,227.1047107,237.3624846,393.5344,414.4176471,795,54.63917526,1590,-320000,87040,-232960,16
9173,777,22,8,0.0780904523,0.921909548,2818.229535,3378.993124,4919.963371,5631.146718,9950,1173.349057,19900,-4696576,397824,-4298752,16
9318,632,24,6,0.0635175879,0.936482412,2838.756751,3304.945507,4949.78944,5354.568038,9950,959.4985535,19900,-4770816,323584,-4447232,16
628,176,20,10,0.218905473,0.781094527,227.0377267,249.1918409,400.6480892,409.1079545,804,95.94272076,1608,-321536,90112,-231424,16
651,173,21,9,0.209951456,0.790048544,235.0807316,247.2616945,407.7542243,430.3583815,824,57.02422145,1648,-333312,88576,-244736,16
666,199,20,10,0.230057803,0.769942197,245.5562746,261.463428,425.2957958,458.7839196,865,98.97025172,1730,-340992,101888,-239104,16
9237,713,23,7,0.0716582915,0.928341709,2833.498181,3318.259316,4950.959944,5293.419355,9950,732.1559971,19900,-4729344,365056,-4364288,16
9227,724,24,6,0.0727565069,0.927243493,2835.440904,3295.090658,4952.361764,5277.256906,9951,1020.615385,19902,-4724224,370688,-4353536,16
622,189,21,9,0.233045623,0.766954377,233.1347646,235.9856697,399.3279743,427.957672,811,36.10863758,1622,-318464,96768,-221696,16
665,187,20,10,0.219483568,0.780516432,253.4801589,208.8713547,441.1819549,374.2887701,852,62.83185841,1704,-340480,95744,-244736,16
440,89,20,10,0.168241966,0.831758034,151.0460783,133.7351695,281.4295455,183.7752809,529,24.77751756,1058,-225280,45568,-179712,16
2071,199,22,8,0.0876651982,0.912334802,655.8466757,540.0131738,1168.621439,790.8040201,2270,39.57461646,4540,-1060352,101888,-958464,16
9222,731,24,6,0.0734451924,0.926554808,2826.893165,3379.061792,4945.925504,5369.023256,9953,594.2089552,19906,-4721664,374272,-4347392,16
461,87,21,9,0.158759124,0.841240876,155.049053,148.2397586,290.2407809,191.091954,548,46.32290786,1096,-236032,44544,-191488,16
583,175,19,11,0.230870712,0.769129288,214.1738358,233.4981047,377.5574614,385.9714286,758,74.45972495,1516,-298496,89600,-208896,16
399,86,20,10,0.177319588,0.822680412,137.799028,129.5643807,257.7092732,174.755814,485,7.519379845,970,-204288,44032,-160256,16
517,98,19,11,0.159349593,0.840650407,172.7040015,161.0636155,328.9303675,197.5816327,615,62.43654822,1230,-264704,50176,-214528,16
8587,1289,20,10,0.130518429,0.869481571,2905.388837,2374.828488,4849.888902,5528.805275,9876,252.5185375,19752,-4396544,659968,-3736576,16
8373,1478,20,10,0.150035529,0.849964471,2866.533866,2674.800888,4854.157052,5332.996617,9851,355.7602022,19702,-4286976,756736,-3530240,16
8436,1415,20,10,0.14364024,0.85635976,2856.63028,2712.330609,4842.123992,5426.055124,9851,266.6035183,19702,-4319232,724480,-3594752,16
472,92,20,10,0.163120567,0.836879433,157.810085,164.9208133,297.9809322,203.076087,564,30.45356371,1128,-241664,47104,-194560,16
606,179,20,10,0.228025478,0.771974522,221.3619857,243.0499229,397,379.4581006,785,61.56862745,1570,-310272,91648,-218624,16
669,173,19,11,0.205463183,0.794536817,235.2934917,270.6559329,424.7623318,408.8843931,842,89.86125934,1684,-342528,88576,-253952,16
698,202,20,10,0.224444444,0.775555556,253.1252658,280.7979294,444.8237822,470.1138614,900,106.0070671,1800,-357376,103424,-253952,16
8066,1276,20,10,0.136587455,0.863412545,2712.720932,2560.459579,4610.452393,5057.401254,9342,164.7328513,18684,-4129792,653312,-3476480,16
8218,1325,20,10,0.138845227,0.861154773,2773.440231,2576.015542,4688.025675,5292.830943,9543,168.8428875,19086,-4207616,678400,-3529216,16
7603,1359,19,11,0.151640259,0.848359741,2576.75553,2524.447728,4351.936735,5206.348786,8962,157.8372666,17924,-3892736,695808,-3196928,16
734,199,20,10,0.213290461,0.786709539,262.1359572,293.2135942,460.746594,490.0653266,933,84.05405405,1866,-375808,101888,-273920,16
703,181,19,11,0.204751131,0.795248869,246.1797396,287.2258425,445.455192,431.0220994,884,75.74978578,1768,-359936,92672,-267264,16
691,182,20,10,0.208476518,0.791523482,244.1825375,279.679018,438.5296671,431.1923077,873,88.7195122,1746,-353792,93184,-260608,16
672,179,20,10,0.210340776,0.789659224,237.8720425,272.795609,428.0386905,418.3463687,851,77.85910339,1702,-344064,91648,-252416,16
667,185,20,10,0.21713615,0.78286385,238.6707673,270.5757044,426.2278861,427.4810811,852,44.93670886,1704,-341504,94720,-246784,16
730,201,20,10,0.215896885,0.784103115,261.3316261,293.2731836,460.4671233,486.0945274,931,67.46376812,1862,-373760,102912,-270848,16
677,162,20,10,0.193087008,0.806912992,234.8250511,270.8435344,419.6824225,421.3271605,839,85.26422764,1678,-346624,82944,-263680,16
718,194,20,10,0.212719298,0.787280702,255.9491245,287.7217072,450.6309192,478.2216495,912,39.79057592,1824,-367616,99328,-268288,16
683,199,20,10,0.225623583,0.774376417,247.6899762,276.1400225,435.7335286,461.2914573,882,101.9653179,1764,-349696,101888,-247808,16
5568,280,20,10,0.047879617,0.952120383,1677.585724,1749.856927,2959.074533,2236.960714,5848,596.1264016,11696,-2850816,143360,-2707456,17
4530,267,19,11,0.0556597874,0.944340213,1371.715628,1523.902523,2424.999779,1957.88015,4797,87.10731796,9594,-2319360,136704,-2182656,17
5835,301,19,11,0.0490547588,0.950945241,1759.867591,1824.786715,3107.172237,2318.82392,6136,299.7557401,12272,-2987520,154112,-2833408,17
5406,284,19,11,0.0499121265,0.950087873,1631.680953,1692.349497,2882.143914,2147.975352,5690,688.8619855,11380,-2767872,145408,-2622464,17
5435,283,20,10,0.0494928297,0.95050717,1640.401014,1703.276363,2894.336155,2190.473498,5718,461.5012107,11436,-2782720,144896,-2637824,17
5867,297,19,11,0.0481829981,0.951817002,1766.79846,1859.904513,3120.412988,2333.558923,6164,148.4943387,12328,-3003904,152064,-2851840,17
3139,201,20,10,0.0601796407,0.939820359,957.4294841,1004.528641,1692.269513,1330.527363,3340,204.1564792,6680,-1607168,102912,-1504256,17
4229,247,19,11,0.0551831993,0.944816801,1282.677101,1325.422146,2271.045637,1681.271255,4476,181.1412384,8952,-2165248,126464,-2038784,17
5056,265,19,11,0.0498026687,0.950197331,1527.807087,1567.754674,2692.61254,2057.856604,5321,532.1,10642,-2588672,135680,-2452992,17
6089,304,20,10,0.04755201,0.95244799,1833.36795,1915.920684,3235.646083,2422.934211,6393,628.6135693,12786,-3117568,155648,-2961920,17
4248,245,20,10,0.0545292677,0.945470732,1288.887832,1368.573921,2270.376412,1841.681633,4493,434.5261122,8986,-2174976,125440,-2049536,17
4545,260,20,10,0.0541103018,0.945889698,1377.497274,1427.009627,2435.959296,1826.846154,4805,515.0053591,9610,-2327040,133120,-2193920,17
4258,250,20,10,0.0554569654,0.944543035,1291.84077,1342.61212,2286.310709,1712.7,4508,387.2852234,9016,-2180096,128000,-2052096,17
5640,288,20,10,0.048582996,0.951417004,1699.792147,1797.132718,2998.472163,2299.211806,5928,547.3684211,11856,-2887680,147456,-2740224,17
1645,119,20,10,0.0674603175,0.932539683,498.0415393,594.4853899,899.8358663,642.8571429,1764,36.19946645,3528,-842240,60928,-781312,17
224,52,20,10,0.188405797,0.811594203,79.49851076,71.95432014,146.0133929,106.1346154,276,15.24019879,552,-114688,26624,-88064,17
6089,301,20,10,0.0471048513,0.952895149,1832.193451,1941.747737,3231.533914,2466.561462,6390,578.280543,12780,-3117568,154112,-2963456,17
5248,272,20,10,0.0492753623,0.950724638,1582.364007,1670.572583,2793.636242,2121.165441,5520,529.2425695,11040,-2686976,139264,-2547712,17
4892,257,20,10,0.0499126044,0.950087396,1477.962213,1537.045705,2604.070523,2021.642023,5149,437.4681393,10298,-2504704,131584,-2373120,17
1260,114,20,10,0.0829694323,0.917030568,383.4545976,496.3434998,701.102381,537.1578947,1374,17.14285714,2748,-645120,58368,-586752,17
2699,221,19,11,0.0756849315,0.924315068,831.8322573,922.369383,1483.690626,1177.280543,2920,126.9013472,5840,-1381888,113152,-1268736,17
1868,187,20,10,0.0909975669,0.909002433,571.1847908,779.9333349,1027.640792,1031.588235,2055,128.5178236,4110,-956416,95744,-860672,17
1835,216,20,10,0.105314481,0.894685519,564.3554871,778.71863,1011.720436,1147.310185,2051,170.066335,4102,-939520,110592,-828928,17
2702,224,20,10,0.0765550239,0.923444976,831.0141712,959.2791244,1484.445966,1210.839286,2926,260.0888889,5852,-1383424,114688,-1268736,17
2715,217,20,10,0.0740109141,0.925989086,833.792986,965.2149631,1483.641252,1252.036866,2932,295.2668681,5864,-1390080,111104,-1278976,17
2765,218,20,10,0.0730807911,0.926919209,847.9099058,973.789933,1513.410488,1220.440367,2983,228.7576687,5966,-1415680,111616,-1304064,17
2697,209,20,10,0.0719201652,0.928079835,828.0469193,946.5361376,1468.624768,1258.325359,2906,200.275672,5812,-1380864,107008,-1273856,17
2688,222,20,10,0.0762886598,0.92371134,826.4659636,941.128828,1479.829241,1160.918919,2910,207.7087794,5820,-1376256,113664,-1262592,17
2723,217,20,10,0.0738095238,0.926190476,838.2281202,945.1591409,1487.433346,1258.013825,2940,293.4131737,5880,-1394176,111104,-1283072,17
2707,233,19,11,0.0792517007,0.920748299,833.4241064,971.7861352,1493.052826,1208.480687,2940,269.4775435,5880,-1385984,119296,-1266688,17
2843,234,20,10,0.0760480988,0.923951901,871.7076181,1050.246194,1554.7777,1347.307692,3077,54.15346709,6154,-1455616,119808,-1335808,17
1867,181,20,10,0.0883789063,0.911621094,569.2808555,782.2068782,1025.580075,1013.359116,2048,164.1025641,4096,-955904,92672,-863232,17
2711,215,19,11,0.0734791524,0.926520848,831.8880367,957.8203647,1483.127628,1216.009302,2926,296.7545639,5852,-1388032,110080,-1277952,17
1830,184,20,10,0.0913604767,0.908639523,560.1951293,760.7082683,1007.416393,1008.331522,2014,209.7916667,4028,-936960,94208,-842752,17
1835,180,19,11,0.0893300248,0.910669975,560.6356038,763.7885687,1008.66594,1001.211111,2015,186.9202226,4030,-939520,92160,-847360,17
2785,222,20,10,0.0738277353,0.926172265,855.6755491,967.1103304,1526.458169,1222.261261,3007,278.6839666,6014,-1425920,113664,-1312256,17
2775,216,19,11,0.0722166499,0.92778335,850.1291954,972.1617282,1518.883604,1202.009259,2991,220.5752212,5982,-1420800,110592,-1310208,17
2704,220,20,10,0.0752393981,0.924760602,829.501597,974.2107655,1482.199704,1220.372727,2924,191.9894944,5848,-1384448,112640,-1271808,17
2871,216,19,11,0.0699708455,0.930029155,880.0619075,994.0703952,1562.746778,1294.824074,3087,337.0087336,6174,-1469952,110592,-1359360,17
1438,128,19,11,0.0817369093,0.918263091,441.3789677,494.9989956,805.5125174,536.203125,1566,19.46308725,3132,-736256,65536,-670720,17
1944,185,20,10,0.086895256,0.913104744,596.3830262,753.9155743,1083.414609,871.4972973,2129,138.7874837,4258,-995328,94720,-900608,17
1853,184,19,11,0.0903289151,0.909671085,567.049895,767.8253726,1017.392876,1035.184783,2037,186.5384615,4074,-948736,94208,-854528,17
1835,178,20,10,0.088425236,0.911574764,561.053885,756.2391648,1003.015804,1048.073034,2013,183.6678832,4026,-939520,91136,-848384,17
1861,178,20,10,0.0872976949,0.912702305,567.5818182,775.004183,1020.032778,1019.657303,2039,134.4100198,4078,-952832,91136,-861696,17
1952,179,20,10,0.0839981229,0.916001877,597.6014785,767.6348304,1078.860143,925.7597765,2131,232.6419214,4262,-999424,91648,-907776,17
1957,180,19,11,0.0842302293,0.915769771,600.0215695,765.4661869,1080.782831,940.8944444,2137,175.5957272,4274,-1001984,92160,-909824,17
1957,177,19,11,0.0829428304,0.91705717,598.2873833,764.8856185,1083.161472,894.3389831,2134,70.38258575,4268,-1001984,90624,-911360,17
1826,178,20,10,0.0888223553,0.911177645,556.5978179,767.2953922,1005.471522,972.0168539,2004,169.6867062,4008,-934912,91136,-843776,17
1969,174,19,11,0.081194587,0.918805413,601.4114045,768.3703886,1086.682072,905.8563218,2143,228.2215122,4286,-1008128,89088,-919040,17
1984,191,20,10,0.087816092,0.912183908,609.4463535,768.461498,1106.493448,895.9005236,2175,189.625109,4350,-1015808,97792,-918016,17
1954,182,20,10,0.0852059925,0.914794007,596.8517994,780.650335,1083.461105,907.8736264,2136,132.2600619,4272,-1000448,93184,-907264,17
1938,173,20,10,0.0819516817,0.918048318,592.5603661,765.0327648,1065.651187,947.8843931,2111,190.0090009,4222,-992256,88576,-903680,17
1935,183,20,10,0.0864022663,0.913597734,591.5486306,772.5893019,1075.056331,895.010929,2118,116.2458836,4236,-990720,93696,-897024,17
1966,183,19,11,0.0851558865,0.914844114,603.0640023,768.250862,1088.207528,933.1092896,2149,121.1386697,4298,-1006592,93696,-912896,17
1959,183,20,10,0.0854341737,0.914565826,598.5933193,787.011188,1084.206738,935.4754098,2142,102.0972355,4284,-1003008,93696,-909312,17
1823,179,20,10,0.0894105894,0.910589411,556.1407275,765.1989852,1002.452002,991.8044693,2002,172.5862069,4004,-933376,91648,-841728,17
1948,175,20,10,0.0824305228,0.917569477,596.2605906,766.6796665,1071.096509,960.7428571,2123,238.0044843,4246,-997376,89600,-907776,17
1964,188,20,10,0.0873605948,0.912639405,602.2884142,768.1346351,1094.32332,890.3031915,2152,176.3934426,4304,-1005568,96256,-909312,17
1951,183,19,11,0.0857544517,0.914245548,598.446668,762.2386389,1082.013839,912.7650273,2134,152.6466381,4268,-998912,93696,-905216,17
1835,190,20,10,0.0938271605,0.90617284,563.8525895,755.9550713,1013.121526,1011.826316,2025,156.855151,4050,-939520,97280,-842240,17
6804,574,20,10,0.0777988615,0.922201139,2071.240561,2589.90081,3619.477513,4519.522648,7378,129.5294944,14756,-3483648,293888,-3189760,17
2260,192,20,10,0.0783034258,0.921696574,692.5709952,867.1699877,1228.484513,1203.140625,2452,144.2352941,4904,-1157120,98304,-1058816,17
1993,177,21,9,0.0815668203,0.91843318,609.0004296,796.2656433,1087.84295,1059.118644,2170,166.0290742,4340,-1020416,90624,-929792,17
2130,177,20,10,0.0767230169,0.923276983,649.9594814,831.9385848,1159.642254,1086.101695,2307,150.3911343,4614,-1090560,90624,-999936,17
6929,591,20,10,0.0785904255,0.921409574,2110.227888,2652.417408,3691.061336,4574.612521,7520,133.1916401,15040,-3547648,302592,-3245056,17
6334,366,20,10,0.0546268657,0.945373134,1912.659961,2232.840969,3374.608147,2933.284153,6700,150.1905402,13400,-3243008,187392,-3055616,17
6424,373,20,10,0.0548771517,0.945122848,1938.697279,2319.832595,3410.599004,3199.235925,6797,156.6851083,13594,-3289088,190976,-3098112,17
7635,770,20,10,0.0916121356,0.908387864,2367.47691,2722.739582,4094.658939,5277.264935,8405,148.3671668,16810,-3909120,394240,-3514880,17
6365,381,20,10,0.0564779128,0.943522087,1922.807558,2309.534573,3386.321917,3159.296588,6746,156.4471243,13492,-3258880,195072,-3063808,17
2113,183,20,10,0.0797038328,0.920296167,647.7023977,816.8672627,1150.26408,1128.131148,2296,228.9132602,4592,-1081856,93696,-988160,17
6104,372,20,10,0.057442866,0.942557134,1847.691858,2190.894695,3247.391055,3092.610215,6476,152.2331923,12952,-3125248,190464,-2934784,17
8200,787,20,10,0.0875709358,0.912429064,2556.809309,2787.714867,4403.588171,5436.029225,8987,164.9596182,17974,-4198400,402944,-3795456,17
6390,361,20,10,0.0534735595,0.946526441,1925.796605,2315.696228,3383.031612,3251.534626,6751,153.0491952,13502,-3271680,184832,-3086848,17
5695,616,20,10,0.0976073522,0.902392648,1821.923489,1763.608646,3109.414925,3586.685065,6311,112.0163294,12622,-2915840,315392,-2600448,17
2193,189,20,10,0.0793450882,0.920654912,670.3241818,861.238132,1196.518012,1133.275132,2382,130.0218341,4764,-1122816,96768,-1026048,17
6293,365,20,10,0.0548212676,0.945178732,1900.343535,2261.144383,3334.678214,3240.221918,6658,139.0850219,13316,-3222016,186880,-3035136,17
6222,361,21,9,0.0548382197,0.94516178,1879.294484,2209.04579,3310.100611,2980.027701,6583,151.8569781,13166,-3185664,184832,-3000832,17
6403,381,20,10,0.0561615566,0.943838443,1934.303048,2315.354708,3405.288146,3177.585302,6784,135.1394422,13568,-3278336,195072,-3083264,17
2098,186,20,10,0.0814360771,0.918563923,640.584687,840.505754,1147.293613,1088.430108,2284,143.018159,4568,-1074176,95232,-978944,17
1373,120,20,10,0.0803750837,0.919624916,419.9016549,515.9115008,760.9140568,587.8,1493,17.98145249,2986,-702976,61440,-641536,17
9389,568,22,8,0.0570452948,0.942954705,2849.591683,2830.92503,5073.525722,3416.496479,9957,200.7459677,19914,-4807168,290816,-4516352,17
9426,533,22,8,0.0535194297,0.94648057,2850.122696,3066.816968,5044.388818,3841.296435,9959,709.8360656,19918,-4826112,272896,-4553216,17
2678,273,22,8,0.0925110132,0.907488987,852.325483,790.5976786,1505.648992,1185.157509,2951,53.98829126,5902,-1371136,139776,-1231360,17
109,12,23,7,0.0991735537,0.900826446,33.22607494,46.29944804,62.19266055,50.16666667,121,15.85845347,242,-55808,6144,-49664,17
9483,481,22,8,0.0482737856,0.951726214,2853.312582,3058.113982,5043.601708,3777.869023,9964,879.435128,19928,-4855296,246272,-4609024,17
9371,581,21,9,0.0583802251,0.941619775,2844.152863,3054.643255,5051.955928,3759.464716,9952,831.411863,19904,-4797952,297472,-4500480,17
9351,603,22,8,0.0605786618,0.939421338,2843.811113,2986.381413,5065.18351,3617.751244,9954,715.0862069,19908,-4787712,308736,-4478976,17
966,115,21,9,0.106382979,0.893617021,308.5300251,287.7162302,561.4399586,369.3043478,1081,19.43196117,2162,-494592,58880,-435712,17
9381,576,22,8,0.0578487496,0.94215125,2845.382232,2999.653541,5062.464663,3619.65625,9957,947.3834443,19914,-4803072,294912,-4508160,17
9354,599,22,8,0.0601828594,0.939817141,2845.70764,2940.567837,5066.145179,3584.906511,9953,881.5766165,19906,-4789248,306688,-4482560,17
9389,568,21,9,0.0570452948,0.942954705,2844.876203,3037.382103,5058.282991,3668.457746,9957,1205.447942,19914,-4807168,290816,-4516352,17
1315,153,20,10,0.104223433,0.895776567,422.5287421,403.041905,752.3269962,581.2810458,1468,48.19435325,2936,-673280,78336,-594944,17
9366,590,21,9,0.0592607473,0.940739253,2843.605163,3030.029525,5061.432095,3661.988136,9956,1590.415335,19912,-4795392,302080,-4493312,17
9426,536,21,9,0.0538044569,0.946195543,2851.679149,2986.865176,5055.22247,3685.029851,9962,1295.448635,19924,-4826112,274432,-4551680,17
9389,563,22,8,0.0565715434,0.943428457,2846.151562,2990.79811,5055.917883,3652.069272,9952,803.8772213,19904,-4807168,288256,-4518912,17
9338,615,22,8,0.061790415,0.938209585,2840.022637,3049.430078,5063.363247,3665.682927,9953,511.1967129,19906,-4781056,314880,-4466176,17
9389,567,21,9,0.0569505826,0.943049417,2843.345684,3102.890849,5051.255725,3773.731922,9956,896.129613,19912,-4807168,290304,-4516864,17
9396,560,21,9,0.056247489,0.943752511,2846.447797,3065.999421,5049.62633,3785.101786,9956,791.4149444,19912,-4810752,286720,-4524032,17
9361,598,21,9,0.0600461894,0.939953811,2846.326789,2901.476218,5076.087811,3475.856187,9959,566.4960182,19918,-4792832,306176,-4486656,17
9394,564,22,8,0.0566378791,0.943362121,2848.304516,2976.935285,5060.099638,3637.030142,9958,683.9285714,19916,-4809728,288768,-4520960,17
1900,186,20,10,0.0891658677,0.910834132,579.6733182,796.420987,1043.539474,1043.096774,2086,173.3998337,4172,-972800,95232,-877568,17
9545,433,20,10,0.04339547,0.95660453,2863.288263,3031.630905,5039.551388,3886.17321,9978,523.5047219,19956,-4887040,221696,-4665344,17
1853,186,20,10,0.0912211869,0.908778813,567.7900198,765.7010649,1019.915273,1020.844086,2039,190.917603,4078,-948736,95232,-853504,17
1855,190,20,10,0.0929095355,0.907090465,565.9439433,788.7778159,1018.925067,1062.784211,2045,35.77050901,4090,-949760,97280,-852480,17
9554,423,20,10,0.0423975143,0.957602486,2861.864514,3049.376621,5039.57892,3846.609929,9977,1062.513312,19954,-4891648,216576,-4675072,17
9550,427,20,10,0.0427984364,0.957201564,2860.016056,3061.598219,5042.603874,3790.131148,9977,1002.713568,19954,-4889600,218624,-4670976,17
9547,430,19,11,0.043099128,0.956900872,2860.238185,3061.655444,5042.130617,3809.376744,9977,551.2154696,19954,-4888064,220160,-4667904,17
9549,428,19,11,0.0428986669,0.957101333,2863.364724,3022.232156,5039.133417,3870.485981,9977,549.0919097,19954,-4889088,219136,-4669952,17
9543,434,19,11,0.0435000501,0.95649995,2862.063321,3024.072433,5042.167033,3819.937788,9977,447.8007181,19954,-4886016,222208,-4663808,17
9552,425,20,10,0.0425979753,0.957402025,2861.16119,3034.82719,5042.853643,3778.623529,9977,270.6728161,19954,-4890624,217600,-4673024,17
5213,303,21,9,0.0549311095,0.945068891,1581.395745,1565.26192,2805.185114,1955.30033,5516,98.94170404,11032,-2669056,155136,-2513920,17
1842,180,20,10,0.0890207715,0.910979228,560.6155052,781.3918931,1013.52063,990.8222222,2022,165.8736669,4044,-943104,92160,-850944,17
1875,186,20,10,0.0902474527,0.909752547,572.594082,785.2506681,1033.299733,1007.817204,2061,231.0538117,4122,-960000,95232,-864768,17
9563,414,20,10,0.0414954395,0.95850456,2861.593115,3057.728488,5039.175259,3830,9977,657.2463768,19954,-4896256,211968,-4684288,17
1867,191,20,10,0.092808552,0.907191448,569.4830581,793.7794033,1024.36797,1079.664921,2058,35.97902098,4116,-955904,97792,-858112,17
9550,427,20,10,0.0427984364,0.957201564,2861.24895,3027.316129,5043.506283,3769.948478,9977,893.9964158,19954,-4889600,218624,-4670976,17
9546,431,20,10,0.0431993585,0.956800641,2860.100226,3052.644503,5043.459878,3782.795824,9977,601.0240964,19954,-4887552,220672,-4666880,17
9554,423,19,11,0.0423975143,0.957602486,2860.625077,3054.388372,5041.929349,3793.522459,9977,570.4402516,19954,-4891648,216576,-4675072,17
9558,419,19,11,0.0419965922,0.958003408,2861.114912,3060.205615,5040.09615,3823.422434,9977,805.8966074,19954,-4893696,214528,-4679168,17
1847,190,19,11,0.0932744232,0.906725577,564.9153862,777.7157702,1019.407147,1015.042105,2037,145.188881,4074,-945664,97280,-848384,17
4817,258,20,10,0.0508374384,0.949162562,1457.698745,1491.793774,2567.550758,1986.271318,5075,530.8577406,10150,-2466304,132096,-2334208,17
4293,243,19,11,0.0535714286,0.946428571,1302.285087,1326.860465,2297.832285,1750.296296,4536,454.0540541,9072,-2198016,124416,-2073600,17
4423,245,20,10,0.0524850043,0.947514996,1339.121857,1391.674681,2363.394529,1812.865306,4668,138.8046387,9336,-2264576,125440,-2139136,17
120,36,20,10,0.230769231,0.769230769,43.71974827,48.73726488,80.18333333,72.88888889,156,7.643312102,312,-61440,18432,-43008,17
4440,259,19,11,0.0551181102,0.94488189,1347.163402,1383.112341,2383.977477,1767.528958,4699,338.057554,9398,-2273280,132608,-2140672,17
4516,254,20,10,0.0532494759,0.946750524,1367.334355,1427.305956,2416.915412,1826.948819,4770,371.4953271,9540,-2312192,130048,-2182144,17
6536,313,20,10,0.0457001022,0.954299898,1963.369247,2099.790365,3462.212362,2647.939297,6849,193.3653303,13698,-3346432,160256,-3186176,17
4245,244,20,10,0.0543550902,0.94564491,1287.681728,1330.24597,2274.440283,1732.811475,4489,196.1975524,8978,-2173440,124928,-2048512,17
5141,271,19,11,0.0500739098,0.94992609,1552.101892,1618.270651,2739.998055,2071.02583,5412,553.9406346,10824,-2632192,138752,-2493440,17
5443,283,20,10,0.0494236815,0.950576319,1642.342774,1705.072305,2899.25519,2175.812721,5726,689.8795181,11452,-2786816,144896,-2641920,17
5880,297,19,11,0.048081593,0.951918407,1772.166315,1839.610356,3126.15085,2353.488215,6177,274.5333333,12354,-3010560,152064,-2858496,17
6946,327,21,9,0.044960814,0.955039186,2085.564712,2226.426306,3675.297437,2823.501529,7273,739.1260163,14546,-3556352,167424,-3388928,17
6357,305,19,11,0.0457820474,0.954217953,1910.622037,2036.321768,3366.361019,2604.904918,6662,537.2580645,13324,-3254784,156160,-3098624,17
4811,255,20,10,0.0503355705,0.94966443,1453.403718,1513.058672,2563.874247,1960.439216,5066,403.6653386,10132,-2463232,130560,-2332672,17
4778,264,20,10,0.0523601745,0.947639825,1446.83471,1470.408233,2556.005651,1897,5042,499.2079208,10084,-2446336,135168,-2311168,17
5881,298,20,10,0.0482278686,0.951772131,1772.265142,1863.878955,3125.363884,2392.097315,6179,692.7130045,12358,-3011072,152576,-2858496,17
6769,323,20,10,0.0455442752,0.954455725,2033.155819,2157.908791,3586.68208,2704.417957,7092,348.5012285,14184,-3465728,165376,-3300352,17
5187,276,20,10,0.0505216914,0.949478309,1567.630398,1596.894463,2768.390013,2048.105072,5463,543.0417495,10926,-2655744,141312,-2514432,17
3665,205,20,10,0.0529715762,0.947028424,1111.852947,1133.953485,1958.220191,1529.307317,3870,345.5357143,7740,-1876480,104960,-1771520,17
4242,236,20,10,0.0527020992,0.947297901,1287.205913,1310.789782,2264.139085,1796.622881,4478,352.8762805,8956,-2171904,120832,-2051072,17
2838,214,21,9,0.0701179554,0.929882045,871.3079178,985.6007774,1539.281536,1356.995327,3052,440.4040404,6104,-1453056,109568,-1343488,17
2867,226,22,8,0.0730682186,0.926931781,878.9695488,1039.580245,1559.921172,1383.084071,3093,312.7401416,6186,-1467904,115712,-1352192,17
2878,209,22,8,0.0677032718,0.932296728,878.5365468,1032.981859,1556.970118,1365.397129,3087,378.7730061,6174,-1473536,107008,-1366528,17
2900,220,21,9,0.0705128205,0.929487179,888.5503112,1025.462391,1576.081379,1355.109091,3120,350.5617978,6240,-1484800,112640,-1372160,17
2868,213,21,9,0.0691333982,0.930866602,875.0861078,1041.157824,1556.584728,1331.15493,3081,403.2722513,6162,-1468416,109056,-1359360,17
2867,217,21,9,0.0703631647,0.929636835,873.6513467,1085.112437,1546.15661,1494.18894,3084,54.08628551,6168,-1467904,111104,-1356800,17
2865,221,22,8,0.0716137395,0.928386261,877.3359066,1024.019873,1560.900175,1317.927602,3086,282.6007326,6172,-1466880,113152,-1353728,17
2851,207,21,9,0.0676913015,0.932308698,870.4998317,1020.929967,1542.282006,1353.454106,3058,353.9351852,6116,-1459712,105984,-1353728,17
2821,203,21,9,0.0671296296,0.93287037,861.3590281,977.1866499,1532.952499,1228.280788,3024,64.61538462,6048,-1444352,103936,-1340416,17
2835,221,21,9,0.0723167539,0.927683246,868.353633,1018.675696,1545.505467,1310.352941,3056,444.1860465,6112,-1451520,113152,-1338368,17
2868,214,22,8,0.0694354315,0.930564568,878.7690635,1014.59344,1551.968968,1401.196262,3082,332.112069,6164,-1468416,109568,-1358848,17
2829,220,21,9,0.0721548049,0.927845195,870.2807583,984.4006442,1537.593496,1363.059091,3049,260.5982906,6098,-1448448,112640,-1335808,17
2862,215,21,9,0.0698732532,0.930126747,877.2717822,1005.580124,1552.725716,1356.288372,3077,265.2586207,6154,-1465344,110080,-1355264,17
2860,204,22,8,0.0665796345,0.933420366,875.8529755,972.3625745,1547.951049,1315.882353,3064,221.5473608,6128,-1464320,104448,-1359872,17
2896,221,22,8,0.0709015079,0.929098492,889.6489205,1002.355908,1574.246892,1359.20362,3117,280.0539084,6234,-1482752,113152,-1369600,17
2878,217,21,9,0.0701130856,0.929886914,883.2896455,994.6259296,1563.992703,1335.894009,3095,511.5702479,6190,-1473536,111104,-1362432,17
2837,215,21,9,0.0704456094,0.929554391,867.7789094,1025.743405,1539.157561,1359.47907,3052,253.4883721,6104,-1452544,110080,-1342464,17
2868,213,21,9,0.0691333982,0.930866602,875.616155,1040.047115,1554.805788,1355.107981,3081,438.8888889,6162,-1468416,109056,-1359360,17
2888,222,21,9,0.0713826367,0.928617363,886.7524901,1012.371222,1569.769391,1369.869369,3110,264.9063032,6220,-1478656,113664,-1364992,17
2159,136,22,8,0.0592592593,0.940740741,654.550008,708.4583932,1167.648448,836.0808824,2295,28.87518873,4590,-1105408,69632,-1035776,17
3557,216,22,8,0.0572488736,0.942751126,1082.032285,1113.48681,1913.479618,1450.944444,3773,146.1270333,7546,-1821184,110592,-1710592,17
3990,217,22,8,0.0515806988,0.948419301,1208.889179,1237.796017,2127.136842,1678.580645,4207,393.5453695,8414,-2042880,111104,-1931776,17
3062,193,21,9,0.0592933948,0.940706605,932.9401351,974.4656985,1650.236773,1275.207254,3255,291.1449016,6510,-1567744,98816,-1468928,17
4433,236,21,9,0.0505461555,0.949453845,1340.529055,1358.632148,2365.209113,1767.555085,4669,437.1722846,9338,-2269696,120832,-2148864,17
4400,238,21,9,0.0513152221,0.948684778,1332.437893,1343.193357,2348.659545,1780.415966,4638,186.8654311,9276,-2252800,121856,-2130944,17
4654,236,22,8,0.0482617587,0.951738241,1404.812933,1437.599398,2472.781908,1907.491525,4890,435.828877,9780,-2382848,120832,-2262016,17
3788,212,22,8,0.053,0.947,1148.618403,1165.793328,2026.309398,1539.339623,4000,249.8438476,8000,-1939456,108544,-1830912,17
3117,195,21,9,0.0588768116,0.941123188,949.6643408,996.9143623,1677.177414,1325.979487,3312,282.8351836,6624,-1595904,99840,-1496064,17
3093,189,21,9,0.0575868373,0.942413163,942.9491542,966.002868,1660.550921,1329.730159,3282,352.9032258,6564,-1583616,96768,-1486848,17
3984,219,22,8,0.0521056388,0.947894361,1206.802758,1244.23874,2126.530371,1655.748858,4203,335.971223,8406,-2039808,112128,-1927680,17
4678,241,22,8,0.0489936979,0.951006302,1411.119858,1462.988359,2490.296708,1871.917012,4919,514.0020899,9838,-2395136,123392,-2271744,17
4418,232,22,8,0.0498924731,0.950107527,1334.755352,1375.249764,2353.404255,1794.116379,4650,352.2727273,9300,-2262016,118784,-2143232,17
3091,190,21,9,0.057909174,0.942090826,941.0557893,985.1626951,1661.102232,1313.968421,3281,328.1,6562,-1582592,97280,-1485312,17
3098,192,21,9,0.0583586626,0.941641337,944.1874916,980.1989862,1665.530665,1322.296875,3290,321.9178082,6580,-1586176,98304,-1487872,17
3644,207,22,8,0.0537522721,0.946247728,1104.836414,1149.703338,1949.533205,1511.724638,3851,350.7285974,7702,-1865728,105984,-1759744,17
3119,201,22,8,0.0605421687,0.939457831,953.9483861,967.9996416,1681.55755,1333.741294,3320,154.9953315,6640,-1596928,102912,-1494016,17
3568,205,22,8,0.0543334217,0.945666578,1084.325375,1097.167488,1909.752803,1490.990244,3773,360.3629417,7546,-1826816,104960,-1721856,17
2818,187,22,8,0.0622296173,0.937770383,864.0299003,885.1050162,1518.585167,1268.139037,3005,229.389313,6010,-1442816,95744,-1347072,17
4420,236,22,8,0.0506872852,0.949312715,1335.596783,1390.881879,2356.865158,1797.254237,4656,579.1044776,9312,-2263040,120832,-2142208,17
4436,225,20,10,0.0482729028,0.951727097,1340.102151,1364.116106,2355.047791,1856.884444,4661,424.1128298,9322,-2271232,115200,-2156032,17
9408,546,22,8,0.0548523207,0.945147679,2835.321394,2989.014542,5076.445791,3272.587912,9954,921.6666667,19908,-4816896,279552,-4537344,17
9387,568,21,9,0.0570567554,0.942943245,2832.000376,2944.053574,5088.378289,3153.84331,9955,1089.16849,19910,-4806144,290816,-4515328,17
9397,559,21,9,0.056147047,0.943852953,2833.690896,3099.809363,5070.311376,3435.116279,9956,1111.160714,19912,-4811264,286208,-4525056,17
9421,536,22,8,0.0538314753,0.946168525,2840.140754,3064.687622,5063.008704,3502.421642,9957,1373.37931,19914,-4823552,274432,-4549120,17
9411,544,22,8,0.0546459066,0.945354093,2832.281095,3084.200401,5072.728297,3339.235294,9955,924.3268338,19910,-4818432,278528,-4539904,17
9394,562,21,9,0.0564483728,0.943551627,2831.04452,2952.199983,5089.458803,3123.790036,9956,739.6731055,19912,-4809728,287744,-4521984,17
9394,560,21,9,0.0562587904,0.94374121,2827.807727,2956.994147,5091.577177,3063.855357,9954,643.0232558,19908,-4809728,286720,-4523008,17
9410,544,22,8,0.0546513964,0.945348604,2838.984993,3055.438088,5063.27949,3493.704044,9954,702.4700071,19908,-4817920,278528,-4539392,17
9399,557,21,9,0.0559461631,0.944053837,2837.31112,3008.7952,5073.950952,3367.829443,9956,1490.419162,19912,-4812288,285184,-4527104,17
9401,555,22,8,0.0557452792,0.944254721,2832.856265,2948.452659,5086.570684,3147.918919,9956,723.5465116,19912,-4813312,284160,-4529152,17
9405,550,21,9,0.0552486188,0.944751381,2830.516573,2963.323053,5087.268262,3109.512727,9955,807.3803731,19910,-4815360,281600,-4533760,17
9398,557,22,8,0.055951783,0.944048217,2838.057519,2956.457187,5077.05299,3306.725314,9955,1010.659898,19910,-4811776,285184,-4526592,17
9399,555,21,9,0.0557564798,0.94424352,2838.506188,2963.265258,5074.507607,3334.663063,9954,1069.172932,19908,-4812288,284160,-4528128,17
9398,557,21,9,0.055951783,0.944048217,2836.316319,2976.937077,5077.806555,3294.010772,9955,1400.140647,19910,-4811776,285184,-4526592,17
9153,513,21,9,0.0530726257,0.946927374,2760.663574,2866.841819,4919.834153,3293.116959,9666,169.6384696,19332,-4686336,262656,-4423680,17
9399,557,21,9,0.0559461631,0.944053837,2834.304607,2965.672315,5082.994255,3215.229803,9956,1192.335329,19912,-4812288,285184,-4527104,17
9404,551,22,8,0.0553490708,0.944650929,2832.288665,3062.051081,5075.331348,3316.831216,9955,1102.436323,19910,-4814848,282112,-4532736,17
9425,531,22,8,0.0533346726,0.946665327,2841.78272,2958.021479,5069.960743,3355.114878,9956,466.5417057,19912,-4825600,271872,-4553728,17
9377,577,22,8,0.0579666466,0.942033353,2836.131419,2934.228498,5082.856457,3265.320624,9954,819.2592593,19908,-4801024,295424,-4505600,17
9482,481,22,8,0.0482786309,0.951721369,2844.775783,3179.507923,5046.368171,3713.10395,9963,652.4557957,19926,-4854784,246272,-4608512,17
43,16,20,10,0.271186441,0.728813559,16.82609167,17.45250251,30.62790698,28.3125,59,5.560791706,118,-22016,8192,-13824,18
590,71,20,10,0.107413011,0.892586989,187.6981378,209.1737593,336.6355932,284.1690141,661,41.05590062,1322,-302080,36352,-265728,18
601,69,20,10,0.102985075,0.897014925,190.4777408,210.6778789,341.2895175,285.0724638,670,65.49364614,1340,-307712,35328,-272384,18
42,17,20,10,0.288135593,0.711864407,16.8322388,17.49305349,30.23809524,29.41176471,59,15.08951407,118,-21504,8704,-12800,18
589,66,19,11,0.100763359,0.899236641,186.3934696,207.0623467,332.614601,286.8181818,655,62.98076923,1310,-301568,33792,-267776,18
616,67,19,11,0.0980966325,0.901903367,194.6875321,214.6634183,346.2824675,302.6268657,683,94.46749654,1366,-315392,34304,-281088,18
590,69,20,10,0.104704097,0.895295903,187.6905165,206.0418477,334.9050847,288.057971,659,86.71052632,1318,-302080,35328,-266752,18
594,68,20,10,0.102719033,0.897280967,188.2240951,208.7132574,336.9191919,284.1617647,662,54.12919052,1324,-304128,34816,-269312,18
617,64,20,10,0.093979442,0.906020558,193.5676875,221.4377889,344.076175,311.34375,681,71.98731501,1362,-315904,32768,-283136,18
590,66,20,10,0.100609756,0.899390244,187.2120581,202.0663281,333.5847458,283.0454545,656,66.87054027,1312,-302080,33792,-268288,18
594,67,19,11,0.101361573,0.898638427,188.5347056,206.1470558,335.2491582,293.3283582,661,46.51653765,1322,-304128,34304,-269824,18
42,20,19,11,0.322580645,0.677419355,16.88766741,19.71141801,30.5952381,33.4,62,1.111111111,124,-21504,10240,-11264,18
630,70,19,11,0.1,0.9,199.1559357,222.7125557,354.9269841,310.6571429,700,128.9134438,1400,-322560,35840,-286720,18
584,64,19,11,0.0987654321,0.901234568,184.5051924,205.8277775,328.2414384,290.359375,648,57.19329214,1296,-299008,32768,-266240,18
44,16,20,10,0.266666667,0.733333333,17.08188531,17.85871198,31.06818182,28.9375,60,13.95348837,120,-22528,8192,-14336,18
613,68,20,10,0.0998531571,0.900146843,193.3758289,219.7223358,345.2871126,302.3529412,681,73.1471536,1362,-313856,34816,-279040,18
43,18,19,11,0.295081967,0.704918033,17.50123228,17.81220625,31.44186047,29.94444444,61,9.682539683,122,-22016,9216,-12800,18
590,78,20,10,0.116766467,0.883233533,187.9157847,225.4647611,337.3271186,313.1153846,668,29.49227373,1336,-302080,39936,-262144,18
42,16,20,10,0.275862069,0.724137931,16.55719148,17.1299035,30.04761905,28.0625,58,9.369951535,116,-21504,8192,-13312,18
619,79,19,11,0.113180516,0.886819484,196.7099375,234.933815,351.7043619,332.2278481,698,29.46390882,1396,-316928,40448,-276480,18
39,15,20,10,0.277777778,0.722222222,15.46355815,15.76268449,28.17948718,25.73333333,54,13.26781327,108,-19968,7680,-12288,18
750,81,19,11,0.0974729242,0.902527076,236.4814204,265.4611026,420.7093333,372.3950617,831,29.49946752,1662,-384000,41472,-342528,18
765,78,19,11,0.0925266904,0.90747331,239.8321807,273.0322598,425.5803922,386.8846154,843,91.23376623,1686,-391680,39936,-351744,18
770,82,20,10,0.0962441315,0.903755869,242.1559414,278.9868408,427.2363636,419.5853659,852,69.04376013,1704,-394240,41984,-352256,18
783,81,20,10,0.09375,0.90625,246.1884783,275.8329896,436.4176245,394.6296296,864,113.9841689,1728,-400896,41472,-359424,18
38,14,20,10,0.269230769,0.730769231,14.75534553,15.48600421,27.26315789,24.42857143,52,10.99365751,104,-19456,7168,-12288,18
781,85,20,10,0.0981524249,0.901847575,246.1980093,282.0501921,435.1126761,418.6823529,866,74.01709402,1732,-399872,43520,-356352,18
791,95,20,10,0.107223476,0.892776524,250.1705447,298.269375,442.9557522,448.0315789,886,58.02226588,1772,-404992,48640,-356352,18
785,80,20,10,0.0924855491,0.907514451,246.9267172,272.9372169,436.6203822,397.475,865,116.8918919,1730,-401920,40960,-360960,18
832,80,20,10,0.0877192982,0.912280702,260.7436504,287.0882878,458.875,431.8,912,92.68292683,1824,-425984,40960,-385024,18
814,84,20,10,0.0935412027,0.906458797,254.4144863,301.7809749,448.527027,458.9285714,898,54.68940317,1796,-416768,43008,-373760,18
791,90,20,10,0.10215664,0.89784336,248.4353979,299.2293618,437.335019,473.2111111,881,15.39402411,1762,-404992,46080,-358912,18
752,83,19,11,0.0994011976,0.900598802,238.3988866,262.0836514,421.1462766,389.4939759,835,24.94771437,1670,-385024,42496,-342528,18
792,82,20,10,0.0938215103,0.90617849,249.1413578,276.9469324,442.1893939,392.2073171,874,109.5238095,1748,-405504,41984,-363520,18
826,78,19,11,0.0862831858,0.913716814,258.5089811,283.9006008,455.3498789,422.3205128,904,114.7208122,1808,-422912,39936,-382976,18
771,76,20,10,0.0897284534,0.910271547,242.093994,267.3939767,425.3281453,410.5263158,847,71.05704698,1694,-394752,38912,-355840,18
39,14,20,10,0.264150943,0.735849057,15.18009354,15.29439006,27.97435897,24.28571429,53,6.393244873,106,-19968,7168,-12800,18
803,86,19,11,0.0967379078,0.903262092,251.9708772,296.6033549,445.4769614,440.5465116,889,61.39502762,1778,-411136,44032,-367104,18
41,17,19,11,0.293103448,0.706896552,16.54992627,17.11976943,30.04878049,28.17647059,58,11.17533719,116,-20992,8704,-12288,18
788,91,19,11,0.103526735,0.896473265,247.5990279,301.7695231,440.2347716,437.967033,879,15.36713287,1758,-403456,46592,-356864,18
4562,263,23,7,0.054507772,0.945492228,1379.025384,1483.001035,2448.710653,1793.562738,4825,317.2255095,9650,-2335744,134656,-2201088,18
4536,265,23,7,0.055196834,0.944803166,1372.486929,1467.555555,2436.994268,1784.886792,4801,228.4015224,9602,-2322432,135680,-2186752,18
4612,264,23,7,0.05414274,0.94585726,1394.061609,1489.378787,2474.778838,1804.719697,4876,383.0322074,9752,-2361344,135168,-2226176,18
4583,266,22,8,0.0548566715,0.945143329,1386.080815,1483.714366,2461.385337,1798.105263,4849,674.4089013,9698,-2346496,136192,-2210304,18
4632,266,22,8,0.0543078808,0.945692119,1400.601512,1486.191984,2486.699698,1801.721805,4898,548.4882419,9796,-2371584,136192,-2235392,18
4679,268,22,8,0.054174247,0.945825753,1415.425239,1489.543019,2511.313315,1822.548507,4947,497.1859296,9894,-2395648,137216,-2258432,18
4521,257,23,7,0.0537881959,0.946211804,1366.356499,1449.620395,2425.578854,1754.821012,4778,248.9838458,9556,-2314752,131584,-2183168,18
4691,268,22,8,0.0540431539,0.945956846,1417.110889,1469.530215,2523.371349,1720.839552,4959,112.987013,9918,-2401792,137216,-2264576,18
4615,266,23,7,0.0544970293,0.945502971,1395.994441,1498.232206,2475.307476,1845.778195,4881,422.2318339,9762,-2362880,136192,-2226688,18
4545,274,23,7,0.0568582694,0.943141731,1375.760289,1546.886793,2439.130913,1926.788321,4819,84.44016121,9638,-2327040,140288,-2186752,18
4581,262,23,7,0.0540986992,0.945901301,1384.527919,1482.451185,2457.831478,1795.496183,4843,431.6399287,9686,-2345472,134144,-2211328,18
4629,262,23,7,0.0535677776,0.946432222,1399.725496,1473.802986,2481.967164,1810.534351,4891,420.5503009,9782,-2370048,134144,-2235904,18
4603,262,22,8,0.0538540596,0.94614594,1392.872854,1450.964374,2469.46448,1792.366412,4865,313.4664948,9730,-2356736,134144,-2222592,18
4605,260,23,7,0.0534429599,0.94655704,1391.026399,1521.850792,2464.009989,1883.765385,4865,449.6303142,9730,-2357760,133120,-2224640,18
4681,268,23,7,0.054152354,0.945847646,1415.542506,1502.705665,2511.691946,1834.123134,4949,489.0316206,9898,-2396672,137216,-2259456,18
4695,265,22,8,0.0534274194,0.946572581,1419.183428,1536.021719,2512.021938,1922.026415,4960,313.7254902,9920,-2403840,135680,-2268160,18
4573,263,22,8,0.0543837883,0.945616212,1383.218163,1451.183912,2456.523289,1757.357414,4836,191.9809448,9672,-2341376,134656,-2206720,18
4586,266,23,7,0.0548227535,0.945177246,1387.089688,1492.955307,2461.477104,1823.473684,4852,372.3714505,9704,-2348032,136192,-2211840,18
4632,266,23,7,0.0543078808,0.945692119,1402.128027,1464.379842,2486.272021,1809.169173,4898,333.424098,9796,-2371584,136192,-2235392,18
4705,273,23,7,0.0548413017,0.945158698,1423.657455,1509.740587,2527.120085,1841.139194,4978,499.2978937,9956,-2408960,139776,-2269184,18
770,86,19,11,0.10046729,0.89953271,242.8637919,281.0168156,431.3025974,403.4069767,856,78.17351598,1712,-394240,44032,-350208,18
802,80,19,11,0.0907029478,0.909297052,250.921551,286.3465459,445.223192,404.175,882,87.84860558,1764,-410624,40960,-369664,18
39,16,19,11,0.290909091,0.709090909,15.88816934,15.68388903,28.76923077,26.125,55,22.08835341,110,-19968,8192,-11776,18
825,84,20,10,0.0924092409,0.907590759,259.0687435,290.1872783,459.0436364,415.2857143,909,130.7913669,1818,-422400,43008,-379392,18
778,76,19,11,0.0889929742,0.911007026,243.7554012,272.3279515,429.6491003,405.5,854,74.71566054,1708,-398336,38912,-359424,18
787,84,19,11,0.0964408726,0.903559127,247.8214091,283.0616895,436.1753494,434.3571429,871,76.60510114,1742,-402944,43008,-359936,18
43,17,19,11,0.283333333,0.716666667,17.23448817,17.38173085,31.25581395,28.58823529,60,11.19402985,120,-22016,8704,-13312,18
759,77,20,10,0.0921052632,0.907894737,238.4248538,265.2814256,422.3860343,380.1948052,836,62.85714286,1672,-388608,39424,-349184,18
832,82,19,11,0.0897155361,0.910284464,260.631326,293.0627799,460.2463942,429.6341463,914,97.02760085,1828,-425984,41984,-384000,18
786,84,19,11,0.0965517241,0.903448276,246.5048361,290.3496709,437.5050891,416.7380952,870,15.28998243,1740,-402432,43008,-359424,18
784,91,20,10,0.104,0.896,246.6931453,298.5910969,438.4005102,434.5494505,875,15.34818453,1750,-401408,46592,-354816,18
778,81,19,11,0.0942956927,0.905704307,244.6737947,274.6141376,434.0642674,390.962963,859,129.3674699,1718,-398336,41472,-356864,18
763,76,19,11,0.0905840286,0.909415971,239.8270783,263.8976769,422.1087811,398.8289474,839,94.69525959,1678,-390656,38912,-351744,18
41,17,19,11,0.293103448,0.706896552,16.7306051,16.64591557,30.19512195,27.82352941,58,11.26213592,116,-20992,8704,-12288,18
42,17,20,10,0.288135593,0.711864407,16.85346005,17.4250744,30.35714286,29.11764706,59,12.88209607,118,-21504,8704,-12800,18
38,14,20,10,0.269230769,0.730769231,14.75534553,15.48600421,27.26315789,24.42857143,52,7.525325615,104,-19456,7168,-12288,18
766,83,19,11,0.097762073,0.902237927,241.3767746,271.5180637,430.6305483,373.0361446,849,71.70608108,1698,-392192,42496,-349696,18
769,80,19,11,0.0942285041,0.905771496,242.0713137,270.6040639,428.0559168,395.625,849,78.24884793,1698,-393728,40960,-352768,18
487,47,19,11,0.0880149813,0.911985019,148.8191371,183.7665745,275.063655,189.1276596,534,8.35942392,1068,-249344,24064,-225280,18
479,47,19,11,0.0893536122,0.910646388,146.5428606,176.4368165,271.8977035,177.9148936,526,7.841383423,1052,-245248,24064,-221184,18
860,130,22,8,0.131313131,0.868686869,281.3806516,305.7211206,505.2069767,431.2846154,990,133.7837838,1980,-440320,66560,-373760,18
924,135,22,8,0.127478754,0.872521246,300.8580172,329.0845611,539.9264069,462.0592593,1059,128.2082324,2118,-473088,69120,-403968,18
772,113,22,8,0.127683616,0.872316384,253.8986102,259.8207919,450.8005181,389.7079646,885,122.2375691,1770,-395264,57856,-337408,18
926,128,23,7,0.121442125,0.878557875,300.3297179,324.4289137,536.2181425,464.4296875,1054,113.9459459,2108,-474112,65536,-408576,18
905,132,22,8,0.12729026,0.87270974,294.8519058,321.0150206,528.5502762,453.5227273,1037,97.73798303,2074,-463360,67584,-395776,18
933,133,22,8,0.124765478,0.875234522,302.7642914,333.7003208,542.5412647,470.075188,1066,122.3880597,2132,-477696,68096,-409600,18
962,137,22,8,0.124658781,0.875341219,313.7525045,333.9473664,559.0790021,486.2481752,1099,120.504386,2198,-492544,70144,-422400,18
888,133,22,8,0.130264447,0.869735553,290.197071,315.4083963,520.9932432,444.2781955,1021,149.9265786,2042,-454656,68096,-386560,18
919,133,23,7,0.126425856,0.873574144,299.6278765,324.4482924,534.921654,468.3082707,1052,75.46628407,2104,-470528,68096,-402432,18
933,134,22,8,0.125585754,0.874414246,303.2242346,331.4031891,543.9056806,465.0298507,1067,136.4450128,2134,-477696,68608,-409088,18
970,135,22,8,0.122171946,0.877828054,314.0463108,343.2018769,563.457732,477.8592593,1105,92.16013344,2210,-496640,69120,-427520,18
943,132,23,7,0.122790698,0.877209302,306.0033026,330.5253438,548.2279958,464.9318182,1075,138.5309278,2150,-482816,67584,-415232,18
926,134,22,8,0.126415094,0.873584906,301.3646694,327.3378421,540.9060475,458.5895522,1060,75.17730496,2120,-474112,68608,-405504,18
948,132,22,8,0.122222222,0.877777778,306.6459638,335.7582838,551.5843882,460.8939394,1080,92.70386266,2160,-485376,67584,-417792,18
934,131,22,8,0.123004695,0.876995305,302.4658948,330.6233479,543.856531,455.5954198,1065,77.73722628,2130,-478208,67072,-411136,18
907,131,23,7,0.126204239,0.873795761,295.7183456,316.7260338,529.6538037,449.1984733,1038,132.7365729,2076,-464384,67072,-397312,18
865,124,25,5,0.125379171,0.874620829,281.8203243,302.201735,504.2346821,430.5806452,989,68.395574,1978,-442880,63488,-379392,18
1009,137,23,7,0.119546248,0.880453752,328.2430592,344.2807158,580.9613479,518.5474453,1146,112.7952756,2292,-516608,70144,-446464,18
966,141,22,8,0.127371274,0.872628726,315.9778193,337.6492155,562.3219462,496.9858156,1107,123.8255034,2214,-494592,72192,-422400,18
802,112,22,8,0.122538293,0.877461707,258.5018705,289.4804101,467.4775561,386.0535714,914,165.2802893,1828,-410624,57344,-353280,18
892,130,23,7,0.127201566,0.872798434,290.1493925,317.2541334,522.0201794,439.3153846,1022,135.7237716,2044,-456704,66560,-390144,18
859,129,22,8,0.130566802,0.869433198,280.419518,305.589569,505.3527357,422.2325581,988,123.3458177,1976,-439808,66048,-373760,18
901,133,22,8,0.128626692,0.871373308,293.4783963,322.13515,527.6470588,448.7593985,1034,145.6338028,2068,-461312,68096,-393216,18
888,131,22,8,0.128557409,0.871442591,289.3032077,315.8528215,520.6452703,437.8396947,1019,83.66174056,2038,-454656,67072,-387584,18
921,133,22,8,0.126185958,0.873814042,298.7161915,332.1330773,537.4440825,458.6390977,1054,63.07600239,2108,-471552,68096,-403456,18
869,130,23,7,0.13013013,0.86986987,283.719091,311.3254926,508.9252014,440.3384615,999,138.9429764,1998,-444928,66560,-378368,18
905,130,23,7,0.125603865,0.874396135,294.0060305,320.9076363,528.3889503,445.6769231,1035,115.6424581,2070,-463360,66560,-396800,18
875,131,22,8,0.130218688,0.869781312,285.8027705,310.4525343,514.0194286,433.2366412,1006,97.38625363,2012,-448000,67072,-380928,18
908,132,22,8,0.126923077,0.873076923,295.0714619,324.9984411,530.6651982,450.5757576,1040,87.68971332,2080,-464896,67584,-397312,18
948,135,23,7,0.12465374,0.87534626,309.0739093,328.0963996,552.0063291,471.7333333,1083,114.4820296,2166,-485376,69120,-416256,18
939,135,23,7,0.125698324,0.874301676,307.5423753,322.5554519,544.6091587,488.0518519,1074,78.73900293,2148,-480768,69120,-411648,18
892,134,22,8,0.130604288,0.869395712,291.2954525,318.9047705,523.529148,446.738806,1026,125.7352941,2052,-456704,68608,-388096,18
943,137,22,8,0.126851852,0.873148148,308.1664932,329.8705722,548.8218452,483.2189781,1080,68.92150606,2160,-482816,70144,-412672,18
894,132,23,7,0.128654971,0.871345029,291.9523752,316.6812353,522.5145414,452.4469697,1026,73.86609071,2052,-457728,67584,-390144,18
889,132,22,8,0.129285015,0.870714985,289.8778957,317.3978556,521.0494938,443.3181818,1021,136.3150868,2042,-455168,67584,-387584,18
1016,135,22,8,0.117289314,0.882710686,326.641609,363.7202873,585.6643701,503.2666667,1151,155.9620596,2302,-520192,69120,-451072,18
930,133,22,8,0.125117592,0.874882408,301.6118045,333.2310239,541.8817204,462.9022556,1063,141.1686587,2126,-476160,68096,-408064,18
909,129,23,7,0.124277457,0.875722543,295.5144208,316.1776013,530.7216722,440.4263566,1038,114.9501661,2076,-465408,66048,-399360,18
910,130,23,7,0.125,0.875,296.2482948,318.9879456,529.921978,454.5461538,1040,109.4736842,2080,-465920,66560,-399360,18
892,132,22,8,0.12890625,0.87109375,291.1678267,312.8036672,524.1558296,433.7348485,1024,77.45839637,2048,-456704,67584,-389120,18
1101,136,23,7,0.109943411,0.890056589,352.981295,385.1489107,625.1653043,569.0882353,1237,134.4565217,2474,-563712,69632,-494080,18
1056,137,22,8,0.114836547,0.885163453,340.3512638,371.7297876,602.0823864,557.8248175,1193,157.3878628,2386,-540672,70144,-470528,18
1080,153,22,8,0.124087591,0.875912409,350.1286507,393.5843338,620.5759259,591.7581699,1233,111.1812444,2466,-552960,78336,-474624,18
1032,135,23,7,0.115681234,0.884318766,333.5230857,358.501056,589.7577519,539.9851852,1167,128.5242291,2334,-528384,69120,-459264,18
1114,138,23,7,0.110223642,0.889776358,357.3637292,388.5208753,633.1301616,572.9782609,1252,89.5565093,2504,-570368,70656,-499712,18
1006,134,23,7,0.11754386,0.88245614,325.4307238,352.2066157,576.4075547,526.1492537,1140,60.41335453,2280,-515072,68608,-446464,18
1037,139,23,7,0.118197279,0.881802721,335.4051693,366.3691403,593.4513018,551.5611511,1176,141.3461538,2352,-530944,71168,-459776,18
1286,142,22,8,0.0994397759,0.900560224,407.4074339,450.5006737,720.0085537,664.6126761,1428,143.5175879,2856,-658432,72704,-585728,18
1108,151,23,7,0.119936458,0.880063542,359.2381824,391.9901117,633.4431408,604.7350993,1259,85.93856655,2518,-567296,77312,-489984,18
993,137,22,8,0.121238938,0.878761062,322.1363253,351.3577478,571.3776435,522.8978102,1130,99.55947137,2260,-508416,70144,-438272,18
1100,138,22,8,0.111470113,0.888529887,353.0061778,388.1473733,624.5545455,579.2101449,1238,153.2178218,2476,-563200,70656,-492544,18
1058,136,22,8,0.113902848,0.886097152,341.0309531,367.8699383,604.0491493,546.5514706,1194,200,2388,-541696,69632,-472064,18
1245,142,22,8,0.102379236,0.897620764,396.1437893,433.4233948,698.9855422,650.2887324,1387,140.9552846,2774,-637440,72704,-564736,18
1225,142,23,7,0.103877103,0.896122897,389.8234383,431.7944598,688.562449,644.6408451,1367,73.21906802,2734,-627200,72704,-554496,18
1138,149,23,7,0.115773116,0.884226884,367.6046961,397.5196353,649.6933216,600.5167785,1287,132,2574,-582656,76288,-506368,18
1177,150,23,7,0.113036925,0.886963075,378.6009958,410.6866151,672.3160578,598.7466667,1327,52.80541186,2654,-602624,76800,-525824,18
1008,135,23,7,0.118110236,0.881889764,325.7214095,358.2775241,576.4236111,538.9703704,1143,74.95081967,2286,-516096,69120,-446976,18
1027,141,22,8,0.120719178,0.879280822,332.4527864,366.5038562,590.7799416,538.7588652,1168,116.8,2336,-525824,72192,-453632,18
928,131,22,8,0.123701605,0.876298395,297.901204,355.8320062,531.9450431,516.221374,1059,172.7569331,2118,-475136,67072,-408064,18
1059,153,22,8,0.126237624,0.873762376,340.9590364,406.1767611,605.4428706,613.8169935,1212,22.59929144,2424,-542208,78336,-463872,18
4673,271,23,7,0.0548139159,0.945186084,1414.783374,1468.202487,2511.977958,1791.760148,4944,366.493699,9888,-2392576,138752,-2253824,18
4542,264,22,8,0.0549313358,0.945068664,1374.21314,1459.734156,2440.085205,1774.068182,4806,357.8555473,9612,-2325504,135168,-2190336,18
4556,262,23,7,0.0543794105,0.945620589,1377.45049,1481.602706,2444.138499,1807.160305,4818,550.6285714,9636,-2332672,134144,-2198528,18
4441,258,24,6,0.054905299,0.945094701,1343.223795,1409.944259,2388.650529,1684.70155,4699,427.5705187,9398,-2273792,132096,-2141696,18
4617,266,23,7,0.0544747082,0.945525292,1395.059124,1552.206337,2471.935023,1922.413534,4883,577.1867612,9766,-2363904,136192,-2227712,18
4620,264,23,7,0.0540540541,0.945945946,1396.551355,1493.588293,2478.175325,1818.181818,4884,622.1656051,9768,-2365440,135168,-2230272,18
4577,258,23,7,0.05336091,0.94663909,1383.991114,1462.111243,2452.246668,1810.453488,4835,475.4178958,9670,-2343424,132096,-2211328,18
4680,260,23,7,0.0526315789,0.947368421,1414.211682,1497.59173,2504.542735,1857.730769,4940,398.708636,9880,-2396160,133120,-2263040,18
4678,265,23,7,0.0536111673,0.946388833,1413.308149,1566.1325,2500.415135,1970.392453,4943,417.4831081,9886,-2395136,135680,-2259456,18
4715,264,22,8,0.0530226953,0.946977305,1424.777901,1517.151074,2524.670838,1870.784091,4979,557.5587906,9958,-2414080,135168,-2278912,18
4608,268,22,8,0.0549630845,0.945036916,1394.488096,1458.787314,2477.832899,1762.208955,4876,289.2052195,9752,-2359296,137216,-2222080,18
4642,265,23,7,0.0540044834,0.945995517,1402.968592,1507.82836,2489.236751,1836.758491,4907,369.503012,9814,-2376704,135680,-2241024,18
4558,264,22,8,0.0547490668,0.945250933,1377.691656,1481.362737,2448.297718,1776.181818,4822,362.556391,9644,-2333696,135168,-2198528,18
4736,270,22,8,0.0539352777,0.946064722,1433.446988,1503.24115,2539.324113,1875.118519,5006,435.3043478,10012,-2424832,138240,-2286592,18
4493,262,22,8,0.0550998948,0.944900105,1358.748348,1457.376645,2414.356777,1754.522901,4755,801.8549747,9510,-2300416,134144,-2166272,18
4480,258,22,8,0.0544533558,0.945546644,1354.224852,1417.102489,2409.15558,1680.906977,4738,245.2380952,9476,-2293760,132096,-2161664,18
7017,337,23,7,0.0458254011,0.954174599,2104.935425,2288.365928,3720.830554,2775.272997,7354,688.576779,14708,-3592704,172544,-3420160,18
4647,265,23,7,0.0539495114,0.946050489,1405.943131,1465.584034,2494.053153,1797.973585,4912,339.2265193,9824,-2379264,135680,-2243584,18
4619,266,22,8,0.0544524053,0.945547595,1397.027075,1482.728607,2479.77073,1804.488722,4885,510.9832636,9770,-2364928,136192,-2228736,18
1982,191,22,8,0.0878969167,0.912103083,628.7223252,507.7847616,1118.479818,760.3350785,2173,88.29744007,4346,-1014784,97792,-916992,18
928,128,23,7,0.121212121,0.878787879,300.0824703,326.8596641,539.2866379,450.296875,1056,74.84053863,2112,-475136,65536,-409600,18
921,129,23,7,0.122857143,0.877142857,298.6786847,322.8507819,536.218241,448.9767442,1050,103.960396,2100,-471552,66048,-405504,18
932,132,22,8,0.12406015,0.87593985,302.4643814,331.0157941,541.8154506,466.7272727,1064,92.84467714,2128,-477184,67584,-409600,18
921,131,22,8,0.124524715,0.875475285,298.5700785,328.7350413,536.6536374,455.1145038,1052,123.9104829,2104,-471552,67072,-404480,18
916,132,23,7,0.125954198,0.874045802,297.2389346,329.8157396,533.808952,459.9015152,1048,115.1648352,2096,-468992,67584,-401408,18
955,129,23,7,0.11900369,0.88099631,308.1367766,339.1685941,551.3706806,476.8294574,1084,141.3298566,2168,-488960,66048,-422912,18
923,132,23,7,0.125118483,0.874881517,300.0393779,326.9643497,537.3867822,462.3636364,1055,83.92999204,2110,-472576,67584,-404992,18
921,129,23,7,0.122857143,0.877142857,298.1118972,331.2147036,533.393051,469.1472868,1050,71.18644068,2100,-471552,66048,-405504,18
949,131,23,7,0.121296296,0.878703704,306.6422899,337.5822155,550.6933614,466.6564885,1080,137.5796178,2160,-485888,67072,-418816,18
868,128,22,8,0.128514056,0.871485944,283.0594727,306.3787002,509.2165899,425.828125,996,129.8565841,1992,-444416,65536,-378880,18
880,124,23,7,0.123505976,0.876494024,285.7901748,309.0231911,511.8352273,436.25,1004,116.744186,2008,-450560,63488,-387072,18
948,132,23,7,0.122222222,0.877777778,307.3345337,333.8734852,550.1265823,471.3636364,1080,112.7348643,2160,-485376,67584,-417792,18
931,131,22,8,0.123352166,0.876647834,301.1674355,334.2221993,541.3845328,461.2519084,1062,103.9138943,2124,-476672,67072,-409600,18
897,128,23,7,0.124878049,0.875121951,291.1867187,317.9618825,523.1750279,441.6953125,1025,103.5353535,2050,-459264,65536,-393728,18
911,131,22,8,0.12571977,0.87428023,295.8292714,324.2412067,531.8880351,449.259542,1042,94.21338156,2084,-466432,67072,-399360,18
927,128,23,7,0.121327014,0.878672986,300.5847859,324.5181765,536.9924488,462.875,1055,79.86373959,2110,-474624,65536,-409088,18
942,131,22,8,0.122087605,0.877912395,305.3475897,331.649553,546.5902335,468.0381679,1073,119.6209588,2146,-482304,67072,-415232,18
759,110,22,8,0.126582278,0.873417722,244.7207775,279.2538435,445.4347826,363,869,121.3687151,1738,-388608,56320,-332288,18
721,108,22,8,0.130277443,0.869722557,233.9966872,262.4024143,425.0818308,347.6944444,829,92.41917503,1658,-369152,55296,-313856,18
932,130,22,8,0.122410546,0.877589454,301.5759923,333.2678942,540.4635193,467.2384615,1062,63.55475763,2124,-477184,66560,-410624,18
897,130,23,7,0.126582278,0.873417722,291.1835733,326.8008329,520.8093645,467.0153846,1027,40.43307087,2054,-459264,66560,-392704,18
895,131,22,8,0.127680312,0.872319688,291.4878824,318.4276032,523.3273743,446.3587786,1026,55.6097561,2052,-458240,67072,-391168,18
824,126,24,6,0.132631579,0.867368421,270.9545023,288.1109525,484.4150485,417.1984127,950,94.81037924,1900,-421888,64512,-357376,18
970,136,23,7,0.122965642,0.877034358,316.5711725,333.7590317,560.4494845,503.9338235,1106,63.09184256,2212,-496640,69632,-427008,18
896,134,22,8,0.130097087,0.869902913,292.7272412,318.9129063,525.2477679,450.3208955,1030,107.966457,2060,-458752,68608,-390144,18
919,133,22,8,0.126425856,0.873574144,299.1776321,324.7938261,536.5451578,457.0902256,1052,74.45152159,2104,-470528,68096,-402432,18
871,130,23,7,0.12987013,0.87012987,284.7843133,308.4999972,510.228473,439.1692308,1001,115.7225434,2002,-445952,66560,-379392,18
894,130,23,7,0.126953125,0.873046875,291.6711496,314.7825319,521.2774049,452.1384615,1024,89.19860627,2048,-457728,66560,-391168,18
906,131,23,7,0.12632594,0.87367406,295.2904412,317.6041902,528.9878587,449.9236641,1037,98.95038168,2074,-463872,67072,-396800,18
897,132,23,7,0.128279883,0.871720117,292.8294383,316.6961785,524.5629877,450.0151515,1029,118.9595376,2058,-459264,67584,-391680,18
882,129,23,7,0.127596439,0.872403561,287.9646709,308.5558781,516.0147392,437.5271318,1011,69.82044199,2022,-451584,66048,-385536,18
953,139,23,7,0.127289377,0.872710623,311.8885352,331.7033292,554.8163694,489.4820144,1092,100.4599816,2184,-487936,71168,-416768,18
914,130,22,8,0.124521073,0.875478927,297.1803402,319.3998588,533.2056893,447.2307692,1044,141.0810811,2088,-467968,66560,-401408,18
870,132,23,7,0.131736527,0.868263473,285.1188957,307.6136139,511.1804598,437.6969697,1002,19.26923077,2004,-445440,67584,-377856,18
927,133,23,7,0.125471698,0.874528302,301.8165848,327.0944426,539.3451996,468.8496241,1060,131.5136476,2120,-474624,68096,-406528,18
960,133,22,8,0.12168344,0.87831656,311.1185521,337.3659038,556.7635417,476.5263158,1093,131.0551559,2186,-491520,68096,-423424,18
999,148,22,8,0.129032258,0.870967742,326.7519404,347.7279218,586.4224224,490.1486486,1147,91.54030327,2294,-511488,75776,-435712,18
856,129,23,7,0.130964467,0.869035533,280.4965234,299.9291902,503.2453271,425.0155039,985,94.16826004,1970,-438272,66048,-372224,18
1173,152,22,8,0.114716981,0.885283019,377.5959021,408.9258249,673.7783461,579.8223684,1325,80.69427527,2650,-600576,77824,-522752,18
901,132,22,8,0.127783156,0.872216844,293.7945093,318.4540131,526.9778024,448.8939394,1033,89.51473137,2066,-461312,67584,-393728,18
9541,445,23,7,0.0445623873,0.955437613,2861.423644,3031.797544,5053.632953,3704.222472,9986,1127.088036,19972,-4884992,227840,-4657152,19
9459,515,24,6,0.051634249,0.948365751,2862.557978,2987.574662,5043.721112,3954.887379,9974,816.202946,19948,-4843008,263680,-4579328,19
9503,472,24,6,0.0473182957,0.952681704,2868.792912,2983.988932,5026.500158,4212.858051,9975,687.4569263,19950,-4865536,241664,-4623872,19
9492,482,23,7,0.0483256467,0.951674353,2870.112771,2946.013511,5027.288032,4203.956432,9974,799.1987179,19948,-4859904,246784,-4613120,19
9468,506,24,6,0.0507319029,0.949268097,2864.307336,2954.938086,5043.673638,3936.409091,9974,803.0595813,19948,-4847616,259072,-4588544,19
9490,485,24,6,0.0486215539,0.951378446,2866.976066,2966.490976,5035.38862,4060.746392,9975,932.2429907,19950,-4858880,248320,-4610560,19
9485,491,24,6,0.0492181235,0.950781877,2867.526822,2956.57892,5036.841856,4054.645621,9976,804.516129,19952,-4856320,251392,-4604928,19
2673,227,24,6,0.0782758621,0.921724138,842.5312663,720.9175055,1472.803217,1187.872247,2900,52.38439306,5800,-1368576,116224,-1252352,19
9443,529,22,8,0.0530485359,0.946951464,2869.036245,2836.464077,5046.946098,3907.497164,9972,614.4177449,19944,-4834816,270848,-4563968,19
9465,510,24,6,0.0511278195,0.94887218,2864.244927,2976.747561,5042.052192,3984.854902,9975,847.4936279,19950,-4846080,261120,-4584960,19
9482,492,24,6,0.0493282535,0.950671747,2867.116422,2948.134426,5036.598502,4041.256098,9974,640.1797176,19948,-4854784,251904,-4602880,19
9452,521,23,7,0.0522410508,0.947758949,2866.291044,2970.077462,5034.611511,4123.230326,9973,949.8095238,19946,-4839424,266752,-4572672,19
9424,542,23,7,0.0543849087,0.945615091,2869.088777,2893.092064,5029.984189,4175.258303,9966,1011.77665,19932,-4825088,277504,-4547584,19
9506,470,22,8,0.0471130714,0.952886929,2871.963861,2938.771956,5024.979592,4250.680851,9976,1203.377563,19952,-4867072,240640,-4626432,19
9467,507,23,7,0.0508321636,0.949167836,2862.851167,3000.995253,5040.757685,3993.04142,9974,310.3298071,19948,-4847104,259584,-4587520,19
9480,494,23,7,0.0495287748,0.950471225,2864.247708,2978.217721,5040.133122,3977.455466,9974,1418.776671,19948,-4853760,252928,-4600832,19
9467,507,22,8,0.0508321636,0.949167836,2868.733935,2954.770819,5030.765396,4179.623274,9974,969.2905734,19948,-4847104,259584,-4587520,19
9505,469,24,6,0.0470222579,0.952977742,2865.985436,2975.697023,5035.166334,4021.469083,9974,676.2033898,19948,-4866560,240128,-4626432,19
9514,462,22,8,0.0463111468,0.953688853,2873.464636,2914.428401,5023.759617,4262.396104,9976,580.3374055,19952,-4871168,236544,-4634624,19
9494,481,24,6,0.0482205514,0.951779449,2867.725298,2973.561076,5031.911628,4121.27027,9975,781.7398119,19950,-4860928,246272,-4614656,19
9451,527,24,6,0.0528161956,0.947183804,2850.63835,3132.357228,5056.931859,3780.204934,9978,474.9167063,19956,-4838912,269824,-4569088,19
9225,522,23,7,0.05355494,0.94644506,2803.369971,2827.812124,4927.586341,3927,9747,386.4789849,19494,-4723200,267264,-4455936,19
81,12,23,7,0.129032258,0.870967742,25.94844407,30.96626749,48.24691358,38.58333333,93,1.694606414,186,-41472,6144,-35328,19
9287,438,24,6,0.0450385604,0.95496144,2809.965368,2654.268158,4896.442662,4153.908676,9725,169.9877644,19450,-4754944,224256,-4530688,19
9537,444,24,6,0.0444845206,0.955515479,2874.109397,2921.864975,5027.667086,4203.400901,9981,1330.8,19962,-4882944,227328,-4655616,19
9509,471,22,8,0.0471943888,0.952805611,2868.556556,2945.20137,5040.457672,3981.906582,9980,2105.485232,19960,-4868608,241152,-4627456,19
7547,355,23,7,0.0449253354,0.955074665,2265.37937,2517.382008,3980.089307,3343.715493,7902,304.9787727,15804,-3864064,181760,-3682304,19
9491,486,24,6,0.0487120377,0.951287962,2876.425876,2793.969576,5036.463386,4062.096708,9977,1144.151376,19954,-4859392,248832,-4610560,19
9469,511,24,6,0.0512024048,0.948797595,2864.415916,2829.378343,5065.907699,3593.170254,9980,1633.387889,19960,-4848128,261632,-4586496,19
9531,450,23,7,0.0450856628,0.954914337,2878.805593,2815.51528,5028.900325,4188.271111,9981,1247.625,19962,-4879872,230400,-4649472,19
9504,477,24,6,0.0477908025,0.952209197,2875.652897,2865.630764,5032.952231,4155.121593,9981,1011.246201,19962,-4866048,244224,-4621824,19
9532,450,23,7,0.0450811461,0.954918854,2882.839572,2770.633302,5023.131347,4321.477778,9982,990.2777778,19964,-4880384,230400,-4649984,19
9487,491,22,8,0.0492082582,0.950791742,2861.25896,3010.422127,5048.300727,3853.364562,9978,1009.919028,19956,-4857344,251392,-4605952,19
9206,490,22,8,0.0505363036,0.949463696,2792.081321,2775.817729,4896.466218,3947.322449,9696,396.5644172,19392,-4713472,250880,-4462592,19
9509,470,23,7,0.0470989077,0.952901092,2865.942059,2958.066816,5044.219056,3893.044681,9979,1528.177642,19958,-4868608,240640,-4627968,19
885,114,24,6,0.114114114,0.885885886,291.9206339,195.8802125,520.6022599,340.0614035,999,23.28128641,1998,-453120,58368,-394752,19
9496,485,22,8,0.0485923254,0.951407675,2870.939864,2915.695446,5039.898905,4033.589691,9981,1828.021978,19962,-4861952,248320,-4613632,19
9460,519,22,8,0.0520092194,0.947990781,2868.557191,2875.864849,5050.884038,3880.244701,9979,1070.708155,19958,-4843520,265728,-4577792,19
9510,474,24,6,0.0474759615,0.952524038,2873.810979,2828.980514,5047.202208,3894.993671,9984,821.0526316,19968,-4869120,242688,-4626432,19
9474,505,22,8,0.0506062732,0.949393727,2856.605065,3077.397466,5051.896348,3828.8,9979,588.7315634,19958,-4850688,258560,-4592128,19
9242,715,23,7,0.0718087777,0.928191222,2881.633248,2776.285328,4986.926423,4876.544056,9957,435.9457093,19914,-4731904,366080,-4365824,19
9175,779,23,7,0.078259996,0.921740004,2877.400585,2800.096474,5009.094169,4605.386393,9954,498.9473684,19908,-4697600,398848,-4298752,19
8363,664,23,7,0.0735571065,0.926442894,2611.421393,2507.474577,4542.427478,4155.959337,9027,232.6546392,18054,-4281856,339968,-3941888,19
8464,666,23,7,0.0729463308,0.927053669,2635.350046,2626.977113,4584.42663,4324.966967,9130,186.5549653,18260,-4333568,340992,-3992576,19
1156,118,23,7,0.0926216641,0.907378336,366.0304906,314.4071973,659.0069204,426.8050847,1274,22.40985048,2548,-591872,60416,-531456,19
8615,695,23,7,0.074650913,0.925349087,2696.410051,2559.291021,4677.826233,4378.751079,9310,235.8156028,18620,-4410880,355840,-4055040,19
4050,322,22,8,0.0736505032,0.926349497,1251.906729,1128.399842,2247.78963,1415.621118,4372,76.35347538,8744,-2073600,164864,-1908736,19
9165,791,23,7,0.0794495781,0.920550422,2882.146949,2739.897943,5016.723513,4535.619469,9956,481.6642477,19912,-4692480,404992,-4287488,19
9207,748,22,8,0.0751381215,0.924861878,2868.218709,2937.559397,4989.310307,4838.783422,9955,820.0164745,19910,-4713984,382976,-4331008,19
8786,714,23,7,0.0751578947,0.924842105,2749.332804,2630.456633,4779.103915,4398.519608,9500,210.9236234,19000,-4498432,365568,-4132864,19
9175,784,23,7,0.0787227633,0.921277237,2884.600307,2738.033206,5007.879128,4653.735969,9959,484.8588121,19918,-4697600,401408,-4296192,19
9215,742,23,7,0.0745204379,0.925479562,2872.771155,2880.011968,5000.800651,4708.254717,9957,201.7629179,19914,-4718080,379904,-4338176,19
9218,739,23,7,0.0742191423,0.925780858,2881.876402,2748.102959,5010.664569,4584.028417,9957,607.1341463,19914,-4719616,378368,-4341248,19
9193,763,23,7,0.0766372037,0.923362796,2884.289778,2721.094147,5008.906451,4612.1481,9956,538.7445887,19912,-4706816,390656,-4316160,19
9199,758,23,7,0.0761273476,0.923872652,2886.495134,2705.899865,5002.761605,4690.631926,9957,539.0904169,19914,-4709888,388096,-4321792,19
9205,749,22,8,0.0752461322,0.924753868,2875.417737,2835.751278,4999.34025,4709.089453,9954,505.0228311,19908,-4712960,383488,-4329472,19
8454,672,23,7,0.0736357659,0.926364234,2638.22958,2558.993429,4592.240241,4201.9375,9126,219.1116447,18252,-4328448,344064,-3984384,19
9192,764,22,8,0.0767376456,0.923262354,2879.999199,2764.680687,5014.643386,4543.643979,9956,515.8549223,19912,-4706304,391168,-4315136,19
9190,765,23,7,0.0768458061,0.923154194,2878.038286,2799.028514,5006.658324,4633.72549,9955,581.4836449,19910,-4705280,391680,-4313600,19
9204,753,23,7,0.0756251883,0.924374812,2881.827119,2740.597286,5016.231638,4523.913679,9957,585.0176263,19914,-4712448,385536,-4326912,19
6051,557,23,7,0.0842917676,0.915708232,1885.2225,2134.874972,3300.861015,3344.032316,6608,141.0760034,13216,-3098112,285184,-2812928,19
5639,485,24,6,0.0791966035,0.920803396,1737.38834,2088.47444,3068.258556,2995.546392,6124,108.446963,12248,-2887168,248320,-2638848,19
5033,408,24,6,0.0749862158,0.925013784,1548.708537,1818.708379,2715.566064,2788.031863,5441,139.7636784,10882,-2576896,208896,-2368000,19
4412,336,24,6,0.0707666386,0.929233361,1358.02553,1339.651167,2428.224161,1669.050595,4748,181.846036,9496,-2258944,172032,-2086912,19
5913,477,24,6,0.0746478873,0.925352113,1833.782987,1955.266435,3174.333164,3457.888889,6390,128.7527705,12780,-3027456,244224,-2783232,19
6184,521,23,7,0.0777032066,0.922296793,1927.881549,1989.585833,3322.684185,3712.833013,6705,137.7362366,13410,-3166208,266752,-2899456,19
6048,551,23,7,0.0834974996,0.9165025,1886.955718,2089.684908,3290.531746,3403.927405,6599,143.4877147,13198,-3096576,282112,-2814464,19
6085,518,23,7,0.0784491898,0.92155081,1894.000612,2031.155925,3283.946426,3514.07722,6603,135.307377,13206,-3115520,265216,-2850304,19
5980,495,24,6,0.0764478764,0.923552124,1850.235747,2081.137003,3228.751003,3349.735354,6475,133.6153529,12950,-3061760,253440,-2808320,19
6035,508,23,7,0.0776402262,0.922359774,1862.20351,2179.508639,3267.911516,3320.570866,6543,125.9480269,13086,-3089920,260096,-2829824,19
5104,400,23,7,0.0726744186,0.927325581,1564.294241,1871.279068,2744.399295,2855.865,5504,129.9645809,11008,-2613248,204800,-2408448,19
5984,570,24,6,0.0869697894,0.913030211,1859.750872,2201.574858,3273.518884,3319.294737,6554,116.3294285,13108,-3063808,291840,-2771968,19
5981,552,23,7,0.0844941068,0.915505893,1858.724947,2154.056855,3279.457114,3132.025362,6533,150.0459348,13066,-3062272,282624,-2779648,19
5972,498,24,6,0.0769706337,0.923029366,1848.718366,2074.565589,3221.212827,3406.831325,6470,132.0677689,12940,-3057664,254976,-2802688,19
5026,413,24,6,0.0759330759,0.924066924,1554.639059,1743.718956,2711.080581,2828.544794,5439,139.497307,10878,-2573312,211456,-2361856,19
6066,526,23,7,0.0797936893,0.920206311,1872.468276,2224.3394,3294.606495,3318.336502,6592,115.6491228,13184,-3105792,269312,-2836480,19
5519,416,24,6,0.0700926706,0.929907329,1702.657572,1837.84057,2953.571843,3159.415865,5935,148.2267732,11870,-2825728,212992,-2612736,19
6001,520,24,6,0.0797423708,0.920257629,1868.532381,2032.415875,3250.687219,3380.013462,6521,148.8133272,13042,-3072512,266240,-2806272,19
6262,524,22,8,0.0772178014,0.922782199,1946.706974,2070.566747,3365.464388,3728.53626,6786,148.9137591,13572,-3206144,268288,-2937856,19
5017,440,24,6,0.080630383,0.919369617,1544.937044,1885.20089,2736.446681,2644.090909,5457,124.0227273,10914,-2568704,225280,-2343424,19
6618,529,23,7,0.0740170701,0.92598293,2044.376065,2259.285019,3547.625416,3903.956522,7147,155.1671733,14294,-3388416,270848,-3117568,19
5698,438,23,7,0.0713820078,0.928617992,1746.713512,2062.037833,3060.638821,3170.767123,6136,157.3333333,12272,-2917376,224256,-2693120,19
6656,579,23,7,0.0800276434,0.919972357,2074.612343,2210.347583,3586.316406,3982.224525,7235,156.8733738,14470,-3407872,296448,-3111424,19
5701,429,23,7,0.0699836868,0.930016313,1751.328746,1958.658485,3037.491317,3437.708625,6130,140.2745995,12260,-2918912,219648,-2699264,19
3961,279,23,7,0.0658018868,0.934198113,1213.372604,1125.039571,2173.215097,1372.096774,4240,74.12587413,8480,-2028032,142848,-1885184,19
6643,554,23,7,0.076976518,0.923023482,2058.576836,2278.198755,3577.885744,3852.180505,7197,135.9977324,14394,-3401216,283648,-3117568,19
192,29,23,7,0.131221719,0.868778281,62.28369514,72.85275819,110.2916667,115.6896552,221,4.939651319,442,-98304,14848,-83456,19
5709,431,23,7,0.0701954397,0.92980456,1748.808083,2040.580599,3049.769136,3345.099768,6140,136.9924141,12280,-2923008,220672,-2702336,19
6699,571,23,7,0.0785419532,0.921458047,2075.016319,2302.2316,3593.597403,4127.103327,7270,126.9647223,14540,-3429888,292352,-3137536,19
5764,467,24,6,0.0749478414,0.925052159,1776.187149,2051.012359,3104.008154,3264.010707,6231,129.0062112,12462,-2951168,239104,-2712064,19
5659,412,22,8,0.0678636139,0.932136386,1731.250914,2011.116763,3020.946457,3242.76699,6071,128.4867725,12142,-2897408,210944,-2686464,19
5626,420,23,7,0.0694674165,0.930532584,1721.101606,2034.539262,3010.651617,3195.607143,6046,135.015632,12092,-2880512,215040,-2665472,19
6654,548,23,7,0.076089975,0.923910025,2057.228186,2309.352986,3578.464382,3881.206204,7202,155.786286,14404,-3406848,280576,-3126272,19
6640,539,23,7,0.0750800947,0.924919905,2056.867798,2231.148433,3564.480422,3904.378479,7179,162.3106489,14358,-3399680,275968,-3123712,19
5687,459,22,8,0.0746827205,0.92531728,1744.066129,2111.757614,3076.712854,3033.69281,6146,113.4576334,12292,-2911744,235008,-2676736,19
6583,543,23,7,0.0761998316,0.923800168,2031.700912,2341.27392,3555.946225,3655.077348,7126,145.5473856,14252,-3370496,278016,-3092480,19
6694,526,23,7,0.0728531856,0.927146814,2066.018149,2270.304543,3581.013146,3985.756654,7220,130.0198091,14440,-3427328,269312,-3158016,19
6609,554,23,7,0.0773418959,0.922658104,2045.601784,2309.604326,3568.112574,3747.67148,7163,152.5015968,14326,-3383808,283648,-3100160,19
6598,552,23,7,0.0772027972,0.922797203,2038.943094,2334.696927,3559.510609,3766.619565,7150,134.0708794,14300,-3378176,282624,-3095552,19
5655,442,23,7,0.0724946695,0.92750533,1730.187944,2104.537398,3045.402299,3095.029412,6097,123.4960502,12194,-2895360,226304,-2669056,19
5277,434,23,7,0.0759936964,0.924006304,1623.156415,1591.004329,2942.595035,1803.092166,5711,100.705343,11422,-2701824,222208,-2479616,19
9325,635,24,6,0.0637550201,0.93624498,2852.595597,3188.077556,4984.992493,4914.527559,9960,810.4149715,19920,-4774400,325120,-4449280,19
9361,604,23,7,0.0606121425,0.939387858,2829.344601,3491.227659,5015.471531,4479.745033,9965,508.6778969,19930,-4792832,309248,-4483584,19
5831,412,24,6,0.0659939132,0.934006087,1787.985907,1826.585293,3176.358429,2352.669903,6243,111.4224523,12486,-2985472,210944,-2774528,19
9368,594,23,7,0.059626581,0.940373419,2847.973098,3263.149054,5003.860589,4628.850168,9962,886.2989324,19924,-4796416,304128,-4492288,19
5817,369,23,7,0.0596508244,0.940349176,1757.579882,1977.172275,3150.30875,2197.95393,6186,232.9943503,12372,-2978304,188928,-2789376,19
9310,653,24,6,0.0655425073,0.934457493,2847.061787,3199.292368,5025.058324,4368.105666,9963,1259.54488,19926,-4766720,334336,-4432384,19
5951,347,23,7,0.0550968561,0.944903144,1797.351478,1975.881684,3196.455722,2344.216138,6298,244.5825243,12596,-3046912,177664,-2869248,19
9272,685,24,6,0.068795822,0.931204178,2816.393559,3469.330801,5038.174612,4178.026277,9957,277.8956182,19914,-4747264,350720,-4396544,19
9358,602,24,6,0.0604417671,0.939558233,2841.485934,3354.436229,4987.023723,4879.089701,9960,1013.224822,19920,-4791296,308224,-4483072,19
9305,655,22,8,0.0657630522,0.934236948,2826.362684,3473.36431,5007.593444,4595.607634,9960,665.3306613,19920,-4764160,335360,-4428800,19
9338,629,24,6,0.0631082572,0.936891743,2838.71317,3305.722397,5035.281859,4222.680445,9967,822.359736,19934,-4781056,322048,-4459008,19
5994,369,23,7,0.0579915134,0.942008487,1811.22149,2026.131698,3235.002002,2321.04065,6363,214.9662162,12726,-3068928,188928,-2880000,19
9376,586,23,7,0.0588235294,0.941176471,2847.296518,3297.908859,4978.603456,5027.84471,9962,778.28125,19924,-4800512,300032,-4500480,19
5746,362,23,7,0.0592665357,0.940733464,1739.387751,1923.684881,3106.844936,2223.632597,6108,239.9057345,12216,-2941952,185344,-2756608,19
9346,618,23,7,0.0620232838,0.937976716,2853.063162,3207.822955,4979.779371,5023.644013,9964,605.7142857,19928,-4785152,316416,-4468736,19
9415,553,24,6,0.0554775281,0.944522472,2851.342732,3288.234287,4992.613914,4846.358047,9968,823.8016529,19936,-4820480,283136,-4537344,19
9424,544,24,6,0.0545746388,0.945425361,2857.245308,3154.904211,5017.240132,4417.325368,9968,886.0444444,19936,-4825088,278528,-4546560,19
9337,628,24,6,0.063020572,0.936979428,2842.355844,3342.153717,4992.416622,4842.995223,9965,681.1346548,19930,-4780544,321536,-4459008,19
9384,583,23,7,0.058493027,0.941506973,2845.93312,3336.322546,4994.44075,4815.945111,9967,691.6724497,19934,-4804608,298496,-4506112,19
9212,746,23,7,0.0749146415,0.925085359,2846.243475,3203.341108,4972.882219,5061.219839,9958,620.0498132,19916,-4716544,381952,-4334592,19
9220,738,23,7,0.0741112673,0.925888733,2851.645109,3140.518458,4963.209219,5183.02439,9958,402.3434343,19916,-4720640,377856,-4342784,19
9235,722,23,7,0.0725118007,0.927488199,2849.907615,3160.009468,4959.814727,5224.396122,9957,865.0738488,19914,-4728320,369664,-4358656,19
9280,680,23,7,0.0682730924,0.931726908,2869.704821,2923.139905,4952.813793,5358.335294,9960,574.7259088,19920,-4751360,348160,-4403200,19
6584,421,23,7,0.0600999286,0.939900071,2018.794402,1940.10698,3548.488305,2791.610451,7005,270.2546296,14010,-3371008,215552,-3155456,19
9250,709,23,7,0.0711918867,0.928808113,2858.064758,3083.790209,4970.729297,5100.950635,9959,560.438942,19918,-4736000,363008,-4372992,19
9307,656,23,7,0.0658436214,0.934156379,2859.84135,3085.004669,4963.316643,5247.070122,9963,688.5279889,19926,-4765184,335872,-4429312,19
6543,435,22,8,0.062338779,0.937661221,2025.395329,1743.288013,3527.533089,2917.429885,6978,281.4844695,13956,-3350016,222720,-3127296,19
6574,443,23,7,0.0631323928,0.936867607,2026.158157,1865.989234,3559.088378,2765.702032,7017,302.3265834,14034,-3365888,226816,-3139072,19
625,109,23,7,0.148501362,0.851498638,217.3020261,166.944844,377.2896,311.3669725,734,28.88626525,1468,-320000,55808,-264192,19
9259,699,23,7,0.0701948182,0.929805182,2857.597714,3087.44302,4968.176045,5129.497854,9958,696.3636364,19916,-4740608,357888,-4382720,19
9261,699,23,7,0.0701807229,0.929819277,2846.728098,3228.777867,4982.223842,4957.660944,9960,228.5452042,19920,-4741632,357888,-4383744,19
6525,408,23,7,0.0588489831,0.941151017,2004.591375,1799.467673,3512.476169,2739.715686,6933,269.766537,13866,-3340800,208896,-3131904,19
9276,686,23,7,0.0688616744,0.931138326,2849.454151,3210.099314,4985.75248,4923.998542,9962,561.2394366,19924,-4749312,351232,-4398080,19
9272,688,23,7,0.0690763052,0.930923695,2856.71941,3113.633393,4980.362274,4982.356105,9960,767.3343606,19920,-4747264,352256,-4395008,19
9312,652,23,7,0.065435568,0.934564432,2865.906254,3013.972302,4967.877685,5191.338957,9964,556.9591951,19928,-4767744,333824,-4433920,19
9294,669,23,7,0.0671484493,0.932851551,2860.348897,3085.771989,4978.404992,5031.943199,9963,630.9689677,19926,-4758528,342528,-4416000,19
9264,694,22,8,0.0696927094,0.930307291,2852.773381,3148.347361,4968.741364,5123.113833,9958,676.0353021,19916,-4743168,355328,-4387840,19
9275,683,23,7,0.0685880699,0.93141193,2848.988724,3197.049483,4966.185013,5160.314788,9958,758.9939024,19916,-4748800,349696,-4399104,19
9264,697,22,8,0.0699728943,0.930027106,2855.342895,3120.507757,4962.39864,5228.235294,9961,601.8731118,19922,-4743168,356864,-4386304,19
9456,518,23,7,0.0519350311,0.948064969,2863.771638,2962.694524,5044.319268,3950.274131,9974,1054.334038,19948,-4841472,265216,-4576256,19
9452,522,23,7,0.0523360738,0.947663926,2862.884565,2923.519042,5052.109077,3817.605364,9974,632.8680203,19948,-4839424,267264,-4572160,19
9487,487,24,6,0.0488269501,0.95117305,2864.428955,3017.261022,5033.495099,4091.492813,9974,1022.974359,19948,-4857344,249344,-4608000,19
5785,359,23,7,0.0584309896,0.94156901,1763.952758,1827.354464,3108.508729,2492.247911,6144,111.6481919,12288,-2961920,183808,-2778112,19
9507,468,23,7,0.0469172932,0.953082707,2867.391727,2989.447118,5030.239613,4129.940171,9975,848.9361702,19950,-4867584,239616,-4627968,19
9387,579,23,7,0.0580975316,0.941902468,2866.354141,2900.163243,5038.728028,4088.119171,9966,1057.961783,19932,-4806144,296448,-4509696,19
9484,491,23,7,0.0492230576,0.950776942,2865.266551,3000.129548,5035.198545,4076.327902,9975,830.5578684,19950,-4855808,251392,-4604416,19
9478,497,23,7,0.0498245614,0.950175439,2867.216749,2947.068037,5037.988605,4034.696177,9975,801.8488746,19950,-4852736,254464,-4598272,19
9498,479,23,7,0.048010424,0.951989576,2870.751241,2902.46551,5036.660139,4043.956159,9977,547.2846956,19954,-4862976,245248,-4617728,19
9468,507,24,6,0.0508270677,0.949172932,2865.516553,2947.910461,5042.85245,3963.654832,9975,616.8831169,19950,-4847616,259584,-4588032,19
9471,503,24,6,0.0504311209,0.949568879,2860.804953,3013.038626,5044.304192,3917.932406,9974,462.6159555,19948,-4849152,257536,-4591616,19
9453,521,23,7,0.0522358131,0.947764187,2863.230216,2984.264531,5042.556966,3988.548944,9974,994.4167498,19948,-4839936,266752,-4573184,19
9475,499,23,7,0.0500300782,0.949969922,2865.693925,2982.739603,5035.422586,4077.547094,9974,806.305578,19948,-4851200,255488,-4595712,19
9460,514,23,7,0.0515339884,0.948466012,2863.621962,2993.774186,5039.85,4024.015564,9974,1176.179245,19948,-4843520,263168,-4580352,19
9392,573,24,6,0.0575012544,0.942498746,2869.579316,2855.698997,5035.505004,4122.394415,9965,840.2192243,19930,-4808704,293376,-4515328,19
9460,514,23,7,0.0515339884,0.948466012,2863.438927,2992.069579,5040.632981,4009.605058,9974,868.815331,19948,-4843520,263168,-4580352,19
3276,266,23,7,0.0750988142,0.924901186,1017.188228,919.865982,1816.52381,1216.996241,3542,62.34817814,7084,-1677312,136192,-1541120,19
3455,262,23,7,0.0704869518,0.929513048,1058.863613,1103.271273,1901.107091,1303.732824,3717,67.06964995,7434,-1768960,134144,-1634816,19
9468,506,22,8,0.0507319029,0.949268097,2863.485076,2994.540632,5039.993768,4005.264822,9974,641.8275418,19948,-4847616,259072,-4588544,19
9498,477,23,7,0.0478195489,0.952180451,2868.241621,2977.378344,5029.565172,4160.356394,9975,773.8557021,19950,-4862976,244224,-4618752,19
9432,543,23,7,0.0544360902,0.94556391,2849.718025,3043.846992,5067.050148,3614.88582,9975,785.4330709,19950,-4829184,278016,-4551168,19
9504,474,23,7,0.0475045099,0.95249549,2869.741331,2873.353028,5044.342487,3889.873418,9978,666.0881175,19956,-4866048,242688,-4623360,19
9437,537,24,6,0.053839984,0.946160016,2856.685031,3138.399735,5034.291512,4165.206704,9974,1488.656716,19948,-4831744,274944,-4556800,19
9482,492,24,6,0.0493282535,0.950671747,2861.488948,3151.284811,5016.298777,4432.479675,9974,1063.326226,19948,-4854784,251904,-4602880,19
9438,536,23,7,0.0537397233,0.946260277,2866.223856,2828.682394,5057.510595,3754.738806,9974,1408.757062,19948,-4832256,274432,-4557824,19
9441,533,22,8,0.0534389412,0.946561059,2849.98088,3075.161485,5061.259083,3681.009381,9974,516.5199379,19948,-4833792,272896,-4560896,19
9432,543,24,6,0.0544360902,0.94556391,2857.046024,3119.230946,5038.164334,4116.637201,9975,1073.735199,19950,-4829184,278016,-4551168,19
9410,566,23,7,0.0567361668,0.943263833,2853.035228,2855.982755,5084.310733,3395.60424,9976,1047.89916,19952,-4817920,289792,-4528128,19
9405,570,23,7,0.0571428571,0.942857143,2833.912475,3131.884329,5086.189474,3367.873684,9975,329.5341923,19950,-4815360,291840,-4523520,19
9426,547,24,6,0.0548480898,0.94515191,2849.424838,3107.7339,5057.138659,3778.358318,9973,954.354067,19946,-4826112,280064,-4546048,19
9410,563,23,7,0.0564524215,0.943547578,2848.548256,3106.157497,5059.382891,3777.190053,9973,644.250646,19946,-4817920,288256,-4529664,19
9392,581,24,6,0.0582572947,0.941742705,2847.700708,3089.469488,5063.809838,3745.351119,9973,736.5583456,19946,-4808704,297472,-4511232,19
9427,548,24,6,0.0549373434,0.945062657,2838.185415,3190.263637,5071.457516,3552.317518,9975,560.3932584,19950,-4826624,280576,-4546048,19
9428,543,23,7,0.054457928,0.945542072,2852.953401,3121.741654,5043.931905,3980.139963,9971,838.6038688,19942,-4827136,278016,-4549120,19
9394,577,24,6,0.0578678167,0.942132183,2846.595645,3227.559374,5040.329146,4101.480069,9971,1018.488253,19942,-4809728,295424,-4514304,19
3199,241,23,7,0.0700581395,0.92994186,978.3488872,948.6784408,1770.339794,1058.93361,3440,60.52076003,6880,-1637888,123392,-1514496,19
9466,509,23,7,0.0510275689,0.948972431,2857.294235,3211.3522,5019.065709,4410.263261,9975,816.953317,19950,-4846592,260608,-4585984,19
9437,535,23,7,0.0536502206,0.946349779,2861.564382,3036.420412,5035.788386,4117.08972,9972,752.6037736,19944,-4831744,273920,-4557824,19
9429,544,22,8,0.0545472776,0.945452722,2868.617793,2931.199266,5034.815039,4158.235294,9973,460.0092251,19946,-4827648,278528,-4549120,19
9530,451,23,7,0.0451858531,0.954814147,2883.01132,2788.561306,5016.875131,4444.237251,9981,870.1830863,19962,-4879360,230912,-4648448,19
3755,318,22,8,0.0780751289,0.921924871,1143.071672,1494.30383,2019.764581,2240.518868,4073,71.82154823,8146,-1922560,162816,-1759744,19
3744,312,23,7,0.0769230769,0.923076923,1136.300301,1495.58612,2004.328526,2318.557692,4056,97.38295318,8112,-1916928,159744,-1757184,19
3754,316,22,8,0.0776412776,0.922358722,1137.816956,1516.620419,2010.021577,2338.177215,4070,84.8977889,8140,-1922048,161792,-1760256,19
7278,593,23,7,0.0753398552,0.924660145,2247.758981,2527.130416,3907.744435,4282.785835,7871,144.6609079,15742,-3726336,303616,-3422720,19
3723,303,22,8,0.0752608048,0.924739195,1132.223687,1463.198227,1995.139672,2239.09571,4026,107.3313783,8052,-1906176,155136,-1751040,19
3758,316,23,7,0.0775650466,0.922434953,1142.967635,1480.194373,2011.347525,2348.515823,4074,104.0347293,8148,-1924096,161792,-1762304,19
3731,292,23,7,0.0725826498,0.92741735,1133.319082,1452.258095,1993.350844,2250.287671,4023,89.49944383,8046,-1910272,149504,-1760768,19
7188,611,22,8,0.0783433774,0.921656623,2234.530756,2404.874149,3865.926822,4300.847791,7799,152.5625978,15598,-3680256,312832,-3367424,19
3820,345,23,7,0.0828331333,0.917166867,1162.190919,1561.766549,2062.273822,2312.489855,4165,73.71681416,8330,-1955840,176640,-1779200,19
3750,330,23,7,0.0808823529,0.919117647,1144.802014,1474.583279,2016.1096,2317.663636,4080,101.2406948,8160,-1920000,168960,-1751040,19
3755,314,23,7,0.0771688376,0.922831162,1144.268215,1485.705759,2025.475632,2148.898089,4069,111.6323731,8138,-1922560,160768,-1761792,19
3757,321,23,7,0.0787150564,0.921284944,1146.482509,1485.490547,2029.442907,2157.208723,4078,101.0656753,8156,-1923584,164352,-1759232,19
3748,306,22,8,0.0754810064,0.924518994,1141.684697,1463.96365,2012.522946,2210.944444,4054,98.85393806,8108,-1918976,156672,-1762304,19
3781,312,23,7,0.0762277058,0.923772294,1149.234051,1470.731137,2016.72494,2413.891026,4093,72.55805708,8186,-1935872,159744,-1776128,19
3782,308,23,7,0.0753056235,0.924694377,1147.546816,1497.165066,2020.762824,2349.253247,4090,100.6397638,8180,-1936384,157696,-1778688,19
513,63,23,7,0.109375,0.890625,160.4111889,187.7309311,278.128655,372.952381,576,19.10447761,1152,-262656,32256,-230400,19
3744,317,23,7,0.0780595912,0.921940409,1140.18103,1496.79623,2022.314103,2133.586751,4061,97.06022945,8122,-1916928,162304,-1754624,19
4013,318,23,7,0.0734241515,0.926575849,1216.7425,1589.548045,2144.466982,2437.735849,4331,84.32632399,8662,-2054656,162816,-1891840,19
1872,136,23,7,0.0677290837,0.932270916,572.5782993,563.8240041,1029.832265,655.8088235,2008,31.52276295,4016,-958464,69632,-888832,19
1839,149,23,7,0.0749496982,0.925050302,566.7944811,573.1233821,1019.23056,689.2684564,1988,31.37131135,3976,-941568,76288,-865280,19
3206,274,21,9,0.0787356322,0.921264368,987.741908,965.9240488,1796.674049,1083.222628,3480,62.12067119,6960,-1641472,140288,-1501184,20
3272,275,22,8,0.0775303073,0.922469693,1007.227377,983.9031629,1830.161064,1105.785455,3547,62.53526093,7094,-1675264,140800,-1534464,20
3263,293,22,8,0.0823959505,0.917604049,1006.43953,1093.201821,1826.660742,1242.156997,3556,62.32036453,7112,-1670656,150016,-1520640,20
3220,276,22,8,0.0789473684,0.921052632,992.902232,981.0594654,1802.873292,1114.144928,3496,64.00585866,6992,-1648640,141312,-1507328,20
3201,272,21,9,0.0783184567,0.921681543,987.0231958,974.634606,1789.819431,1115.400735,3473,61.16590349,6946,-1638912,139264,-1499648,20
3170,257,21,9,0.074992705,0.925007295,973.8744211,966.6557661,1764.384858,1092.521401,3427,87.49042635,6854,-1623040,131584,-1491456,20
3185,276,21,9,0.0797457382,0.920254262,982.4287658,959.4932632,1787.313658,1081.148551,3461,62.1476028,6922,-1630720,141312,-1489408,20
3180,269,22,8,0.0779936213,0.922006379,980.540694,955.0956841,1778.377358,1093.996283,3449,74.73456121,6898,-1628160,137728,-1490432,20
3234,273,22,8,0.0778443114,0.922155689,996.2543852,979.2752141,1808.362709,1110.010989,3507,87.43455497,7014,-1655808,139776,-1516032,20
3217,257,22,8,0.0739781232,0.926021877,991.0723455,954.5624034,1785.427728,1137.564202,3474,87.0240481,6948,-1647104,131584,-1515520,20
1480,178,21,9,0.107358263,0.892641737,472.7277171,437.7715397,862.4472973,555.5561798,1658,29.37632884,3316,-757760,91136,-666624,20
3229,266,22,8,0.0761087268,0.923891273,992.5258986,976.7800915,1801.826881,1094.590226,3495,62.91629163,6990,-1653248,136192,-1517056,20
3203,284,21,9,0.0814453685,0.918554631,986.8699931,991.2295697,1802.539806,1083.778169,3487,61.1969112,6974,-1639936,145408,-1494528,20
3204,271,22,8,0.0779856115,0.922014388,988.1753609,960.1542672,1791.680712,1103.339483,3475,60.90080617,6950,-1640448,138752,-1501696,20
3110,250,21,9,0.0744047619,0.925595238,954.9300566,932.5056246,1731.263987,1048.996,3360,73.18666957,6720,-1592320,128000,-1464320,20
3270,267,22,8,0.0754877014,0.924512299,1005.43875,986.7978656,1822.01896,1119.666667,3537,83.02816901,7074,-1674240,136704,-1537536,20
3161,255,22,8,0.0746487119,0.925351288,971.2058727,957.9862108,1758.575767,1087.756863,3416,87.47759283,6832,-1618432,130560,-1487872,20
3220,281,22,8,0.0802627821,0.919737218,994.5516347,991.0139999,1804.539752,1137.483986,3501,78.23463687,7002,-1648640,143872,-1504768,20
3221,258,22,8,0.0741592412,0.925840759,990.67508,963.8607412,1789.886371,1117.193798,3479,72.82813481,6958,-1649152,132096,-1517056,20
3214,268,22,8,0.0769672602,0.92303274,988.7893277,972.5014403,1795.611388,1092.567164,3482,62.59212655,6964,-1645568,137216,-1508352,20
42,13,21,9,0.236363636,0.763636364,15.92535023,15.30943168,28.95238095,24.92307692,55,1.645228836,110,-21504,6656,-14848,20
40,13,22,8,0.245283019,0.754716981,15.03942735,16.00887328,27.375,25.84615385,53,5.584826133,106,-20480,6656,-13824,20
43,13,22,8,0.232142857,0.767857143,16.20845148,15.5928219,29.46511628,25.30769231,56,1.709923664,112,-22016,6656,-15360,20
44,15,22,8,0.254237288,0.745762712,16.80484729,17.65471294,30.22727273,29.33333333,59,1.803178484,118,-22528,7680,-14848,20
44,14,21,9,0.24137931,0.75862069,16.93137583,15.55257706,30.68181818,25.78571429,58,1.711924439,116,-22528,7168,-15360,20
42,16,21,9,0.275862069,0.724137931,16.24598328,17.94076625,29.14285714,30.4375,58,1.598236429,116,-21504,8192,-13312,20
42,13,21,9,0.236363636,0.763636364,15.95602304,15.18524666,28.97619048,24.84615385,55,1.55984118,110,-21504,6656,-14848,20
43,13,22,8,0.232142857,0.767857143,16.17822586,15.71642189,29.44186047,25.38461538,56,1.621778164,112,-22016,6656,-15360,20
44,16,22,8,0.266666667,0.733333333,16.974869,18.22504715,30.38636364,30.8125,60,1.828153565,120,-22528,8192,-14336,20
44,15,22,8,0.254237288,0.745762712,16.80484729,17.65471294,30.22727273,29.33333333,59,1.810926949,118,-22528,7680,-14848,20
43,13,22,8,0.232142857,0.767857143,16.20845148,15.5928219,29.46511628,25.30769231,56,1.646090535,112,-22016,6656,-15360,20
43,13,22,8,0.232142857,0.767857143,16.15065631,15.84839417,29.39534884,25.53846154,56,1.59181353,112,-22016,6656,-15360,20
44,14,21,9,0.24137931,0.75862069,16.85836722,15.96248791,30.5,26.35714286,58,1.729278473,116,-22528,7168,-15360,20
45,14,22,8,0.237288136,0.762711864,17.2127716,15.84378459,31.17777778,26.21428571,59,1.747112822,118,-23040,7168,-15872,20
43,13,22,8,0.232142857,0.767857143,16.21268858,15.59851305,29.44186047,25.38461538,56,1.525885559,112,-22016,6656,-15360,20
43,14,22,8,0.245614035,0.754385965,16.47250524,16.2260813,29.65116279,27,57,1.679929266,114,-22016,7168,-14848,20
42,13,21,9,0.236363636,0.763636364,15.95602304,15.18524666,28.97619048,24.84615385,55,1.625775939,110,-21504,6656,-14848,20
43,13,22,8,0.232142857,0.767857143,16.17822586,15.71642189,29.44186047,25.38461538,56,1.492537313,112,-22016,6656,-15360,20
42,13,21,9,0.236363636,0.763636364,15.95602304,15.18524666,28.97619048,24.84615385,55,1.454257007,110,-21504,6656,-14848,20
42,13,21,9,0.236363636,0.763636364,15.92983481,15.20899765,29.04761905,24.61538462,55,1.620506777,110,-21504,6656,-14848,20
551,144,21,9,0.207194245,0.792805755,191.9782597,225.689652,359.1887477,305.1875,695,18.21278826,1390,-282112,73728,-208384,20
573,145,22,8,0.201949861,0.798050139,198.3294013,234.1638982,370.7015707,315.2344828,718,20.24816695,1436,-293376,74240,-219136,20
563,131,22,8,0.188760807,0.811239193,191.7497274,228.0463448,358.2007105,301.5114504,694,18.82289124,1388,-288256,67072,-221184,20
541,127,20,10,0.19011976,0.80988024,184.89275,217.9335633,344.9981516,289.7795276,668,17.41397289,1336,-276992,65024,-211968,20
557,136,22,8,0.196248196,0.803751804,191.7968156,226.9047328,356.2423698,309.1470588,693,18.83152174,1386,-285184,69632,-215552,20
556,149,22,8,0.211347518,0.788652482,191.4242951,243.3067905,354.5071942,347.3758389,705,13.41324201,1410,-284672,76288,-208384,20
556,138,22,8,0.198847262,0.801152738,193.2511233,220.4259624,359.2356115,300.2173913,694,17.79943575,1388,-284672,70656,-214016,20
564,136,22,8,0.194285714,0.805714286,192.9470921,231.3472969,360.7907801,307.8235294,700,19.34235977,1400,-288768,69632,-219136,20
556,138,22,8,0.198847262,0.801152738,190.5555952,234.0430871,353.6654676,322.6594203,694,18.75675676,1388,-284672,70656,-214016,20
563,132,22,8,0.189928058,0.810071942,191.1664424,234.7614476,354.5097691,320.2348485,695,19.06198574,1390,-288256,67584,-220672,20
567,136,22,8,0.193456615,0.806543385,195.5081112,224.791697,363.7901235,302.8455882,703,19.65334079,1406,-290304,69632,-220672,20
559,136,22,8,0.195683453,0.804316547,192.6504716,226.1257285,357.7978533,307.7279412,695,19.68838527,1390,-286208,69632,-216576,20
554,139,20,10,0.200577201,0.799422799,190.6404281,228.1137293,358.5252708,301.0647482,693,18.91891892,1386,-283648,71168,-212480,20
552,138,21,9,0.2,0.8,189.2451899,228.1320584,357.9003623,295.8985507,690,19.0397351,1380,-282624,70656,-211968,20
554,141,21,9,0.202877698,0.797122302,191.0538481,230.1903821,358.1624549,308.070922,695,18.69284562,1390,-283648,72192,-211456,20
636,143,22,8,0.183568678,0.816431322,217.6134432,247.5847794,402.1352201,336.027972,779,20.33942559,1558,-325632,73216,-252416,20
564,136,22,8,0.194285714,0.805714286,192.4494113,233.6219274,360.1755319,310.375,700,18.21493625,1400,-288768,69632,-219136,20
568,141,21,9,0.19887165,0.80112835,194.4718293,239.935201,360.959507,330.9929078,709,17.72056986,1418,-290816,72192,-218624,20
577,137,22,8,0.191876751,0.808123249,197.3464042,233.0862825,369.2911612,307.8394161,714,19.94413408,1428,-295424,70144,-225280,20
483,121,20,10,0.200331126,0.799668874,165.5970099,193.8952689,317.8530021,241.214876,604,7.694267516,1208,-247296,61952,-185344,20
584,140,22,8,0.193370166,0.806629834,200.0778638,238.3781059,372.3270548,321.5071429,724,18.30594185,1448,-299008,71680,-227328,20
546,127,22,8,0.188707281,0.811292719,186.8264256,219.7275129,345.5695971,300.1574803,673,17.01643489,1346,-279552,65024,-214528,20
560,139,22,8,0.198855508,0.801144492,193.7740639,223.378956,363.2982143,296.4244604,699,19.17695473,1398,-286720,71168,-215552,20
577,138,22,8,0.193006993,0.806993007,197.6205996,234.7905399,368.3275563,314.8188406,715,19.30866865,1430,-295424,70656,-224768,20
555,136,22,8,0.196816208,0.803183792,193.4185581,218.8705338,354.7711712,310.2058824,691,17.64555669,1382,-284160,69632,-214528,20
578,127,22,8,0.180141844,0.819858156,194.3685626,238.2246314,359.982699,321.2204724,705,18.7400319,1410,-295936,65024,-230912,20
572,141,21,9,0.197755961,0.802244039,196.6137868,235.9637429,366.1660839,319.8156028,713,15.51011529,1426,-292864,72192,-220672,20
556,138,21,9,0.198847262,0.801152738,192.5890567,225.602774,356.1348921,312.7101449,694,18.0541103,1388,-284672,70656,-214016,20
577,142,22,8,0.197496523,0.802503477,198.6872485,237.5597358,367.9098787,327.8591549,719,19.81808159,1438,-295424,72704,-222720,20
567,135,22,8,0.192307692,0.807692308,194.4647325,226.8795884,363.6878307,300.3111111,702,19.67488789,1404,-290304,69120,-221184,20
563,127,22,8,0.184057971,0.815942029,192.2373461,224.1098456,353.4085258,310.4409449,690,19.38746839,1380,-288256,65024,-223232,20
564,141,22,8,0.2,0.8,195.2150236,227.889961,364.6702128,306.3191489,705,18.95670879,1410,-288768,72192,-216576,20
552,126,20,10,0.185840708,0.814159292,187.3083128,223.0912155,350.1123188,293.0079365,678,18.21112006,1356,-282624,64512,-218112,20
572,131,22,8,0.186344239,0.813655761,195.2876619,231.19814,358.6451049,322.9847328,703,20.05706134,1406,-292864,67072,-225792,20
562,129,22,8,0.186685962,0.813314038,190.3258886,229.6707101,356.5088968,300.2170543,691,17.48924323,1382,-287744,66048,-221696,20
567,145,21,9,0.203651685,0.796348315,196.1095847,233.5037673,367.9717813,311.6413793,712,18.68766404,1424,-290304,74240,-216064,20
569,140,21,9,0.197461213,0.802538787,197.183134,226.6447184,366.5606327,308.0142857,709,16.029844,1418,-291328,71680,-219648,20
569,133,22,8,0.189458689,0.810541311,195.0506001,228.0671056,360.8681898,311.4210526,702,19.33351694,1404,-291328,68096,-223232,20
625,144,21,9,0.187256177,0.812743823,216.2525801,238.5981038,396.8704,333.4791667,769,19.53760163,1538,-320000,73728,-246272,20
579,135,21,9,0.18907563,0.81092437,198.2036087,231.4406549,368.2780656,311.2740741,714,19.62616822,1428,-296448,69120,-227328,20
527,124,21,9,0.19047619,0.80952381,180.49461,213.586788,333.7362429,293.1209677,651,17.24960254,1302,-269824,63488,-206336,20
532,128,21,9,0.193939394,0.806060606,182.5999858,219.1414438,335.6466165,309.109375,660,18.13685078,1320,-272384,65536,-206848,20
537,123,22,8,0.186363636,0.813636364,182.8507187,217.3067669,338.7337058,294.5528455,660,16.62887377,1320,-274944,62976,-211968,20
575,138,22,8,0.193548387,0.806451613,200.3936946,220.6597834,368.5391304,308.9202899,713,18.73850197,1426,-294400,70656,-223744,20
546,142,22,8,0.206395349,0.793604651,190.8435295,223.9243632,351.5677656,317.3239437,688,19.36936937,1376,-279552,72704,-206848,20
519,118,22,8,0.185243328,0.814756672,176.2915268,211.5331675,325.8015414,289.0847458,637,18.03000283,1274,-265728,60416,-205312,20
524,126,21,9,0.193846154,0.806153846,180.028724,212.7696132,334.0629771,289.8888889,650,16.59856997,1300,-268288,64512,-203776,20
534,132,21,9,0.198198198,0.801801802,183.153134,224.3027453,338.3389513,313.9242424,666,18.09782609,1332,-273408,67584,-205824,20
537,137,21,9,0.203264095,0.796735905,186.1130386,221.1008426,346.566108,301.9635036,674,17.86850477,1348,-274944,70144,-204800,20
532,124,21,9,0.18902439,0.81097561,179.3359961,226.4163641,333.0526316,308.9677419,656,11.68091168,1312,-272384,63488,-208896,20
549,134,22,8,0.196193265,0.803806735,189.1507974,222.6581096,351.7413479,302.0895522,683,17.99736495,1366,-281088,68608,-212480,20
530,135,21,9,0.203007519,0.796992481,185.1934459,212.200629,342.7943396,294.5481481,665,17.78550415,1330,-271360,69120,-202240,20
549,140,22,8,0.203193033,0.796806967,192.0241359,219.7026538,354.7285974,306.85,689,18.46689895,1378,-281088,71680,-209408,20
577,134,21,9,0.188466948,0.811533052,199.6891312,223.4156964,365.1299827,316.6865672,711,18.4244623,1422,-295424,68608,-226816,20
548,130,22,8,0.191740413,0.808259587,188.6241087,219.0285189,348.629562,301.0153846,678,17.62412269,1356,-280576,66560,-214016,20
533,127,22,8,0.192424242,0.807575758,182.4478029,219.6732272,336.1144465,306.9370079,660,17.43264659,1320,-272896,65024,-207872,20
548,131,22,8,0.192930781,0.807069219,187.4008873,226.9574409,345.7572993,315.9160305,679,17.74235694,1358,-280576,67072,-213504,20
530,126,22,8,0.192073171,0.807926829,181.4356184,217.4910871,335.0358491,301.0079365,656,17.43753323,1312,-271360,64512,-206848,20
550,136,22,8,0.198250729,0.801749271,187.9883661,233.0999968,348.7309091,322.3455882,686,12.03297667,1372,-281600,69632,-211968,20
595,133,22,8,0.182692308,0.817307692,204.4669179,227.4851612,375.507563,315.2556391,728,19.42369264,1456,-304640,68096,-236544,20
538,133,21,9,0.198211624,0.801788376,185.7749667,219.9605474,343.9925651,303.6691729,671,16.478389,1342,-275456,68096,-207360,20
539,138,22,8,0.203840473,0.796159527,187.5323342,220.9528824,346.8849722,308.2028986,677,18.86319309,1354,-275968,70656,-205312,20
530,130,22,8,0.196969697,0.803030303,186.7442666,201.4932523,339.0584906,295.6076923,660,15.67323676,1320,-271360,66560,-204800,20
572,132,21,9,0.1875,0.8125,197.3366068,217.9898981,365.6660839,295.4469697,704,18.61448969,1408,-292864,67584,-225280,20
541,132,22,8,0.196136701,0.803863299,186.8474191,217.1230196,347.2809612,294.8636364,673,18.86739557,1346,-276992,67584,-209408,20
548,136,22,8,0.198830409,0.801169591,190.0519282,220.2673449,352.5018248,302.1985294,684,17.26400808,1368,-280576,69632,-210944,20
544,136,22,8,0.2,0.8,187.5685964,224.988479,348.6194853,308.0220588,680,18.07068828,1360,-278528,69632,-208896,20
539,133,21,9,0.197916667,0.802083333,186.8461464,217.63459,344.4434137,304.3082707,672,18.76046901,1344,-275968,68096,-207872,20
554,127,22,8,0.186490455,0.813509545,189.5822628,220.7028237,349.6191336,303.4015748,681,18.45528455,1362,-283648,65024,-218624,20
527,132,21,9,0.20030349,0.79969651,181.6011088,219.0110782,337.2371917,301.1060606,659,17.9956308,1318,-269824,67584,-202240,20
550,118,22,8,0.176646707,0.823353293,186.4904993,217.3361744,341.1509091,303.5,668,17.01477331,1336,-281600,60416,-221184,20
536,137,21,9,0.203566122,0.796433878,187.7306793,210.2693565,350.136194,285.6058394,673,16.49105611,1346,-274432,70144,-204288,20
523,133,21,9,0.202743902,0.797256098,182.1101089,213.014684,336.0038241,298.9924812,656,16.46173149,1312,-267776,68096,-199680,20
542,134,22,8,0.198224852,0.801775148,188.8896679,212.6549022,349.7324723,293.0671642,676,17.24049987,1352,-277504,68608,-208896,20
555,137,22,8,0.197976879,0.802023121,192.8382813,218.359344,359.0792793,295.540146,692,18.77883311,1384,-284160,70144,-214016,20
602,149,22,8,0.19840213,0.80159787,210.8723804,237.4923433,382.3870432,350.1946309,751,19.19734151,1502,-308224,76288,-231936,20
233,70,21,9,0.231023102,0.768976898,83.24425836,100.2520711,151.8583691,152.4714286,303,6.148538961,606,-119296,35840,-83456,20
539,135,22,8,0.200296736,0.799703264,186.2825676,223.5911829,342.3042672,318.3185185,674,16.64197531,1348,-275968,69120,-206848,20
552,137,22,8,0.198838897,0.801161103,191.7156135,219.3600535,356.6358696,298.1167883,689,17.35953641,1378,-282624,70144,-212480,20
545,135,21,9,0.198529412,0.801470588,189.8858675,217.1722681,348.7009174,307.3925926,680,17.70372299,1360,-279040,69120,-209920,20
521,126,23,7,0.194744977,0.805255023,178.0071702,215.8793079,332.4088292,289.2301587,647,18.15375982,1294,-266752,64512,-202240,20
575,141,23,7,0.196927374,0.803072626,199.7586017,229.5887811,367.013913,323.7801418,716,19.81184283,1432,-294400,72192,-222208,20
526,130,23,7,0.198170732,0.801829268,180.6436097,215.0555493,339.9524715,282.1615385,656,18.43214386,1312,-269312,66560,-202752,20
537,135,23,7,0.200892857,0.799107143,184.9264744,224.6464052,342.9590317,310.8074074,672,18.00160729,1344,-274944,69120,-205824,20
526,131,23,7,0.199391172,0.800608828,181.1766725,218.2115382,335.9942966,300.9160305,657,18.617172,1314,-269312,67072,-202240,20
530,134,22,8,0.201807229,0.798192771,182.8427375,219.4624877,341.7264151,296.0074627,664,19.05855339,1328,-271360,68608,-202752,20
539,130,24,6,0.19431988,0.80568012,182.134781,232.0124345,340.1410019,313.6846154,669,19.83397569,1338,-275968,66560,-209408,20
571,138,23,7,0.194640339,0.805359661,197.6586234,228.6789855,362.7250438,323.0362319,709,20.59250653,1418,-292352,70656,-221696,20
511,126,23,7,0.197802198,0.802197802,175.5277278,211.5774651,326.7514677,287.5634921,637,18.21561338,1274,-261632,64512,-197120,20
542,133,23,7,0.197037037,0.802962963,185.9834083,224.0638154,346.6107011,302.9097744,675,19.27470017,1350,-277504,68096,-209408,20
513,127,23,7,0.1984375,0.8015625,177.1028248,207.5596125,330.9727096,278.1968504,640,17.54385965,1280,-262656,65024,-197632,20
176,44,23,7,0.2,0.8,62.44301431,61.19873466,116.9204545,84.81818182,220,5.671564836,440,-90112,22528,-67584,20
518,121,22,8,0.189358372,0.810641628,174.9580258,216.7759644,328.5694981,283.3140496,639,18.8551195,1278,-265216,61952,-203264,20
520,129,23,7,0.198767334,0.801232666,177.0821775,221.0201435,333.1096154,292.3100775,649,18.43226356,1298,-266240,66048,-200192,20
177,46,23,7,0.206278027,0.793721973,63.65142404,61.68811426,118.1016949,88.52173913,223,6.356898518,446,-90624,23552,-67072,20
536,140,24,6,0.207100592,0.792899408,185.2535072,226.1614395,347.0037313,305.9428571,676,19.58852507,1352,-274432,71680,-202752,20
586,128,23,7,0.179271709,0.820728291,200.579791,224.3922124,367.2645051,312.796875,714,18.85397412,1428,-300032,65536,-234496,20
496,124,24,6,0.2,0.8,172.4067985,202.2872773,314.6814516,293.7741935,620,16.11645438,1240,-253952,63488,-190464,20
544,130,24,6,0.192878338,0.807121662,187.7573363,218.5626474,344.2242647,309.3615385,674,18.62392926,1348,-278528,66560,-211968,20
556,126,25,5,0.184750733,0.815249267,191.3025191,215.7261909,350.1079137,303.515873,682,16.65039063,1364,-284672,64512,-220160,20
3195,272,25,5,0.0784539948,0.921546005,984.7593242,959.5236359,1789.18529,1085.775735,3467,63.47491761,6934,-1635840,139264,-1496576,20
3201,263,24,6,0.0759237875,0.924076212,985.8580435,977.4244299,1781.549828,1135.509506,3464,60.86803725,6928,-1638912,134656,-1504256,20
3168,274,23,7,0.0796048809,0.920395119,978.5187947,946.8995635,1776.22601,1088.755474,3442,73.06304394,6884,-1622016,140288,-1481728,20
3260,266,23,7,0.0754395916,0.924560408,1002.79023,980.1136713,1816.062577,1119.31203,3526,63.8652418,7052,-1669120,136192,-1532928,20
3175,261,23,7,0.0759604191,0.924039581,977.8548799,950.477315,1769.508661,1097.992337,3436,62.26893802,6872,-1625600,133632,-1491968,20
3160,254,25,5,0.0743995313,0.925600469,970.6728311,970.3258794,1755.886392,1105.527559,3414,60.89903675,6828,-1617920,130048,-1487872,20
3164,265,22,8,0.0772820064,0.922717994,974.9183197,940.8001816,1768.693742,1073.916981,3429,61.98481562,6858,-1619968,135680,-1484288,20
3216,271,24,6,0.0777172354,0.922282765,990.6209708,962.8090315,1799.19745,1088.9631,3487,66.69854629,6974,-1646592,138752,-1507840,20
3204,272,23,7,0.0782508631,0.921749137,987.9591622,952.8183494,1793.901373,1085.904412,3476,82.00047181,6952,-1640448,139264,-1501184,20
3141,258,24,6,0.0759046778,0.924095322,966.0901127,955.2823036,1750.471506,1085.53876,3399,61.95771054,6798,-1608192,132096,-1476096,20
3215,272,23,7,0.0780040149,0.921995985,989.8511232,967.3668726,1799.867185,1083.658088,3487,65.7428356,6974,-1646080,139264,-1506816,20
3178,272,24,6,0.0788405797,0.92115942,981.916932,928.7327358,1780.796413,1079.426471,3450,76.44582318,6900,-1627136,139264,-1487872,20
3172,275,23,7,0.0797795184,0.920220482,977.7472523,956.7308813,1780.945776,1067.156364,3447,64.68380559,6894,-1624064,140800,-1483264,20
3159,266,22,8,0.0776642336,0.922335766,972.7701952,957.5341748,1766.154479,1081.740602,3425,60.19332162,6850,-1617408,136192,-1481216,20
3208,257,24,6,0.0741702742,0.925829726,984.78365,976.0849381,1783.620012,1101.136187,3465,85.61897702,6930,-1642496,131584,-1510912,20
3174,273,23,7,0.0791993037,0.920800696,979.475406,952.2057133,1778.828292,1086.545788,3447,83.30111165,6894,-1625088,139776,-1485312,20
3241,278,22,8,0.0789997158,0.921000284,999.8324796,1056.673499,1804.462203,1241.647482,3519,61.70436612,7038,-1659392,142336,-1517056,20
3186,263,23,7,0.0762539867,0.923746013,980.1129139,965.6827867,1777.05022,1094.460076,3449,62.14414414,6898,-1631232,134656,-1496576,20
3176,273,25,5,0.0791533778,0.920846622,979.2879465,989.7431386,1776.34131,1127.710623,3449,62.25631769,6898,-1626112,139776,-1486336,20
3170,273,23,7,0.0792913157,0.920708684,977.6983779,974.0719378,1774.921767,1107.487179,3443,61.29606552,6886,-1623040,139776,-1483264,20
3221,253,24,6,0.0728267127,0.927173287,990.2750639,965.0756541,1784.951878,1133.379447,3474,87.13318284,6948,-1649152,129536,-1519616,20
3189,257,24,6,0.0745792223,0.925420778,980.2566453,975.0008492,1772.208529,1119.097276,3446,86.8885527,6892,-1632768,131584,-1501184,20
289,50,23,7,0.147492625,0.852507375,97.15911157,97.9595345,174.4359862,144.36,339,11.95345557,678,-147968,25600,-122368,20
3266,269,24,6,0.076096181,0.923903819,1007.750322,974.6207438,1818.357624,1156.594796,3535,78.24258521,7070,-1672192,137728,-1534464,20
3175,243,23,7,0.0710942071,0.928905793,973.5285774,973.164372,1753.982047,1128.304527,3418,86.50974437,6836,-1625600,124416,-1501184,20
3167,263,25,5,0.0766763848,0.923323615,975.5764505,949.9446879,1767.405747,1090.460076,3430,60.40859458,6860,-1621504,134656,-1486848,20
3162,265,24,6,0.0773271083,0.922672892,975.1080658,941.8295568,1766.422834,1088.486792,3427,63.04267844,6854,-1618944,135680,-1483264,20
2549,244,24,6,0.0873612603,0.91263874,793.7049967,776.7025958,1443.342487,912.8729508,2793,49.15522703,5586,-1305088,124928,-1180160,20
3180,265,23,7,0.0769230769,0.923076923,979.0287037,960.6783841,1775.633019,1091.403774,3445,60.65140845,6890,-1628160,135680,-1492480,20
3149,266,23,7,0.0778916545,0.922108346,969.4283255,980.8086765,1758.617974,1108.766917,3415,71.69850934,6830,-1612288,136192,-1476096,20
3198,259,23,7,0.0749204513,0.925079549,985.2945442,941.2216199,1779.476548,1105.741313,3457,61.95340502,6914,-1637376,132608,-1504768,20
3177,258,23,7,0.0751091703,0.92489083,975.7757932,972.6982683,1768.642115,1094.395349,3435,64.43444007,6870,-1626624,132096,-1494528,20
3340,273,23,7,0.0755604761,0.924439524,1028.883854,1003.902225,1858.974251,1171.124542,3613,92.26251277,7226,-1710080,139776,-1570304,20
3174,265,24,6,0.0770572841,0.922942716,977.7462111,955.7554388,1772.369565,1092.750943,3439,62.47048138,6878,-1625088,135680,-1489408,20
3227,260,22,8,0.0745626613,0.925437339,991.0578199,1002.695858,1792.618841,1140.565385,3487,61.83720518,6974,-1652224,133120,-1519104,20
3174,268,23,7,0.0778617083,0.922138292,978.0115654,979.0740779,1772.340265,1119.384328,3442,61.64040115,6884,-1625088,137216,-1487872,20
3273,265,24,6,0.0749010741,0.925098926,1005.687829,988.6039493,1822.170791,1118.966038,3538,91.72932331,7076,-1675776,135680,-1540096,20
3187,266,24,6,0.0770344628,0.922965537,982.9302535,938.1754018,1780.327267,1088.075188,3453,83.22487346,6906,-1631744,136192,-1495552,20
3220,264,23,7,0.0757749713,0.924225029,992.8094976,963.7679839,1792.223602,1136.022727,3484,90.21232522,6968,-1648640,135168,-1513472,20
646,130,23,7,0.167525773,0.832474227,218.8363372,247.0129394,392.8250774,367.0076923,776,9.973011181,1552,-330752,66560,-264192,20
586,160,23,7,0.214477212,0.785522788,205.7621571,246.3086776,378.9010239,353.71875,746,13.05793804,1492,-300032,81920,-218112,20
658,150,23,7,0.185643564,0.814356436,228.1925295,251.031002,412.7917933,368.1266667,808,21.40964494,1616,-336896,76800,-260096,20
607,147,24,6,0.194960212,0.805039788,210.1928737,243.7063305,384.9555189,346.7142857,754,21.27539503,1508,-310784,75264,-235520,20
610,144,23,7,0.190981432,0.809018568,209.1830948,249.0103094,383.1147541,353.7152778,754,21.16788321,1508,-312320,73728,-238592,20
594,149,23,7,0.200538358,0.799461642,206.6894228,238.6369622,382.3905724,330.5771812,743,20.79485027,1486,-304128,76288,-227840,20
601,150,23,7,0.199733688,0.800266312,208.8997655,243.9418495,382.9118136,348.3066667,751,20.34678949,1502,-307712,76800,-230912,20
572,147,24,6,0.204450626,0.795549374,201.3550678,227.4549585,367.9825175,328.9387755,719,19.77447745,1438,-292864,75264,-217600,20
581,148,23,7,0.203017833,0.796982167,203.5012554,232.945675,373.2151463,332.75,729,20.56997743,1458,-297472,75776,-221696,20
586,142,22,8,0.195054945,0.804945055,203.399399,233.4060579,372.0836177,333.2042254,728,19.67567568,1456,-300032,72704,-227328,20
576,151,24,6,0.207702889,0.792297111,203.1349221,231.0714397,372.2673611,332.4635762,727,20.43282743,1454,-294912,77312,-217600,20
582,142,23,7,0.196132597,0.803867403,202.0857798,232.5613545,370.2250859,330.8380282,724,15.78373665,1448,-297984,72704,-225280,20
593,147,23,7,0.198648649,0.801351351,205.8931744,239.2051274,379.0640809,335.952381,740,21.31336406,1480,-303616,75264,-228352,20
638,159,23,7,0.199498118,0.800501882,224.5791404,245.36786,410.6990596,352.0566038,797,22.08367969,1594,-326656,81408,-245248,20
594,139,24,6,0.189631651,0.810368349,204.514308,234.9719591,376.7895623,325.1654676,733,20.08219178,1466,-304128,71168,-232960,20
618,156,22,8,0.201550388,0.798449612,217.7903268,241.0828134,396.710356,351.0128205,774,20.3043022,1548,-316416,79872,-236544,20
609,151,23,7,0.198684211,0.801315789,213.2465382,241.7152217,385.1116585,361.9006623,760,20.98867716,1520,-311808,77312,-234496,20
616,145,22,8,0.190538765,0.809461235,213.313398,243.4964585,386.5373377,357.4758621,761,20.00525762,1522,-315392,74240,-241152,20
647,150,22,8,0.188205772,0.811794228,225.2140732,247.080425,406.8964451,364.94,797,22.04702628,1594,-331264,76800,-254464,20
593,152,23,7,0.204026846,0.795973154,208.5565473,236.5949031,380.3305228,344.4013158,745,18.79888973,1490,-303616,77824,-225792,20
487,127,23,7,0.206840391,0.793159609,167.813422,207.6685145,313.9507187,282.7637795,614,7.780030411,1228,-249344,65024,-184320,20
749,80,19,11,0.0965018094,0.903498191,229.6165439,303.5272576,406.0881175,498.4375,829,138.1666667,1658,-383488,40960,-342528,21
5924,349,20,10,0.0556352622,0.944364738,1802.323924,1734.843687,3187.981938,2271.621777,6273,674.516129,12546,-3033088,178688,-2854400,21
1498,128,21,9,0.0787207872,0.921279213,467.3622537,491.8906048,815.4218959,791.0078125,1626,367.8733032,3252,-766976,65536,-701440,21
5263,337,19,11,0.0601785714,0.939821429,1609.470864,1475.015774,2855.878396,1935.643917,5600,619.4690265,11200,-2694656,172544,-2522112,21
897,105,21,9,0.104790419,0.895209581,278.9028353,339.0607734,486.2586399,631.7047619,1002,183.5164835,2004,-459264,53760,-405504,21
2512,268,19,11,0.0964028777,0.903597122,812.4815126,659.9425606,1414.853901,1162.227612,2780,229.1838417,5560,-1286144,137216,-1148928,21
3699,302,21,9,0.0754811297,0.92451887,1154.37661,1003.750447,2047.030008,1437.208609,4001,453.6281179,8002,-1893888,154624,-1739264,21
876,108,20,10,0.109756098,0.890243902,274.7317483,328.4447403,478.2180365,608.3425926,984,191.4396887,1968,-448512,55296,-393216,21
774,70,20,10,0.0829383886,0.917061611,237.4765164,301.7363412,419.6098191,454.4571429,844,165.8153242,1688,-396288,35840,-360448,21
972,94,21,9,0.0881801126,0.911819887,303.8070227,320.4999737,521.5421811,657.1489362,1066,187.3462214,2132,-497664,48128,-449536,21
5204,316,21,9,0.0572463768,0.942753623,1580.534933,1527.44706,2815.905842,1848.056962,5520,552.5525526,11040,-2664448,161792,-2502656,21
3872,273,20,10,0.0658624849,0.934137515,1190.365804,1074.773946,2120.518853,1399.032967,4145,419.1102123,8290,-1982464,139776,-1842688,21
5595,378,20,10,0.0632847815,0.936715218,1712.741142,1641.95314,3047.739231,2087.962963,5973,1072.351885,11946,-2864640,193536,-2671104,21
2931,245,20,10,0.0771410579,0.922858942,925.5037777,677.3554742,1623.561583,1169.04898,3176,349.010989,6352,-1500672,125440,-1375232,21
6364,375,21,9,0.0556462383,0.944353762,1934.249091,1852.612065,3429.654777,2357.618667,6739,704.916318,13478,-3258368,192000,-3066368,21
5726,346,19,11,0.0569828722,0.943017128,1749.060425,1649.658223,3080.79532,2303.450867,6072,519.4183062,12144,-2931712,177152,-2754560,21
3349,282,20,10,0.0776645552,0.922335445,1055.182155,874.8261662,1848.188713,1433.730496,3631,559.4761171,7262,-1714688,144384,-1570304,21
2629,248,19,11,0.0862009037,0.913799096,836.6165619,728.2303026,1459.497147,1221.71371,2877,210.3070175,5754,-1346048,126976,-1219072,21
2554,271,20,10,0.0959292035,0.904070796,817.6067187,766.5429888,1434.437745,1210.9631,2825,117.7573989,5650,-1307648,138752,-1168896,21
3011,263,19,11,0.0803298717,0.919670128,949.1497964,824.0865871,1667.327134,1296.019011,3274,162.0792079,6548,-1541632,134656,-1406976,21
5936,380,20,10,0.0601646612,0.939835339,1811.932284,1729.457217,3219.850236,2200.144737,6316,596.9754253,12632,-3039232,194560,-2844672,21
9362,597,20,10,0.0599457777,0.940054222,2841.838172,3238.419187,5033.298547,4144.18593,9959,898.8267148,19918,-4793344,305664,-4487680,21
6661,376,21,9,0.0534318602,0.94656814,2013.350035,2034.723007,3581.143072,2418.109043,7037,881.8295739,14074,-3410432,192512,-3217920,21
2292,276,19,11,0.107476636,0.892523364,752.7724133,571.1606934,1316.918412,1015.286232,2568,293.1506849,5136,-1173504,141312,-1032192,21
5819,442,20,10,0.0705957515,0.929404249,1789.037461,1672.003885,3215.775735,2014.914027,6261,485.7253685,12522,-2979328,226304,-2753024,21
5358,371,19,11,0.0647582475,0.935241752,1644.536678,1542.227347,2924.850504,2000.636119,5729,145.516891,11458,-2743296,189952,-2553344,21
6792,350,21,9,0.0490058807,0.950994119,2048.549766,2081.537873,3620.947144,2611.942857,7142,934.8167539,14284,-3477504,179200,-3298304,21
2851,252,21,9,0.0812117306,0.918788269,899.8222123,752.517947,1585.200631,1176.384921,3103,368.0901542,6206,-1459712,129024,-1330688,21
2504,290,21,9,0.103793844,0.896206156,815.2577887,667.3753327,1429.148163,1124.234483,2794,67.244284,5588,-1282048,148480,-1133568,21
2059,241,21,9,0.104782609,0.895217391,674.8769933,518.3026636,1174.57018,944.8547718,2300,97.33389759,4600,-1054208,123392,-930816,21
5842,423,21,9,0.0675179569,0.932482043,1794.548092,1662.042311,3209.759329,2072.886525,6265,526.0285474,12530,-2991104,216576,-2774528,21
2819,267,20,10,0.0865197667,0.913480233,893.7934627,780.4435862,1576.024477,1200.104869,3086,198.8402062,6172,-1443328,136704,-1306624,21
9323,632,21,9,0.0634856856,0.936514314,2834.004561,3346.941698,5019.693017,4362.962025,9955,454.1514599,19910,-4773376,323584,-4449792,21
2458,247,20,10,0.0913123845,0.908687616,787.7650058,616.9907998,1386.373474,1020.88664,2705,241.3024086,5410,-1258496,126464,-1132032,21
7533,539,21,9,0.0667740337,0.933225966,2280.958499,2917.077617,4057.563255,3742.122449,8072,592.6578561,16144,-3856896,275968,-3580928,21
695,82,20,10,0.105534106,0.894465894,217.1690697,274.5631274,384.523741,426.9390244,777,95.80764488,1554,-355840,41984,-313856,21
2231,288,19,11,0.114331084,0.885668916,739.5322129,579.5393312,1287.832362,1044.395833,2519,175.0521195,5038,-1142272,147456,-994816,21
3050,285,21,9,0.0854572714,0.914542729,971.0423287,836.3763372,1689.020984,1443.038596,3335,232.5662483,6670,-1561600,145920,-1415680,21
1624,131,21,9,0.0746438746,0.925356125,508.6843199,417.9219183,896.3768473,650.1832061,1755,32.97012963,3510,-831488,67072,-764416,21
6790,381,19,11,0.0531306652,0.946869335,2051.538862,2083.110109,3648.458468,2472.895013,7171,711.4087302,14342,-3476480,195072,-3281408,21
822,115,21,9,0.122732124,0.877267876,260.20784,289.3346629,446.8990268,626.973913,937,169.133574,1874,-420864,58880,-361984,21
5794,394,20,10,0.0636716225,0.936328378,1768.903218,1747.088765,3161.903176,2103.296954,6188,558.9882565,12376,-2966528,201728,-2764800,21
2551,278,21,9,0.0982679392,0.901732061,824.8780051,670.8643712,1446.578205,1125.230216,2829,317.5084175,5658,-1306112,142336,-1163776,21
1621,168,21,9,0.0939072107,0.906092789,514.3307273,534.2592371,899.6822949,849.8214286,1789,263.0882353,3578,-829952,86016,-743936,21
5742,414,20,10,0.067251462,0.932748538,1762.672784,1666.912263,3151.098049,2071.596618,6156,535.3043478,12312,-2939904,211968,-2727936,21
2500,253,20,10,0.0918997457,0.908100254,802.846505,641.6239071,1406.1964,1088.498024,2753,332.8899637,5506,-1280000,129536,-1150464,21
5637,396,19,11,0.0656389856,0.934361014,1730.002201,1692.510774,3075.434096,2185.199495,6033,105.9536354,12066,-2886144,202752,-2683392,21
689,105,20,10,0.132241814,0.867758186,227.6393836,238.3276256,394.5283019,417,794,15.41747573,1588,-352768,53760,-299008,21
2028,253,19,11,0.110916265,0.889083735,668.6088312,546.8079376,1160.223373,986.9090909,2281,141.3258984,4562,-1038336,129536,-908800,21
2511,270,21,9,0.0970873786,0.902912621,813.9833595,617.5525665,1422.500996,1098.040741,2781,251.4466546,5562,-1285632,138240,-1147392,21
2749,310,20,10,0.101340307,0.898659693,889.4299206,769.6796517,1561.570753,1250.03871,3059,93.60465116,6118,-1407488,158720,-1248768,21
5573,401,21,9,0.0671242049,0.932875795,1713.699764,1590.913206,3055.638794,2040.523691,5974,487.2756933,11948,-2853376,205312,-2648064,21
5743,408,20,10,0.0663306779,0.933669322,1762.834884,1658.128806,3146.050845,2089.965686,6151,247.5251509,12302,-2940416,208896,-2731520,21
2666,268,21,9,0.0913428766,0.908657123,853.7945327,745.8955721,1487.95949,1263.973881,2934,489.8163606,5868,-1364992,137216,-1227776,21
5618,369,20,10,0.0616335393,0.938366461,1715.889646,1644.404213,3055.477216,2058.01355,5987,792.9801325,11974,-2876416,188928,-2687488,21
2436,267,19,11,0.0987791343,0.901220866,786.3493769,682.7274131,1376.646962,1127.131086,2703,55.00610501,5406,-1247232,136704,-1110528,21
5014,406,20,10,0.0749077491,0.925092251,1557.546699,1355.080564,2783.745513,1805.935961,5420,449.0472245,10840,-2567168,207872,-2359296,21
2456,264,20,10,0.0970588235,0.902941176,792.6942833,655.9804062,1388.688111,1098.265152,2720,309.7949886,5440,-1257472,135168,-1122304,21
2862,239,21,9,0.0770719123,0.922928088,891.8863856,850.0864844,1581.990217,1179.895397,3101,378.1707317,6202,-1465344,122368,-1342976,21
5333,368,19,11,0.0645500789,0.935449921,1637.484555,1527.100716,2909.528408,2002.815217,5701,572.3895582,11402,-2730496,188416,-2542080,21
9056,863,21,9,0.0870047384,0.912995262,2825.507606,3213.472302,4926.834585,5308.025492,9919,494.2202292,19838,-4636672,441856,-4194816,21
9125,812,21,9,0.0817148033,0.918285197,2826.086857,3297.725017,4946.112986,5226.197044,9937,453.123575,19874,-4672000,415744,-4256256,21
9175,753,21,9,0.0758460919,0.924153908,2838.187846,3169.656799,4939.832698,5265.061089,9928,294.2501482,19856,-4697600,385536,-4312064,21
2807,280,21,9,0.0907029478,0.909297052,893.821515,804.6055913,1573.892056,1244.332143,3087,201.5013055,6174,-1437184,143360,-1293824,21
9120,815,21,9,0.0820332159,0.917966784,2816.377638,3388.37895,4953.906908,5125.704294,9935,495.758483,19870,-4669440,417280,-4252160,21
9243,699,21,9,0.0703077852,0.929692215,2837.557395,3268.605761,4974.991778,4925.327611,9942,685.6551724,19884,-4732416,357888,-4374528,21
9201,739,20,10,0.0743460765,0.925653924,2831.45481,3304.482683,4978.049886,4876.499323,9940,584.0188014,19880,-4710912,378368,-4332544,21
9117,783,21,9,0.0790909091,0.920909091,2823.470765,3218.358569,4926.308654,5232.176245,9900,414.0526976,19800,-4667904,400896,-4267008,21
9118,816,19,11,0.0821421381,0.917857862,2818.203355,3340.170609,4928.058456,5408.220588,9934,396.2504986,19868,-4668416,417792,-4250624,21
9148,785,19,11,0.0790294976,0.920970502,2822.793614,3341.387873,4956.674027,5087.333758,9933,242.3273969,19866,-4683776,401920,-4281856,21
5085,351,20,10,0.0645695364,0.935430464,1562.027589,1448.774971,2773.981711,1914.726496,5436,797.0674487,10872,-2603520,179712,-2423808,21
9270,677,21,9,0.0680607218,0.931939278,2840.143982,3236.353845,5007.048544,4521.474151,9947,697.0567624,19894,-4746240,346624,-4399616,21
2475,276,21,9,0.100327154,0.899672846,799.8235238,715.3263519,1396.567677,1191.561594,2751,311.199095,5502,-1267200,141312,-1125888,21
2889,233,20,10,0.0746316464,0.925368354,895.2968506,931.6317372,1582.996539,1294.961373,3122,193.4324659,6244,-1479168,119296,-1359872,21
9259,687,21,9,0.0690729942,0.930927006,2842.131308,3234.180546,4983.393779,4840.157205,9946,510.312981,19892,-4740608,351744,-4388864,21
9175,760,20,10,0.076497232,0.923502768,2819.448427,3390.504518,4948.089809,5208.363158,9935,426.0291595,19870,-4697600,389120,-4308480,21
9208,731,21,9,0.0735486467,0.926451353,2833.128149,3262.422909,4937.998045,5373.110807,9939,423.8379531,19878,-4714496,374272,-4340224,21
9142,792,19,11,0.0797261929,0.920273807,2815.615485,3401.937685,4945.941698,5216.34596,9934,259.6445374,19868,-4680704,405504,-4275200,21
9137,799,20,10,0.0804146538,0.919585346,2818.697791,3375.853808,4948.855532,5193.145181,9936,471.570954,19872,-4678144,409088,-4269056,21
9150,786,21,9,0.0791062802,0.92089372,2828.636407,3260.813245,4929.574754,5421.637405,9936,458.5140748,19872,-4684800,402432,-4282368,21
8231,595,20,10,0.0674144573,0.932585543,2516.319812,2942.208923,4398.928563,4615.07563,8826,628.1850534,17652,-4214272,304640,-3909632,21
680,79,19,11,0.104084321,0.895915679,217.5998976,231.648988,379.9529412,380.4050633,759,30.72874494,1518,-348160,40448,-307712,21
8548,643,20,10,0.0699597432,0.930040257,2610.263355,3169.357139,4596.246958,4592.716952,9191,361.4235155,18382,-4376576,329216,-4047360,21
8141,601,19,11,0.0687485701,0.93125143,2489.137535,2950.392228,4367.19973,4429.750416,8742,448.5377116,17484,-4168192,307712,-3860480,21
8767,662,21,9,0.0702089299,0.92979107,2678.16029,3246.246788,4714.776206,4717.963746,9429,383.9169381,18858,-4488704,338944,-4149760,21
8596,665,20,10,0.0718065004,0.9281935,2626.489108,3216.595663,4621.609935,4752.378947,9261,365.9028052,18522,-4401152,340480,-4060672,21
3627,300,21,9,0.076394194,0.923605806,1134.979762,956.7297684,2009.849187,1409.683333,3927,239.3053016,7854,-1857024,153600,-1703424,21
8660,687,21,9,0.0734995186,0.926500481,2649.178807,3253.364419,4678.622402,4615.732169,9347,533.5045662,18694,-4433920,351744,-4082176,21
2570,263,20,10,0.0928344511,0.907165549,827.6248866,613.8770637,1452.715564,1067.992395,2833,216.5902141,5666,-1315840,134656,-1181184,21
8527,682,19,11,0.0740579868,0.925942013,2610.5652,3196.326767,4608.841328,4556.972141,9209,543.6245573,18418,-4365824,349184,-4016640,21
8984,703,20,10,0.0725714876,0.927428512,2753.043759,3287.23445,4821.591385,5130.371266,9687,260.2632993,19374,-4599808,359936,-4239872,21
5990,373,21,9,0.0586201477,0.941379852,1826.262356,1780.471839,3236.914691,2300.126005,6363,732.2209436,12726,-3066880,190976,-2875904,21
8592,649,20,10,0.0702304945,0.929769505,2624.505117,3179.020969,4607.816923,4795.528505,9241,402.3073574,18482,-4399104,332288,-4066816,21
8399,600,20,10,0.0666740749,0.933325925,2560.55189,3064.41922,4485.109656,4708.44,8999,477.9075943,17998,-4300288,307200,-3993088,21
8559,633,21,9,0.0688642298,0.93113577,2618.23079,3072.729909,4572.451805,4921.663507,9192,292.8321121,18384,-4382208,324096,-4058112,21
8654,693,20,10,0.0741414358,0.925858564,2650.923444,3231.110685,4670.928472,4712.356421,9347,451.3278609,18694,-4430848,354816,-4076032,21
3240,274,20,10,0.077973819,0.922026181,1012.448989,841.3483074,1806.761728,1174.989051,3514,72.6934216,7028,-1658880,140288,-1518592,21
8549,670,21,9,0.0726759952,0.927324005,2618.068031,3161.402919,4609.892736,4611.368657,9219,253.3388293,18438,-4377088,343040,-4034048,21
8474,667,19,11,0.0729679466,0.927032053,2593.45793,3156.879299,4563.438046,4667.071964,9141,490.9237379,18282,-4338688,341504,-3997184,21
6851,446,21,9,0.0611210086,0.938878991,2078.351089,2330.219472,3705.923077,2774.605381,7297,129.9554764,14594,-3507712,228352,-3279360,21
3752,340,21,9,0.0830889541,0.916911046,1180.302882,991.5822719,2103.864339,1413.467647,4092,251.1970534,8184,-1921024,174080,-1746944,21
781,111,20,10,0.124439462,0.875560538,247.6306003,286.1354141,427.9282971,577.1711712,892,132.5408618,1784,-399872,56832,-343040,21
7807,518,20,10,0.0622222222,0.937777778,2365.239565,2818.908257,4211.032023,3439.088803,8325,350.3787879,16650,-3997184,265216,-3731968,21
4225,375,21,9,0.0815217391,0.918478261,1326.921125,1124.282555,2362.354556,1603.605333,4600,452.3107178,9200,-2163200,192000,-1971200,21
7027,489,20,10,0.0650612028,0.934938797,2148.717526,2084.621896,3845.267824,2511.633947,7516,678.3393502,15032,-3597824,250368,-3347456,21
7152,416,19,11,0.0549682875,0.945031712,2168.938349,2189.333503,3845.372623,2737.959135,7568,774.616172,15136,-3661824,212992,-3448832,21
7227,413,21,9,0.0540575916,0.945942408,2192.167444,2186.697245,3878.973018,2797.292978,7640,853.6312849,15280,-3700224,211456,-3488768,21
7732,511,19,11,0.0619919932,0.938008007,2356.38061,2338.265632,4209.177962,2802.900196,8243,715.5381944,16486,-3958784,261632,-3697152,21
6395,456,20,10,0.0665596263,0.933440374,1962.059429,1866.748064,3504.29179,2328.026316,6851,208.363747,13702,-3274240,233472,-3040768,21
6603,448,21,9,0.0635370869,0.936462913,2021.240628,1966.68944,3595.629865,2499.736607,7051,695.3648915,14102,-3380736,229376,-3151360,21
7740,504,21,9,0.0611353712,0.938864629,2355.895667,2356.951568,4208.30969,2804.708333,8244,550.7014028,16488,-3962880,258048,-3704832,21
4417,289,21,9,0.0614109647,0.938589035,1353.666117,1283.618572,2393.512339,1741.961938,4706,333.0502477,9412,-2261504,147968,-2113536,21
3644,330,20,10,0.0830397584,0.916960242,1145.132096,985.0864358,2042.19978,1383.481818,3974,417.8759201,7948,-1865728,168960,-1696768,21
3803,353,19,11,0.0849374398,0.91506256,1200.494272,1009.645663,2134.678938,1473.263456,4156,257.1782178,8312,-1947136,180736,-1766400,21
7257,505,20,10,0.0650605514,0.934939449,2223.250739,2169.610163,3962.036241,2724.170297,7762,173.5300693,15524,-3715584,258560,-3457024,21
6716,480,20,10,0.0667037243,0.933296276,2056.310157,1993.330473,3684.632817,2393.358333,7196,959.4666667,14392,-3438592,245760,-3192832,21
7599,485,21,9,0.059995052,0.940004948,2313.667317,2274.084264,4123.87801,2767.465979,8084,825.7405516,16168,-3890688,248320,-3642368,21
6966,431,20,10,0.0582668649,0.941733135,2117.786903,2167.357808,3761.053546,2696.064965,7397,741.1823647,14794,-3566592,220672,-3345920,21
5777,419,19,11,0.0676242737,0.932375726,1775.185758,1683.243201,3169.457331,2120.169451,6196,536.4502165,12392,-2957824,214528,-2743296,21
645,32,20,10,0.047267356,0.952732644,192.4868082,216.8449344,344.772093,222.65625,677,131.7120623,1354,-330240,16384,-313856,21
2801,246,20,10,0.0807351493,0.919264851,881.2762769,758.5726892,1558.15316,1135.126016,3047,54.44960686,6094,-1434112,125952,-1308160,21
61,13,20,10,0.175675676,0.824324324,21.21683906,11.79007706,41.09836066,20.61538462,74,1.822211278,148,-31232,6656,-24576,21
4938,258,20,10,0.0496535797,0.95034642,1491.898609,1498.017403,2633.3145,1932.166667,5196,702.1621622,10392,-2528256,132096,-2396160,21
5240,435,21,9,0.0766519824,0.923348018,1595.838628,2079.598012,2829.79084,2936.887356,5675,297.4318658,11350,-2682880,222720,-2460160,21
5419,341,21,9,0.0592013889,0.940798611,1651.539618,1604.216182,2934.49917,2022.372434,5760,588.9570552,11520,-2774528,174592,-2599936,21
4192,297,21,9,0.0661617287,0.933838271,1289.335259,1201.186144,2292.166031,1579.276094,4489,455.2738337,8978,-2146304,152064,-1994240,21
5603,456,20,10,0.0752599439,0.924740056,1708.043045,2190.682947,3034.633232,2973.070175,6059,133.9597612,12118,-2868736,233472,-2635264,21
2622,235,20,10,0.0822541127,0.917745887,821.8797067,795.9342638,1456.060641,1127.07234,2857,598.951782,5714,-1342464,120320,-1222144,21
169,31,20,10,0.155,0.845,54.6958372,72.0805423,100.4970414,100.516129,200,11.01928375,400,-86528,15872,-70656,21
4312,305,20,10,0.0660602123,0.933939788,1327.260012,1222.436045,2356.892393,1631.911475,4617,467.3076923,9234,-2207744,156160,-2051584,21
5277,345,21,9,0.0613660619,0.938633938,1612.882604,1501.091907,2870.850673,1903.692754,5622,866.2557781,11244,-2701824,176640,-2525184,21
5444,332,21,9,0.0574792244,0.942520776,1655.226487,1671.398656,2936.203159,2106.283133,5776,637.5275938,11552,-2787328,169984,-2617344,21
4953,324,21,9,0.0613985219,0.938601478,1514.197069,1432.380521,2691.77024,1832.299383,5277,540.6762295,10554,-2535936,165888,-2370048,21
5291,354,20,10,0.0627103632,0.937289637,1616.482736,1611.031024,2877.003402,2015.847458,5645,634.9831271,11290,-2708992,181248,-2527744,21
5520,412,20,10,0.0694538098,0.93054619,1678.899082,2106.707379,2975.970652,2839.61165,5932,595.5823293,11864,-2826240,210944,-2615296,21
4872,327,19,11,0.0628967109,0.937103289,1492.192602,1434.316403,2649.482759,1862.752294,5199,700.6738544,10398,-2494464,167424,-2327040,21
5287,356,20,10,0.0630870105,0.93691299,1617.029842,1614.434955,2873.483828,2057.407303,5643,463.6811832,11286,-2706944,182272,-2524672,21
5160,350,19,11,0.0635208711,0.936479129,1579.102137,1510.684384,2813.662209,1898.022857,5510,707.3170732,11020,-2641920,179200,-2462720,21
4845,303,19,11,0.0588578089,0.941142191,1478.198114,1399.617203,2622.429102,1808.108911,5148,394.4827586,10296,-2480640,155136,-2325504,21
657,34,20,10,0.0492040521,0.950795948,196.1544609,236.5422503,350.8447489,252.3823529,691,10.63895304,1382,-336384,17408,-318976,21
6525,375,21,9,0.0543478261,0.945652174,1980.577058,1953.224411,3504.459464,2511.605333,6900,928.6675639,13800,-3340800,192000,-3148800,21
4631,392,20,10,0.0780410113,0.921958989,1443.9693,1335.930679,2570.864608,1816.586735,5023,91.14498276,10046,-2371072,200704,-2170368,21
6964,417,20,10,0.0564964097,0.94350359,2114.678189,2091.036135,3757.423894,2581.705036,7381,1182.852564,14762,-3565568,213504,-3352064,21
6121,407,21,9,0.0623468137,0.937653186,1870.700117,1763.386797,3335.600229,2195.201474,6528,328.3702213,13056,-3133952,208384,-2925568,21
7521,345,21,9,0.0438596491,0.956140351,2262.869097,2313.287807,3967.679032,3188.397101,7866,961.6136919,15732,-3850752,176640,-3674112,21
6070,419,21,9,0.0645708121,0.935429188,1857.275568,1758.362978,3320.485338,2151.453461,6489,760.7268464,12978,-3107840,214528,-2893312,21
1267,219,20,10,0.147375505,0.852624495,434.2289855,381.3831711,725.7947908,845.9315068,1486,243.207856,2972,-648704,112128,-536576,21
5550,391,19,11,0.0658138361,0.934186164,1703.728113,1627.405788,3033.435856,2084.762148,5941,814.951989,11882,-2841600,200192,-2641408,21
6014,360,20,10,0.0564794478,0.943520552,1825.415744,2022.642564,3212.747922,2765.719444,6374,339.0425532,12748,-3079168,184320,-2894848,21
625,35,21,9,0.053030303,0.946969697,188.1453346,202.9469137,336.2688,227.4857143,660,20.71563089,1320,-320000,17920,-302080,21
7459,431,21,9,0.054626109,0.945373891,2259.89728,2245.267809,4015.226572,2738.793503,7890,902.7459954,15780,-3819008,220672,-3598336,21
7325,371,19,11,0.0482068607,0.951793139,2207.126547,2286.206464,3897.37529,2883.509434,7696,900.1169591,15392,-3750400,189952,-3560448,21
5688,430,21,9,0.0702844067,0.929715593,1751.686805,1644.632786,3135.45218,2054.811628,6118,160.031389,12236,-2912256,220160,-2692096,21
6046,334,21,9,0.0523510972,0.947648903,1835.185532,1818.038766,3229.410519,2486.149701,6380,848.4042553,12760,-3095552,171008,-2924544,21
6055,393,20,10,0.0609491315,0.939050868,1845.334584,1796.036362,3292.099917,2182.979644,6448,565.6140351,12896,-3100160,201216,-2898944,21
7432,445,20,10,0.0564935889,0.943506411,2254.705736,2224.348473,4014.252557,2682.197753,7877,681.991342,15754,-3805184,227840,-3577344,21
6494,412,20,10,0.0596582682,0.940341732,1977.467281,1922.448341,3523.31506,2353.065534,6906,396.6685813,13812,-3324928,210944,-3113984,21
6219,372,21,9,0.0564406008,0.943559399,1889.113874,1848.045644,3355.917189,2294.319892,6591,927.0042194,13182,-3184128,190464,-2993664,21
6487,356,20,10,0.0520239661,0.947976034,1965.730129,1970.718431,3467.124711,2599.741573,6843,818.5406699,13686,-3321344,182272,-3139072,21
6528,356,21,9,0.0517141197,0.94828588,1977.196217,1964.397684,3490.600184,2560.483146,6884,701.0183299,13768,-3342336,182272,-3160064,21
9293,661,21,9,0.0664054651,0.933594535,2832.034504,3317.169966,5029.709782,4243.482602,9954,244.7504303,19908,-4758016,338432,-4419584,21
9331,626,19,11,0.0628703425,0.937129658,2839.751344,3249.406842,5031.32183,4199.103834,9957,583.9882698,19914,-4777472,320512,-4456960,21
9286,666,20,10,0.0669212219,0.933078778,2831.371198,3327.081611,5024.827698,4302.66967,9952,834.1994971,19904,-4754432,340992,-4413440,21
9318,637,21,9,0.0639879458,0.936012054,2835.746811,3325.47518,5018.479824,4385.863422,9955,512.0884774,19910,-4770816,326144,-4444672,21
9296,658,20,10,0.0661040788,0.933895921,2830.838146,3366.995573,5018.313898,4400.895137,9954,425.5664814,19908,-4759552,336896,-4422656,21
9326,627,19,11,0.0629960816,0.937003918,2837.120296,3288.346431,5023.247587,4289.113238,9953,513.8358286,19906,-4774912,321024,-4453888,21
9302,649,21,9,0.0652195759,0.934780424,2834.021861,3297.076239,5025.434638,4267.46225,9951,827.8702163,19902,-4762624,332288,-4430336,21
5407,402,20,10,0.0692029609,0.930797039,1663.814209,1613.01068,2969.110597,2042.696517,5809,174.4444444,11618,-2768384,205824,-2562560,21
3562,334,20,10,0.0857289528,0.914271047,1125.818391,954.3504959,1999.750702,1401.928144,3896,549.506347,7792,-1823744,171008,-1652736,21
7606,463,20,10,0.0573800967,0.942619903,2329.415788,2188.736806,4081.827899,3265.727862,8069,539.7324415,16138,-3894272,237056,-3657216,21
9312,645,21,9,0.0647785478,0.935221452,2835.678816,3342.874712,5014.061104,4472.815504,9957,814.811784,19914,-4767744,330240,-4437504,21
3780,352,20,10,0.0851887706,0.914811229,1190.762308,1054.398573,2120.186772,1489.977273,4132,233.7104072,8264,-1935360,180224,-1755136,21
9315,638,20,10,0.064101276,0.935898724,2833.4859,3293.952912,5032.935373,4160.326019,9953,707.8947368,19906,-4769280,326656,-4442624,21
3878,324,20,10,0.0771061399,0.92289386,1210.457568,1069.429205,2152.379319,1492.518519,4202,423.5887097,8404,-1985536,165888,-1819648,21
9308,644,21,9,0.0647106109,0.935289389,2834.706783,3355.007256,5002.220348,4604.753106,9952,686.3448276,19904,-4765696,329728,-4435968,21
6588,409,20,10,0.058453623,0.941546377,2006.654858,1961.926958,3561.810109,2487.281174,6997,699.000999,13994,-3373056,209408,-3163648,21
9303,653,19,11,0.0655885898,0.93441141,2835.387817,3277.217185,5033.820918,4190.367534,9956,333.9818853,19912,-4763136,334336,-4428800,21
9305,645,21,9,0.0648241206,0.935175879,2831.030248,3370.23127,5011.524342,4455.8,9950,790.3097697,19900,-4764160,330240,-4433920,21
7793,500,21,9,0.0602918124,0.939708188,2374.372362,2295.01396,4233.215065,2803.252,8293,145.6957133,16586,-3990016,256000,-3734016,21
9316,639,20,10,0.0641888498,0.93581115,2836.851434,3312.262722,5017.830292,4397.312989,9955,778.342455,19910,-4769792,327168,-4442624,21
9365,592,20,10,0.0594556593,0.940544341,2825.510398,3493.288759,5020.644741,4320.211149,9957,1049.209694,19914,-4794880,303104,-4491776,21
9418,541,21,9,0.0543227232,0.945677277,2841.817499,3167.331,5049.030367,3778.284658,9959,931.6183349,19918,-4822016,276992,-4545024,21
9388,571,21,9,0.0573350738,0.942664926,2835.395687,3314.221303,5038.798892,4013.267951,9959,555.7477679,19918,-4806656,292352,-4514304,21
9438,522,20,10,0.0524096386,0.947590361,2841.476686,3278.501171,5034.455817,4004.954023,9960,703.8869258,19920,-4832256,267264,-4564992,21
9408,552,19,11,0.0554216867,0.944578313,2828.575621,3577.63466,4979.670706,4994.634058,9960,712.956335,19920,-4816896,282624,-4534272,21
9356,600,19,11,0.0602651667,0.939734833,2824.430098,3414.562195,5040.978623,4004.25,9956,554.0345019,19912,-4790272,307200,-4483072,21
9437,526,21,9,0.0527953428,0.947204657,2836.191978,3499.00995,5000.444527,4651.085551,9963,604.9180328,19926,-4831744,269312,-4562432,21
2620,267,21,9,0.0924835469,0.907516453,838.540396,723.9284815,1472.509542,1164.243446,2887,54.44088252,5774,-1341440,136704,-1204736,21
9354,603,20,10,0.0605604098,0.93943959,2824.58269,3529.066533,5007.366581,4538.965174,9957,727.3192111,19914,-4789248,308736,-4480512,21
9434,529,19,11,0.0530964569,0.946903543,2839.942569,3297.417144,5038.747191,3969.990548,9963,1011.472081,19926,-4830208,270848,-4559360,21
9412,549,21,9,0.0551149483,0.944885052,2839.271512,3425.761177,4997.172864,4703.734062,9961,757.4904943,19922,-4818944,281088,-4537856,21
9367,593,20,10,0.0595381526,0.940461847,2826.225036,3465.210979,5030.759154,4186.608769,9960,744.9513837,19920,-4795904,303616,-4492288,21
2894,302,20,10,0.0944931164,0.905506884,925.7004705,792.2665787,1639.286109,1207.655629,3196,219.0541467,6392,-1481728,154624,-1327104,21
1049,138,21,9,0.116259478,0.883740522,343.6281183,314.8484908,579.7807436,702.0869565,1187,180.945122,2374,-537088,70656,-466432,21
9443,520,20,10,0.0521931145,0.947806885,2841.051953,3259.719641,5042.692788,3879.842308,9963,863.3448873,19926,-4834816,266240,-4568576,21
9364,598,19,11,0.0600281068,0.939971893,2833.377012,3313.512517,5045.894383,3973.157191,9962,462.7032048,19924,-4794368,306176,-4488192,21
9424,542,20,10,0.0543849087,0.945615091,2840.885038,3235.336496,5049.52048,3835.571956,9966,672.4696356,19932,-4825088,277504,-4547584,21
1126,140,20,10,0.110584518,0.889415482,364.766176,370.1462129,636.4777975,609.55,1266,25.5705918,2532,-576512,71680,-504832,21
718,52,20,10,0.0675324675,0.932467532,215.2081723,298.6228914,381.7019499,437.9423077,770,12.19898606,1540,-367616,26624,-340992,21
9422,537,20,10,0.0539210764,0.946078924,2836.425806,3402.855413,5020.840692,4263.424581,9959,683.0589849,19918,-4824064,274944,-4549120,21
9310,636,22,8,0.0639453046,0.936054695,2872.995067,2793.789878,5008.738024,4457.672956,9946,445.609319,19892,-4766720,325632,-4441088,22
9339,614,21,9,0.0616899427,0.938310057,2856.265049,3111.513569,4990.958989,4764.68241,9953,962.5725338,19906,-4781568,314368,-4467200,22
9374,582,22,8,0.0584572117,0.941542788,2863.086797,3035.626464,4993.028483,4744.496564,9956,311.6118936,19912,-4799488,297984,-4501504,22
9321,627,22,8,0.0630277443,0.936972256,2865.580136,2905.520752,5011.918356,4418.23764,9948,392.7358863,19896,-4772352,321024,-4451328,22
9311,640,22,8,0.0643151442,0.935684856,2859.032968,3033.126292,5004.508001,4561.253125,9951,673.2746955,19902,-4767232,327680,-4439552,22
9370,583,21,9,0.0585753039,0.941424696,2868.899575,2889.625795,5010.099466,4445.024014,9953,1432.086331,19906,-4797440,298496,-4498944,22
9345,610,22,8,0.0612757408,0.938724259,2851.537277,3187.589192,4991.712253,4767.932787,9955,1085.605234,19910,-4784640,312320,-4472320,22
9315,633,21,9,0.0636308806,0.936369119,2887.195041,2574.064479,5011.191412,4434.562401,9948,554.5150502,19896,-4769280,324096,-4445184,22
9370,586,22,8,0.0588589795,0.94114102,2854.58737,3156.029662,4995.91302,4700.069966,9956,539.036275,19912,-4797440,300032,-4497408,22
2918,193,22,8,0.0620379299,0.93796207,894.6847309,838.8083592,1584.260452,1128.725389,3111,57.33505345,6222,-1494016,98816,-1395200,22
9433,534,22,8,0.0535768035,0.946423197,2874.014492,2882.570294,5013.931623,4455.264045,9967,911.8938701,19934,-4829696,273408,-4556288,22
9286,656,22,8,0.0659826997,0.9340173,2854.144059,3085.630946,4973.931833,4937.07622,9942,784.0694006,19884,-4754432,335872,-4418560,22
9366,588,22,8,0.05907173,0.94092827,2856.569457,3124.262225,4989.460175,4786.991497,9954,963.6011617,19908,-4795392,301056,-4494336,22
9356,599,22,8,0.0601707685,0.939829232,2862.21589,3040.07222,4991.990808,4759.472454,9955,696.1538462,19910,-4790272,306688,-4483584,22
9415,543,22,8,0.0545290219,0.945470978,2867.75573,2973.149036,4997.93043,4659.937385,9958,698.3169705,19916,-4820480,278016,-4542464,22
9386,568,22,8,0.0570624874,0.942937513,2868.301551,2950.959088,4989.147347,4785.03169,9954,877.7777778,19908,-4805632,290816,-4514816,22
8214,386,21,9,0.0448837209,0.955116279,2467.71976,2690.552464,4332.72766,3614.702073,8600,173.9130435,17200,-4205568,197632,-4007936,22
9366,588,22,8,0.05907173,0.94092827,2860.391644,3069.301378,4988.207559,4806.943878,9954,578.7209302,19908,-4795392,301056,-4494336,22
9335,615,22,8,0.0618090452,0.938190955,2857.795329,3084.333735,4974.622389,4988.821138,9950,1480.654762,19900,-4779520,314880,-4464640,22
9336,619,21,9,0.0621798091,0.937820191,2860.585871,3065.60991,4977.714974,4982.298869,9955,837.962963,19910,-4780032,316928,-4463104,22
5911,632,23,7,0.0965917775,0.903408223,1875.083605,1963.345979,3227.037557,3692.526899,6543,144.4370861,13086,-3026432,323584,-2702848,22
6235,620,23,7,0.0904449307,0.909555069,1976.206726,1950.085745,3383.626143,3874.243548,6855,163.6819484,13710,-3192320,317440,-2874880,22
5964,621,23,7,0.0943052392,0.905694761,1898.491834,1862.817778,3245.245641,3751.626409,6585,152.5011579,13170,-3053568,317952,-2735616,22
7441,761,23,7,0.0927822482,0.907217752,2370.410536,2318.535866,4069.859427,4410.879106,8202,202.7187346,16404,-3809792,389632,-3420160,22
6253,647,24,6,0.0937681159,0.906231884,1985.077627,2000.992708,3403.865664,3901.202473,6900,175.2603505,13800,-3201536,331264,-2870272,22
5951,663,23,7,0.100241911,0.899758089,1901.754236,1912.229221,3254.997311,3778.757164,6614,160.9245742,13228,-3046912,339456,-2707456,22
6201,647,23,7,0.0944801402,0.90551986,1969.93761,1996.960371,3382.207225,3829.843895,6848,133.2554972,13696,-3174912,331264,-2843648,22
7375,763,23,7,0.09375768,0.90624232,2351.508976,2269.027356,4018.584271,4561.640891,8138,141.9501134,16276,-3776000,390656,-3385344,22
6813,647,23,7,0.0867292225,0.913270777,2147.369832,2178.527449,3693.078233,4124.556414,7460,188.2887431,14920,-3488256,331264,-3156992,22
6174,647,23,7,0.094854127,0.905145873,1966.919461,1931.88594,3363.695011,3862.408037,6821,159.7423888,13642,-3161088,331264,-2829824,22
6050,625,23,7,0.0936329588,0.906367041,1918.116358,1956.707046,3292.776529,3775.7632,6675,157.2808671,13350,-3097600,320000,-2777600,22
136,65,23,7,0.323383085,0.676616915,60.67460247,50.72703141,96.43382353,110.5538462,201,12.29357798,402,-69632,33280,-36352,22
6486,529,23,7,0.0754098361,0.924590164,2026.251317,2008.686006,3501.599599,3586.47448,7015,479.49419,14030,-3320832,270848,-3049984,22
6172,654,23,7,0.0958101377,0.904189862,1964.971572,1973.610809,3369.245139,3831.146789,6826,187.4759681,13652,-3160064,334848,-2825216,22
6126,659,23,7,0.0971260133,0.902873987,1954.730145,1940.80947,3345.869246,3831.122914,6785,176.0051881,13570,-3136512,337408,-2799104,22
6027,637,23,7,0.0955882353,0.904411765,1919.12403,1921.897254,3290.505226,3729.835165,6664,157.3553719,13328,-3085824,326144,-2759680,22
460,67,23,7,0.127134725,0.872865275,149.7920266,114.4415343,280.6086957,149.9701493,527,15.55030983,1054,-235520,34304,-201216,22
2970,203,24,6,0.0639773085,0.936022691,896.7279534,1119.057879,1607.586195,1285.812808,3173,56.18912697,6346,-1520640,103936,-1416704,22
6289,656,23,7,0.0944564435,0.905543557,1994.588546,2056.399264,3430.417236,3881.23628,6945,175.6005057,13890,-3219968,335872,-2884096,22
6114,657,23,7,0.0970314577,0.902968542,1945.05601,1973.950486,3332.832188,3880.776256,6771,179.4593162,13542,-3130368,336384,-2793984,22
7500,647,23,7,0.0794157359,0.920584264,2340.559689,2395.281764,4021.186267,4686.214838,8147,189.2450639,16294,-3840000,331264,-3508736,22
7397,645,22,8,0.0802039294,0.919796071,2306.124693,2425.356116,3973.864675,4567.792248,8042,193.9233181,16084,-3787264,330240,-3457024,22
8711,832,23,7,0.0871843236,0.912815676,2739.139212,2874.119698,4728.15291,5231.076923,9543,200.3569179,19086,-4460032,425984,-4034048,22
256,43,24,6,0.143812709,0.856187291,85.39622151,91.17476191,148.65625,158,299,39.29040736,598,-131072,22016,-109056,22
8892,818,24,6,0.0842430484,0.915756952,2795.550641,2825.915076,4805.179825,5402.501222,9710,231.3006193,19420,-4552704,418816,-4133888,22
8691,840,23,7,0.0881334592,0.911866541,2740.440842,2799.753324,4711.244966,5332.519048,9531,243.3239724,19062,-4449792,430080,-4019712,22
7450,680,24,6,0.0836408364,0.916359164,2325.166557,2533.095077,4025.896242,4499.394118,8130,216.3384779,16260,-3814400,348160,-3466240,22
7447,653,24,6,0.080617284,0.919382716,2323.390041,2417.4939,3996.388479,4667.603369,8100,224.1283896,16200,-3812864,334336,-3478528,22
7550,669,24,6,0.0813967636,0.918603236,2359.908183,2438.932101,4059.050199,4684.994021,8219,145.5720864,16438,-3865600,342528,-3523072,22
9048,851,23,7,0.0859682796,0.91403172,2851.274139,2860.586717,4895.558134,5528.836663,9899,251.4351029,19798,-4632576,435712,-4196864,22
7581,717,22,8,0.086406363,0.913593637,2369.18617,2630.422982,4115.573275,4508.214784,8298,209.5454545,16596,-3881472,367104,-3514368,22
7576,665,24,6,0.0806940905,0.919305909,2358.876681,2560.161322,4084.341077,4538.63609,8241,157.4512801,16482,-3878912,340480,-3538432,22
8656,778,24,6,0.0824676701,0.91753233,2719.07486,2663.931104,4651.948822,5446.820051,9434,202.4029178,18868,-4431872,398336,-4033536,22
7569,689,24,6,0.0834342456,0.916565754,2362.260994,2568.858788,4089.46915,4569.258345,8258,219.1613588,16516,-3875328,352768,-3522560,22
8403,722,23,7,0.0791232877,0.920876712,2622.675627,2757.920609,4547.498631,4743.412742,9125,241.0195457,18250,-4302336,369664,-3932672,22
8769,858,23,7,0.0891243378,0.910875662,2762.875046,2907.859501,4773.811495,5224.737762,9627,237.5863771,19254,-4489728,439296,-4050432,22
8770,843,24,6,0.087693748,0.912306252,2764.396457,2830.688446,4756.625086,5331.066429,9613,177.7551775,19226,-4490240,431616,-4058624,22
8741,829,23,7,0.0866248694,0.913375131,2748.50289,2872.752881,4744.988788,5212.651387,9570,219.0432593,19140,-4475392,424448,-4050944,22
9161,772,23,7,0.0777207289,0.922279271,2857.490591,2969.504848,4944.403013,5235.148964,9933,436.0403863,19866,-4690432,395264,-4295168,22
7716,554,23,7,0.0669891173,0.933010883,2372.29005,2587.5895,4138.351089,4095.790614,8270,325.7187869,16540,-3950592,283648,-3666944,22
3060,321,23,7,0.0949423248,0.905057675,947.3259539,1148.618019,1651.181373,2070.579439,3381,87.13917526,6762,-1566720,164352,-1402368,22
4093,420,23,7,0.0930644804,0.90693552,1297.650915,1330.670123,2233.702419,2484.040476,4513,111.2946979,9026,-2095616,215040,-1880576,22
3049,350,23,7,0.102971462,0.897028538,954.9960191,1148.588739,1668.189242,1977.117143,3399,90.23095301,6798,-1561088,179200,-1381888,22
3036,319,24,6,0.0950819672,0.904918033,938.1509644,1148.004749,1636.680171,2071.250784,3355,91.69171905,6710,-1554432,163328,-1391104,22
4136,408,23,7,0.0897887324,0.910211268,1306.207161,1330.443588,2243.126692,2570.264706,4544,115.6528379,9088,-2117632,208896,-1908736,22
3041,336,24,6,0.0994965946,0.900503405,945.1397263,1176.448657,1658.849063,1961.883929,3377,89.17348825,6754,-1556992,172032,-1384960,22
2998,316,23,7,0.0953530477,0.904646952,925.422038,1111.472985,1608.612408,2121.313291,3314,88.20867714,6628,-1534976,161792,-1373184,22
4064,426,24,6,0.0948775056,0.905122494,1291.207963,1311.536227,2216.960384,2517.765258,4490,108.1667068,8980,-2080768,218112,-1862656,22
3004,321,23,7,0.0965413534,0.903458647,928.2577747,1152.378652,1623.473369,2032.900312,3325,87.13312369,6650,-1538048,164352,-1373696,22
4068,433,23,7,0.0962008443,0.903799156,1292.674887,1338.035856,2226.235251,2483.662818,4501,119.1371096,9002,-2082816,221696,-1861120,22
3044,348,23,7,0.10259434,0.89740566,943.2256411,1198.728192,1657.97339,2033.497126,3392,66.82427108,6784,-1558528,178176,-1380352,22
4079,434,24,6,0.0961666297,0.90383337,1296.188123,1330.518259,2226.947291,2539.453917,4513,127.8108185,9026,-2088448,222208,-1866240,22
3047,322,23,7,0.0955773226,0.904422677,938.2670941,1153.759887,1636.331474,2145.537267,3369,82.29115779,6738,-1560064,164864,-1395200,22
522,72,23,7,0.121212121,0.878787879,165.9120948,145.581677,316.5957854,159.0555556,594,20.21095611,1188,-267264,36864,-230400,22
3072,335,22,8,0.0983269739,0.901673026,952.6539572,1143.373779,1656.778971,2137.023881,3407,76.16811983,6814,-1572864,171520,-1401344,22
2978,317,24,6,0.0962063733,0.903793627,920.5172521,1171.594021,1620.968099,1901.946372,3295,65.87365054,6590,-1524736,162304,-1362432,22
3099,345,23,7,0.100174216,0.899825784,960.8997769,1194.02882,1681.944176,2086.797101,3444,77.06422018,6888,-1586688,176640,-1410048,22
4092,443,24,6,0.0976846748,0.902315325,1300.256538,1370.268264,2244.918622,2481.20316,4535,118.0067655,9070,-2095104,226816,-1868288,22
3011,329,23,7,0.098502994,0.901497006,934.2822895,1119.110828,1624.500166,2091.489362,3340,74.17277371,6680,-1541632,168448,-1373184,22
3080,351,24,6,0.102302536,0.897697464,957.0431572,1189.12522,1675.924675,2067.65812,3431,68.77129685,6862,-1576960,179712,-1397248,22
8814,841,24,6,0.0871051269,0.912894873,2804.482867,2598.560849,4826.009871,4848.857313,9655,211.8718455,19310,-4512768,430592,-4082176,22
4382,430,23,7,0.0893599335,0.910640067,1336.878494,1803.352372,2372.950707,2748.390698,4812,188.7799137,9624,-2243584,220160,-2023424,22
8457,757,24,6,0.0821575863,0.917842414,2678.155381,2437.472805,4589.911789,4803.990753,9214,187.8491335,18428,-4329984,387584,-3942400,22
8521,799,24,6,0.0857296137,0.914270386,2704.079396,2540.537938,4661.842389,4646.18398,9320,188.6257843,18640,-4362752,409088,-3953664,22
4346,382,23,7,0.0807952623,0.919204738,1324.98614,1658.306168,2315.873217,2917.725131,4728,125.8450892,9456,-2225152,195584,-2029568,22
4376,409,23,7,0.0854754441,0.914524556,1336.38599,1723.485627,2348.85809,2865.286064,4785,131.2037291,9570,-2240512,209408,-2031104,22
4363,401,23,7,0.0841729639,0.915827036,1331.287988,1737.750336,2346.6562,2772.491272,4764,118.5369495,9528,-2233856,205312,-2028544,22
4333,415,23,7,0.0874052233,0.912594777,1324.013282,1748.961047,2341.347334,2720.645783,4748,114.2444658,9496,-2218496,212480,-2006016,22
4466,403,24,6,0.0827685356,0.917231464,1367.284417,1707.403779,2392.972682,2900.741935,4869,100.5991736,9738,-2286592,206336,-2080256,22
4351,396,24,6,0.0834211081,0.916578892,1326.27651,1705.96127,2328.464261,2874.318182,4747,127.2654155,9494,-2227712,202752,-2024960,22
4411,430,24,6,0.088824623,0.911175377,1348.307771,1730.340527,2366.440716,2980.676744,4841,128.75,9682,-2258432,220160,-2038272,22
6129,689,22,8,0.101056028,0.898943972,1955.135461,1979.851788,3341.298417,4016.187228,6818,174.061782,13636,-3138048,352768,-2785280,22
4284,397,24,6,0.0848109378,0.915189062,1305.512903,1731.615012,2307.847806,2698.743073,4681,116.4427861,9362,-2193408,203264,-1990144,22
8505,807,24,6,0.0866623711,0.913337629,2701.083727,2547.753639,4655.818225,4663.685254,9312,213.0404942,18624,-4354560,413184,-3941376,22
8306,769,23,7,0.084738292,0.915261708,2634.146453,2452.741354,4522.980496,4700.226268,9075,176.5907764,18150,-4252672,393728,-3858944,22
4441,412,24,6,0.0848959407,0.915104059,1356.176704,1708.633461,2372.759063,3011.669903,4853,113.6267853,9706,-2273792,210944,-2062848,22
4365,375,23,7,0.0791139241,0.920886076,1330.605083,1659.050562,2324.993127,2900.2,4740,109.3425606,9480,-2234880,192000,-2042880,22
4380,401,24,6,0.0838736666,0.916126333,1334.552693,1756.232764,2354.584247,2788.758105,4781,124.052932,9562,-2242560,205312,-2037248,22
4426,404,23,7,0.0836438923,0.916356108,1352.192247,1714.90269,2370.080886,2913.086634,4830,118.7315634,9660,-2266112,206848,-2059264,22
8340,767,24,6,0.084220929,0.915779071,2649.739889,2385.928101,4568.280216,4398.723598,9107,160.9010601,18214,-4270080,392704,-3877376,22
8475,834,24,6,0.0895907187,0.910409281,2676.03923,2497.772125,4536.414277,5860.052758,9309,190.4849601,18618,-4339200,427008,-3912192,22
8392,815,23,7,0.0885196046,0.911480395,2644.575389,2541.334573,4497.092946,5704.814724,9207,193.5463527,18414,-4296704,417280,-3879424,22
4063,477,23,7,0.105066079,0.894933921,1317.020576,1118.522683,2207.428255,2807.733753,4540,108.5345446,9080,-2080256,244224,-1836032,22
7317,682,23,7,0.0852606576,0.914739342,2286.764523,2330.446357,3910.723111,4957.828446,7999,155.8651598,15998,-3746304,349184,-3397120,22
9165,764,24,6,0.0769463189,0.923053681,2885.204371,2545.201211,4912.482706,5595.001309,9929,611.7683303,19858,-4692480,391168,-4301312,22
7861,704,24,6,0.0821949796,0.91780502,2448.8659,2482.006272,4187.006869,5354.877841,8565,209.2085979,17130,-4024832,360448,-3664384,22
9020,888,23,7,0.0896245458,0.910375454,2834.358335,2778.784047,4823.214523,6288.052928,9908,338.7350427,19816,-4618240,454656,-4163584,22
7632,707,24,6,0.084782348,0.915217652,2382.293206,2450.89116,4077.943789,5163.738331,8339,179.7585687,16678,-3907584,361984,-3545600,22
7849,816,24,6,0.0941719561,0.905828044,2490.562586,2395.761689,4232.282966,5301.784314,8665,204.6528106,17330,-4018688,417792,-3600896,22
7795,638,24,6,0.0756551642,0.924344836,2418.129662,2496.600246,4153.180629,4996.736677,8433,147.9733287,16866,-3991040,326656,-3664384,22
7163,668,23,7,0.0853020049,0.914697995,2240.103913,2304.124965,3836.661175,4766.754491,7831,182.6685328,15662,-3667456,342016,-3325440,22
8742,814,23,7,0.0851820846,0.914817915,2750.295845,2572.65814,4670.107412,5942.588452,9556,224.3719183,19112,-4475904,416768,-4059136,22
4657,228,22,8,0.0466734903,0.95332651,1408.561844,1387.142546,2461.970152,2055.526316,4885,89.55087076,9770,-2384384,116736,-2267648,22
7125,704,24,6,0.0899220846,0.910077915,2239.407769,2238.711625,3819.087298,4885.707386,7829,191.3713029,15658,-3648000,360448,-3287552,22
7934,718,22,8,0.0829865927,0.917013407,2471.730659,2506.34316,4224.777666,5450.545961,8652,217.059709,17304,-4062208,367616,-3694592,22
8601,887,23,7,0.0934865093,0.906513491,2725.958506,2656.603443,4639.998023,5757.827508,9488,216.1768057,18976,-4403712,454144,-3949568,22
7145,687,24,6,0.0877170582,0.912282942,2240.242654,2237.304007,3821.353534,4906.050946,7832,186.7429661,15664,-3658240,351744,-3306496,22
7887,761,24,6,0.0879972248,0.912002775,2491.007884,2343.612101,4231.358058,5289.822602,8648,209.3946731,17296,-4038144,389632,-3648512,22
8159,819,24,6,0.0912229895,0.90877701,2579.35023,2464.016856,4381.103076,5569.3663,8978,224.5622811,17956,-4177408,419328,-3758080,22
8265,786,23,7,0.086841233,0.913158767,2602.885522,2540.379152,4438.982577,5441.01145,9051,205.0521069,18102,-4231680,402432,-3829248,22
9321,621,21,9,0.0624622812,0.937537719,2855.037193,3079.969718,4983.942925,4784.73591,9942,568.4391081,19884,-4772352,317952,-4454400,22
9336,602,22,8,0.0605755685,0.939424431,2852.466992,3109.692473,4962.086011,5084.478405,9938,861.925412,19876,-4780032,308224,-4471808,22
9460,501,21,9,0.050296155,0.949703845,2871.660476,2789.868304,5029.989429,4055.97006,9961,1275.416133,19922,-4843520,256512,-4587008,22
9338,609,21,9,0.0612244898,0.93877551,2860.969973,3025.048202,4966.103127,5095.085386,9947,557.5672646,19894,-4781056,311808,-4469248,22
9331,618,22,8,0.0621167957,0.937883204,2851.349858,3159.420219,4960.149502,5199.223301,9949,631.6825397,19898,-4777472,316416,-4461056,22
9455,507,22,8,0.0508933949,0.949106605,2878.094457,2754.428299,5015.957694,4338.901381,9962,1372.176309,19924,-4840960,259584,-4581376,22
9389,562,22,8,0.056476736,0.943523264,2860.87287,3053.64256,4989.133667,4756.58363,9951,685.3305785,19902,-4807168,287744,-4519424,22
9492,472,22,8,0.0473705339,0.952629466,2871.448553,2930.704523,5006.864412,4492.527542,9964,1435.73487,19928,-4859904,241664,-4618240,22
9352,597,22,8,0.0600060308,0.939993969,2853.313889,3150.720184,4974.770103,4978.60134,9949,753.7121212,19898,-4788224,305664,-4482560,22
4045,325,20,10,0.0743707094,0.925629291,1260.368427,1238.192714,2209.216069,1890.326154,4370,76.97727673,8740,-2071040,166400,-1904640,22
9213,719,20,10,0.0723922674,0.927607733,2843.867015,3149.826316,4964.508629,4992.01669,9932,515.1452282,19864,-4717056,368128,-4348928,22
9360,588,22,8,0.0591073583,0.940892642,2863.459272,2983.616765,4993.859188,4666.333333,9948,660.9966777,19896,-4792320,301056,-4491264,22
9308,634,22,8,0.0637698652,0.936230135,2855.369969,3070.982286,4984.082832,4786.766562,9942,519.4357367,19884,-4765696,324608,-4441088,22
9497,470,22,8,0.0471556135,0.952844386,2872.685079,2934.670855,5005.256081,4554.491489,9967,1067.130621,19934,-4862464,240640,-4621824,22
9346,603,22,8,0.0606091064,0.939390894,2849.295988,3203.733439,4976.399636,4953.306799,9949,810.1791531,19898,-4785152,308736,-4476416,22
9448,503,22,8,0.0505476836,0.949452316,2851.323103,3219.021612,4997.88696,4564.890656,9951,565.3977273,19902,-4837376,257536,-4579840,22
9314,628,20,10,0.0631663649,0.936833635,2831.621138,3300.69934,4921.439231,5713.961783,9942,770.1006971,19884,-4768768,321536,-4447232,22
9334,608,21,9,0.0611546972,0.938845303,2834.81232,3305.811815,4932.033319,5577.391447,9942,768.9095128,19884,-4779008,311296,-4467712,22
9336,613,21,9,0.0616142326,0.938385767,2840.618038,3308.208835,4962.738003,5161.750408,9949,719.3781634,19898,-4780032,313856,-4466176,22
9339,604,22,8,0.0607462536,0.939253746,2839.066439,3299.216694,4951.14327,5294.485099,9943,707.1834993,19886,-4781568,309248,-4472320,22
6080,667,23,7,0.098858752,0.901141248,1939.81825,1962.896374,3325.206743,3818.772114,6747,160.1091599,13494,-3112960,341504,-2771456,22
6140,647,23,7,0.095329306,0.904670694,1956.664867,1928.013908,3347.311075,3837.075734,6787,177.3915316,13574,-3143680,331264,-2812416,22
6356,653,23,7,0.0931659295,0.90683407,2022.145106,1972.872322,3456.275173,3979.264931,7009,184.4473684,14018,-3254272,334336,-2919936,22
6189,641,23,7,0.0938506589,0.906149341,1963.731425,1993.693498,3369.942802,3855.365055,6830,172.7364694,13660,-3168768,328192,-2840576,22
7215,736,22,8,0.0925669727,0.907433027,2308.892341,2123.195932,3939.02675,4338.44837,7951,204.6589447,15902,-3694080,376832,-3317248,22
5961,602,23,7,0.0917263447,0.908273655,1884.579521,1938.169491,3238.215568,3715.553156,6563,160.2294922,13126,-3052032,308224,-2743808,22
7080,714,23,7,0.0916089299,0.90839107,2261.189635,2095.990523,3858.393503,4285.278711,7794,200.9280742,15588,-3624960,365568,-3259392,22
6047,637,23,7,0.0953022142,0.904697786,1923.112204,1930.869517,3294.602778,3797.185243,6684,170.4667177,13368,-3096064,326144,-2769920,22
6198,653,23,7,0.0953145526,0.904685447,1965.871921,2031.709156,3378.282672,3878.912711,6851,171.0611735,13702,-3173376,334336,-2839040,22
5805,593,23,7,0.0926852141,0.907314786,1840.224104,1836.878114,3148.047201,3703.182125,6398,158.5232904,12796,-2972160,303616,-2668544,22
6874,657,23,7,0.0872394104,0.91276059,2176.860882,2134.805587,3747.905295,3955.319635,7531,172.4130037,15062,-3519488,336384,-3183104,22
6026,620,23,7,0.0932891965,0.906710803,1917.230401,1875.283277,3278.313973,3762.679032,6646,154.6660461,13292,-3085312,317440,-2767872,22
2216,134,23,7,0.0570212766,0.942978723,669.3727967,716.878461,1198.02843,802.9402985,2350,41.90442225,4700,-1134592,68608,-1065984,22
5930,663,23,7,0.100561201,0.899438799,1896.646541,1908.745142,3249.235076,3724.218703,6593,171.2022851,13186,-3036160,339456,-2696704,22
5049,446,22,8,0.0811646952,0.918835305,1578.894643,1662.624027,2737.223213,2870,5495,96.79408138,10990,-2585088,228352,-2356736,22
6316,672,23,7,0.096164854,0.903835146,2015.190883,1970.518891,3442.439994,3983.802083,6988,176.5092195,13976,-3233792,344064,-2889728,22
6298,664,23,7,0.0953748923,0.904625108,2003.320495,2016.503965,3434.701651,3925.379518,6962,154.9521478,13924,-3224576,339968,-2884608,22
6188,649,24,6,0.0949246746,0.905075325,1967.65243,1983.35226,3375.748546,3831.38829,6837,175.668037,13674,-3168256,332288,-2835968,22
3583,253,24,6,0.0659541189,0.934045881,1092.573225,1295.954828,1924.355847,1835.56917,3836,74.13993042,7672,-1834496,129536,-1704960,22
6062,643,23,7,0.0958985831,0.904101417,1929.233928,1940.349003,3306.539426,3791.015552,6705,123.4579267,13410,-3103744,329216,-2774528,22
6975,362,23,7,0.0493389669,0.950661033,2123.465502,1924.04571,3698.424659,3102.046961,7337,267.3833819,14674,-3571200,185344,-3385856,22
7082,398,24,6,0.0532085561,0.946791444,2169.089728,1881.370641,3773.682011,3150.060302,7480,238.3683875,14960,-3625984,203776,-3422208,22
7697,414,23,7,0.0510417951,0.948958205,2347.433238,2075.865342,4098.276991,3269.995169,8111,301.9731943,16222,-3940864,211968,-3728896,22
5838,366,23,7,0.0589941973,0.941005803,1804.194593,1522.531656,3124.368619,2753.677596,6204,217.6842105,12408,-2989056,187392,-2801664,22
3751,285,24,6,0.0706144698,0.92938553,1171.961387,1070.557244,2019.148494,2009.964912,4036,157.5946896,8072,-1920512,145920,-1774592,22
6546,342,23,7,0.0496515679,0.950348432,1992.616668,1808.85451,3475.060189,2859.567251,6888,231.2961719,13776,-3351552,175104,-3176448,22
5153,334,23,7,0.06087115,0.93912885,1591.773676,1421.409521,2764.422472,2428.919162,5487,184.0657497,10974,-2638336,171008,-2467328,22
6806,534,23,7,0.0727520436,0.927247956,2109.54433,2198.080439,3640.189098,4056.822097,7340,266.6182347,14680,-3484672,273408,-3211264,22
5394,365,23,7,0.0633790589,0.936620941,1674.283667,1439.393963,2901.713941,2559.109589,5759,194.1017863,11518,-2761728,186880,-2574848,22
7180,470,24,6,0.0614379085,0.938562092,2219.446654,1898.975208,3871.281894,3126.108511,7650,200.1046299,15300,-3676160,240640,-3435520,22
6643,406,23,7,0.0575968222,0.942403178,2045.078404,1760.053983,3560.672588,2941.32266,7049,212.6395173,14098,-3401216,207872,-3193344,22
6614,381,23,7,0.0544674768,0.945532523,2027.096171,1746.542426,3536.736468,2825.551181,6995,234.7315436,13990,-3386368,195072,-3191296,22
8718,592,23,7,0.0635875403,0.93641246,2688.162762,2651.668641,4680.468341,4287.807432,9310,315.0592217,18620,-4463616,303104,-4160512,22
7842,508,23,7,0.0608383234,0.939161677,2411.107984,2377.024059,4196.32581,3854.011811,8350,317.1287505,16700,-4015104,260096,-3755008,22
5296,356,24,6,0.0629865534,0.937013447,1644.393731,1392.971833,2846.851397,2523.744382,5652,201.2103952,11304,-2711552,182272,-2529280,22
6987,398,24,6,0.0538930264,0.946106974,2138.704061,1862.021548,3734.649492,2961.831658,7385,224.8781973,14770,-3577344,203776,-3373568,22
7014,395,23,7,0.0533135376,0.946686462,2145.094929,1897.009946,3743.60921,3019.417722,7409,250.3040541,14818,-3591168,202240,-3388928,22
5168,309,23,7,0.0564177469,0.943582253,1592.722486,1337.105444,2756.769737,2441.802589,5477,180.461285,10954,-2646016,158208,-2487808,22
5215,291,23,7,0.0528514348,0.947148565,1598.929624,1372.614271,2770.702397,2445.216495,5506,198.200144,11012,-2670080,148992,-2521088,22
1906,94,23,7,0.047,0.953,573.0818999,652.5373944,1004.555089,918.2765957,2000,31.35287663,4000,-975872,48128,-927744,22
7334,693,23,7,0.086333624,0.913666376,2305.575325,2327.477638,3948.823834,4703.757576,8027,217.3571622,16054,-3755008,354816,-3400192,22
6738,650,24,6,0.0879805089,0.912019491,2120.674588,2164.064215,3636.453399,4296.22,7388,182.5098814,14776,-3449856,332800,-3117056,22
6732,678,23,7,0.0914979757,0.908502024,2121.385874,2237.841108,3651.505645,4241.620944,7410,142.7470622,14820,-3446784,347136,-3099648,22
6736,669,23,7,0.0903443619,0.909655638,2123.226541,2216.150698,3653.189727,4204.527653,7405,137.4095379,14810,-3448832,342528,-3106304,22
6975,665,23,7,0.0870418848,0.912958115,2192.370422,2257.764107,3764.993835,4402.688722,7640,212.2811892,15280,-3571200,340480,-3230720,22
6635,644,23,7,0.0884736914,0.911526309,2091.030843,2095.019512,3576.584627,4293.35559,7279,199.6982167,14558,-3397120,329728,-3067392,22
6709,678,23,7,0.0917828618,0.908217138,2114.198316,2250.909543,3646.096438,4168.019174,7387,170.2466006,14774,-3435008,347136,-3087872,22
6937,674,23,7,0.0885560373,0.911443963,2181.082582,2277.964821,3750.328528,4378.986647,7611,175.3686636,15222,-3551744,345088,-3206656,22
6989,666,22,8,0.0870019595,0.91299804,2199.158449,2223.174969,3768.051366,4457.100601,7655,191.9027325,15310,-3578368,340992,-3237376,22
6675,672,22,8,0.0914659045,0.908534096,2105.839444,2220.998472,3631.353109,4097.613095,7347,172.5863284,14694,-3417600,344064,-3073536,22
6722,652,22,8,0.0884187686,0.911581231,2114.492151,2179.534643,3628.778042,4292.912577,7374,190.7891332,14748,-3441664,333824,-3107840,22
6618,652,23,7,0.0896836314,0.910316369,2081.316536,2188.516162,3579.810517,4200.765337,7270,194.6973755,14540,-3388416,333824,-3054592,22
6773,685,23,7,0.0918476803,0.90815232,2131.78971,2294.011202,3679.542891,4223.455474,7458,178.9776818,14916,-3467776,350720,-3117056,22
7725,721,23,7,0.0853658537,0.914634146,2435.036913,2433.067951,4184.868738,4637.40638,8446,204.4541273,16892,-3955200,369152,-3586048,22
6962,668,23,7,0.0875491481,0.912450852,2192.577463,2212.620814,3756.497845,4430.429641,7630,203.3040234,15260,-3564544,342016,-3222528,22
6719,647,23,7,0.0878360033,0.912163997,2114.7877,2181.769699,3635.536092,4181.598145,7366,169.7235023,14732,-3440128,331264,-3108864,22
144,22,23,7,0.13253012,0.86746988,46.04658669,58.17833796,82.36805556,90.90909091,166,5.688827964,332,-73728,11264,-62464,22
7186,705,23,7,0.0893422887,0.910657711,2262.252102,2376.907224,3897.796549,4437.333333,7891,206.5706806,15782,-3679232,360960,-3318272,22
8096,730,23,7,0.0827101745,0.917289826,2550.698022,2457.4824,4366.908226,4930.221918,8826,221.7030897,17652,-4145152,373760,-3771392,22
6726,662,23,7,0.0896047645,0.910395236,2120.435985,2182.611147,3641.701308,4230.941088,7388,176.8310196,14776,-3443712,338944,-3104768,22
2265,270,23,7,0.106508876,0.893491124,713.2464882,857.0545483,1286.092715,1116.222222,2535,92.28248999,5070,-1159680,138240,-1021440,23
2003,266,23,7,0.117232261,0.882767739,640.5806299,736.6693685,1155.524713,980.4473684,2269,82.41917908,4538,-1025536,136192,-889344,23
1898,264,23,7,0.122109158,0.877890842,609.1177929,711.8428867,1097.867756,963.8257576,2162,77.15917202,4324,-971776,135168,-836608,23
1896,258,23,7,0.119777159,0.880222841,609.5276824,685.839596,1098.622363,922.2751938,2154,67.04014939,4308,-970752,132096,-838656,23
1887,266,23,7,0.123548537,0.876451463,607.6298854,690.5711003,1100.043455,913.5300752,2153,74.34392265,4306,-966144,136192,-829952,23
1882,266,23,7,0.123836127,0.876163873,607.4228321,686.8437295,1094.39373,933.7481203,2148,78.27988338,4296,-963584,136192,-827392,23
43,15,20,10,0.25862069,0.74137931,16.83071955,16.13195586,30.51162791,26.6,58,1.510416667,116,-22016,7680,-14336,23
1986,260,23,7,0.115761354,0.884238646,633.1607596,738.0369414,1142.770393,976.3038462,2246,83.52547415,4492,-1016832,133120,-883712,23
1668,192,23,7,0.103225806,0.896774194,525.6725614,559.7316833,961.1330935,664.375,1860,62.31155779,3720,-854016,98304,-755712,23
1906,266,23,7,0.122467772,0.877532228,611.8795205,713.4436884,1104.222455,959.5112782,2172,78.38325514,4344,-975872,136192,-839680,23
1974,261,23,7,0.116778523,0.883221477,630.6808291,724.0759785,1140.221378,949.9348659,2235,80.36677454,4470,-1010688,133632,-877056,23
1923,277,23,7,0.125909091,0.874090909,620.5644229,713.9820696,1119.612585,967.8158845,2200,73.97444519,4400,-984576,141824,-842752,23
1986,253,23,7,0.112996874,0.887003126,633.0262631,729.8421382,1136.465257,990.7509881,2239,76.33822025,4478,-1016832,129536,-887296,23
1530,208,23,7,0.119677791,0.880322209,487.8365873,573.6940372,889.1084967,725.2644231,1738,23.01377119,3476,-783360,106496,-676864,23
1451,197,23,7,0.119538835,0.880461165,462.8164654,528.6985368,848.7112336,646.1725888,1648,60.96929338,3296,-742912,100864,-642048,23
2021,264,23,7,0.115536105,0.884463895,645.900551,738.4510337,1163.161306,988.6590909,2285,84.97582745,4570,-1034752,135168,-899584,23
1883,269,23,7,0.125,0.875,607.1652692,699.019567,1094.540627,950.2156134,2152,75.98870056,4304,-964096,137728,-826368,23
1898,260,23,7,0.120481928,0.879518072,610.8582812,691.772383,1096.99157,951.8115385,2158,77.01641685,4316,-971776,133120,-838656,23
1901,297,23,7,0.135122839,0.864877161,612.3244914,760.7039654,1104.015255,1070.599327,2198,39.09640697,4396,-973312,152064,-821248,23
2070,268,23,7,0.114627887,0.885372113,659.4553679,763.0844785,1191.507246,999.5186567,2338,85.04910877,4676,-1059840,137216,-922624,23
1772,276,23,7,0.134765625,0.865234375,579.9114505,655.8515689,1034.01298,963.423913,2048,74.79912345,4096,-907264,141312,-765952,23
1843,273,23,7,0.129017013,0.870982987,598.4313504,684.2439506,1069.387954,984.996337,2116,67.17460317,4232,-943616,139776,-803840,23
1762,273,23,7,0.134152334,0.865847666,575.7249233,654.4803317,1028,953.4578755,2035,68.63406408,4070,-902144,139776,-762368,23
1790,282,23,7,0.136100386,0.863899614,588.604677,654.0157171,1042.743017,996.8723404,2072,70.38043478,4144,-916480,144384,-772096,23
1255,169,23,7,0.118679775,0.881320225,404.3221054,419.3270845,735.8191235,539.3313609,1424,39.51165372,2848,-642560,86528,-556032,23
1786,284,23,7,0.137198068,0.862801932,587.4624061,654.1300366,1045.319709,973.7464789,2070,72.12543554,4140,-914432,145408,-769024,23
1788,274,23,7,0.132880698,0.867119302,585.7824538,646.4755783,1045.290828,941.5072993,2062,74.73722363,4124,-915456,140288,-775168,23
1635,275,23,7,0.143979058,0.856020942,537.76192,622.671539,965.8250765,894.1127273,1910,38.53136978,3820,-837120,140800,-696320,23
1759,281,23,7,0.137745098,0.862254902,581.4525795,630.7138433,1029.326322,965.2491103,2040,69.48228883,4080,-900608,143872,-756736,23
1858,264,23,7,0.124410933,0.875589067,602.1611372,670.9398168,1077.26211,950.5681818,2122,68.05644644,4244,-951296,135168,-816128,23
2087,274,23,7,0.11605252,0.88394748,670.6120546,747.3823393,1197.889315,1052.357664,2361,82.17890707,4722,-1068544,140288,-928256,23
1775,288,23,7,0.139602521,0.860397479,585.5583667,648.9599331,1043.80338,959.2534722,2063,76.09738104,4126,-908800,147456,-761344,23
1779,282,23,7,0.136826783,0.863173217,587.0167692,639.8486635,1040.071951,973.7695035,2061,73.24093817,4122,-910848,144384,-766464,23
1786,287,23,7,0.138446696,0.861553304,590.5812764,640.2020946,1048.818029,963.456446,2073,78.552482,4146,-914432,146944,-767488,23
1814,286,23,7,0.136190476,0.863809524,598.0011276,649.9858551,1063.42172,968.541958,2100,65.89268905,4200,-928768,146432,-782336,23
74,41,23,7,0.356521739,0.643478261,32.44169068,30.04204866,50.44594595,71.63414634,115,4.307116105,230,-37888,20992,-16896,23
1775,272,23,7,0.132877382,0.867122618,583.5217765,631.3755969,1036.136338,944.8014706,2047,77.07078313,4094,-908800,139264,-769536,23
1777,276,23,7,0.134437409,0.865562591,579.6230396,668.5018292,1034.454136,979.0072464,2053,69.38154782,4106,-909824,141312,-768512,23
1787,268,23,7,0.130413625,0.869586375,586.4538119,630.8496758,1039.889759,948.7201493,2055,73.41907824,4110,-914944,137216,-777728,23
1780,281,23,7,0.136341582,0.863658418,588.5042102,626.8039311,1045.288764,940.4875445,2061,70.43745728,4122,-911360,143872,-767488,23
932,149,20,10,0.137835338,0.862164662,314.4125918,289.1693404,531.0053648,603.5167785,1081,37.21170396,2162,-477184,76288,-400896,23
978,158,20,10,0.139084507,0.860915493,331.0149318,300.1778625,558.0378323,633.2594937,1136,61.60520607,2272,-500736,80896,-419840,23
938,146,20,10,0.134686347,0.865313653,315.1613224,286.6044978,530.6044776,618.9246575,1084,67.07920792,2168,-480256,74752,-405504,23
935,156,19,11,0.142988084,0.857011916,317.962274,282.672409,532.3251337,627.9615385,1091,61.53412296,2182,-478720,79872,-398848,23
996,169,20,10,0.145064378,0.854935622,338.2361893,321.1715849,575.5100402,627.1420118,1165,46.06563859,2330,-509952,86528,-423424,23
975,162,20,10,0.142480211,0.857519789,330.57012,307.6268774,559.5251282,626.0246914,1137,69.88322065,2274,-499200,82944,-416256,23
973,143,20,10,0.128136201,0.871863799,324.4079843,301.7895334,551.2034943,608.1468531,1116,55.19287834,2232,-498176,73216,-424960,23
922,139,20,10,0.131008483,0.868991517,306.2908198,298.4770898,521.3709328,594.8705036,1061,66.18839676,2122,-472064,71168,-400896,23
43,22,19,11,0.338461538,0.661538462,18.1637882,19.83678235,32.46511628,34.04545455,65,14.44444444,130,-22016,11264,-10752,23
60,21,18,12,0.259259259,0.740740741,23.4302511,21.44126608,43.7,33.28571429,81,16.77018634,162,-30720,10752,-19968,23
58,27,20,10,0.317647059,0.682352941,24.29971032,25.03183159,43.15517241,42.66666667,85,8.24442289,170,-29696,13824,-15872,23
1005,157,20,10,0.135111876,0.864888124,336.5275804,323.9732915,573.6965174,631.4522293,1162,71.28834356,2324,-514560,80384,-434176,23
965,153,20,10,0.136851521,0.863148479,323.676613,312.8936632,552.2331606,605.3333333,1118,58.04776739,2236,-494080,78336,-415744,23
968,167,19,11,0.147136564,0.852863436,330.9054445,296.393329,554.6115702,645.6047904,1135,97.59243336,2270,-495616,85504,-410112,23
50,18,21,9,0.264705882,0.735294118,20.13066318,17.05953627,36.42,29.16666667,68,3.481822837,136,-25600,9216,-16384,23
759,115,19,11,0.131578947,0.868421053,244.5505053,295.3302744,443.5810277,397.3652174,874,13.1152461,1748,-388608,58880,-329728,23
684,95,19,11,0.12195122,0.87804878,216.3979193,265.6217063,379.1447368,468.1578947,779,75.19305019,1558,-350208,48640,-301568,23
740,117,19,11,0.136522754,0.863477246,239.3962925,269.5213567,412.1283784,535.7094017,857,12.63825394,1714,-378880,59904,-318976,23
981,166,21,9,0.144725371,0.855274629,333.3229406,309.0974227,562.4954128,641.9879518,1147,94.09351928,2294,-502272,84992,-417280,23
43,15,19,11,0.25862069,0.74137931,16.90683279,15.31099823,31.13953488,24.8,58,8.529411765,116,-22016,7680,-14336,23
411,51,21,9,0.11038961,0.88961039,128.9884712,160.679356,235.6009732,198.4509804,462,48.32635983,924,-210432,26112,-184320,23
412,79,21,9,0.16089613,0.83910387,134.9202788,167.4616865,253.6262136,206.2278481,491,40.41152263,982,-210944,40448,-170496,23
377,64,20,10,0.145124717,0.854875283,123.2972889,122.2915917,234.2891247,142.71875,441,60.24590164,882,-193024,32768,-160256,23
405,67,21,9,0.141949153,0.858050847,130.5678897,149.9746396,247.5975309,169.4179104,472,20.62937063,944,-207360,34304,-173056,23
405,74,21,9,0.154488518,0.845511482,132.5463097,156.0652314,249.5851852,187.5405405,479,54.49374289,958,-207360,37888,-169472,23
60,22,19,11,0.268292683,0.731707317,23.86375681,21.97392331,43.76666667,35.31818182,82,14.64285714,164,-30720,11264,-19456,23
74,30,19,11,0.288461538,0.711538462,29.65208534,30.71980903,53.67567568,49.6,104,13.64829396,208,-37888,15360,-22528,23
379,50,19,11,0.116550117,0.883449883,119.8108593,132.1473738,224.0422164,146.46,429,46.83406114,858,-194048,25600,-168448,23
43,16,19,11,0.271186441,0.728813559,17.40687965,14.64568516,32.02325581,24.5625,59,13.05309735,118,-22016,8192,-13824,23
41,15,20,10,0.267857143,0.732142857,16.36608993,14.65363057,30.17073171,23.93333333,56,6.060606061,112,-20992,7680,-13312,23
374,46,21,9,0.10952381,0.89047619,117.951096,125.0348931,219.0828877,140.7173913,420,45.65217391,840,-191488,23552,-167936,23
41,15,19,11,0.267857143,0.732142857,16.40856264,14.34278758,30.31707317,23.53333333,56,12.36203091,112,-20992,7680,-13312,23
396,63,20,10,0.137254902,0.862745098,126.5367072,161.9944849,234.7348485,200.2380952,459,43.46590909,918,-202752,32256,-170496,23
421,58,21,9,0.121085595,0.878914405,132.6269787,170.6011622,244.3254157,208.6034483,479,36.76132003,958,-215552,29696,-185856,23
41,16,20,10,0.280701754,0.719298246,16.82057039,14.82185886,30.46341463,25.25,57,8.073654391,114,-20992,8192,-12800,23
378,45,21,9,0.106382979,0.893617021,118.5552427,137.6181871,218.3227513,158.8888889,423,41.22807018,846,-193536,23040,-170496,23
46,18,21,9,0.28125,0.71875,18.00904257,19.55563447,32.97826087,31.27777778,64,6.142034549,128,-23552,9216,-14336,23
408,76,19,11,0.157024793,0.842975207,133.3023277,162.4031972,251.1372549,196.1315789,484,57.8255675,968,-208896,38912,-169984,23
396,74,20,10,0.157446809,0.842553191,130.0532101,151.2327123,245.6969697,180.9324324,470,57.38705739,940,-202752,37888,-164864,23
388,74,19,11,0.16017316,0.83982684,127.4373008,143.0698651,244.3762887,163.9864865,462,55.46218487,924,-198656,37888,-160768,23
1465,174,21,9,0.106162294,0.893837706,461.5852012,556.0077885,828.4320819,749.0057471,1639,75.63451777,3278,-750080,89088,-660992,23
43,16,20,10,0.271186441,0.728813559,17.2580391,15.39975142,31.79069767,25.1875,59,9.204368175,118,-22016,8192,-13824,23
1449,171,22,8,0.105555556,0.894444444,464.1968262,494.4347398,814.8654244,773.5087719,1620,131.6003249,3240,-741888,87552,-654336,23
1467,170,22,8,0.103848503,0.896151497,463.3989822,542.3592011,825.1676892,765.7764706,1637,127.9906177,3274,-751104,87040,-664064,23
1468,178,22,8,0.108140948,0.891859052,468.7493457,519.4032498,832.2915531,750.994382,1646,97.28132388,3292,-751616,91136,-660480,23
1430,166,21,9,0.104010025,0.895989975,451.781797,531.0926676,800.9867133,777.0783133,1596,149.4382022,3192,-732160,84992,-647168,23
44,16,20,10,0.266666667,0.733333333,17.18955754,17.16999108,31.79545455,26.9375,60,1.05764146,120,-22528,8192,-14336,23
1482,171,21,9,0.103448276,0.896551724,467.4373106,550.0696505,834.6349528,760.8304094,1653,87.32171157,3306,-758784,87552,-671232,23
43,18,21,9,0.295081967,0.704918033,17.01489819,18.94509611,31.06976744,30.83333333,61,9.242424242,122,-22016,9216,-12800,23
61,24,20,10,0.282352941,0.717647059,24.81635857,22.93272165,45.13114754,37.58333333,85,14.09618574,170,-31232,12288,-18944,23
40,16,18,12,0.285714286,0.714285714,16.51325225,14.34780035,30.25,24.125,56,7.506702413,112,-20480,8192,-12288,23
43,16,19,11,0.271186441,0.728813559,17.2832165,15.29654781,31.81395349,25.125,59,10.92592593,118,-22016,8192,-13824,23
1447,165,22,8,0.10235732,0.89764268,453.9068378,553.6756435,811.5577056,762.1454545,1612,93.77545084,3224,-740864,84480,-656384,23
1480,195,21,9,0.11641791,0.88358209,478.7347833,512.2163496,847.9567568,762.4307692,1675,109.6204188,3350,-757760,99840,-657920,23
1465,166,22,8,0.10177805,0.89822195,460.4448785,550.5377158,822.7351536,756.560241,1631,141.2121212,3262,-750080,84992,-665088,23
40,15,19,11,0.272727273,0.727272727,16.15083202,14.11760131,29.725,23.4,55,6.138392857,110,-20480,7680,-12800,23
1502,185,21,9,0.109662122,0.890337878,478.9464275,540.3007172,854.6251664,757.7351351,1687,72.59036145,3374,-769024,94720,-674304,23
1460,175,21,9,0.107033639,0.892966361,461.2867688,551.4020664,823.0815068,775.6057143,1635,125.3834356,3270,-747520,89600,-657920,23
771,91,21,9,0.105568445,0.894431555,243.6185175,255.258157,446.6990921,302.7252747,862,108.427673,1724,-394752,46592,-348160,23
1493,168,21,9,0.101143889,0.898856111,473.5111515,525.3332242,838.2083054,766.9404762,1661,152.2456462,3322,-764416,86016,-678400,23
709,103,22,8,0.126847291,0.873152709,228.3797481,272.2361716,405.842031,411.0291262,812,64.54689984,1624,-363008,52736,-310272,23
707,104,22,8,0.128236745,0.871763255,228.1871254,270.8969425,404.9731259,412.9807692,811,42.02072539,1622,-361984,53248,-308736,23
723,105,22,8,0.126811594,0.873188406,233.2135168,275.5940187,413.3651452,422.3142857,828,60.61493411,1656,-370176,53760,-316416,23
705,104,22,8,0.12855377,0.87144623,227.9980981,267.8093798,403.3092199,416.4615385,809,63.00623053,1618,-360960,53248,-307712,23
722,104,22,8,0.12590799,0.87409201,232.3660087,276.6617357,411.666205,426.2307692,826,41.01290963,1652,-369664,53248,-316416,23
713,104,22,8,0.127294982,0.872705018,232.118927,259.8512431,410.0841515,401.5673077,817,37.54595588,1634,-365056,53248,-311808,23
707,102,22,8,0.126081582,0.873918418,227.6328098,270.9482977,404.7567185,406.6862745,809,66.85950413,1618,-361984,52224,-309760,23
707,103,22,8,0.127160494,0.872839506,227.9086937,270.7437545,403.9533239,416.1165049,810,76.99619772,1620,-361984,52736,-309248,23
58,11,22,8,0.15942029,0.84057971,18.82629148,22.46540039,36.86206897,25.18181818,69,1.527562542,138,-29696,5632,-24064,23
714,104,22,8,0.127139364,0.872860636,228.9764904,280.3442554,408.7647059,414.5480769,818,66.23481781,1636,-365568,53248,-312320,23
707,103,22,8,0.127160494,0.872839506,227.1629329,274.6115322,402.9561528,422.961165,810,72.97297297,1620,-361984,52736,-309248,23
708,101,22,8,0.124845488,0.875154512,225.6771699,282.5423324,405.5042373,401.4653465,809,62.90824261,1618,-362496,51712,-310784,23
712,104,22,8,0.12745098,0.87254902,229.7013631,272.0303373,406.8595506,419.7307692,816,56.12104539,1632,-364544,53248,-311296,23
706,102,22,8,0.126237624,0.873762376,227.4347285,270.0831655,404.3583569,405.4803922,808,56.1891516,1616,-361472,52224,-309248,23
723,105,22,8,0.126811594,0.873188406,231.2391118,286.8117848,413.3222683,422.6095238,828,53.28185328,1656,-370176,53760,-316416,23
704,104,22,8,0.128712871,0.871287129,227.0659578,271.1793071,402.9019886,415.3173077,808,68.18565401,1616,-360448,53248,-307200,23
709,104,22,8,0.127921279,0.872078721,228.7241011,271.9094027,407.2073343,405.5865385,813,51.19647355,1626,-363008,53248,-309760,23
373,57,22,8,0.13255814,0.86744186,119.6188683,143.4909331,221.8873995,173.7017544,430,33.48909657,860,-190976,29184,-161792,23
406,57,22,8,0.123110151,0.876889849,127.8251517,162.0706958,238.5172414,185.5789474,463,41.63669065,926,-207872,29184,-178688,23
708,102,22,8,0.125925926,0.874074074,229.4143912,262.38386,406.0564972,401.6372549,810,58.31533477,1620,-362496,52224,-310272,23
703,104,22,8,0.128872367,0.871127633,227.3375688,267.8635946,403.4537696,407.6923077,807,69.15167095,1614,-359936,53248,-306688,23
706,106,22,8,0.130541872,0.869458128,228.7920089,268.4469039,404.5453258,419.5188679,812,74.08759124,1624,-361472,54272,-307200,23
706,105,22,8,0.12946979,0.87053021,228.0366318,271.2372141,404.4206799,416.6190476,811,76.43732328,1622,-361472,53760,-307712,23
710,103,22,8,0.126691267,0.873308733,226.9446073,282.3761244,406.9605634,407.2718447,813,60.04431315,1626,-363520,52736,-310784,23
216,21,22,8,0.0886075949,0.911392405,66.28532507,84.74943729,120.9675926,98.76190476,237,5.817378498,474,-110592,10752,-99840,23
708,107,22,8,0.131288344,0.868711656,229.3464974,271.0273771,406.5437853,417.635514,815,70.68516912,1630,-362496,54784,-307712,23
708,105,22,8,0.129151292,0.870848708,230.5731334,260.4979126,405.3305085,418.2571429,813,47.54385965,1626,-362496,53760,-308736,23
706,102,22,8,0.126237624,0.873762376,227.4529943,269.9070639,403.6600567,410.3137255,808,65.53122466,1616,-361472,52224,-309248,23
703,105,22,8,0.129950495,0.870049505,227.3075304,269.6707373,404.197724,406.5238095,808,71.75843694,1616,-359936,53760,-306176,23
717,105,22,8,0.127737226,0.872262774,232.6472589,266.8187434,412.0432357,407.7904762,822,57.6033637,1644,-367104,53760,-313344,23
707,103,22,8,0.127160494,0.872839506,228.0789087,269.9731623,405.0084866,408.8737864,810,66.28477905,1620,-361984,52736,-309248,23
704,106,22,8,0.130864198,0.869135802,227.5081814,272.0879595,405.2698864,407.0283019,810,61.55015198,1620,-360448,54272,-306176,23
710,103,22,8,0.126691267,0.873308733,228.8666695,271.3120017,405.7352113,415.7184466,813,48.71180348,1626,-363520,52736,-310784,23
717,106,22,8,0.128797084,0.871202916,231.5372426,274.7106954,410.3040446,423.4716981,823,83.13131313,1646,-367104,54272,-312832,23
461,66,22,8,0.125237192,0.874762808,146.9124486,174.7668137,271.9240781,208.6515152,527,12.04571429,1054,-236032,33792,-202240,23
706,103,22,8,0.127317676,0.872682324,227.1168487,273.410057,403.9291785,412.3398058,809,58.87918486,1618,-361472,52736,-308736,23
405,56,22,8,0.121475054,0.878524946,127.9623706,162.2168874,235.2098765,200.5535714,461,43.49056604,922,-207360,28672,-178688,23
714,104,22,8,0.127139364,0.872860636,229.3818242,277.9037176,410.9663866,399.4326923,818,33.56585966,1636,-365568,53248,-312320,23
714,105,22,8,0.128205128,0.871794872,233.0103851,257.259687,413.4005602,386.8761905,819,32.13024716,1638,-365568,53760,-311808,23
706,103,22,8,0.127317676,0.872682324,227.8186416,269.4927655,405.0283286,404.8058252,809,68.0976431,1618,-361472,52736,-308736,23
705,103,22,8,0.127475248,0.872524752,227.14502,271.3361346,403.9191489,408.4757282,808,74.19651056,1616,-360960,52736,-308224,23
709,103,22,8,0.126847291,0.873152709,228.6665002,270.6175794,406.4880113,406.5825243,812,58.92597968,1624,-363008,52736,-310272,23
699,105,22,8,0.130597015,0.869402985,226.138135,267.8128673,400.0157368,419.0380952,804,61.00151745,1608,-357888,53760,-304128,23
702,109,22,8,0.134401973,0.865598027,223.6919298,291.2338597,402.1082621,431.0642202,811,14.57584472,1622,-359424,55808,-303616,23
702,103,22,8,0.127950311,0.872049689,226.6195615,268.3678485,402.531339,406.1941748,805,70.92511013,1610,-359424,52736,-306688,23
701,100,22,8,0.124843945,0.875156055,225.2415021,269.3967296,401.9429387,394.39,801,61.28538638,1602,-358912,51200,-307712,23
710,105,22,8,0.128834356,0.871165644,229.436119,270.951597,405.7352113,423.3142857,815,64.68253968,1630,-363520,53760,-309760,23
702,102,22,8,0.126865672,0.873134328,225.9160471,270.8005256,402.048433,405.6078431,804,79.21182266,1608,-359424,52224,-307200,23
700,105,22,8,0.130434783,0.869565217,226.3733774,268.5552113,400.7414286,418.0571429,805,78.69012708,1610,-358400,53760,-304640,23
702,104,22,8,0.129032258,0.870967742,226.6446584,269.8262589,402.9287749,407.3557692,806,59.83667409,1612,-359424,53248,-306176,23
706,111,22,8,0.135862913,0.864137087,227.3785787,282.6217757,405.131728,433.6036036,817,14.27572951,1634,-361472,56832,-304640,23
708,102,22,8,0.125925926,0.874074074,228.1654398,269.8657392,405.6751412,404.2843137,810,66.88687036,1620,-362496,52224,-310272,23
703,105,22,8,0.129950495,0.870049505,227.0678482,270.9448204,405.4352774,398.2380952,808,63.17435496,1616,-359936,53760,-306176,23
716,107,22,8,0.130012151,0.869987849,231.1724258,276.5843193,411.0963687,418.046729,823,70.70446735,1646,-366592,54784,-311808,23
702,104,22,8,0.129032258,0.870967742,227.8980048,262.2330398,405.511396,389.9230769,806,46.77887406,1612,-359424,53248,-306176,23
697,104,22,8,0.129837703,0.870162297,224.823901,270.2231845,401.6470588,396.6634615,801,55.58639833,1602,-356864,53248,-303616,23
404,56,22,8,0.12173913,0.87826087,127.8410362,161.043408,234.6163366,200.8035714,460,42.87045666,920,-206848,28672,-178176,23
404,57,22,8,0.123644252,0.876355748,127.9504112,162.3774031,234.8094059,204,461,42.80408542,922,-206848,29184,-177664,23
710,105,22,8,0.128834356,0.871165644,231.2559251,260.3633892,410.0746479,393.9714286,815,27.46882373,1630,-363520,53760,-309760,23
716,102,22,8,0.124694377,0.875305623,229.6595609,277.1442698,411.0055866,398.9313725,818,56.02739726,1636,-366592,52224,-314368,23
1021,172,21,9,0.14417435,0.85582565,342.5206079,354.9249106,594.5259549,611.6860465,1193,37.64594509,2386,-522752,88064,-434688,23
1045,181,21,9,0.147634584,0.852365416,358.7754777,313.5328126,600.1626794,690.5027624,1226,67.92243767,2452,-535040,92672,-442368,23
43,16,18,12,0.271186441,0.728813559,17.39227059,14.42423633,32.20930233,24.0625,59,8.286516854,118,-22016,8192,-13824,23
1021,176,21,9,0.147034252,0.852965748,351.9769517,294.2868479,585.9049951,674.9659091,1197,60.302267,2394,-522752,90112,-432640,23
984,145,22,8,0.128432241,0.871567759,328.3176486,292.0623249,551.0731707,659.5103448,1129,88.47962382,2258,-503808,74240,-429568,23
983,154,20,10,0.135444151,0.864555849,331.4130023,293.8881773,556.0274669,651.8051948,1137,70.44609665,2274,-503296,78848,-424448,23
969,156,21,9,0.138666667,0.861333333,328.004124,296.8807471,553.3467492,622.9615385,1125,75.80862534,2250,-496128,79872,-416256,23
43,17,19,11,0.283333333,0.716666667,17.75312951,15.11501465,32.41860465,25.64705882,60,11.92842942,120,-22016,8704,-13312,23
1028,156,21,9,0.131756757,0.868243243,345.3678576,306.7161671,581.0554475,667.9166667,1184,128.5559175,2368,-526336,79872,-446464,23
1025,177,22,8,0.147254576,0.852745424,341.5417146,375.7394691,606.3717073,573.2881356,1202,80.72531901,2404,-524800,90624,-434176,23
63,25,18,12,0.284090909,0.715909091,25.75421161,22.95651542,47.36507937,37.28,88,11.78045515,176,-32256,12800,-19456,23
1010,180,22,8,0.151260504,0.848739496,347.2606542,313.380744,583.5306931,662.6611111,1190,75.36415453,2380,-517120,92160,-424960,23
989,156,21,9,0.136244541,0.863755459,332.3396875,300.4414427,557.3518706,672.2051282,1145,86.09022556,2290,-506368,79872,-426496,23
708,98,21,9,0.121588089,0.878411911,227.5018585,262.1203619,410.1370056,355.5510204,806,85.38135593,1612,-362496,50176,-312320,23
725,98,21,9,0.119076549,0.880923451,230.8311318,265.451138,399.7227586,502.8265306,823,96.82352941,1646,-371200,50176,-321024,23
695,96,22,8,0.12136536,0.87863464,223.886482,255.177277,390.8028777,433.625,791,86.16557734,1582,-355840,49152,-306688,23
40,17,18,12,0.298245614,0.701754386,16.98999706,14.23966875,30.8,24.76470588,57,8.728943338,114,-20480,8704,-11776,23
980,159,21,9,0.139596137,0.860403863,333.0343119,288.8835789,557.0653061,649.7232704,1139,89.61447679,2278,-501760,81408,-420352,23
1013,145,22,8,0.125215889,0.874784111,334.7411825,325.1455637,571.1411649,637.8965517,1158,113.5294118,2316,-518656,74240,-444416,23
993,163,21,9,0.14100346,0.85899654,334.8070425,307.6784504,561.6817724,680.9570552,1156,20.20979021,2312,-508416,83456,-424960,23
747,109,22,8,0.127336449,0.872663551,240.9827941,285.4246834,427.3186078,436.5963303,856,48.30699774,1712,-382464,55808,-326656,23
754,107,22,8,0.1242741,0.8757259,241.103416,295.732008,431.4257294,428,861,38.11420983,1722,-386048,54784,-331264,23
758,107,22,8,0.123699422,0.876300578,243.5288706,289.6894277,432.6253298,435.6542056,865,70.49714751,1730,-388096,54784,-333312,23
758,111,22,8,0.127733026,0.872266974,241.926734,304.6661293,436.7585752,422.990991,869,59.97239476,1738,-388096,56832,-331264,23
747,106,22,8,0.124267292,0.875732708,239.6362967,288.5209427,427.0468541,426.6698113,853,81.94044188,1706,-382464,54272,-328192,23
744,116,22,8,0.134883721,0.865116279,241.2513334,288.3233184,427.2284946,451.4827586,860,15.008726,1720,-380928,59392,-321536,23
761,105,22,8,0.121247113,0.878752887,243.2746821,293.6389055,435.6977661,417.5714286,866,38.90386343,1732,-389632,53760,-335872,23
756,106,22,8,0.122969838,0.877030162,242.5219667,289.6096863,433.260582,418.9433962,862,67.82061369,1724,-387072,54272,-332800,23
751,108,22,8,0.12572759,0.87427241,241.8686021,286.8363797,429.747004,431.7592593,859,78.51919561,1718,-384512,55296,-329216,23
754,110,22,8,0.127314815,0.872685185,242.6655046,291.485558,432.9429708,429.4636364,864,61.1898017,1728,-386048,56320,-329728,23
748,109,22,8,0.127187865,0.872812135,240.7412776,288.9016461,428.3008021,433.7981651,857,69.16868442,1714,-382976,55808,-327168,23
752,108,22,8,0.125581395,0.874418605,239.7282596,300.9765382,431.3218085,424.7777778,860,82.13944604,1720,-385024,55296,-329728,23
751,107,22,8,0.124708625,0.875291375,241.4356255,287.7221003,429.0719041,432.5046729,858,74.15730337,1716,-384512,54784,-329728,23
744,108,22,8,0.126760563,0.873239437,239.4721377,286.6292426,426.6505376,425.462963,852,61.07526882,1704,-380928,55296,-325632,23
745,108,23,7,0.126611958,0.873388042,241.3519964,277.6214466,427.0416107,426.712963,853,35.60100167,1706,-381440,55296,-326144,23
748,109,22,8,0.127187865,0.872812135,241.4773566,284.5815954,427.8770053,436.706422,857,58.49829352,1714,-382976,55808,-327168,23
752,106,22,8,0.123543124,0.876456876,241.3553845,288.6175517,429.5625,429.0566038,858,64.80362538,1716,-385024,54272,-330752,23
754,107,22,8,0.1242741,0.8757259,242.1407961,289.7155167,430.9748011,431.1775701,861,65.03021148,1722,-386048,54784,-331264,23
750,106,22,8,0.123831776,0.876168224,240.2078954,291.1609775,427.392,436.3396226,856,74.11255411,1712,-384000,54272,-329728,23
767,109,22,8,0.124429224,0.875570776,249.4606751,274.8672073,441.4132986,418,876,21.99347226,1752,-392704,55808,-336896,23
9474,479,20,10,0.0481261931,0.951873807,2869.110243,2919.91045,4998.610935,4549.563674,9953,985.4455446,19906,-4850688,245248,-4605440,24
9344,600,21,9,0.0603378922,0.939662108,2874.678236,2770.975001,5000.040989,4543.595,9944,509.1653866,19888,-4784128,307200,-4476928,24
9343,601,21,9,0.0604384553,0.939561545,2859.169245,3040.422161,4965.396018,5082.936772,9944,643.2082794,19888,-4783616,307712,-4475904,24
1542,322,23,7,0.172746781,0.827253219,518.4727582,621.7353627,923.5,975.5993789,1864,53.85726669,3728,-789504,164864,-624640,24
9504,447,21,9,0.0449201085,0.955079891,2871.801299,2876.748315,4988.54577,4709.255034,9951,438.9501544,19902,-4866048,228864,-4637184,24
9491,462,22,8,0.0464181654,0.953581835,2865.299611,3011.629947,4993.098093,4646.292208,9953,1423.891273,19906,-4859392,236544,-4622848,24
3261,259,21,9,0.0735795455,0.926420455,1022.275111,905.8929356,1778.320454,1536.127413,3520,65.2335063,7040,-1669632,132608,-1537024,24
2785,152,21,9,0.05175349,0.94824651,847.8396764,786.899514,1485.772352,1161.690789,2937,51.7989418,5874,-1425920,77824,-1348096,24
1193,226,23,7,0.159267089,0.840732911,392.3467885,488.5906915,701.7736798,753.4247788,1419,29.34850052,2838,-610816,115712,-495104,24
9366,581,22,8,0.0584095707,0.941590429,2860.891847,3024.140329,4957.44811,5240.824441,9947,786.3241107,19894,-4795392,297472,-4497920,24
9321,620,21,9,0.062367971,0.937632029,2870.441464,2830.78777,4996.733505,4584.125806,9941,463.4498834,19882,-4772352,317440,-4454912,24
1398,305,23,7,0.179095713,0.820904287,473.5079455,547.8448681,822.9184549,985.2983607,1703,29.86147642,3406,-715776,156160,-559616,24
9258,684,21,9,0.0687990344,0.931200966,2877.489728,2751.831473,4991.960467,4694.565789,9942,318.960539,19884,-4740096,350208,-4389888,24
9425,524,21,9,0.0526686099,0.94733139,2864.313394,2975.080712,4998.804244,4546.841603,9949,1043.966422,19898,-4825600,268288,-4557312,24
9332,614,21,9,0.0617333601,0.93826664,2876.739567,2726.50778,5009.695456,4423.376221,9946,328.7933884,19892,-4777984,314368,-4463616,24
1569,325,23,7,0.171594509,0.828405491,530.1175427,615.942182,932.8680688,1018.138462,1894,61.13621691,3788,-803328,166400,-636928,24
3152,245,21,9,0.072122461,0.927877539,973.2698206,1047.83083,1682.479378,1911.542857,3397,41.00676002,6794,-1613824,125440,-1488384,24
3700,247,21,9,0.0625791741,0.937420826,1131.0446,1249.446816,1983.436216,1832.647773,3947,56.64466131,7894,-1894400,126464,-1767936,24
1555,322,22,8,0.171550346,0.828449654,521.5840231,630.188312,934.7967846,959.2981366,1877,59.32364096,3754,-796160,164864,-631296,24
2755,235,21,9,0.0785953177,0.921404682,859.9068176,880.1317035,1510.961525,1314.238298,2990,52.85487007,5980,-1410560,120320,-1290240,24
5396,730,21,9,0.119164218,0.880835782,1761.507122,1682.627632,3151.151223,2415.60137,6126,121.6200119,12252,-2762752,373760,-2388992,24
1554,336,22,8,0.177777778,0.822222222,523.9221271,614.2875631,912.966538,1095.967262,1890,48.51129363,3780,-795648,172032,-623616,24
995,129,21,9,0.114768683,0.885231317,318.6539239,331.1953315,581.5718593,415.3953488,1124,40.14285714,2248,-509440,66048,-443392,24
668,106,21,9,0.136950904,0.863049096,214.8832179,245.9128917,404.3532934,281.2924528,774,30.41257367,1548,-342016,54272,-287744,24
286,49,22,8,0.146268657,0.853731343,91.61521281,113.3976686,175.2342657,125.7755102,335,9.41011236,670,-146432,25088,-121344,24
2630,442,22,8,0.143880208,0.856119792,897.7987288,810.6928234,1553.90038,1432.963801,3072,75.12839325,6144,-1346560,226304,-1120256,24
1066,148,22,8,0.121911038,0.878088962,340.3140733,411.1020294,615.9803002,546.4189189,1214,23.25670498,2428,-545792,75776,-470016,24
4002,587,22,8,0.127914578,0.872085422,1332.141313,1194.717579,2355.224638,1884.405451,4589,84.74607572,9178,-2049024,300544,-1748480,24
34,35,21,9,0.507246377,0.492753623,13.41024888,19.84416842,24.44117647,45.25714286,69,1.615168539,138,-17408,17920,512,24
889,114,22,8,0.113659023,0.886340977,283.5972263,314.7345039,514.8571429,401.7368421,1003,25.71135606,2006,-455168,58368,-396800,24
1609,330,22,8,0.17019082,0.82980918,547.5313313,604.0624576,947.6302051,1079.069697,1939,50.28526971,3878,-823808,168960,-654848,24
902,119,21,9,0.1165524,0.8834476,282.1621036,349.5291954,528.3991131,379.1176471,1021,37.3036171,2042,-461824,60928,-400896,24
3080,536,22,8,0.148230088,0.851769912,1054.235945,975.532762,1826.623701,1704.356343,3616,99.09564264,7232,-1576960,274432,-1302528,24
897,137,22,8,0.132495164,0.867504836,288.0360029,346.8957932,530.9241918,429.6058394,1034,19.29824561,2068,-459264,70144,-389120,24
4273,511,21,9,0.106814381,0.893185619,1382.934187,1130.391746,2478.961853,1669.502935,4784,89.38714499,9568,-2187776,261632,-1926144,24
1043,145,22,8,0.122053872,0.877946128,331.8793449,406.1760506,604.8811122,519.8275862,1188,22.69340974,2376,-534016,74240,-459776,24
1173,183,22,8,0.134955752,0.865044248,377.819159,468.0166723,683.8653026,644.1092896,1356,33.25159392,2712,-600576,93696,-506880,24
1935,239,22,8,0.109935603,0.890064397,622.6851322,580.3980486,1125.534884,779.5606695,2174,50.12681577,4348,-990720,122368,-868352,24
1057,145,22,8,0.12063228,0.87936772,334.8300494,401.5454287,619.5033113,470.262069,1202,25.71673085,2404,-541184,74240,-466944,24
815,95,20,10,0.104395604,0.895604396,258.0365816,262.7060993,471.409816,319.0105263,910,17.15686275,1820,-417280,48640,-368640,24
576,95,21,9,0.141579732,0.858420268,183.9116562,230.0794771,348.78125,258.5052632,671,20.0717918,1342,-294912,48640,-246272,24
2678,561,22,8,0.173201605,0.826798395,946.137151,876.2519472,1635.474608,1546.130125,3239,59.47484392,6478,-1371136,287232,-1083904,24
1000,178,22,8,0.151103565,0.848896435,330.2242203,385.8859393,599.566,532.9494382,1178,25.37152703,2356,-512000,91136,-420864,24
134,39,22,8,0.225433526,0.774566474,49.22143276,51.48061558,89.41044776,78.71794872,173,4.909194098,346,-68608,19968,-48640,24
793,102,21,9,0.11396648,0.88603352,250.8497699,279.8506696,464.3266078,321.0686275,895,32.97715549,1790,-406016,52224,-353792,24
708,112,20,10,0.136585366,0.863414634,231.3540798,226.6567362,431.5550847,277.4017857,820,31.49001536,1640,-362496,57344,-305152,24
1159,68,22,8,0.0554197229,0.944580277,346.7058804,395.8517761,627.7730802,379.25,1227,23.19470699,2454,-593408,34816,-558592,24
798,121,21,9,0.131664853,0.868335147,254.0350523,316.8369591,473.0651629,373.8347107,919,17.72420444,1838,-408576,61952,-346624,24
214,55,22,8,0.204460967,0.795539033,74.24723829,86.66838862,140.2850467,114.4363636,269,6.904517454,538,-109568,28160,-81408,24
810,143,22,8,0.150052466,0.849947534,263.6623518,329.9345755,483.817284,438.3846154,953,30.09156931,1906,-414720,73216,-341504,24
2142,197,22,8,0.0842240274,0.915775973,670.8771758,646.939386,1197.944444,866.1573604,2339,41.53053977,4678,-1096704,100864,-995840,24
1735,355,22,8,0.169856459,0.830143541,608.1943081,578.0734369,1051.520461,1016.076056,2090,36.73756372,4180,-888320,181760,-706560,24
892,171,22,8,0.160865475,0.839134525,295.6332144,358.9227988,536.3979821,509.0584795,1063,33.78893833,2126,-456704,87552,-369152,24
1725,364,22,8,0.174246051,0.825753949,603.5436674,600.5457044,1042.747826,1055.673077,2089,44.21164021,4178,-883200,186368,-696832,24
2818,569,21,9,0.167995276,0.832004724,985.8746771,933.8497803,1706.789212,1630.660808,3387,67.90296712,6774,-1442816,291328,-1151488,24
2745,678,22,8,0.198071867,0.801928133,931.1692747,1063.722911,1593.3898,2192.213864,3423,62.304332,6846,-1405440,347136,-1058304,24
2686,491,22,8,0.154548316,0.845451684,931.7440872,798.2265142,1628.790767,1371.325866,3177,84.51715882,6354,-1375232,251392,-1123840,24
1531,340,22,8,0.181721005,0.818278995,535.2545102,554.4617944,918.2475506,1015.938235,1871,49.32770894,3742,-783872,174080,-609792,24
72,24,22,8,0.25,0.75,28.12513032,25.5709457,50.43055556,42.70833333,96,1.682734443,192,-36864,12288,-24576,24
723,106,22,8,0.127864897,0.872135103,229.7729167,273.3774835,430.6431535,308.3018868,829,22.78098379,1658,-370176,54272,-315904,24
748,109,23,7,0.127187865,0.872812135,236.6032618,275.3853625,448.8262032,292.9449541,857,16.19119592,1714,-382976,55808,-327168,24
2527,326,22,8,0.114265685,0.885734315,818.6639687,834.4371797,1452.676692,1227.966258,2853,63.91129032,5706,-1293824,166912,-1126912,24
5756,714,23,7,0.110355487,0.889644513,1847.510867,1943.247832,3301.448923,2703.844538,6470,166.4951107,12940,-2947072,365568,-2581504,24
1223,136,22,8,0.100073584,0.899926416,381.3149951,424.9106847,703.5519215,468.2058824,1359,32.37255836,2718,-626176,69632,-556544,24
680,93,22,8,0.120310479,0.879689521,214.7226349,215.6822864,409.3073529,223.8924731,773,20.77956989,1546,-348160,47616,-300544,24
1705,257,23,7,0.130988787,0.869011213,567.0491087,536.9805062,1004.764223,827.1595331,1962,41.47991543,3924,-872960,131584,-741376,24
1178,141,23,7,0.106899166,0.893100834,372.3121502,412.3201019,678.9745331,501.4751773,1319,31.03529412,2638,-603136,72192,-530944,24
101,34,23,7,0.251851852,0.748148148,37.90815652,40.94220122,70.68316832,60.02941176,135,4.560810811,270,-51712,17408,-34304,24
1199,142,22,8,0.105891126,0.894108874,375.8500835,424.5292902,694.0025021,476.7746479,1341,29.72074468,2682,-613888,72704,-541184,24
1308,150,23,7,0.102880658,0.897119342,413.8323088,441.6085257,749.3769113,556.1733333,1458,26.2560778,2916,-669696,76800,-592896,24
2417,296,23,7,0.109104313,0.890895687,778.3726951,770.7240897,1389.814646,1089.050676,2713,59.78404584,5426,-1237504,151552,-1085952,24
720,106,23,7,0.128329298,0.871670702,231.9658154,240.2191935,432.8680556,281.9433962,826,14.52180028,1652,-368640,54272,-314368,24
741,106,23,7,0.12514758,0.87485242,231.7604022,313.0518374,432.6950067,363.2169811,847,16.97054698,1694,-379392,54272,-325120,24
677,100,23,7,0.128700129,0.871299871,218.4567279,233.3715105,404.9394387,281.09,777,15.54,1554,-346624,51200,-295424,24
2084,273,23,7,0.115825202,0.884174798,677.6473283,651.9362964,1210.775432,936.4358974,2357,48.13150909,4714,-1067008,139776,-927232,24
94,34,23,7,0.265625,0.734375,34.9388394,41.78309454,65.85106383,60.76470588,128,3.723094823,256,-48128,17408,-30720,24
4607,672,23,7,0.127296837,0.872703163,1505.075555,1636.909785,2665.156284,2467.537202,5279,115.463692,10558,-2358784,344064,-2014720,24
1214,146,23,7,0.107352941,0.892647059,381.9413042,449.9273532,696.7018122,545.7808219,1360,31.25,2720,-621568,74752,-546816,24
890,137,23,7,0.133398247,0.866601753,286.3380847,336.9625327,530.1539326,409.0583942,1027,14.49541284,2054,-455680,70144,-385536,24
876,128,22,8,0.12749004,0.87250996,279.1978576,324.8015586,521.7579909,370.703125,1004,15.0434522,2008,-448512,65536,-382976,24
2448,181,22,8,0.0688474705,0.931152529,747.7057478,852.690294,1334.867647,1046.292818,2629,52.0800317,5258,-1253376,92672,-1160704,24
2469,189,22,8,0.0711060948,0.928893905,760.124935,836.7084298,1342.656946,1157.624339,2658,108.5784314,5316,-1264128,96768,-1167360,24
1429,105,22,8,0.0684485007,0.931551499,433.621114,497.3998943,784.6536039,534.047619,1534,61.38455382,3068,-731648,53760,-677888,24
2478,165,22,8,0.0624290579,0.937570942,754.2833711,830.6377256,1341.348668,1031.418182,2643,58.26719577,5286,-1268736,84480,-1184256,24
3086,363,22,8,0.105247898,0.894752102,997.0789563,983.161264,1722.993519,1742.057851,3449,106.0252075,6898,-1580032,185856,-1394176,24
1494,119,21,9,0.0737755735,0.926224427,452.8709382,575.7701662,820.8125837,633.5882353,1613,29.18928701,3226,-764928,60928,-704000,24
2517,186,22,8,0.0688124306,0.931187569,773.2298132,837.7163297,1368.796583,1124.704301,2703,67.45695034,5406,-1288704,95232,-1193472,24
1633,144,22,8,0.081035453,0.918964547,499.4718513,615.5070092,905.7660747,698.8680556,1777,31.02304469,3554,-836096,73728,-762368,24
2914,320,22,8,0.0989486704,0.90105133,922.4328328,1027.585765,1610.946122,1677.18125,3234,80.66849588,6468,-1491968,163840,-1328128,24
2848,342,21,9,0.107210031,0.892789969,913.8848133,976.9455615,1593.325492,1613.608187,3190,68.70557829,6380,-1458176,175104,-1283072,24
3129,379,22,8,0.108038769,0.891961231,999.2036851,1100.35225,1732.07063,1939.675462,3508,77.79995564,7016,-1602048,194048,-1408000,24
34,20,22,8,0.37037037,0.62962963,16.13502713,14.30131113,26.11764706,29.85,54,1.932021467,108,-17408,10240,-7168,24
2373,174,22,8,0.0683156655,0.931684335,725.8918059,782.9239467,1297.919933,947.7816092,2547,45.69429494,5094,-1214976,89088,-1125888,24
1385,95,22,8,0.0641891892,0.935810811,418.4365638,457.4271042,759.4801444,463.7894737,1480,46.04853765,2960,-709120,48640,-660480,24
3086,380,22,8,0.109636469,0.890363531,992.8063231,1059.788087,1726.857421,1787.444737,3466,76.73234448,6932,-1580032,194560,-1385472,24
2888,352,22,8,0.108641975,0.891358025,925.8589444,1007.803595,1613.780471,1675.630682,3240,79.82261641,6480,-1478656,180224,-1298432,24
1805,149,22,8,0.0762538383,0.923746162,554.7282037,642.3459033,991.7357341,805.0469799,1954,35.15020687,3908,-924160,76288,-847872,24
2464,179,22,8,0.0677260689,0.932273931,753.4231902,856.0135186,1337.46388,1109.134078,2643,93.85653409,5286,-1261568,91648,-1169920,24
2875,341,21,9,0.106032338,0.893967662,920.787508,988.027219,1601.36487,1668.656891,3216,79.72235994,6432,-1472000,174592,-1297408,24
2878,331,22,8,0.103147398,0.896852602,910.4821409,1038.471961,1585.130994,1777.758308,3209,78.34472656,6418,-1473536,169472,-1304064,24
9491,479,21,9,0.0480441324,0.951955868,2844.998086,3211.440138,5050.131388,3704.881002,9970,612.4078624,19940,-4859392,245248,-4614144,24
9495,471,22,8,0.0472606863,0.952739314,2852.644054,3318.415537,4996.377988,4723.889597,9966,398.7995198,19932,-4861440,241152,-4620288,24
9517,454,21,9,0.0455320429,0.954467957,2845.947023,3205.32738,5050.287801,3638.363436,9971,804.1129032,19942,-4872704,232448,-4640256,24
4193,223,21,9,0.0504981884,0.949501812,1254.203243,1535.752242,2234.175531,1725.730942,4416,95.93743211,8832,-2146816,114176,-2032640,24
8704,345,22,8,0.0381257598,0.96187424,2594.918075,2907.746279,4556.144072,3739.266667,9049,301.9352686,18098,-4456448,176640,-4279808,24
114,36,21,9,0.24,0.76,44.4157067,39.29057429,76.77192982,71.47222222,150,5.530973451,300,-58368,18432,-39936,24
8206,375,21,9,0.0437012003,0.9562988,2452.42005,2825.779246,4331.360102,3407.813333,8581,185.0150927,17162,-4201472,192000,-4009472,24
7680,464,21,9,0.0569744597,0.94302554,2316.349075,2623.019971,4139.942578,2956.209052,8144,98.64341085,16288,-3932160,237568,-3694592,24
7975,449,21,9,0.053300095,0.946699905,2399.641758,2673.78801,4280.12815,3011.309577,8424,121.7869018,16848,-4083200,229888,-3853312,24
6962,445,21,9,0.0600783043,0.939921696,2109.101906,2297.793225,3772.636168,2630.191011,7407,98.22304734,14814,-3564544,227840,-3336704,24
9522,449,21,9,0.0450305887,0.954969411,2855.844458,3138.260196,5035.988448,3925.888641,9971,701.1954993,19942,-4875264,229888,-4645376,24
6301,321,21,9,0.048474781,0.951525219,1892.169439,2117.666362,3350.661482,2542.788162,6622,135.8916479,13244,-3226112,164352,-3061760,24
9491,477,21,9,0.04785313,0.95214687,2844.535744,3206.79605,5049.397113,3693.224319,9968,467.5422139,19936,-4859392,244224,-4615168,24
9486,484,21,9,0.0485456369,0.951454363,2858.974866,3082.389441,5033.540164,4043.952479,9970,546.9007131,19940,-4856832,247808,-4609024,24
9551,423,22,8,0.0424102667,0.957589733,2851.374369,3161.989763,5047.211287,3639.267139,9974,198.2114467,19948,-4890112,216576,-4673536,24
9131,490,21,9,0.0509302567,0.949069743,2744.214534,3156.811665,4867.230752,3763.157143,9621,173.6329182,19242,-4675072,250880,-4424192,24
9430,534,21,9,0.0535929346,0.946407065,2838.981376,3371.640168,5027.859173,4181.494382,9964,380.5958747,19928,-4828160,273408,-4554752,24
9487,483,21,9,0.048445336,0.951554664,2845.923702,3178.468495,5052.080742,3677.732919,9970,404.9553209,19940,-4857344,247296,-4610048,24
6830,321,22,8,0.0448888267,0.955111173,2039.842884,2290.166933,3625.334114,2526.305296,7151,325.1932697,14302,-3496960,164352,-3332608,24
9497,474,21,9,0.0475378598,0.95246214,2842.676976,3221.121171,5054.919132,3605.14557,9971,633.8842975,19942,-4862464,242688,-4619776,24
2134,239,22,8,0.100716393,0.899283607,681.3876278,690.7130254,1207.309278,1005.661088,2373,43.87132557,4746,-1092608,122368,-970240,24
2341,249,23,7,0.0961389961,0.903861004,741.5878577,791.3291315,1309.046134,1168.144578,2590,52.92194524,5180,-1198592,127488,-1071104,24
2675,428,23,7,0.137931034,0.862068966,888.9336959,928.5118078,1532.986916,1670.831776,3103,59.91504151,6206,-1369600,219136,-1150464,24
2432,310,21,9,0.113056163,0.886943837,796.3356052,747.6818315,1360.851563,1455.03871,2742,53.46071359,5484,-1245184,158720,-1086464,24
4608,579,22,8,0.111625217,0.888374783,1510.744853,1380.492025,2608.903863,2475.386874,5187,108.7421384,10374,-2359296,296448,-2062848,24
2424,364,23,7,0.130559541,0.869440459,805.5683904,796.5364669,1384.291254,1462.483516,2788,67.85105865,5576,-1241088,186368,-1054720,24
749,88,23,7,0.105137395,0.894862605,240.3263467,212.5557766,434.1214953,290.2954545,837,17.26841345,1674,-383488,45056,-338432,24
2477,397,22,8,0.138135003,0.861864997,824.1292208,848.8700138,1414.100121,1583.498741,2874,53.40022297,5748,-1268224,203264,-1064960,24
2460,356,23,7,0.126420455,0.873579545,804.6509982,865.134711,1399.25813,1472.36236,2816,53.39400834,5632,-1259520,182272,-1077248,24
2800,438,21,9,0.135268684,0.864731316,929.5955861,934.563846,1583.425,1850.116438,3238,65.53329286,6476,-1433600,224256,-1209344,24
3829,504,23,7,0.11631664,0.88368336,1257.878585,1184.148008,2187.710107,2009.660714,4333,90.93389297,8666,-1960448,258048,-1702400,24
2093,227,22,8,0.0978448276,0.902155172,668.8824277,666.4768034,1173.013856,1045.118943,2320,47.17364782,4640,-1071616,116224,-955392,24
2969,494,21,9,0.142650881,0.857349119,1000.582797,989.6923055,1717.349276,1820.052632,3463,63.25114155,6926,-1520128,252928,-1267200,24
2459,363,21,9,0.128632176,0.871367824,809.5522982,841.8001997,1397.045547,1509.415978,2822,49.72687225,5644,-1259008,185856,-1073152,24
3703,361,23,7,0.0888287402,0.91117126,1173.890501,1121.047796,2062.276262,1727.066482,4064,75.65152643,8128,-1895936,184832,-1711104,24
2646,423,23,7,0.137829912,0.862170088,880.1988857,913.6951101,1517.735072,1642.997636,3069,55.14824798,6138,-1354752,216576,-1138176,24
2839,470,23,7,0.142036869,0.857963131,950.498963,975.9325114,1636.581543,1766.255319,3309,60.78251286,6618,-1453568,240640,-1212928,24
2620,418,22,8,0.13759052,0.86240948,865.9543163,932.8293642,1498.775573,1649.399522,3038,54.51282971,6076,-1341440,214016,-1127424,24
1431,167,22,8,0.104505632,0.895494368,455.8834474,503.5321703,794.7533194,840.1736527,1598,23.26732673,3196,-732672,85504,-647168,24
1201,170,23,7,0.123997082,0.876002918,384.6361465,466.5217531,683.3555371,704.6823529,1371,16.70932358,2742,-614912,87040,-527872,24
3950,607,24,6,0.133201668,0.866798332,1325.368574,1249.317318,2278.654937,2281.24547,4557,113.4993773,9114,-2022400,310784,-1711616,24
1565,148,24,6,0.0863981319,0.913601868,478.7315813,608.3488774,874.3220447,673.8310811,1713,45.05523409,3426,-801280,75776,-725504,24
1586,167,22,8,0.0952652596,0.90473474,488.9699063,635.5198163,888.6696091,766.1736527,1753,42.63132296,3506,-812032,85504,-726528,24
3310,458,25,5,0.121549894,0.878450106,1104.376635,958.8385829,1883.886405,1888.934498,3768,93.08300395,7536,-1694720,234496,-1460224,24
1495,128,23,7,0.078866297,0.921133703,456.5237964,559.6314581,827.5759197,630.078125,1623,35.35177521,3246,-765440,65536,-699904,24
3462,479,24,6,0.121542756,0.878457244,1155.00773,1000.590503,1980.869728,1899.665971,3941,98.89585947,7882,-1772544,245248,-1527296,24
1619,165,24,6,0.0924887892,0.907511211,499.2205747,621.4960275,910.9104385,711.8545455,1784,37.48686699,3568,-828928,84480,-744448,24
2072,165,25,5,0.0737594993,0.926240501,634.8964916,726.4057271,1138.412162,875.230303,2237,47.57549979,4474,-1060864,84480,-976384,24
2729,460,23,7,0.144245845,0.855754155,913.895535,932.9720028,1560.187981,1801.526087,3189,56.36267232,6378,-1397248,235520,-1161728,24
1634,165,22,8,0.0917176209,0.908282379,503.6362004,643.3057751,911.7105263,784.030303,1799,31.62242925,3598,-836608,84480,-752128,24
215,51,24,6,0.191729323,0.808270677,75.73193652,77.409788,138.6465116,111.8039216,266,6.216405702,532,-110080,26112,-83968,24
200,71,24,6,0.26199262,0.73800738,78.08111103,70.72915783,146.49,106.4507042,271,9.897735573,542,-102400,36352,-66048,24
1642,157,23,7,0.0872707059,0.912729294,503.9591705,644.939648,912.3288672,771.0573248,1799,48.64791779,3598,-840704,80384,-760320,24
1719,180,24,6,0.0947867299,0.90521327,530.0567372,657.7727696,973.2827225,727.65,1899,33.80808261,3798,-880128,92160,-787968,24
1542,144,24,6,0.0854092527,0.914590747,471.3743459,601.4925212,859.5719844,671.3958333,1686,39.73603582,3372,-789504,73728,-715776,24
118,43,25,5,0.267080745,0.732919255,46.11026217,45.05167996,85.66101695,68.20930233,161,2.834507042,322,-60416,22016,-38400,24
2936,473,23,7,0.138750367,0.861249633,984.7286596,960.1919124,1675.584469,1887.587738,3409,66.93500884,6818,-1503232,242176,-1261056,24
4216,677,24,6,0.138360924,0.861639076,1426.234156,1321.08199,2434.666034,2523.809453,4893,104.3283582,9786,-2158592,346624,-1811968,24
3472,500,22,8,0.125881168,0.874118832,1164.262982,1014.6473,1992.628168,1943.946,3972,117.8984862,7944,-1777664,256000,-1521664,24
249,57,24,6,0.18627451,0.81372549,84.36116665,101.5839044,158.0281124,133.7192982,306,6.386975579,612,-127488,29184,-98304,24
3664,558,22,8,0.132164851,0.867835149,1231.82962,1127.489465,2102.172489,2172.747312,4222,89.50604198,8444,-1875968,285696,-1590272,24
1752,171,22,8,0.0889235569,0.911076443,542.7284,655.5224434,974.4497717,834.4444444,1923,37.529274,3846,-897024,87552,-809472,24
3401,564,22,8,0.142244641,0.857755359,1142.395575,1150.822833,1963.532196,2100.393617,3965,80.58943089,7930,-1741312,288768,-1452544,24
1854,183,22,8,0.0898379971,0.910162003,576.3280877,676.4661703,1034.25027,864.4972678,2037,40.13002364,4074,-949248,93696,-855552,24
3112,500,22,8,0.138427464,0.861572536,1042.462348,1028.688294,1779.811375,1972.61,3612,80.05319149,7224,-1593344,256000,-1337344,24
5509,594,22,8,0.0973291824,0.902670818,1779.565784,1427.110842,3123.212017,2391.550505,6103,117.7730606,12206,-2820608,304128,-2516480,24
1984,227,22,8,0.102668476,0.897331524,625.2192585,736.4634088,1116.289819,1016.066079,2211,39.44692239,4422,-1015808,116224,-899584,24
1526,138,22,8,0.0829326923,0.917067308,475.5938135,475.2706204,852.8453473,607.5217391,1664,40.80431584,3328,-781312,70656,-710656,24
196,23,23,7,0.105022831,0.894977169,62.15109421,71.64858581,110.2295918,108.0434783,219,5.438291532,438,-100352,11776,-88576,24
4577,635,22,8,0.121834229,0.878165771,1523.845361,1352.606384,2621.636006,2497.401575,5212,109.9810087,10424,-2343424,325120,-2018304,24
5506,590,22,8,0.0967847769,0.903215223,1773.499815,1449.369927,3123.554849,2348.072881,6096,117.3210162,12192,-2819072,302080,-2516992,24
3960,558,22,8,0.123505976,0.876494024,1312.987989,1239.979362,2255.570707,2287.385305,4518,88.08734646,9036,-2027520,285696,-1741824,24
3324,551,22,8,0.142193548,0.857806452,1110.29384,1153.108564,1909.880566,2107.635209,3875,67.74475524,7750,-1701888,282112,-1419776,24
114,17,22,8,0.129770992,0.870229008,36.08183497,44.28900056,68.51754386,49.11764706,131,11.68599465,262,-58368,8704,-49664,24
3579,572,22,8,0.137798121,0.862201879,1202.165611,1171.054385,2064.194747,2149.865385,4151,79.15713196,8302,-1832448,292864,-1539584,24
1775,170,22,8,0.087403599,0.912596401,551.0331001,643.1957733,986.8214085,828.6882353,1945,43.57078853,3890,-908800,87040,-821760,24
3789,558,22,8,0.128364389,0.871635611,1269.561104,1149.581811,2179.042491,2139.759857,4347,89.31580029,8694,-1939968,285696,-1654272,24
1805,187,22,8,0.093875502,0.906124498,557.098001,703.8682563,1013.952355,828.0427807,1992,37.784522,3984,-924160,95744,-828416,24
133,22,22,8,0.141935484,0.858064516,43.69285564,50.24931643,78.95488722,72.22727273,155,1.868595539,310,-68096,11264,-56832,24
136,22,22,8,0.139240506,0.860759494,44.27801246,52.52439418,80.67647059,72.22727273,158,1.838705923,316,-69632,11264,-58368,24
1459,143,23,7,0.0892634207,0.910736579,446.5817751,595.0778528,809.3214531,721.6993007,1602,31.60386664,3204,-747008,73216,-673792,24
2700,519,23,7,0.161230196,0.838769804,917.0262987,945.3690813,1558.033704,1880.344894,3219,82.09640398,6438,-1382400,265728,-1116672,24
1534,147,24,6,0.0874479477,0.912552052,468.3309606,622.0745554,852.9335072,716.4693878,1681,34.69556244,3362,-785408,75264,-710144,24
1412,130,22,8,0.084306096,0.915693904,432.0400651,550.5343172,783.9093484,636.7153846,1542,38.90010091,3084,-722944,66560,-656384,24
1520,143,24,6,0.0859891762,0.914010824,463.025611,624.3290522,841.6473684,729.4545455,1663,33.773355,3326,-778240,73216,-705024,24
2133,369,22,8,0.147482014,0.852517986,699.6294299,795.7147935,1207.886545,1503.607046,2502,61.64079823,5004,-1092096,188928,-903168,24
1329,124,23,7,0.0853406745,0.914659326,406.094771,493.7425743,747.0075245,512.5645161,1453,53.1261426,2906,-680448,63488,-616960,24
2141,376,22,8,0.149384188,0.850615812,706.8252802,778.7131746,1212.361513,1524.566489,2517,53.37150127,5034,-1096192,192512,-903680,24
1899,342,23,7,0.152610442,0.847389558,605.3932492,794.786748,1075.420221,1374.087719,2241,74.8496994,4482,-972288,175104,-797184,24
2866,575,22,8,0.167102586,0.832897414,982.136403,1007.573352,1668.654571,1981.907826,3441,66.63439194,6882,-1467392,294400,-1172992,24
95,36,23,7,0.27480916,0.72519084,35.65445118,42.9944728,66.21052632,65.44444444,131,3.809246874,262,-48640,18432,-30208,24
1999,344,24,6,0.146820316,0.853179684,642.2471385,795.5780553,1125.396698,1442.813953,2343,85.26200873,4686,-1023488,176128,-847360,24
2079,374,24,6,0.152466368,0.847533632,677.8252922,793.8139895,1173.414141,1524.874332,2453,51.09352218,4906,-1064448,191488,-872960,24
2799,646,23,7,0.187518142,0.812481858,997.1500615,916.8376282,1649.325116,2042.219814,3445,85.69651741,6890,-1433088,330752,-1102336,24
2687,509,23,7,0.159261577,0.840738423,923.2070352,887.9294326,1557.059546,1817.263261,3196,86.75352877,6392,-1375744,260608,-1115136,24
2120,383,23,7,0.15301638,0.84698362,699.1240409,807.6223974,1213.289623,1466.27154,2503,45.16420065,5006,-1085440,196096,-889344,24
1907,336,23,7,0.149799376,0.850200624,609.2292143,787.5301176,1078.403776,1369.434524,2243,68.17629179,4486,-976384,172032,-804352,24
400,72,24,6,0.152542373,0.847457627,133.1302839,106.0339306,254.65,135.6666667,472,8.673281882,944,-204800,36864,-167936,24
2520,476,22,8,0.158878505,0.841121495,853.8830892,887.7242443,1456.09246,1723.010504,2996,77.21649485,5992,-1290240,243712,-1046528,24
1471,150,22,8,0.0925354719,0.907464528,450.3817798,597.2994842,824.8565602,675.1133333,1621,32.05457781,3242,-753152,76800,-676352,24
2853,233,24,6,0.0755022683,0.924497732,887.8498936,926.5199734,1541.660358,1566.025751,3086,258.0267559,6172,-1460736,119296,-1341440,25
3714,290,24,6,0.0724275724,0.927572428,1138.253394,1331.032767,1981.030964,2277.451724,4004,289.9348298,8008,-1901568,148480,-1753088,25
3734,282,24,6,0.0702191235,0.929780876,1157.088794,1186.85215,2012.999197,1948.925532,4016,70.91647537,8032,-1911808,144384,-1767424,25
2864,230,24,6,0.0743374273,0.925662573,892.2508933,903.6285218,1544.586941,1583.773913,3094,220.3703704,6188,-1466368,117760,-1348608,25
2990,241,24,6,0.0745899102,0.92541009,932.2626258,938.2311526,1616.164214,1613.962656,3231,67.6790951,6462,-1530880,123392,-1407488,25
2882,231,23,7,0.074204947,0.925795053,897.9863865,904.2184105,1551.695697,1623.177489,3113,273.7906772,6226,-1475584,118272,-1357312,25
2795,230,24,6,0.0760330579,0.923966942,874.105639,856.4711062,1504.827191,1612.317391,3025,267.9362267,6050,-1431040,117760,-1313280,25
3257,248,23,7,0.0707560628,0.929243937,1010.382119,1025.043979,1745.350936,1853.455645,3505,184.6680717,7010,-1667584,126976,-1540608,25
4198,306,23,7,0.0679396092,0.932060391,1284.317873,1476.791225,2233.556694,2512.382353,4504,364.6963563,9008,-2149376,156672,-1992704,25
2837,226,23,7,0.073783872,0.926216128,883.7831329,884.0184894,1524.388086,1627.553097,3063,152.7680798,6126,-1452544,115712,-1336832,25
2905,240,24,6,0.0763116057,0.923688394,907.3236137,914.3014161,1571.053356,1596.5625,3145,233.3086053,6290,-1487360,122880,-1364480,25
4080,305,23,7,0.0695553022,0.930444698,1247.650956,1466.83295,2174.996078,2433.839344,4385,376.7182131,8770,-2088960,156160,-1932800,25
2978,237,23,7,0.0737169518,0.926283048,928.4256908,919.0412752,1600.775688,1698.776371,3215,167.5351746,6430,-1524736,121344,-1403392,25
3327,255,23,7,0.0711892797,0.92881072,1033.536586,1036.717442,1784.947099,1876.996078,3582,275.5384615,7164,-1703424,130560,-1572864,25
3931,310,23,7,0.0730959679,0.926904032,1208.86969,1392.399991,2106.743831,2301.777419,4241,319.8340875,8482,-2012672,158720,-1853952,25
3419,254,23,7,0.0691532807,0.930846719,1057.483098,1097.479967,1836.015209,1850.255906,3673,306.5943239,7346,-1750528,130048,-1620480,25
3861,292,24,6,0.0703106188,0.929689381,1182.495408,1362.204559,2054.263921,2377.630137,4153,84.56526166,8306,-1976832,149504,-1827328,25
2962,226,24,6,0.0708908407,0.929109159,923.6417667,866.0480587,1585.180959,1716.637168,3188,190.2147971,6376,-1516544,115712,-1400832,25
3419,260,23,7,0.0706713781,0.929328622,1061.565345,1068.147204,1839.201521,1850.5,3679,246.2516734,7358,-1750528,133120,-1617408,25
3047,248,23,7,0.0752655539,0.924734446,948.8484182,979.4312743,1647.911388,1649.08871,3295,174.2464305,6590,-1560064,126976,-1433088,25
199,35,24,6,0.14957265,0.85042735,66.30210359,72.58641015,120.0301508,103.1142857,234,31.24165554,468,-101888,17920,-83968,25
208,39,22,8,0.157894737,0.842105263,69.58303923,79.49892386,125.2836538,117.1538462,247,55.38116592,494,-106496,19968,-86528,25
211,42,23,7,0.166007905,0.833992095,70.68765675,82.97273,129.1800948,116.047619,253,37.20588235,506,-108032,21504,-86528,25
204,48,24,6,0.19047619,0.80952381,70.37739806,75.48507199,133.3088235,97.5625,252,52.0661157,504,-104448,24576,-79872,25
205,38,24,6,0.156378601,0.843621399,69.10634004,73.67225937,124.8243902,106.7631579,243,53.17286652,486,-104960,19456,-85504,25
205,49,22,8,0.192913386,0.807086614,72.9921225,72.98602903,130.9073171,113.244898,254,25.83926755,508,-104960,25088,-79872,25
201,42,23,7,0.172839506,0.827160494,69.01473206,73.31238105,125.2935323,106.2380952,243,48.89336016,486,-102912,21504,-81408,25
207,44,23,7,0.175298805,0.824701195,70.30137363,80.30616775,129.0434783,111.6818182,251,35.70412518,502,-105984,22528,-83456,25
198,53,22,8,0.211155378,0.788844622,71.80847528,70.75125023,131.7929293,104.3584906,251,60.7748184,502,-101376,27136,-74240,25
208,44,24,6,0.174603175,0.825396825,71.42925326,77.23512454,129.375,112.9090909,252,36.78832117,504,-106496,22528,-83968,25
164,44,23,7,0.211538462,0.788461538,59.05603963,52.65450994,112.9939024,72.84090909,208,10.36372696,416,-83968,22528,-61440,25
55,32,23,7,0.367816092,0.632183908,22.22563482,28.21651777,40.14545455,50.625,87,3.067700987,174,-28160,16384,-11776,25
204,36,24,6,0.15,0.85,67.9819635,75.78272121,121.8382353,112.9166667,240,39.08794788,480,-104448,18432,-86016,25
206,48,24,6,0.188976378,0.811023622,72.22144524,75.08962238,131.8300971,108.9166667,254,48.84615385,508,-105472,24576,-80896,25
203,44,24,6,0.178137652,0.821862348,69.95288972,77.02537952,122.9162562,129,247,4.377880184,494,-103936,22528,-81408,25
205,49,22,8,0.192913386,0.807086614,71.81256355,74.37851347,133.4243902,102.7142857,254,38.3107089,508,-104960,25088,-79872,25
210,42,24,6,0.166666667,0.833333333,70.30146052,81.83579946,129.8809524,109.5952381,252,32.8125,504,-107520,21504,-86016,25
211,51,23,7,0.194656489,0.805343511,74.64016898,78.49145738,134.3791469,119.5882353,262,50.57915058,524,-108032,26112,-81920,25
215,51,23,7,0.191729323,0.808270677,74.47382196,80.57401239,139.8232558,106.8431373,266,39.17525773,532,-110080,26112,-83968,25
213,53,22,8,0.19924812,0.80075188,74.64654175,82.45077067,137.9577465,115.5849057,266,23.43612335,532,-109056,27136,-81920,25
371,33,22,8,0.0816831683,0.918316832,113.8343018,123.2757516,208.8975741,130.5757576,404,89.57871397,808,-189952,16896,-173056,25
372,32,22,8,0.0792079208,0.920792079,114.5202981,115.2732487,208.8763441,128.375,404,75.51401869,808,-190464,16384,-174080,25
371,32,22,8,0.0794044665,0.920595533,114.4065697,114.7425404,208.1536388,130.65625,403,81.41414141,806,-189952,16384,-173568,25
370,34,22,8,0.0841584158,0.915841584,114.1877935,118.92867,209.0675676,131.0294118,404,60.56971514,808,-189440,17408,-172032,25
366,33,21,9,0.0827067669,0.917293233,112.8417516,118.7104107,206.1612022,131.6666667,399,57.99418605,798,-187392,16896,-170496,25
377,30,23,7,0.0737100737,0.926289926,115.5851731,122.3965504,209.0822281,140.1333333,407,67.60797342,814,-193024,15360,-177664,25
369,33,21,9,0.0820895522,0.917910448,113.3197412,121.8983077,207.9132791,129.7878788,402,38.43212237,804,-188928,16896,-172032,25
369,30,23,7,0.0751879699,0.92481203,113.2331814,121.0161789,205.00271,138.4666667,399,89.0625,798,-188928,15360,-173568,25
369,32,22,8,0.0798004988,0.920199501,113.9683754,110.4122955,207.4173442,127,401,75.09363296,802,-188928,16384,-172544,25
368,31,22,8,0.0776942356,0.922305764,113.0142864,121.3338288,205.375,136.1935484,399,66.16915423,798,-188416,15872,-172544,25
367,32,22,8,0.0802005013,0.919799499,112.5674969,121.3384302,206.1280654,129.71875,399,82.26804124,798,-187904,16384,-171520,25
368,34,22,8,0.0845771144,0.915422886,113.8197827,117.5237736,207.8722826,132.5294118,402,116.5217391,804,-188416,17408,-171008,25
372,34,21,9,0.0837438424,0.916256158,114.6989397,119.5179331,210.1639785,130.5882353,406,121.1940299,812,-190464,17408,-173056,25
372,31,23,7,0.0769230769,0.923076923,114.4351017,121.1630595,207.1370968,140.3548387,403,76.32575758,806,-190464,15872,-174592,25
367,33,21,9,0.0825,0.9175,113.0818114,119.8547407,206.613079,132.5151515,400,61.34969325,800,-187904,16896,-171008,25
369,30,23,7,0.0751879699,0.92481203,113.2381282,120.7012842,205.0406504,138,399,46.72131148,798,-188928,15360,-173568,25
370,34,21,9,0.0841584158,0.915841584,114.1134313,120.3296941,208.9783784,132,404,60.56971514,808,-189440,17408,-172032,25
366,29,23,7,0.0734177215,0.926582278,112.3215388,110.4135131,203.7486339,125.4482759,395,88.36689038,790,-187392,14848,-172544,25
317,34,22,8,0.0968660969,0.903133903,97.97508975,122.051807,180.0694006,138.0588235,351,5.629510826,702,-162304,17408,-144896,25
325,34,21,9,0.0947075209,0.905292479,101.2210654,115.5877264,184.5661538,136.3529412,359,5.683977201,718,-166400,17408,-148992,25
1780,110,23,7,0.0582010582,0.941798942,535.0113528,688.3468759,951.1696629,853.7545455,1890,88.48314607,3780,-911360,56320,-855040,25
1762,115,23,7,0.0612679808,0.938732019,528.5107003,701.1332019,948.0879682,799.7565217,1877,98.11813905,3754,-902144,58880,-843264,25
1711,103,22,8,0.0567805954,0.943219405,512.850218,652.8084141,918.2998247,728.0970874,1814,300.3311258,3628,-876032,52736,-823296,25
1779,111,24,6,0.0587301587,0.941269841,534.280229,695.0354019,951.6863406,846.3513514,1890,95.84178499,3780,-910848,56832,-854016,25
1711,105,23,7,0.0578193833,0.942180617,513.2554439,654.2204011,919.2255991,733.7238095,1816,31.50043365,3632,-876032,53760,-822272,25
1759,106,24,6,0.0568364611,0.943163539,527.5629531,670.3313219,943.4411597,759.7358491,1865,140.015015,3730,-900608,54272,-846336,25
1720,100,23,7,0.0549450549,0.945054945,515.8592265,647.8399552,919.7877907,750.75,1820,126.6527488,3640,-880640,51200,-829440,25
1775,101,23,7,0.0538379531,0.946162047,531.9238383,686.972637,941.5504225,884.8910891,1876,108.2515868,3752,-908800,51712,-857088,25
1780,115,22,8,0.0606860158,0.939313984,534.3768264,703.6724048,955.9320225,825.226087,1895,62.41765481,3790,-911360,58880,-852480,25
1781,104,24,6,0.0551724138,0.944827586,534.0399255,690.9747467,947.1617069,871.7307692,1885,105.1897321,3770,-911872,53248,-858624,25
1758,111,22,8,0.0593900482,0.940609952,527.464322,694.6888106,941.8367463,826.7207207,1869,102.9752066,3738,-900096,56832,-843264,25
1772,96,23,7,0.051391863,0.948608137,531.0773295,669.4719698,937.8194131,873.2291667,1868,129.0055249,3736,-907264,49152,-858112,25
1717,91,24,6,0.0503318584,0.949668142,513.8615014,651.8852419,908.1630751,835.3846154,1808,111.5360888,3616,-879104,46592,-832512,25
1709,93,24,6,0.051609323,0.948390677,510.6599241,657.3161886,908.8267993,766.8602151,1802,286.031746,3604,-875008,47616,-827392,25
1527,59,23,7,0.0372005044,0.962799496,454.3940705,522.6141382,798.5605763,662.5254237,1586,176.6146993,3172,-781824,30208,-751616,25
1759,100,22,8,0.0537923615,0.946207639,528.2379708,667.3198945,929.2450256,943.28,1859,72.90196078,3718,-900608,51200,-849408,25
1775,108,22,8,0.0573552841,0.942644716,532.635685,693.3816903,947.3464789,854.1296296,1883,70.57721139,3766,-908800,55296,-853504,25
1765,103,24,6,0.0551391863,0.944860814,530.8371689,666.4629314,936.0912181,907.2330097,1868,76.24489796,3736,-903680,52736,-850944,25
1743,98,24,6,0.0532319392,0.946768061,523.4835844,656.4885407,919.313253,951,1841,77.32045359,3682,-892416,50176,-842240,25
1723,97,23,7,0.0532967033,0.946703297,517.2853843,647.5578917,915.0110273,830.371134,1820,180.734856,3640,-882176,49664,-832512,25
104,26,23,7,0.2,0.8,37.70591272,29.83584279,70.31730769,46.23076923,130,36.11111111,260,-53248,13312,-39936,25
110,20,24,6,0.153846154,0.846153846,36.74262056,38.49347347,68.12727273,51.05,130,22.03389831,260,-56320,10240,-46080,25
103,26,23,7,0.201550388,0.798449612,37.4681264,30.4388027,69.46601942,47.30769231,129,34.21750663,258,-52736,13312,-39424,25
109,33,22,8,0.232394366,0.767605634,41.30774671,34.07769441,77.01834862,53.27272727,142,31.76733781,284,-55808,16896,-38912,25
106,29,24,6,0.214814815,0.785185185,39.0775181,33.5984188,72.59433962,51.20689655,135,19.45244957,270,-54272,14848,-39424,25
104,31,24,6,0.22962963,0.77037037,39.62745802,31.70063534,72.82692308,51.80645161,135,34.00503778,270,-53248,15872,-37376,25
106,22,23,7,0.171875,0.828125,36.34518781,35.7757305,67.76415094,48.77272727,128,18.20768137,256,-54272,11264,-43008,25
107,28,23,7,0.207407407,0.792592593,38.67959316,35.9821916,72.10280374,52.32142857,135,32.21957041,270,-54784,14336,-40448,25
120,26,23,7,0.178082192,0.821917808,42.33354331,38.19982109,76.56666667,59.34615385,146,36.68341709,292,-61440,13312,-48128,25
112,31,24,6,0.216783217,0.783216783,41.28450551,35.81740605,77.01785714,53.87096774,143,36.8556701,286,-57344,15872,-41472,25
118,29,23,7,0.197278912,0.802721088,42.48892584,37.32917493,78.33898305,56.34482759,147,33.33333333,294,-60416,14848,-45568,25
104,26,24,6,0.2,0.8,37.87732139,30.59924198,69.77884615,48.38461538,130,23.72262774,260,-53248,13312,-39936,25
111,33,23,7,0.229166667,0.770833333,41.52162044,37.98059047,77.00900901,57.33333333,144,31.16883117,288,-56832,16896,-39936,25
117,32,22,8,0.214765101,0.785234899,43.58621068,37.92256708,78.67521368,61.5625,149,34.33179724,298,-59904,16384,-43520,25
103,22,24,6,0.176,0.824,35.400279,37.94798528,64.84466019,54.36363636,125,2.188758536,250,-52736,11264,-41472,25
121,32,23,7,0.209150327,0.790849673,44.43760538,37.4206974,82.04132231,57.9375,153,13.52785146,306,-61952,16384,-45568,25
110,25,23,7,0.185185185,0.814814815,38.75365725,36.80860769,71.16363636,54.08,135,32.29665072,270,-56320,12800,-43520,25
120,29,22,8,0.194630872,0.805369128,43.07814604,39.93466722,78.3,61.34482759,149,26.46536412,298,-61440,14848,-46592,25
122,34,22,8,0.217948718,0.782051282,45.23123723,39.58071775,83.40983607,60.88235294,156,24.48979592,312,-62464,17408,-45056,25
117,30,22,8,0.204081633,0.795918367,42.64833254,37.75154154,77.99145299,58.43333333,147,35.16746411,294,-59904,15360,-44544,25
1518,164,22,8,0.0975029727,0.902497027,481.8284837,515.1072214,847.7944664,783.2378049,1682,147.027972,3364,-777216,83968,-693248,25
1893,165,24,6,0.0801749271,0.919825073,588.034382,658.0860458,1033.278394,986.1515152,2058,204.5725646,4116,-969216,84480,-884736,25
1910,171,24,6,0.0821720327,0.917827967,594.5964948,663.0718169,1045.809948,987.2748538,2081,127.4341702,4162,-977920,87552,-890368,25
1415,151,24,6,0.0964240102,0.90357599,452.5427106,447.3496727,784.9095406,770.2913907,1566,68.41415465,3132,-724480,77312,-647168,25
1891,163,24,6,0.0793573515,0.920642648,586.8704812,655.4985822,1033.321523,959.9631902,2054,148.6251809,4108,-968192,83456,-884736,25
1888,178,23,7,0.0861568248,0.913843175,588.9945864,664.7106596,1041.040784,953.5168539,2066,191.4735867,4132,-966656,91136,-875520,25
1397,172,24,6,0.109623964,0.890376036,446.0441525,502.3420132,778.5468862,837.4127907,1569,28.33664439,3138,-715264,88064,-627200,25
1522,151,24,6,0.0902570233,0.909742977,480.1085427,510.7018406,837.6222076,830.7284768,1673,121.7612809,3346,-779264,77312,-701952,25
1401,159,24,6,0.101923077,0.898076923,446.5297213,482.5519575,780.5210564,780.3144654,1560,145.3867661,3120,-717312,81408,-635904,25
1912,170,23,7,0.0816522574,0.918347743,594.1978814,670.717628,1046.239017,988.2,2082,168.4466019,4164,-978944,87040,-891904,25
1100,111,24,6,0.0916597853,0.908340215,348.8808921,353.3808684,610.52,561.2072072,1211,61.69128884,2422,-563200,56832,-506368,25
1899,180,23,7,0.0865800866,0.913419913,592.7350914,666.9505196,1048.473934,950.6,2079,203.8235294,4158,-972288,92160,-880128,25
1395,147,24,6,0.0953307393,0.904669261,442.4485837,469.6753648,770.0960573,784.8231293,1542,125.264013,3084,-714240,75264,-638976,25
1403,160,24,6,0.102367242,0.897632758,447.8430972,479.5161164,783.0926586,772.41875,1563,112.3652049,3126,-718336,81920,-636416,25
2047,178,22,8,0.08,0.92,634.1697848,723.1581105,1120.900342,1022.146067,2225,200.9936766,4450,-1048064,91136,-956928,25
2018,179,24,6,0.0814747383,0.918525262,626.8582019,703.9780046,1108.037166,997.1173184,2197,172.1786834,4394,-1033216,91648,-941568,25
1519,161,22,8,0.0958333333,0.904166667,481.6143167,515.1798626,842.5892034,820.7888199,1680,137.9310345,3360,-777728,82432,-695296,25
1432,162,23,7,0.101631117,0.898368883,461.8299756,437.1900008,806.402933,718.8024691,1594,73.18640955,3188,-733184,82944,-650240,25
909,104,22,8,0.10266535,0.89733465,286.0401161,342.300769,504.2574257,530.9711538,1013,48.74879692,2026,-465408,53248,-412160,25
1411,160,23,7,0.101845958,0.898154042,450.0008115,483.2241302,787.1445783,775.90625,1571,163.4755463,3142,-722432,81920,-640512,25
212,23,22,8,0.0978723404,0.90212766,66.26243091,76.04314266,120.8537736,91.69565217,235,50.97613883,470,-108544,11776,-96768,25
214,25,22,8,0.10460251,0.89539749,66.51935994,78.76624658,124.1728972,84.28,239,39.24466338,478,-109568,12800,-96768,25
212,25,22,8,0.105485232,0.894514768,66.76832841,76.81826866,121.8820755,94.56,237,54.35779817,474,-108544,12800,-95744,25
214,24,22,8,0.100840336,0.899159664,67.46068365,75.3200463,122.0093458,97.125,238,60.40609137,476,-109568,12288,-97280,25
218,24,22,8,0.0991735537,0.900826446,68.24195435,76.3174565,124.940367,90.25,242,51.27118644,484,-111616,12288,-99328,25
213,26,23,7,0.108786611,0.891213389,66.94272837,78.33565505,123.4694836,91.57692308,239,10.35080121,478,-109056,13312,-95744,25
213,25,22,8,0.105042017,0.894957983,66.60766284,78.24366045,123.0375587,89.36,238,89.47368421,476,-109056,12800,-96256,25
216,21,22,8,0.0886075949,0.911392405,67.3577446,76.26986935,120.712963,101.3809524,237,27.62237762,474,-110592,10752,-99840,25
216,25,22,8,0.10373444,0.89626556,67.67186055,77.16264381,124.6944444,89.08,241,26.02591793,482,-110592,12800,-97792,25
216,28,22,8,0.114754098,0.885245902,68.04477365,78.59340602,126.962963,88.07142857,244,42.95774648,488,-110592,14336,-96256,25
213,26,22,8,0.108786611,0.891213389,66.77441105,77.85702265,123.9342723,87.76923077,239,68.28571429,478,-109056,13312,-95744,25
211,27,22,8,0.113445378,0.886554622,66.55497266,77.36596445,123.3222749,89.62962963,238,52.42290749,476,-108032,13824,-94208,25
212,26,22,8,0.109243697,0.890756303,66.80890344,77.80213106,122.6933962,93.46153846,238,53.84615385,476,-108544,13312,-95232,25
210,23,22,8,0.0987124464,0.901287554,65.39892948,75.58295184,120.3952381,86,233,30.61760841,466,-107520,11776,-95744,25
217,27,23,7,0.110655738,0.889344262,68.7809667,75.14717156,126.5069124,90.2962963,244,28.87573964,488,-111104,13824,-97280,25
212,25,22,8,0.105485232,0.894514768,66.4158595,77.58160607,122.4339623,89.88,237,46.10894942,474,-108544,12800,-95744,25
213,25,23,7,0.105042017,0.894957983,67.0161145,77.60876239,122.3286385,95.4,238,36.39143731,476,-109056,12800,-96256,25
212,25,22,8,0.105485232,0.894514768,67.01709439,75.20280846,121.8018868,95.24,237,35.53223388,474,-108544,12800,-95744,25
212,31,22,8,0.127572016,0.872427984,67.47224486,83.16076478,125.1226415,100.6451613,243,3.820754717,486,-108544,15872,-92672,25
214,30,22,8,0.12295082,0.87704918,68.38956698,81.30360796,125.0514019,104.3,244,3.851010101,488,-109568,15360,-94208,25
1168,164,23,7,0.123123123,0.876876877,382.3373861,397.647898,671.7953767,628.7865854,1332,53.13123255,2664,-598016,83968,-514048,25
1165,169,23,7,0.126686657,0.873313343,382.6816709,398.3935344,674.055794,622.3076923,1334,53.68209256,2668,-596480,86528,-509952,25
1155,161,24,6,0.122340426,0.877659574,377.0513101,397.0094805,664.561039,615.0186335,1316,56.94504543,2632,-591360,82432,-508928,25
1134,159,24,6,0.122969838,0.877030162,368.8320942,403.2850296,645.6843034,656.3836478,1293,39.98144712,2586,-580608,81408,-499200,25
1125,158,24,6,0.12314887,0.87685113,366.0895417,399.375852,643.4355556,631.778481,1283,54.57252233,2566,-576000,80896,-495104,25
1133,163,24,6,0.125771605,0.874228395,368.5548244,410.689613,649.4104148,642.1717791,1296,47.19592134,2592,-580096,83456,-496640,25
1125,155,23,7,0.12109375,0.87890625,364.9260347,400.8734283,642.4888889,626.0645161,1280,48.54000758,2560,-576000,79360,-496640,25
1153,167,23,7,0.126515152,0.873484848,378.426666,394.0728167,668.6981787,603.8982036,1320,49.88662132,2640,-590336,85504,-504832,25
1134,156,24,6,0.120930233,0.879069767,369.7584693,390.4068233,648.2619048,625.4230769,1290,49.96127033,2580,-580608,79872,-500736,25
1145,167,24,6,0.127286585,0.872713415,374.3060924,407.8074974,657.3580786,650.6167665,1312,48.66468843,2624,-586240,85504,-500736,25
1124,159,24,6,0.123928293,0.876071707,367.8195072,385.3341887,647.9234875,600.1257862,1283,53.65955667,2566,-575488,81408,-494080,25
1147,168,22,8,0.127756654,0.872243346,376.4866843,398.0316116,663.7776809,618.5535714,1315,55.36842105,2630,-587264,86016,-501248,25
1126,160,23,7,0.124416796,0.875583204,367.0032919,395.637627,651.1127886,589.925,1286,52.59713701,2572,-576512,81920,-494592,25
1152,168,23,7,0.127272727,0.872727273,375.8717597,414.2260218,663.5434028,639.6309524,1320,56.53104925,2640,-589824,86016,-503808,25
1130,164,23,7,0.126738794,0.873261206,369.0257635,402.8923291,649.9982301,630.2865854,1294,53.71523454,2588,-578560,83968,-494592,25
1130,161,23,7,0.124709527,0.875290473,368.4109681,396.5434265,654.2663717,587.9813665,1291,45.9430605,2582,-578560,82432,-496128,25
1188,166,23,7,0.122599705,0.877400295,387.9407032,403.4975137,687.8644781,603.3253012,1354,46.05442177,2708,-608256,84992,-523264,25
1161,182,23,7,0.135517498,0.864482502,378.2620091,442.8940678,669.8484065,685.7252747,1343,23.64020419,2686,-594432,93184,-501248,25
1147,166,23,7,0.126428027,0.873571973,374.2563746,408.5077218,662.467306,619.2228916,1313,43.62126246,2626,-587264,84992,-502272,25
492,78,23,7,0.136842105,0.863157895,162.9657245,172.4723196,289.0772358,262.9358974,570,9.109797027,1140,-251904,39936,-211968,25
237,32,22,8,0.118959108,0.881040892,75.31732392,91.75372523,132.9662447,150.0625,269,23.03082192,538,-121344,16384,-104960,25
235,33,21,9,0.123134328,0.876865672,75.34768182,89.86740564,133.1702128,143.969697,268,29.87736901,536,-120320,16896,-103424,25
236,32,22,8,0.119402985,0.880597015,75.79236459,86.91895808,132.6737288,147.96875,268,34.22733078,536,-120832,16384,-104448,25
228,31,22,8,0.11969112,0.88030888,72.88911919,86.66773659,128.6184211,140.1612903,259,50.29126214,518,-116736,15872,-100864,25
232,33,20,10,0.124528302,0.875471698,74.47915062,89.13172637,132.0517241,139.6666667,265,50.28462998,530,-118784,16896,-101888,25
235,36,21,9,0.132841328,0.867158672,75.84235443,92.24879135,136.493617,132.7777778,271,39.50437318,542,-120320,18432,-101888,25
232,32,22,8,0.121212121,0.878787879,74.27338455,88.8928373,131.9439655,136.53125,264,34.73684211,528,-118784,16384,-102400,25
232,32,21,9,0.121212121,0.878787879,74.43770176,87.35093888,131.125,142.46875,264,49.43820225,528,-118784,16384,-102400,25
227,31,22,8,0.120155039,0.879844961,72.48544948,86.80657748,127.9030837,141.1935484,258,27.65273312,516,-116224,15872,-100352,25
232,37,22,8,0.137546468,0.862453532,75.19192397,91.44984295,135.75,130.2972973,269,34.98049415,538,-118784,18944,-99840,25
233,39,21,9,0.143382353,0.856617647,75.70253305,93.5617661,136.8969957,134.1282051,272,30.90909091,544,-119296,19968,-99328,25
230,31,22,8,0.118773946,0.881226054,73.6179706,86.00491238,129.2695652,143.8387097,261,66.24365482,522,-117760,15872,-101888,25
230,34,21,9,0.128787879,0.871212121,74.02207253,89.42265801,131.6869565,138,264,32.47232472,528,-117760,17408,-100352,25
237,32,21,9,0.118959108,0.881040892,75.63129058,90.99465558,134.1476793,141.3125,269,11.72624237,538,-121344,16384,-104960,25
190,29,21,9,0.132420091,0.867579909,59.33717076,84.11892097,110.8736842,104.2758621,219,34.00621118,438,-97280,14848,-82432,25
233,35,21,9,0.130597015,0.869402985,75.0938882,91.04547417,134.5879828,133.9142857,268,38.84057971,536,-119296,17920,-101376,25
228,40,20,10,0.149253731,0.850746269,73.746097,94.848692,132.8377193,143.975,268,4.692698302,536,-116736,20480,-96256,25
232,31,21,9,0.117870722,0.882129278,73.99067322,88.56460866,130.8362069,140.7096774,263,49.06716418,526,-118784,15872,-102912,25
230,34,21,9,0.128787879,0.871212121,73.87303278,90.42985104,132.726087,130.9705882,264,45.75389948,528,-117760,17408,-100352,25
190,30,21,9,0.136363636,0.863636364,59.46672642,84.7357002,110.3947368,111.1666667,220,3.419866314,440,-97280,15360,-81920,25
223,27,23,7,0.108,0.892,70.16239855,71.68164261,131.1345291,78.96296296,250,48.16955684,500,-114176,13824,-100352,25
224,30,23,7,0.118110236,0.881889764,71.26295182,71.70259564,133.7366071,80.93333333,254,57.72727273,508,-114688,15360,-99328,25
227,24,24,6,0.0956175299,0.90438247,70.18191127,84.84528403,129.3656388,94.16666667,251,51.75257732,502,-116224,12288,-103936,25
232,26,24,6,0.100775194,0.899224806,71.69177805,75.73622866,135.737069,73.84615385,258,45.58303887,516,-118784,13312,-105472,25
228,25,24,6,0.0988142292,0.901185771,72.10418253,70.47069178,131.1622807,89.04,253,43.92361111,506,-116736,12800,-103936,25
228,28,24,6,0.109375,0.890625,72.04141216,71.98929909,134.2807018,81.42857143,256,46.20938628,512,-116736,14336,-102400,25
225,28,23,7,0.110671937,0.889328063,71.01310413,70.66371749,133.0755556,78.17857143,253,56.22222222,506,-115200,14336,-100864,25
220,26,23,7,0.105691057,0.894308943,69.32289328,71.43652787,128.4318182,81.76923077,246,47.30769231,492,-112640,13312,-99328,25
228,24,24,6,0.0952380952,0.904761905,71.1350836,75.04330925,130.8201754,85.45833333,252,81.55339806,504,-116736,12288,-104448,25
253,30,23,7,0.106007067,0.893992933,80.27246813,74.28121491,148.2411067,89.36666667,283,64.7597254,566,-129536,15360,-114176,25
224,26,22,8,0.104,0.896,70.44514755,62.61638867,131.9107143,70.26923077,250,58.00464037,500,-114688,13312,-101376,25
228,25,24,6,0.0988142292,0.901185771,71.77704785,74.01701426,131.0526316,90.04,253,68.75,506,-116736,12800,-103936,25
230,32,23,7,0.122137405,0.877862595,73.77094576,70.76997703,138.2869565,82.71875,262,68.22916667,524,-117760,16384,-101376,25
238,30,23,7,0.111940299,0.888059701,75.619095,72.77256046,140.7941176,84.56666667,268,48.72727273,536,-121856,15360,-106496,25
244,24,24,6,0.0895522388,0.910447761,75.99679566,74.18079219,139.2991803,85.70833333,268,41.16743472,536,-124928,12288,-112640,25
223,29,23,7,0.115079365,0.884920635,71.19443454,62.46816074,133.3183857,74.06896552,252,33.02752294,504,-114176,14848,-99328,25
228,31,24,6,0.11969112,0.88030888,72.82945596,70.69160353,136.622807,81.29032258,259,41.84168013,518,-116736,15872,-100864,25
237,30,23,7,0.112359551,0.887640449,75.16085642,73.38732104,140.3755274,83.63333333,267,19.19482387,534,-121344,15360,-105984,25
225,31,23,7,0.12109375,0.87890625,72.00447668,68.78711372,135.2577778,79.4516129,256,53.78151261,512,-115200,15872,-99328,25
232,28,24,6,0.107692308,0.892307692,73.30622989,71.60559314,136.375,81.82142857,260,30.12746234,520,-118784,14336,-104448,25
845,68,21,9,0.0744797371,0.925520263,257.2396519,299.1097445,468.1928994,317.9117647,913,89.16015625,1826,-432640,34816,-397824,26
892,72,20,10,0.0746887967,0.925311203,271.7648649,314.1682554,494.3150224,336.125,964,136.7375887,1928,-456704,36864,-419840,26
917,63,20,10,0.0642857143,0.935714286,277.2637135,319.9816392,500.7121047,341.8571429,980,90.65679926,1960,-469504,32256,-437248,26
873,78,21,9,0.0820189274,0.917981073,269.6476697,287.384857,488.8442153,332.2435897,951,78.92116183,1902,-446976,39936,-407040,26
895,70,21,9,0.0725388601,0.92746114,272.3474733,312.3386274,494.6413408,334.1571429,965,100.3118503,1930,-458240,35840,-422400,26
890,77,20,10,0.0796277146,0.920372285,271.2666005,317.586072,497.6910112,325.7532468,967,76.6851705,1934,-455680,39424,-416256,26
966,75,20,10,0.0720461095,0.92795389,293.4531199,328.9044343,535.2142857,337.92,1041,134.1494845,2082,-494592,38400,-456192,26
919,59,21,9,0.0603271984,0.939672802,279.0480038,321.3810439,493.9303591,420.4915254,978,106.4200218,1956,-470528,30208,-440320,26
922,75,20,10,0.075225677,0.924774323,282.6431152,321.4605043,508.8091106,378.4133333,997,145.9736457,1994,-472064,38400,-433664,26
921,65,21,9,0.0659229209,0.934077079,280.1096731,321.5738162,501.514658,379.9384615,986,127.3901809,1972,-471552,33280,-438272,26
879,77,21,9,0.0805439331,0.919456067,268.0531001,313.7592602,492.2775882,321.2207792,956,101.9189765,1912,-450048,39424,-410624,26
955,70,21,9,0.0682926829,0.931707317,291.5245111,322.1712765,522.6900524,380.8,1025,134.5144357,2050,-488960,35840,-453120,26
912,85,20,10,0.0852557673,0.914744233,278.4634745,306.9869278,517.9879386,295.2705882,997,128.4793814,1994,-466944,43520,-423424,26
820,76,21,9,0.0848214286,0.915178571,250.3407606,291.5203969,463.2207317,289.6710526,896,13.93251438,1792,-419840,38912,-380928,26
798,71,21,9,0.081703107,0.918296893,244.2641794,281.552696,447.1641604,298.2816901,869,13.53582555,1738,-408576,36352,-372224,26
918,73,20,10,0.0736629667,0.926337033,278.8769173,322.2285571,509.0697168,331.6438356,991,96.4946446,1982,-470016,37376,-432640,26
973,85,21,9,0.0803402647,0.919659735,297.9489456,319.451786,546.8355601,331.0588235,1058,116.7770419,2116,-498176,43520,-454656,26
969,60,21,9,0.0583090379,0.941690962,294.0171244,324.908883,521.4685243,410.5333333,1029,116.5345413,2058,-496128,30720,-465408,26
865,63,21,9,0.067887931,0.932112069,262.5625594,327.7992291,468.4254335,410.6031746,928,16.14755525,1856,-442880,32256,-410624,26
975,83,21,9,0.0784499055,0.921550095,297.5341719,323.9387689,546.6779487,327.7108434,1058,111.6033755,2116,-499200,42496,-456704,26
212,30,24,6,0.123966942,0.876033058,69.177659,64.71603785,126.3867925,86.96666667,242,59.02439024,484,-108544,15360,-93184,26
215,27,23,7,0.111570248,0.888429752,68.40327781,67.33351668,126.7255814,79.88888889,242,26.5060241,484,-110080,13824,-96256,26
215,32,23,7,0.129554656,0.870445344,69.31397842,65.1082932,131.2465116,75.3125,247,63.01020408,494,-110080,16384,-93696,26
216,25,23,7,0.10373444,0.89626556,68.05916783,69.70389946,125.6203704,81.08,241,63.42105263,482,-110592,12800,-97792,26
215,21,24,6,0.0889830508,0.911016949,66.5276585,72.15676434,122.2744186,79.85714286,236,58.56079404,472,-110080,10752,-99328,26
215,27,24,6,0.111570248,0.888429752,68.81500428,67.50956849,126.0465116,85.2962963,242,47.63779528,484,-110080,13824,-96256,26
218,31,24,6,0.124497992,0.875502008,71.50890109,64.25157047,130,89.83870968,249,34.87394958,498,-111616,15872,-95744,26
227,27,23,7,0.106299213,0.893700787,72.65071811,69.38663273,131.6872247,92.2962963,254,41.03392569,508,-116224,13824,-102400,26
216,33,23,7,0.13253012,0.86746988,70.45946541,64.53486896,131.8611111,80.09090909,249,83.55704698,498,-110592,16896,-93696,26
215,33,23,7,0.133064516,0.866935484,69.90385052,64.55040527,131.6651163,77.81818182,248,53.10492505,496,-110080,16896,-93184,26
217,29,23,7,0.117886179,0.882113821,68.83925324,67.35468791,130.1198157,73.96551724,246,64.73684211,492,-111104,14848,-96256,26
219,36,23,7,0.141176471,0.858823529,72.48268297,64.64594934,135.2146119,84.11111111,255,58.21917808,510,-112128,18432,-93696,26
213,24,24,6,0.101265823,0.898734177,66.79641675,69.75209077,123.4788732,79.25,237,43.24817518,474,-109056,12288,-96768,26
229,30,23,7,0.115830116,0.884169884,73.65482417,67.36883553,135.9213974,84.8,259,50.88408644,518,-117248,15360,-101888,26
213,29,24,6,0.119834711,0.880165289,69.20344339,65.52001809,126.028169,88.24137931,242,50.94736842,484,-109056,14848,-94208,26
218,24,23,7,0.0991735537,0.900826446,68.57982217,70.29442052,125.6100917,84.16666667,242,66.85082873,484,-111616,12288,-99328,26
218,26,24,6,0.106557377,0.893442623,69.54513149,67.45549705,126.8027523,86.42307692,244,65.4155496,488,-111616,13312,-98304,26
185,34,22,8,0.155251142,0.844748858,61.56240303,53.56689864,118.0162162,66.38235294,219,3.509615385,438,-94720,17408,-77312,26
186,35,24,6,0.158371041,0.841628959,62.5143473,53.95399401,118.7580645,69.77142857,221,3.55992268,442,-95232,17920,-77312,26
187,34,23,7,0.153846154,0.846153846,62.56884635,45.92947241,119.8716578,62.20588235,221,2.854928304,442,-95744,17408,-78336,26
81,13,23,7,0.138297872,0.861702128,27.00393712,19.22492219,50.51851852,28.69230769,94,3.116710875,188,-41472,6656,-34816,26
80,13,23,7,0.139784946,0.860215054,26.53728509,22.64231782,49.65,30.69230769,93,23.4256927,186,-40960,6656,-34304,26
78,10,24,6,0.113636364,0.886363636,24.81822476,23.56713814,46.65384615,27.7,88,23.71967655,176,-39936,5120,-34816,26
79,16,22,8,0.168421053,0.831578947,27.38924032,21.72843759,51.13924051,32.5,95,20.21276596,190,-40448,8192,-32256,26
80,11,24,6,0.120879121,0.879120879,25.99008224,19.51900959,48.625,26.90909091,91,19.95614035,182,-40960,5632,-35328,26
80,14,24,6,0.14893617,0.85106383,27.18950855,21.55451087,50.075,32.78571429,94,26.62889518,188,-40960,7168,-33792,26
78,15,24,6,0.161290323,0.838709677,26.66397915,23.82286483,49.51282051,33.93333333,93,1.663982823,186,-39936,7680,-32256,26
80,14,23,7,0.14893617,0.85106383,26.95771863,22.31408451,50.2625,31.71428571,94,19.14460285,188,-40960,7168,-33792,26
78,10,24,6,0.113636364,0.886363636,24.88203926,23.51616465,46.57692308,28.3,88,18.92473118,176,-39936,5120,-34816,26
79,15,24,6,0.159574468,0.840425532,27.17836779,21.80968185,50.24050633,33.06666667,94,28.57142857,188,-40448,7680,-32768,26
80,14,24,6,0.14893617,0.85106383,26.63782262,27.00755752,49.5375,35.85714286,94,1.655804122,188,-40960,7168,-33792,26
92,14,23,7,0.132075472,0.867924528,30.35488542,26.09323941,56.16304348,36,106,18.3074266,212,-47104,7168,-39936,26
80,12,23,7,0.130434783,0.869565217,26.12491328,22.97265887,49.0375,29.58333333,92,23.17380353,184,-40960,6144,-34816,26
93,13,22,8,0.122641509,0.877358491,30.01025762,25.77416715,56.50537634,32,106,18.89483066,212,-47616,6656,-40960,26
80,10,24,6,0.111111111,0.888888889,25.46394203,23.78318734,47.6125,28.6,90,25.1396648,180,-40960,5120,-35840,26
82,16,23,7,0.163265306,0.836734694,27.96513509,26.40719303,52,36.6875,98,1.575056252,196,-41984,8192,-33792,26
81,16,23,7,0.164948454,0.835051546,27.68339521,26.26517419,51.44444444,36.625,97,1.583673469,194,-41472,8192,-33280,26
79,11,24,6,0.122222222,0.877777778,25.58448622,23.18734337,47.69620253,29.72727273,90,19.48051948,180,-40448,5632,-34816,26
79,13,23,7,0.141304348,0.858695652,26.23494601,22.36464877,49.17721519,30.23076923,92,21.74940898,184,-40448,6656,-33792,26
80,14,24,6,0.14893617,0.85106383,27.14751082,22.13225553,50.0125,33.14285714,94,24.67191601,188,-40960,7168,-33792,26
314,31,23,7,0.0898550725,0.910144928,98.58079772,96.65709044,177.8089172,124.2903226,345,52.19364599,690,-160768,15872,-144896,26
316,38,22,8,0.107344633,0.892655367,98.91443076,95.52253509,186.8670886,99.60526316,354,106.9486405,708,-161792,19456,-142336,26
309,37,24,6,0.106936416,0.893063584,96.82164778,95.892288,182.1229773,101.4864865,346,98.85714286,692,-158208,18944,-139264,26
311,31,22,8,0.0906432749,0.909356725,96.34725658,100.9521373,177.6688103,109.6129032,342,72.45762712,684,-159232,15872,-143360,26
314,33,22,8,0.0951008646,0.904899135,98.98998946,104.6695004,177.6242038,139.5151515,347,44.71649485,694,-160768,16896,-143872,26
310,37,23,7,0.106628242,0.893371758,96.97280029,96.98933244,182.6709677,101.3513514,347,54.47409733,694,-158720,18944,-139776,26
313,27,24,6,0.0794117647,0.920588235,96.14262171,104.7576601,175.1661342,116.4074074,340,138.2113821,680,-160256,13824,-146432,26
310,34,24,6,0.0988372093,0.901162791,96.81149072,97.9562654,179.6548387,107.2647059,344,74.45887446,688,-158720,17408,-141312,26
312,35,23,7,0.100864553,0.899135447,97.52064023,104.6255286,180.5192308,115.8857143,347,54.30359937,694,-159744,17920,-141824,26
313,40,23,7,0.113314448,0.886685552,98.83609756,92.54733924,186.8019169,100.3,353,53.2428356,706,-160256,20480,-139776,26
315,40,23,7,0.112676056,0.887323944,99.61297623,93.47202456,187.5142857,103.075,355,131.9702602,710,-161280,20480,-140800,26
309,32,23,7,0.0938416422,0.906158358,95.83308458,98.74675628,177.8478964,104.875,341,78.03203661,682,-158208,16384,-141824,26
308,34,24,6,0.0994152047,0.900584795,96.3949187,96.58315259,178.5584416,107.5588235,342,72.76595745,684,-157696,17408,-140288,26
328,36,23,7,0.0989010989,0.901098901,103.1298158,89.75471978,191.0152439,104.9166667,364,62.54295533,728,-167936,18432,-149504,26
308,34,23,7,0.0994152047,0.900584795,96.17027691,94.51332269,179.1461039,102.2352941,342,78.80184332,684,-157696,17408,-140288,26
270,37,23,7,0.120521173,0.879478827,86.28009552,88.62939804,161.0259259,102.7297297,307,4.886200859,614,-138240,18944,-119296,26
271,39,23,7,0.125806452,0.874193548,86.74650491,80.55772878,164.896679,90.20512821,310,4.881889764,620,-138752,19968,-118784,26
310,35,23,7,0.101449275,0.898550725,97.09603151,98.53585279,180.2258065,109,345,118.1506849,690,-158720,17920,-140800,26
306,35,23,7,0.102639296,0.897360704,95.59325321,95.85350217,178.9084967,101.8571429,341,42.2029703,682,-156672,17920,-138752,26
311,34,24,6,0.0985507246,0.901449275,96.49407999,99.09030868,180.807074,101.5882353,345,69.83805668,690,-159232,17408,-141824,26
208,30,22,8,0.12605042,0.87394958,66.56022859,67.42175712,125.8028846,75.8,238,50.85470085,476,-106496,15360,-91136,26
222,33,24,6,0.129411765,0.870588235,73.04416614,64.73352881,133.8648649,88.54545455,255,45.94594595,510,-113664,16896,-96768,26
210,30,24,6,0.125,0.875,67.40221926,65.34446334,126.947619,75.36666667,240,41.16638079,480,-107520,15360,-92160,26
222,25,23,7,0.101214575,0.898785425,70.20977891,68.9241206,128.4099099,84.84,247,46.9581749,494,-113664,12800,-100864,26
207,20,23,7,0.0881057269,0.911894273,63.99878059,72.52756373,117.0386473,82.55,227,51.35746606,454,-105984,10240,-95744,26
211,30,23,7,0.124481328,0.875518672,68.43960323,62.90918499,126.9194313,79.36666667,241,38.93376414,482,-108032,15360,-92672,26
207,26,23,7,0.111587983,0.888412017,65.86608924,64.24713057,122.1256039,76.19230769,233,45.9566075,466,-105984,13312,-92672,26
210,24,23,7,0.102564103,0.897435897,65.86501347,69.29364599,122,78.125,234,36.44859813,468,-107520,12288,-95232,26
225,35,23,7,0.134615385,0.865384615,74.61763417,64.75540163,136.7422222,90.37142857,260,47.18693285,520,-115200,17920,-97280,26
216,27,24,6,0.111111111,0.888888889,68.89301421,65.51972237,127.3009259,79.59259259,243,50.83682008,486,-110592,13824,-96768,26
212,27,23,7,0.112970711,0.887029289,67.78457591,66.95612059,124.759434,82.62962963,239,50.31578947,478,-108544,13824,-94720,26
210,30,23,7,0.125,0.875,67.45586211,70.5282922,125.8,83.4,240,4.278837582,480,-107520,15360,-92160,26
222,23,23,7,0.093877551,0.906122449,69.77005506,71.20002974,126.454955,89.65217391,245,29.8053528,490,-113664,11776,-101888,26
172,34,23,7,0.165048544,0.834951456,58.77469879,53.09041058,109.5755814,72.76470588,206,3.304989572,412,-88064,17408,-70656,26
212,29,23,7,0.12033195,0.87966805,67.63878182,66.17371654,127.2830189,75.06896552,241,85.76512456,482,-108544,14848,-93696,26
223,24,22,8,0.0971659919,0.902834008,69.7729552,72.08482657,128.4484305,82.66666667,247,56.13636364,494,-114176,12288,-101888,26
226,26,23,7,0.103174603,0.896825397,71.45426878,68.54615557,131.6238938,81.96153846,252,46.9273743,504,-115712,13312,-102400,26
215,34,24,6,0.136546185,0.863453815,70.27590931,63.00154472,132.5488372,77.26470588,249,84.98293515,498,-110080,17408,-92672,26
209,26,23,7,0.110638298,0.889361702,65.85106504,67.10449548,123.5454545,73.42307692,235,43.59925788,470,-107008,13312,-93696,26
211,24,23,7,0.10212766,0.89787234,66.86547709,65.85569241,122.056872,82.33333333,235,34.40702782,470,-108032,12288,-95744,26
241,21,23,7,0.0801526718,0.919847328,74.64262358,74.29828953,135.1493776,89.61904762,262,68.94736842,524,-123392,10752,-112640,26
242,28,24,6,0.103703704,0.896296296,76.81129609,63.76298387,142,79.32142857,270,22.51876564,540,-123904,14336,-109568,26
243,22,24,6,0.0830188679,0.916981132,75.53755961,75.45039693,136.6502058,92.68181818,265,60.77981651,530,-124416,11264,-113152,26
243,28,24,6,0.103321033,0.896678967,76.38359858,67.66486857,142.9176955,75.96428571,271,44.79338843,542,-124416,14336,-110080,26
240,32,24,6,0.117647059,0.882352941,77.91638636,65.53693496,142.8583333,88.8125,272,39.88269795,544,-122880,16384,-106496,26
241,36,24,6,0.129963899,0.870036101,78.38296602,59.38488059,148.3900415,76.13888889,277,58.68644068,554,-123392,18432,-104960,26
237,28,24,6,0.105660377,0.894339623,76.43237133,68.52687355,136.9367089,99.67857143,265,51.05973025,530,-121344,14336,-107008,26
240,26,24,6,0.0977443609,0.902255639,75.16346064,70.45990089,139.3291667,79.69230769,266,52.25933202,532,-122880,13312,-109568,26
244,30,22,8,0.109489051,0.890510949,78.86424231,64.61410235,143.1598361,91.46666667,274,46.12794613,548,-124928,15360,-109568,26
255,29,24,6,0.102112676,0.897887324,81.90194961,71.33395194,147.0078431,102.862069,284,47.73109244,568,-130560,14848,-115712,26
238,28,24,6,0.105263158,0.894736842,75.05304247,64.00242143,140.5714286,73.39285714,266,17.90040377,532,-121856,14336,-107520,26
239,26,24,6,0.0981132075,0.901886792,75.55347014,68.01635724,138.2133891,85.07692308,265,37.42937853,530,-122368,13312,-109056,26
245,34,24,6,0.121863799,0.878136201,79.24430942,65.43900856,147.9061224,83.02941176,279,55.13833992,558,-125440,17408,-108032,26
258,34,22,8,0.116438356,0.883561644,82.92446125,74.19559976,153.6550388,92.20588235,292,42.31884058,584,-132096,17408,-114688,26
195,29,23,7,0.129464286,0.870535714,63.51789365,57.77394547,118.4358974,72.5862069,224,3.542622173,448,-99840,14848,-84992,26
196,34,23,7,0.147826087,0.852173913,64.78877411,57.8075497,123.1479592,71.41176471,230,3.686488219,460,-100352,17408,-82944,26
241,27,24,6,0.100746269,0.899253731,76.15293677,66.50257583,140.5311203,80.66666667,268,34.85045514,536,-123392,13824,-109568,26
241,34,23,7,0.123636364,0.876363636,78.7985572,67.39500998,144.4937759,91.97058824,275,84.61538462,550,-123392,17408,-105984,26
240,31,23,7,0.114391144,0.885608856,76.57186122,60.63350952,144.0916667,73.35483871,271,19.4265233,542,-122880,15872,-107008,26
241,30,24,6,0.110701107,0.889298893,76.40438762,69.99769044,142.93361,80.3,271,63.76470588,542,-123392,15360,-108032,26
206,33,24,6,0.138075314,0.861924686,67.43589398,64.17374831,126.5970874,78.81818182,239,44.25925926,478,-105472,16896,-88576,26
208,30,24,6,0.12605042,0.87394958,67.64610649,65.03260721,124.7067308,83.4,238,69.3877551,476,-106496,15360,-91136,26
204,29,22,8,0.124463519,0.875536481,64.81567038,66.11793592,123.5490196,70.93103448,233,47.26166329,466,-104448,14848,-89600,26
205,27,23,7,0.11637931,0.88362069,64.9724503,68.15923823,121.8146341,76.14814815,232,36.53543307,464,-104960,13824,-91136,26
205,32,24,6,0.135021097,0.864978903,66.80704562,61.95889987,125.8634146,75.03125,237,56.29453682,474,-104960,16384,-88576,26
206,23,23,7,0.100436681,0.899563319,64.76132649,66.70208574,119.0970874,78.30434783,229,37.91390728,458,-105472,11776,-93696,26
208,27,23,7,0.114893617,0.885106383,66.05641794,62.7697034,124.1057692,70.96296296,235,15.70855615,470,-106496,13824,-92672,26
204,27,23,7,0.116883117,0.883116883,64.53700258,65.57779493,121.9313725,71.18518519,231,27.96610169,462,-104448,13824,-90624,26
215,25,24,6,0.104166667,0.895833333,68.13659236,68.86884927,124.6325581,84.96,240,34.18803419,480,-110080,12800,-97280,26
204,34,24,6,0.142857143,0.857142857,66.74171003,61.99346991,127.1715686,73.47058824,238,67.61363636,476,-104448,17408,-87040,26
205,31,23,7,0.131355932,0.868644068,65.97593814,64.66943077,125.3560976,73.16129032,236,61.94225722,472,-104960,15872,-89088,26
207,20,23,7,0.0881057269,0.911894273,63.93172614,73.27774219,117.0096618,82.85,227,57.90816327,454,-105984,10240,-95744,26
203,27,23,7,0.117391304,0.882608696,64.90826616,52.88362356,122.4334975,63.37037037,230,50.54945055,460,-103936,13824,-90112,26
213,30,23,7,0.12345679,0.87654321,69.02894286,64.55203758,127.685446,81.63333333,243,38.02816901,486,-109056,15360,-93696,26
211,32,23,7,0.131687243,0.868312757,68.68954235,63.5233025,128.6587678,78.09375,243,68.45070423,486,-108032,16384,-91648,26
209,22,23,7,0.0952380952,0.904761905,65.23742073,70.67315059,119.5598086,82.18181818,231,59.23076923,462,-107008,11264,-95744,26
215,21,24,6,0.0889830508,0.911016949,66.74265358,72.45325336,121.8651163,84.04761905,236,35.38230885,472,-110080,10752,-99328,26
160,25,23,7,0.135135135,0.864864865,51.50107364,53.63425771,98.14375,60.08,185,3.012048193,370,-81920,12800,-69120,26
209,26,23,7,0.110638298,0.889361702,65.68472183,67.71561006,123.6602871,72.5,235,47.18875502,470,-107008,13312,-93696,26
203,32,23,7,0.136170213,0.863829787,66.52729038,49.08855797,126.4285714,64.53125,235,37.66025641,470,-103936,16384,-87552,26
2173,86,24,6,0.0380699425,0.961930058,648.0073488,726.3998839,1137.009204,952.8953488,2259,39.68030915,4518,-1112576,44032,-1068544,26
2168,91,24,6,0.0402833112,0.959716689,648.1651811,711.4877056,1138.373155,930.5164835,2259,393.554007,4518,-1110016,46592,-1063424,26
2168,97,23,7,0.0428256071,0.957174393,647.5996518,731.0572706,1144.976476,865.3195876,2265,422.5746269,4530,-1110016,49664,-1060352,26
2166,83,24,6,0.0369052912,0.963094709,646.1099453,711.7860861,1130.363343,985.0361446,2249,39.31818182,4498,-1108992,42496,-1066496,26
2178,87,24,6,0.038410596,0.961589404,650.1229214,721.198017,1139.674013,965.9195402,2265,380.6722689,4530,-1115136,44544,-1070592,26
2378,97,23,7,0.0391919192,0.960808081,711.0363481,767.1225825,1246.195963,1037.072165,2475,425.989673,4950,-1217536,49664,-1167872,26
2164,90,22,8,0.0399290151,0.960070985,645.4433998,732.1674034,1136.640018,907.7333333,2254,601.0666667,4508,-1107968,46080,-1061888,26
2165,95,24,6,0.0420353982,0.957964602,646.8553776,725.9566911,1141.276674,884.9052632,2260,416.9741697,4520,-1108480,48640,-1059840,26
2178,89,24,6,0.0392589325,0.960741067,650.3397387,724.0819523,1141.43618,952.0224719,2267,523.556582,4534,-1115136,45568,-1069568,26
2175,90,24,6,0.0397350993,0.960264901,649.6017288,724.475906,1140.741149,945.9222222,2265,481.9148936,4530,-1113600,46080,-1067520,26
2395,103,22,8,0.0412329864,0.958767014,716.8526434,768.0098105,1260.840501,985.8058252,2498,280.044843,4996,-1226240,52736,-1173504,26
2405,103,23,7,0.0410685805,0.958931419,719.9344299,789.6761339,1262.627859,1064.718447,2508,44.46808511,5016,-1231360,52736,-1178624,26
2396,96,22,8,0.0385232745,0.961476726,715.6488637,775.8422959,1255.209933,1029.114583,2492,406.5252855,4984,-1226752,49152,-1177600,26
2168,83,23,7,0.0368725011,0.963127499,646.2675253,724.2118914,1130.986624,995.746988,2251,310.9116022,4502,-1110016,42496,-1067520,26
2378,103,23,7,0.0415155179,0.958484482,711.8474086,768.2527744,1251.921783,988.8446602,2481,191.2875867,4962,-1217536,52736,-1164800,26
2135,110,23,7,0.0489977728,0.951002227,642.2797859,716.8065221,1134.385012,902.0272727,2245,36.11066431,4490,-1093120,56320,-1036800,26
2135,109,23,7,0.048573975,0.951426025,642.1288981,711.6064736,1134.305386,891.266055,2244,34.91520149,4488,-1093120,55808,-1037312,26
2174,98,22,8,0.0431338028,0.956866197,649.1699819,733.9214945,1149.392824,850.4897959,2272,460.851927,4544,-1113088,50176,-1062912,26
2191,88,24,6,0.0386134269,0.961386573,654.0785997,723.654002,1147.225468,960.1022727,2279,334.1642229,4558,-1121792,45056,-1076736,26
2180,96,23,7,0.0421792619,0.957820738,651.5356208,727.9292787,1149.479817,889.1666667,2276,332.748538,4552,-1116160,49152,-1067008,26
219,27,21,9,0.109756098,0.890243902,69.51405403,64.13901654,129.4748858,75.03703704,246,36.77130045,492,-112128,13824,-98304,26
223,34,21,9,0.13229572,0.86770428,72.45455133,68.34304373,136.103139,82.41176471,257,41.0543131,514,-114176,17408,-96768,26
220,32,21,9,0.126984127,0.873015873,71.32080996,61.49695114,133.8454545,76,252,33.28929987,504,-112640,16384,-96256,26
215,35,19,11,0.14,0.86,70.45552226,59.66063208,133.972093,73.45714286,250,40,500,-110080,17920,-92160,26
221,34,21,9,0.133333333,0.866666667,72.57852061,67.07814479,134.2443439,87.41176471,255,44.81546573,510,-113152,17408,-95744,26
222,28,21,9,0.112,0.888,70.27844273,71.40163778,131.1306306,80.85714286,250,41.32231405,500,-113664,14336,-99328,26
220,27,21,9,0.109311741,0.890688259,69.67353906,71.61264114,128.95,83.66666667,247,45.23809524,494,-112640,13824,-98816,26
219,32,21,9,0.12749004,0.87250996,70.78908766,61.74075557,133.56621,74.21875,251,50.60483871,502,-112128,16384,-95744,26
222,30,21,9,0.119047619,0.880952381,70.76554957,69.88263176,132.8558559,79.46666667,252,45.08050089,504,-113664,15360,-98304,26
216,35,21,9,0.139442231,0.860557769,71.2759361,59.92869232,133.8194444,77.74285714,251,24.97512438,502,-110592,17920,-92672,26
215,34,21,9,0.136546185,0.863453815,70.94402062,60.95187846,132.0418605,80.47058824,249,34.87394958,498,-110080,17408,-92672,26
222,33,21,9,0.129411765,0.870588235,72.48114986,67.41056041,134.1801802,86.42424242,255,48.20415879,510,-113664,16896,-96768,26
217,30,21,9,0.12145749,0.87854251,70.08251599,61.16761126,130.59447,76.3,247,42.15017065,494,-111104,15360,-95744,26
218,28,21,9,0.113821138,0.886178862,69.85767949,63.38962768,129.2889908,78.42857143,246,40.93178037,492,-111616,14336,-97280,26
220,36,21,9,0.140625,0.859375,72.55445319,62.12231563,136.5363636,79.38888889,256,41.29032258,512,-112640,18432,-94208,26
219,33,21,9,0.130952381,0.869047619,71.46666354,66.11911504,133.0045662,83.33333333,252,52.39085239,504,-112128,16896,-95232,26
218,34,21,9,0.134920635,0.865079365,72.1175646,59.90948334,133.4357798,82.02941176,252,24.18426104,504,-111616,17408,-94208,26
217,30,20,10,0.12145749,0.87854251,70.0000992,63.18477313,130.3778802,77.86666667,247,34.93635078,494,-111104,15360,-95744,26
162,33,20,10,0.169230769,0.830769231,55.79304793,48.16140219,104.2222222,67.45454545,195,3.097204574,390,-82944,16896,-66048,26
164,35,20,10,0.175879397,0.824120603,56.89987861,51.74572052,105.8597561,72.54285714,199,3.158730159,398,-83968,17920,-66048,26
259,33,21,9,0.113013699,0.886986301,83.98323111,74.32162751,151.8532819,104.4848485,292,34.67933492,584,-132608,16896,-115712,26
257,34,21,9,0.116838488,0.883161512,82.33657089,70.94228001,153.9805447,85.67647059,291,46.63461538,582,-131584,17408,-114176,26
256,38,21,9,0.129251701,0.870748299,83.74612855,71.74274988,155.4960938,93.63157895,294,47.11538462,588,-131072,19456,-111616,26
262,28,22,8,0.0965517241,0.903448276,82.28521421,76.26105641,151.4351145,89.96428571,290,49.82817869,580,-134144,14336,-119808,26
258,40,20,10,0.134228188,0.865771812,84.80795785,68.15385169,158.7325581,89.95,298,46.78178964,596,-132096,20480,-111616,26
255,35,20,10,0.120689655,0.879310345,81.62381146,70.15213788,154.2352941,81.85714286,290,41.42857143,580,-130560,17920,-112640,26
258,31,21,9,0.107266436,0.892733564,81.94664025,73.11076653,151.8604651,87.90322581,289,47.84768212,578,-132096,15872,-116224,26
261,41,21,9,0.135761589,0.864238411,86.07302863,67.12930689,161.091954,90.43902439,302,74.01960784,604,-133632,20992,-112640,26
263,42,21,9,0.137704918,0.862295082,86.52962828,67.78718198,163.2889734,88.57142857,305,48.87820513,610,-134656,21504,-113152,26
261,40,21,9,0.132890365,0.867109635,85.62167867,64.85884192,160.8582375,86.675,301,33.11331133,602,-133632,20480,-113152,26
254,41,20,10,0.138983051,0.861016949,83.54638725,67.96250322,157.8425197,87.02439024,295,48.12398042,590,-130048,20992,-109056,26
256,43,20,10,0.143812709,0.856187291,85.17690466,66.982897,159.9804688,90.58139535,299,58.51272016,598,-131072,22016,-109056,26
258,26,21,9,0.0915492958,0.908450704,80.35469835,76.13881942,148.2209302,85.73076923,284,38.90410959,568,-132096,13312,-118784,26
263,35,21,9,0.117449664,0.882550336,83.79110202,85.27504599,156.3231939,98.22857143,298,5.292132836,596,-134656,17920,-116736,26
255,25,21,9,0.0892857143,0.910714286,79.45243074,78.27629015,145.3215686,91.32,280,47.21753794,560,-130560,12800,-117760,26
263,34,21,9,0.114478114,0.885521886,84.12916776,75.04824285,156.5285171,90.76470588,297,38.32258065,594,-134656,17408,-117248,26
259,39,20,10,0.130872483,0.869127517,84.95479389,60.93900336,159.3281853,84.23076923,298,28.0075188,596,-132608,19968,-112640,26
209,33,20,10,0.136363636,0.863636364,67.95241151,73.51221608,126.4545455,90.12121212,242,3.87510008,484,-107008,16896,-90112,26
215,42,21,9,0.163424125,0.836575875,72.78314903,70.22494227,136.2139535,92.07142857,257,3.961159063,514,-110080,21504,-88576,26
258,31,21,9,0.107266436,0.892733564,81.97352423,71.93937499,151.9844961,86.87096774,289,56.33528265,578,-132096,15872,-116224,26
4018,592,24,6,0.128416486,0.871583514,1325.935751,1331.934219,2265.507715,2576.934122,4610,127.3480663,9220,-2057216,303104,-1754112,27
3934,572,23,7,0.126941855,0.873058145,1269.549988,1407.429447,2183.821556,2732.722028,4506,126.3955119,9012,-2014208,292864,-1721344,27
3958,526,24,6,0.117305977,0.882694023,1287.633648,1306.281752,2202.82188,2541.06654,4484,127.5312856,8968,-2026496,269312,-1757184,27
4067,554,23,7,0.11988747,0.88011253,1327.284648,1363.752816,2282.363659,2521.223827,4621,113.5659867,9242,-2082304,283648,-1798656,27
3968,577,23,7,0.126952695,0.873047305,1308.358326,1318.362416,2242.778226,2480.833622,4545,103.3424284,9090,-2031616,295424,-1736192,27
3961,577,23,7,0.127148524,0.872851476,1302.639042,1333.826753,2233.7026,2515.242634,4538,127.2574313,9076,-2028032,295424,-1732608,27
802,137,22,8,0.145899894,0.854100106,260.6661473,243.8277543,504.0049875,270.9343066,939,18.92763556,1878,-410624,70144,-340480,27
3757,574,24,6,0.132532902,0.867467098,1215.66822,1378.728216,2099.191908,2603.278746,4331,117.5943524,8662,-1923584,293888,-1629696,27
3943,549,23,7,0.122217275,0.877782725,1267.109884,1429.582461,2190.666244,2647.506375,4492,115.5349794,8984,-2018816,281088,-1737728,27
4192,575,23,7,0.120620936,0.879379064,1364.684946,1427.566072,2346.692748,2655.986087,4767,122.4505523,9534,-2146304,294400,-1851904,27
3918,523,23,7,0.117766269,0.882233731,1274.171109,1306.828385,2184.278969,2496.091778,4441,119.3496372,8882,-2006016,267776,-1738240,27
3824,581,24,6,0.131895573,0.868104427,1258.665928,1296.272235,2147.752615,2566.624785,4405,118.669181,8810,-1957888,297472,-1660416,27
287,65,22,8,0.184659091,0.815340909,94.48000756,127.4967604,179.7073171,162.3384615,352,8.633799362,704,-146944,33280,-113664,27
3935,568,24,6,0.12613813,0.87386187,1297.998645,1291.359415,2219.9446,2474.073944,4503,114.26034,9006,-2014720,290816,-1723904,27
4024,529,23,7,0.116187129,0.883812871,1307.677617,1343.380333,2247.844433,2498.780718,4553,115.9704534,9106,-2060288,270848,-1789440,27
3887,538,23,7,0.121581921,0.878418079,1266.216007,1318.789185,2172.428608,2506.124535,4425,103.2190343,8850,-1990144,275456,-1714688,27
3929,547,23,7,0.122207328,0.877792672,1265.926187,1428.019571,2194.963604,2551.213894,4476,114.7986663,8952,-2011648,280064,-1731584,27
3546,559,23,7,0.136175396,0.863824604,1184.910443,1170.846128,2025.632826,2226.602862,4105,72.1060952,8210,-1815552,286208,-1529344,27
1617,134,23,7,0.0765276985,0.923472302,487.5427603,567.6538976,906.6456401,506.1940299,1751,28.07439474,3502,-827904,68608,-759296,27
2010,135,22,8,0.0629370629,0.937062937,601.6958901,720.1461601,1100.823881,658.7333333,2145,34.35297886,4290,-1029120,69120,-960000,27
9521,453,23,7,0.045418087,0.954581913,2852.443494,3114.936012,5050.144313,3670.863135,9974,755.0340651,19948,-4874752,231936,-4642816,27
9518,457,22,8,0.0458145363,0.954185464,2845.069426,3195.367909,5057.415949,3542.26477,9975,825.0620347,19950,-4873216,233984,-4639232,27
4330,345,22,8,0.0737967914,0.926203209,1328.647506,1520.84673,2373.234642,1895.77971,4675,83.02255372,9350,-2216960,176640,-2040320,27
9525,450,24,6,0.045112782,0.954887218,2852.810472,3150.242272,5046.582572,3748.002222,9975,1242.216687,19950,-4876800,230400,-4646400,27
9521,453,24,6,0.045418087,0.954581913,2850.192653,3125.598399,5053.556769,3599.14128,9974,1003.420523,19948,-4874752,231936,-4642816,27
9526,448,22,8,0.0449167836,0.955083216,2850.049589,3144.803642,5051.797082,3620.325893,9974,689.2881824,19948,-4877312,229376,-4647936,27
9517,457,24,6,0.0458191297,0.95418087,2852.568428,3117.378774,5049.663549,3692.947484,9974,1740.663176,19948,-4872704,233984,-4638720,27
9456,512,23,7,0.051364366,0.948635634,2842.63646,3279.757345,5042.458756,3914.074219,9968,706.4493267,19936,-4841472,262144,-4579328,27
9493,481,23,7,0.048225386,0.951774614,2844.473817,3141.452801,5063.266301,3492.178794,9974,1018.794688,19948,-4860416,246272,-4614144,27
9501,474,22,8,0.047518797,0.952481203,2847.731956,3164.432887,5055.62404,3632.523207,9975,1197.478992,19950,-4864512,242688,-4621824,27
9506,469,22,8,0.0470175439,0.952982456,2847.27755,3092.21738,5063.757942,3452.488273,9975,767.8983834,19950,-4867072,240128,-4626944,27
9598,377,23,7,0.0377944862,0.962205514,2863.822951,3220.093239,5006.07387,4527.859416,9975,818.2936833,19950,-4914176,193024,-4721152,27
9470,501,23,7,0.0502457126,0.949754287,2841.723016,3320.227413,5043.054065,3907.552894,9971,800.2407705,19942,-4848640,256512,-4592128,27
271,96,23,7,0.261580381,0.738419619,115.2195189,65.74972275,194.1402214,155.375,367,20.80498866,734,-138752,49152,-89600,27
157,45,23,7,0.222772277,0.777227723,57.00302591,61.20929486,104.8917197,89.66666667,202,14.72303207,404,-80384,23040,-57344,27
9552,424,24,6,0.0425020048,0.957497995,2857.072866,3113.984584,5042.345163,3775.459906,9976,1316.094987,19952,-4890624,217088,-4673536,27
9456,513,23,7,0.0514595245,0.948540475,2842.634771,3274.490257,5044.489213,3888.450292,9969,658.019802,19938,-4841472,262656,-4578816,27
5913,540,23,7,0.0836820084,0.916317992,1842.937785,2064.649501,3237.39151,3113.212963,6453,146.1277174,12906,-3027456,276480,-2750976,27
9502,473,22,8,0.0474185464,0.952581454,2849.569934,3105.574206,5058.334561,3575.063425,9975,1037.98127,19950,-4865024,242176,-4622848,27
103,55,24,6,0.348101266,0.651898734,40.88293374,40.03860121,64.30097087,107.9636364,158,7.110711071,316,-52736,28160,-24576,27
4684,399,24,6,0.0784969506,0.921503049,1438.71419,1695.351442,2583.315756,2056.97995,5083,88.70855148,10166,-2398208,204288,-2193920,27
51,20,22,8,0.281690141,0.718309859,20.20679327,21.20442171,35.8627451,36.35,71,1.801116185,142,-26112,10240,-15872,27
8385,570,24,6,0.0636515913,0.936348409,2514.532914,3459.269878,4484.192844,4386.9,8955,216.7231365,17910,-4293120,291840,-4001280,27
8457,600,24,6,0.0662471017,0.933752898,2545.05992,3447.892987,4528.651531,4533.911667,9057,200.9094942,18114,-4329984,307200,-4022784,27
8442,572,23,7,0.0634568449,0.936543155,2543.472301,3347.884698,4499.114428,4631.26049,9014,207.7437198,18028,-4322304,292864,-4029440,27
8504,610,23,7,0.0669299978,0.933070002,2557.303744,3500.068567,4555.343368,4587.565574,9114,225.9856186,18228,-4354048,312320,-4041728,27
8456,593,24,6,0.065532103,0.934467897,2540.88038,3472.851341,4520.087394,4595.052277,9049,223.9851485,18098,-4329472,303616,-4025856,27
8447,596,23,7,0.0659073316,0.934092668,2541.863402,3438.880981,4521.569551,4528.100671,9043,189.5409767,18086,-4324864,305152,-4019712,27
8488,594,24,6,0.065404096,0.934595904,2558.610763,3394.533992,4530.931315,4692.521886,9082,210.4750869,18164,-4345856,304128,-4041728,27
8481,612,22,8,0.06730452,0.93269548,2556.777219,3432.163089,4551.314586,4487.20915,9093,202.6521061,18186,-4342272,313344,-4028928,27
8437,576,22,8,0.0639076889,0.936092311,2536.2865,3419.742713,4501.219154,4591.675347,9013,229.1052364,18026,-4319744,294912,-4024832,27
8453,602,23,7,0.0664826063,0.933517394,2549.125447,3392.833623,4517.959423,4668.98505,9055,224.4670302,18110,-4327936,308224,-4019712,27
8469,608,23,7,0.0669824832,0.933017517,2549.400143,3460.028589,4538.750738,4542.472039,9077,205.361991,18154,-4336128,311296,-4024832,27
8469,578,23,7,0.0638885819,0.936111418,2581.934738,2928.992871,4570.808006,3838.157439,9047,160.8927619,18094,-4336128,295936,-4040192,27
4158,332,21,9,0.0739420935,0.926057906,1264.174099,1494.58684,2298.266234,1584.650602,4490,77.02864985,8980,-2128896,169984,-1958912,27
8488,569,22,8,0.0628243348,0.937175665,2554.194952,3360.271022,4500.234802,4958.101933,9057,158.7276551,18114,-4345856,291328,-4054528,27
8522,616,23,7,0.067410812,0.932589188,2570.562889,3432.768085,4557.87984,4730.258117,9138,217.1577947,18276,-4363264,315392,-4047872,27
8173,494,22,8,0.0569978078,0.943002192,2457.942943,3068.299381,4373.64603,3678.074899,8667,354.768727,17334,-4184576,252928,-3931648,27
8449,610,22,8,0.0673363506,0.932663649,2542.571009,3466.923144,4532.353651,4497.4,9059,224.0662874,18118,-4325888,312320,-4013568,27
8463,600,23,7,0.066203244,0.933796756,2548.154638,3435.888796,4530.096538,4558.848333,9063,200.464499,18126,-4333056,307200,-4025856,27
4493,627,22,8,0.122460938,0.877539063,1447.530153,1628.720445,2506.453594,2947.789474,5120,109.1219096,10240,-2300416,321024,-1979392,27
4429,628,22,8,0.124184299,0.875815701,1409.82701,1720.09444,2472.023482,2930.829618,5057,111.9300575,10114,-2267648,321536,-1946112,27
4493,656,23,7,0.127403379,0.872596621,1454.733156,1645.667136,2524.189628,2923.004573,5149,129.404373,10298,-2300416,335872,-1964544,27
4403,628,23,7,0.124826078,0.875173922,1394.243399,1730.456041,2446.163525,3005.633758,5031,123.4601227,10062,-2254336,321536,-1932800,27
4445,661,23,7,0.129455542,0.870544458,1418.209108,1701.481787,2470.0027,3114.990923,5106,89.57894737,10212,-2275840,338432,-1937408,27
4377,619,23,7,0.123899119,0.876100881,1400.280065,1626.715338,2428.858579,2990.940226,4996,128.267009,9992,-2241024,316928,-1924096,27
4365,630,23,7,0.126126126,0.873873874,1384.438944,1721.480481,2431.689347,2957.438095,4995,126.7444811,9990,-2234880,322560,-1912320,27
4453,666,23,7,0.130103536,0.869896464,1434.022392,1672.387716,2491.993038,3014.707207,5119,122.0262217,10238,-2279936,340992,-1938944,27
4539,600,23,7,0.116754232,0.883245768,1438.458719,1684.992068,2495.748182,3131.715,5139,134.1075157,10278,-2323968,307200,-2016768,27
4515,658,23,7,0.127198917,0.872801083,1439.95203,1752.623126,2521.366113,3037.360182,5173,124.3808608,10346,-2311680,336896,-1974784,27
4338,593,23,7,0.120259582,0.879740418,1373.863796,1649.422602,2393.415629,2996.979764,4931,110.684624,9862,-2221056,303616,-1917440,27
4333,483,23,7,0.100290698,0.899709302,1355.731186,1666.498257,2400.185091,2483.093168,4816,101.9690874,9632,-2218496,247296,-1971200,27
4414,640,22,8,0.12663237,0.87336763,1411.76037,1659.805361,2452.273675,3046.326562,5054,115.7846506,10108,-2259968,327680,-1932288,27
4566,642,23,7,0.123271889,0.876728111,1450.107912,1772.817453,2540.372317,3060.58567,5208,134.5736434,10416,-2337792,328704,-2009088,27
1235,158,23,7,0.113424264,0.886575736,382.9720176,400.5561434,738.5182186,372.4746835,1393,27.85442911,2786,-632320,80896,-551424,27
4441,645,23,7,0.126818718,0.873181282,1423.544146,1684.887822,2481.913983,2967.536434,5086,113.5014506,10172,-2273792,330240,-1943552,27
4433,684,22,8,0.133672073,0.866327927,1436.292141,1664.054998,2497.331604,2958.672515,5117,93.63220494,10234,-2269696,350208,-1919488,27
4862,648,23,7,0.117604356,0.882395644,1566.345703,1738.197191,2719.390991,3026.429012,5510,129.4642857,11020,-2489344,331776,-2157568,27
4418,586,22,8,0.117106315,0.882893685,1403.037093,1601.251757,2422.361249,3106.686007,5004,118.7188612,10008,-2262016,300032,-1961984,27
4495,616,22,8,0.120524359,0.879475641,1427.777311,1679.717485,2478.389544,3122.329545,5111,124.7498169,10222,-2301440,315392,-1986048,27
7336,524,24,6,0.0666666667,0.933333333,2211.966774,2932.856302,3906.230234,4270.276718,7860,145.232816,15720,-3756032,268288,-3487744,27
7313,564,22,8,0.0716008633,0.928399137,2208.592531,2993.801144,3934.824559,3993.140071,7877,185.5594817,15754,-3744256,288768,-3455488,27
7239,551,24,6,0.0707317073,0.929268293,2176.652935,3041.438384,3894.571073,3907.704174,7790,151.1447419,15580,-3706368,282112,-3424256,27
7230,558,23,7,0.0716486903,0.92835131,2179.325539,3000.461314,3890.491978,3946.4319,7788,186.5836128,15576,-3701760,285696,-3416064,27
7539,529,23,7,0.0655676748,0.934432325,2266.110098,3089.425163,4033.2243,4052.680529,8068,195.5878788,16136,-3859968,270848,-3589120,27
7236,554,24,6,0.0711168164,0.928883184,2177.399978,3029.363231,3889.530404,3973.471119,7790,190,15580,-3704832,283648,-3421184,27
7341,551,23,7,0.0698175367,0.930182463,2214.900915,2995.398405,3939.803705,4035.715064,7892,190.122862,15784,-3758592,282112,-3476480,27
7194,554,22,8,0.0715023232,0.928497677,2165.629038,3009.539387,3868.960801,3946.429603,7748,199.0750257,15496,-3683328,283648,-3399680,27
7209,552,23,7,0.071124855,0.928875145,2170.070093,3009.111531,3871.632543,4003.336957,7761,194.2192192,15522,-3691008,282624,-3408384,27
7231,540,24,6,0.0694891262,0.930510874,2177.219586,2988.764135,3878.481953,3986.672222,7771,309.72499,15542,-3702272,276480,-3425792,27
7237,562,23,7,0.0720605206,0.927939479,2182.118211,3003.62499,3902.38773,3869.252669,7799,173.8132382,15598,-3705344,287744,-3417600,27
7211,530,23,7,0.0684666064,0.931533394,2169.487448,2977.501069,3858.362918,4042.935849,7741,192.7539841,15482,-3692032,271360,-3420672,27
7245,558,24,6,0.0715109573,0.928489043,2181.207681,3029.612612,3899.338716,3936.553763,7803,186.2735736,15606,-3709440,285696,-3423744,27
7172,507,23,7,0.0660242219,0.933975778,2184.503378,2616.263417,3858.821807,3573.747535,7679,140.8732343,15358,-3672064,259584,-3412480,27
7208,509,23,7,0.0659582739,0.934041726,2185.336149,2754.951859,3849.16773,3998.235756,7717,146.8785687,15434,-3690496,260608,-3429888,27
6798,438,23,7,0.0605306799,0.93946932,2061.149987,2383.55598,3661.146955,2956.59589,7236,126.1066574,14472,-3480576,224256,-3256320,27
7253,560,22,8,0.0716754128,0.928324587,2185.181585,3020.190046,3901.756101,3974.917857,7813,192.7707871,15626,-3713536,286720,-3426816,27
7228,543,23,7,0.0698751769,0.930124823,2204.515975,2693.611963,3905.54026,3625.895028,7771,148.6703654,15542,-3700736,278016,-3422720,27
7443,524,23,7,0.0657713066,0.934228693,2234.500813,3061.263912,3959.593981,4330.667939,7967,180.2080977,15934,-3810816,268288,-3542528,27
5262,302,21,9,0.0542774982,0.945722502,1575.844001,1796.753254,2839.251805,1793.665563,5564,78.8213628,11128,-2694144,154624,-2539520,27
2803,299,23,7,0.0963894262,0.903610574,853.93357,1216.973843,1546.920442,1594.431438,3102,78.63117871,6204,-1435136,153088,-1282048,27
2776,295,23,7,0.0960599153,0.903940085,849.3739106,1179.780959,1533.068444,1563.586441,3071,124.5336577,6142,-1421312,151040,-1270272,27
2981,326,24,6,0.0985787723,0.901421228,918.4963316,1226.674773,1637.305602,1806.656442,3307,78.49513411,6614,-1526272,166912,-1359360,27
2877,349,22,8,0.108183509,0.891816491,882.7189178,1262.224907,1613.624261,1612.475645,3226,79.75278121,6452,-1473024,178688,-1294336,27
2850,349,22,8,0.109096593,0.890903407,877.2219012,1237.743434,1596.560351,1628.088825,3199,76.11230074,6398,-1459200,178688,-1280512,27
2886,328,23,7,0.102053516,0.897946484,884.250956,1242.006685,1595.40887,1713.887195,3214,80.79436903,6428,-1477632,167936,-1309696,27
2897,344,24,6,0.10614008,0.89385992,891.0250764,1247.020838,1612.369002,1693.686047,3241,85.0656168,6482,-1483264,176128,-1307136,27
1195,157,22,8,0.11612426,0.88387574,378.7611627,387.8723899,709.0292887,428.9044586,1352,23.85742015,2704,-611840,80384,-531456,27
2827,329,23,7,0.104245881,0.895754119,864.920348,1238.067764,1574.515741,1612.735562,3156,66.09424084,6312,-1447424,168448,-1278976,27
2871,348,24,6,0.108108108,0.891891892,882.4372955,1247.706195,1600.888889,1685.166667,3219,85.36197295,6438,-1469952,178176,-1291776,27
2872,330,24,6,0.103060587,0.896939413,881.6519788,1227.474053,1586.649025,1730.748485,3202,86.84567399,6404,-1470464,168960,-1301504,27
2845,325,22,8,0.102523659,0.897476341,873.5072805,1213.040723,1571.320211,1709.627692,3170,80.66157761,6340,-1456640,166400,-1290240,27
2938,357,23,7,0.108345979,0.891654021,902.7797693,1281.907298,1648.226344,1646.137255,3295,79.16866891,6590,-1504256,182784,-1321472,27
2578,249,24,6,0.0880792359,0.911920764,785.0061084,1020.349387,1448.518619,1056.614458,2827,116.5292663,5654,-1319936,127488,-1192448,27
2849,347,23,7,0.108573217,0.891426783,876.8660072,1235.518888,1596.012987,1618.919308,3196,84.28270042,6392,-1458688,177664,-1281024,27
3034,337,24,6,0.0999703352,0.900029665,935.417212,1253.63186,1669.924522,1830.727003,3371,78.8907091,6742,-1553408,172544,-1380864,27
3016,340,22,8,0.101311085,0.898688915,924.6288873,1292.663949,1668.15882,1770.232353,3356,85.59041061,6712,-1544192,174080,-1370112,27
2718,334,23,7,0.109436435,0.890563565,837.2051969,1178.599384,1526.694628,1524.916168,3052,59.93715632,6104,-1391616,171008,-1220608,27
2780,291,23,7,0.094757408,0.905242592,859.1577908,1111.913395,1528.344964,1609.130584,3071,61.64191088,6142,-1423360,148992,-1274368,27
2850,338,24,6,0.106022585,0.893977415,874.0415578,1242.142227,1587.541053,1653.177515,3188,84.85493745,6376,-1459200,173056,-1286144,27
9387,573,23,7,0.0575301205,0.94246988,2857.097461,3024.763875,5034.095984,4102.47993,9960,222.0240749,19920,-4806144,293376,-4512768,27
9373,588,23,7,0.0590302178,0.940969782,2824.68178,3577.454996,4998.965859,4694.615646,9961,473.4315589,19922,-4798976,301056,-4497920,27
9381,580,23,7,0.0582270856,0.941772914,2814.326473,3709.498115,5003.217248,4621.655172,9961,465.6848995,19922,-4803072,296960,-4506112,27
9395,565,23,7,0.0567269076,0.943273092,2857.340495,3023.165622,5033.715061,4095.623009,9960,205.3608247,19920,-4810240,289280,-4520960,27
9391,570,24,6,0.0572231704,0.94277683,2817.563482,3691.894476,4996.803748,4720.626316,9961,524.8155954,19922,-4808192,291840,-4516352,27
9379,582,23,7,0.0584278687,0.941572131,2817.000128,3643.564491,5017.065465,4399.800687,9961,346.7107553,19922,-4802048,297984,-4504064,27
9421,542,24,6,0.0544012848,0.945598715,2853.656248,3132.518927,5028.518204,4173.424354,9963,270.5866377,19926,-4823552,277504,-4546048,27
9425,540,23,7,0.0541896638,0.945810336,2830.952569,3504.873696,5024.061645,4266.322222,9965,706.2367116,19930,-4825600,276480,-4549120,27
9375,585,22,8,0.0587349398,0.94126506,2821.061408,3628.844359,4992.727787,4784.54188,9960,488.7144259,19920,-4800000,299520,-4500480,27
9380,579,23,7,0.0581383673,0.941861633,2845.379106,3154.825608,5041.367377,3985.827288,9959,222.6469931,19918,-4802560,296448,-4506112,27
9390,572,24,6,0.0574181891,0.942581811,2844.842019,3247.056552,5028.527263,4209.496503,9962,378.78327,19924,-4807680,292864,-4514816,27
7332,525,24,6,0.0668193967,0.933180603,2248.678021,2359.729484,3990.963857,3063.630476,7857,140.3286301,15714,-3753984,268800,-3485184,27
9414,549,23,7,0.0551038844,0.944896116,2822.456223,3675.576806,4980.338645,5010.48816,9963,416.8619247,19926,-4819968,281088,-4538880,27
9398,563,23,7,0.0565204297,0.94347957,2820.468318,3665.688941,4995.604171,4737.216696,9961,461.3710051,19922,-4811776,288256,-4523520,27
9395,565,23,7,0.0567269076,0.943273092,2829.396154,3544.717953,4993.168175,4769.849558,9960,332.7764784,19920,-4810240,289280,-4520960,27
9365,594,24,6,0.0596445426,0.940355457,2809.781619,3747.259674,4995.168179,4740.858586,9959,658.6640212,19918,-4794880,304128,-4490752,27
9409,555,24,6,0.0557005219,0.944299478,2823.323085,3655.438031,4993.367946,4798.254054,9964,439.9116998,19928,-4817408,284160,-4533248,27
9442,524,24,6,0.0525787678,0.947421232,2844.573163,3406.650819,4978.661618,5070.683206,9966,431.0553633,19932,-4834304,268288,-4566016,27
4291,269,23,7,0.0589912281,0.941008772,1290.574125,1467.748485,2329.55698,1497.959108,4560,71.33917397,9120,-2196992,137728,-2059264,27
4228,248,23,7,0.055406613,0.944593387,1267.379845,1441.86889,2285.151608,1443.165323,4476,70.37735849,8952,-2164736,126976,-2037760,27
3187,478,20,10,0.13042292,0.86957708,993.3763781,1410.285703,1816.309382,1944.282427,3665,83.08773521,7330,-1631744,244736,-1387008,27
3510,432,23,7,0.109589041,0.890410959,1103.434051,1361.226466,1940.61453,2222.444444,3942,69.64664311,7884,-1797120,221184,-1575936,27
3677,478,21,9,0.115042118,0.884957882,1158.732006,1465.598785,2057.090835,2238.843096,4155,85.93588418,8310,-1882624,244736,-1637888,27
3120,413,22,8,0.116897821,0.883102179,965.7917107,1358.582139,1757.417949,1839.387409,3533,77.66542097,7066,-1597440,211456,-1385984,27
3107,355,22,8,0.102541883,0.897458117,955.8451603,1316.861729,1720.742195,1825.653521,3462,64.46927374,6924,-1590784,181760,-1409024,27
3508,497,23,7,0.124094881,0.875905119,1100.350666,1459.039102,1961.810433,2293.730382,4005,70.38664323,8010,-1796096,254464,-1541632,27
3676,512,22,8,0.122254059,0.877745941,1159.035574,1506.223934,2067.792982,2286.248047,4188,88.95497026,8376,-1882112,262144,-1619968,27
3311,422,22,8,0.113045808,0.886954192,1022.895669,1422.051882,1842.69405,2057.703791,3733,83.79349046,7466,-1695232,216064,-1479168,27
3326,451,22,8,0.119406937,0.880593063,1030.403444,1440.575196,1860.340349,2100.356984,3777,86.1345496,7554,-1702912,230912,-1472000,27
3375,468,23,7,0.121779859,0.878220141,1047.088035,1470.520961,1897.005333,2102.25,3843,72.96373647,7686,-1728000,239616,-1488384,27
2990,353,22,8,0.105593778,0.894406222,920.0946919,1281.471439,1662.780936,1750.087819,3343,72.23422645,6686,-1530880,180736,-1350144,27
1504,203,21,9,0.118922086,0.881077914,475.4746486,404.8960918,911.0738032,431.1477833,1707,30.9912854,3414,-770048,103936,-666112,27
3040,381,20,10,0.111370944,0.888629056,939.2099793,1304.72494,1695.942434,1831.144357,3421,72.89580226,6842,-1556480,195072,-1361408,27
3119,436,22,8,0.122644163,0.877355837,971.3821346,1338.763456,1750.280218,1976.298165,3555,87.86455759,7110,-1596928,223232,-1373696,27
3713,453,22,8,0.108737398,0.891262602,1168.529841,1410.010007,2043.480474,2411.518764,4166,90.80209241,8332,-1901056,231936,-1669120,27
3605,493,23,7,0.120302587,0.879697413,1135.631302,1479.5738,2034.714008,2157.62069,4098,73.21779525,8196,-1845760,252416,-1593344,27
3350,477,22,8,0.124640711,0.875359289,1039.454617,1472.377534,1888.714925,2091.578616,3827,83.8151555,7654,-1715200,244224,-1470976,27
3092,412,22,8,0.117579909,0.882420091,960.0630065,1290.096777,1709.110931,2078.128641,3504,75.06426735,7008,-1583104,210944,-1372160,27
3166,445,23,7,0.123234561,0.876765439,986.4529538,1358.354089,1776.825648,2013.564045,3611,71.93227092,7222,-1620992,227840,-1393152,27
3569,529,22,8,0.12908736,0.87091264,1120.102219,1525.636071,2018.856262,2256.243856,4098,81.53601273,8196,-1827328,270848,-1556480,27
1612,182,24,6,0.101449275,0.898550725,493.4560828,647.12751,925.4565757,649.8846154,1794,50.05580357,3588,-825344,93184,-732160,27
1972,282,24,6,0.125110914,0.874889086,611.9281106,866.8056398,1111.606491,1238.641844,2254,57.70609319,4508,-1009664,144384,-865280,27
1958,279,22,8,0.124720608,0.875279392,606.8339783,870.4628418,1113.754852,1155.810036,2237,60.29649596,4474,-1002496,142848,-859648,27
2011,310,24,6,0.133563119,0.866436881,627.3988692,896.4735168,1152.003481,1219.36129,2321,60.14511531,4642,-1029632,158720,-870912,27
1969,294,24,6,0.129916041,0.870083959,616.1238982,857.3219668,1119.877603,1213.187075,2263,47.85366885,4526,-1008128,150528,-857600,27
61,20,20,10,0.24691358,0.75308642,22.73685982,24.1947825,43.04918033,34.75,81,3.09751434,162,-31232,10240,-20992,27
1978,300,23,7,0.131694469,0.868305531,616.5270333,879.4293403,1130.445905,1199.196667,2278,63.86319036,4556,-1012736,153600,-859136,27
1992,309,22,8,0.134289439,0.865710561,620.5609617,895.6721837,1146.978916,1176.92233,2301,60.34618411,4602,-1019904,158208,-861696,27
1599,173,22,8,0.0976297968,0.902370203,485.4044127,664.1606531,911.9480926,651.2890173,1772,73.07216495,3544,-818688,88576,-730112,27
2013,290,24,6,0.12592271,0.87407729,625.3740922,889.0407462,1142.623944,1217.082759,2303,56.44607843,4606,-1030656,148480,-882176,27
1965,282,22,8,0.125500668,0.874499332,610.092686,869.8526169,1117.534351,1169.053191,2247,52.70935961,4494,-1006080,144384,-861696,27
64,52,24,6,0.448275862,0.551724138,28.87709256,29.47380619,43.640625,76.78846154,116,5.258386219,232,-32768,26624,-6144,27
1611,173,22,8,0.0969730942,0.903026906,496.2940686,636.2927081,911.9900683,711.0057803,1784,38.81636205,3568,-824832,88576,-736256,27
1920,259,24,6,0.118861863,0.881138137,593.8238449,840.7136184,1078.705729,1173.725869,2179,61.78055004,4358,-983040,132608,-850432,27
1953,271,24,6,0.121852518,0.878147482,607.29242,849.4479753,1105.117768,1165.701107,2224,53.24395499,4448,-999936,138752,-861184,27
2003,295,23,7,0.128372498,0.871627502,623.8200319,885.8529495,1145.067898,1179.59322,2298,59.64183753,4596,-1025536,151040,-874496,27
2025,276,23,7,0.119947849,0.880052151,629.5469512,866.0798549,1132.711605,1285.181159,2301,58.35658128,4602,-1036800,141312,-895488,27
2036,285,23,7,0.1227919,0.8772081,633.9108284,882.8329642,1150.982809,1232.561404,2321,51.28148475,4642,-1042432,145920,-896512,27
2033,303,22,8,0.129708904,0.870291096,631.2912009,910.5228149,1161.074274,1218.323432,2336,63.47826087,4672,-1040896,155136,-885760,27
2064,295,23,7,0.125052989,0.874947011,639.0752229,921.2539615,1173.868217,1222.901695,2359,64.45355191,4718,-1056768,151040,-905728,27
9438,528,23,7,0.0529801325,0.947019868,2842.380839,3241.93375,5045.557533,3874.221591,9966,502.5718608,19932,-4832256,270336,-4561920,27
9509,465,24,6,0.0466212152,0.953378785,2850.304579,3089.872126,5057.245347,3561.245161,9974,1114.413408,19948,-4868608,238080,-4630528,27
9501,473,22,8,0.0474233006,0.952576699,2846.29104,3120.56796,5061.861488,3493.824524,9974,1357.006803,19948,-4864512,242176,-4622336,27
9509,465,24,6,0.0466212152,0.953378785,2850.865665,3099.981379,5055.121148,3604.683871,9974,1047.689076,19948,-4868608,238080,-4630528,27
9500,473,22,8,0.0474280558,0.952571944,2847.238721,3107.243626,5060.396947,3512.854123,9973,1392.877095,19946,-4864000,242176,-4621824,27
9517,458,23,7,0.045914787,0.954085213,2852.699835,3103.933607,5051.999159,3658.131004,9975,1179.078014,19950,-4872704,234496,-4638208,27
9417,549,24,6,0.0550872968,0.944912703,2848.224974,3173.629339,5040.857704,3999.642987,9966,297.9372197,19932,-4821504,281088,-4540416,27
9457,510,22,8,0.0511688572,0.948831143,2849.061656,3216.887797,5034.400233,4049.421569,9967,796.7226219,19934,-4841984,261120,-4580864,27
966,135,24,6,0.122615804,0.877384196,305.2102785,248.1866895,591.4927536,261.2518519,1101,21.11217641,2202,-494592,69120,-425472,27
9450,516,23,7,0.0517760385,0.948223961,2843.414702,3257.445247,5041.2,3926.784884,9966,638.4368994,19932,-4838400,264192,-4574208,27
9467,503,22,8,0.0504513541,0.949548646,2848.683772,3237.037848,5036.613394,4023.491054,9970,732.5495959,19940,-4847104,257536,-4589568,27
9497,477,24,6,0.0478243433,0.952175657,2846.246425,3125.251617,5061.578709,3512.603774,9974,887.366548,19948,-4862464,244224,-4618240,27
9497,477,24,6,0.0478243433,0.952175657,2850.842847,3069.404751,5058.678004,3570.356394,9974,1032.505176,19948,-4862464,244224,-4618240,27
9501,472,23,7,0.047327785,0.952672215,2850.316544,3112.399586,5053.914325,3640.065678,9973,1100.772627,19946,-4864512,241664,-4622848,27
9554,422,24,6,0.0423015237,0.957698476,2872.722382,2904.809695,5026.681704,4124.07346,9976,807.1197411,19952,-4891648,216064,-4675584,27
9443,523,23,7,0.0524784267,0.947521573,2849.447735,3123.571256,5046.422218,3847.41109,9966,893.0107527,19932,-4834816,267776,-4567040,27
9511,463,24,6,0.0464206938,0.953579306,2846.877677,3111.943422,5061.346756,3470.531317,9974,1257.755359,19948,-4869632,237056,-4632576,27
9503,469,23,7,0.0470316887,0.952968311,2850.965104,3111.661937,5051.505314,3669.345416,9972,993.2270916,19944,-4865536,240128,-4625408,27
9508,465,24,6,0.0466258899,0.95337411,2846.365025,3135.836274,5058.952566,3515.763441,9973,1003.31992,19946,-4868096,238080,-4630016,27
9511,463,24,6,0.0464206938,0.953579306,2853.621731,3093.702322,5050.146041,3700.617711,9974,1285.309278,19948,-4869632,237056,-4632576,27
3276,289,20,10,0.0810659187,0.918934081,1009.011766,1230.668561,1791.149573,1690.619377,3565,179.1457286,7130,-1677312,147968,-1529344,28
1431,143,20,10,0.0908513342,0.909148666,448.382281,410.1865166,816.453529,497.7622378,1574,27.90780142,3148,-732672,73216,-659456,28
4695,349,20,10,0.0691911182,0.930808882,1427.332156,1798.02971,2519.084558,2568.446991,5044,403.8430745,10088,-2403840,178688,-2225152,28
3367,303,19,11,0.0825613079,0.917438692,1037.870456,1274.149136,1832.059994,1873.726073,3670,200.8757526,7340,-1723904,155136,-1568768,28
4711,341,20,10,0.0674980206,0.932501979,1429.788457,1807.636353,2525.035024,2546.739003,5052,306.1818182,10104,-2412032,174592,-2237440,28
3255,270,20,10,0.0765957447,0.923404255,996.8728617,1238.754804,1767.933333,1703.525926,3525,142.7125506,7050,-1666560,138240,-1528320,28
1642,169,20,10,0.0933186085,0.906681391,510.2948103,558.8439477,934.8118149,626.0650888,1811,31.52855153,3622,-840704,86528,-754176,28
8795,1085,20,10,0.109817814,0.890182186,2877.66644,2635.801844,4941.745196,4930.406452,9880,816.5289256,19760,-4503040,555520,-3947520,28
3401,304,20,10,0.0820512821,0.917948718,1045.323813,1310.112853,1854.935607,1831.345395,3705,131.8036286,7410,-1741312,155648,-1585664,28
8224,1266,20,10,0.133403583,0.866596417,2710.54336,2844.676474,4650.555204,5362.266193,9490,175.5132236,18980,-4210688,648192,-3562496,28
3406,309,20,10,0.0831763122,0.916823688,1048.60269,1306.206835,1855.324134,1887.495146,3715,174.8235294,7430,-1743872,158208,-1585664,28
4706,346,19,11,0.0684877276,0.931512272,1429.594486,1804.822822,2524.972588,2547.274566,5052,294.9211909,10104,-2409472,177152,-2232320,28
8286,1218,20,10,0.128156566,0.871843434,2709.012135,2882.080622,4655.19551,5414.458128,9504,175.739645,19008,-4242432,623616,-3618816,28
3158,266,20,10,0.0776869159,0.922313084,969.5544124,1176.766098,1726.70266,1543.883459,3424,216.57179,6848,-1616896,136192,-1480704,28
4586,319,20,10,0.0650356779,0.934964322,1390.045868,1746.397293,2452.596816,2458.796238,4905,306.7542214,9810,-2348032,163328,-2184704,28
4695,354,20,10,0.0701128936,0.929887106,1428.390641,1798.816644,2520.64984,2582.694915,5049,243.5600579,10098,-2403840,181248,-2222592,28
4715,356,20,10,0.0702031158,0.929796884,1436.998917,1780.06348,2530.0193,2615.210674,5071,312.8315854,10142,-2414080,182272,-2231808,28
4547,312,20,10,0.064210743,0.935789257,1379.449135,1682.597977,2448.533759,2159.894231,4859,343.3922261,9718,-2328064,159744,-2168320,28
8136,1326,20,10,0.140139505,0.859860495,2675.279925,2909.530308,4591.461037,5590.74359,9462,167.9744364,18924,-4165632,678912,-3486720,28
4443,288,20,10,0.0608750793,0.939124921,1348.48592,1538.166504,2395.527797,1910.472222,4731,97.50618302,9462,-2274816,147456,-2127360,28
612,88,22,8,0.125714286,0.874285714,197.5995455,228.9999027,354.3611111,323.6477273,700,92.34828496,1400,-313344,45056,-268288,28
600,92,21,9,0.132947977,0.867052023,194.6783608,229.3778118,349.25,328.5652174,692,56.48979592,1384,-307200,47104,-260096,28
607,93,22,8,0.132857143,0.867142857,197.384009,229.9625425,352.3822076,338.2150538,700,77.3480663,1400,-310784,47616,-263168,28
605,93,22,8,0.133237822,0.866762178,196.6688222,230.173551,351.0760331,339.2473118,698,99.85693848,1396,-309760,47616,-262144,28
615,94,22,8,0.1325811,0.8674189,199.6622442,234.5386592,356.6243902,344.3723404,709,88.07453416,1418,-314880,48128,-266752,28
606,91,22,8,0.130559541,0.869440459,197.2219703,225.5417817,350.9125413,336.2637363,697,73.83474576,1394,-310272,46592,-263680,28
607,90,22,8,0.129124821,0.870875179,196.8765338,227.277844,351.9472817,329.1222222,697,96.53739612,1394,-310784,46080,-264704,28
606,89,22,8,0.128057554,0.871942446,196.0055507,228.3510024,351.3432343,325.2359551,695,63.52833638,1390,-310272,45568,-264704,28
598,92,22,8,0.133333333,0.866666667,194.364948,227.4469472,347.8729097,330.076087,690,102.0710059,1380,-306176,47104,-259072,28
614,93,22,8,0.131541726,0.868458274,199.4407731,232.0259179,356.0586319,340.4086022,707,84.67065868,1414,-314368,47616,-266752,28
617,96,22,8,0.134642356,0.865357644,201.1708936,232.922989,359.445705,341.28125,713,87.699877,1426,-315904,49152,-266752,28
611,89,22,8,0.127142857,0.872857143,198.1880825,224.9320991,354.6104746,322.2808989,700,79.63594994,1400,-312832,45568,-267264,28
612,92,22,8,0.130681818,0.869318182,198.8046096,230.4460231,353.1764706,348,704,63.30935252,1408,-313344,47104,-266240,28
610,90,22,8,0.128571429,0.871428571,197.6085809,228.7817398,353.8295082,327.9333333,700,66.10009443,1400,-312320,46080,-266240,28
616,89,22,8,0.126241135,0.873758865,198.5022054,235.2595689,353.6314935,348.6292135,705,82.94117647,1410,-315392,45568,-269824,28
76,17,22,8,0.182795699,0.817204301,25.96818784,29.42364466,48.59210526,39.88235294,93,1.506072874,186,-38912,8704,-30208,28
608,92,22,8,0.131428571,0.868571429,198.0402503,225.7568336,353.7434211,329.0652174,700,97.62900976,1400,-311296,47104,-264192,28
608,90,22,8,0.128939828,0.871060172,197.1650768,227.1677742,353.0394737,325.5888889,698,70.43390515,1396,-311296,46080,-265216,28
605,91,21,9,0.130747126,0.869252874,196.2161413,228.8029011,351.4099174,329.1538462,696,74.75832438,1392,-309760,46592,-263168,28
622,90,21,9,0.126404494,0.873595506,200.4300492,237.6455554,357.8311897,347.3,712,84.76190476,1424,-318464,46080,-272384,28
613,89,22,8,0.126780627,0.873219373,198.2530957,229.7813021,354.2398042,332.6292135,702,86.77379481,1404,-313856,45568,-268288,28
602,89,22,8,0.128798842,0.871201158,194.7226142,227.9906863,349.0232558,325.5505618,691,80.63010502,1382,-308224,45568,-262656,28
610,89,22,8,0.12732475,0.87267525,197.6130909,226.9114557,353.4606557,326.2808989,699,76.22682661,1398,-312320,45568,-266752,28
611,91,22,8,0.12962963,0.87037037,198.1536284,229.3688605,354.7774141,329.4945055,702,86.45320197,1404,-312832,46592,-266240,28
330,39,22,8,0.105691057,0.894308943,104.4208326,96.36239947,193.5181818,112.9230769,369,60.591133,738,-168960,19968,-148992,28
49,14,20,10,0.222222222,0.777777778,17.88523737,18.28683032,33.46938776,26.85714286,63,15.32846715,126,-25088,7168,-17920,28
327,37,22,8,0.101648352,0.898351648,102.6716667,97.11552841,190.8256881,108.9189189,364,34.0505145,728,-167424,18944,-148480,28
623,89,22,8,0.125,0.875,201.252697,232.2070969,359.5569823,335.1011236,712,114.1025641,1424,-318976,45568,-273408,28
604,92,22,8,0.132183908,0.867816092,197.1025828,222.524723,352.5629139,321.826087,696,65.90909091,1392,-309248,47104,-262144,28
48,13,21,9,0.213114754,0.786885246,17.21008617,18.14471739,32.35416667,26,61,17.03910615,122,-24576,6656,-17920,28
617,92,22,8,0.129760226,0.870239774,200.0188107,233.3044947,356.273906,346.4565217,709,72.27319062,1418,-315904,47104,-268800,28
616,94,21,9,0.132394366,0.867605634,200.0212514,234.3899996,357.3766234,343.2021277,710,72.37512742,1420,-315392,48128,-267264,28
609,92,22,8,0.131241084,0.868758916,198.033219,227.9533879,354.0131363,331.0543478,701,68.99606299,1402,-311808,47104,-264704,28
608,92,22,8,0.131428571,0.868571429,197.6232096,227.8689293,354.1266447,326.5326087,700,90.43927649,1400,-311296,47104,-264192,28
621,88,22,8,0.124118477,0.875881523,200.4645114,231.7168804,356.9758454,341.0568182,709,65.10560147,1418,-317952,45056,-272896,28
47,13,22,8,0.216666667,0.783333333,16.88214413,18.26983805,31.59574468,26.53846154,60,9.538950715,120,-24064,6656,-17408,28
46,13,21,9,0.220338983,0.779661017,16.62229127,17.73906864,31.2173913,25.69230769,59,4.281567489,118,-23552,6656,-16896,28
599,94,22,8,0.135642136,0.864357864,195.4335567,226.2670468,350.1368948,327.0106383,693,72.33820459,1386,-306688,48128,-258560,28
623,97,22,8,0.134722222,0.865277778,201.5556901,244.0790822,358.6388443,372.4536082,720,12.77501774,1440,-318976,49664,-269312,28
613,93,22,8,0.131728045,0.868271955,199.3821083,230.1340724,356.0570962,336.6451613,706,110.8320251,1412,-313856,47616,-266240,28
607,90,22,8,0.129124821,0.870875179,196.3456964,230.5909716,351.568369,331.6777778,697,106.0882801,1394,-310784,46080,-264704,28
616,93,22,8,0.131170663,0.868829337,200.4243035,230.6965509,356.112013,347.6344086,709,66.38576779,1418,-315392,47616,-267776,28
601,89,22,8,0.128985507,0.871014493,194.8486455,224.6561142,349.2712146,320.0337079,690,64.305685,1380,-307712,45568,-262144,28
597,93,22,8,0.134782609,0.865217391,194.4219837,226.3563494,348.6549414,325.2473118,690,91.26984127,1380,-305664,47616,-258048,28
615,94,22,8,0.1325811,0.8674189,199.7607623,233.5289415,357.6455285,337.6914894,709,91.48387097,1418,-314880,48128,-266752,28
315,35,22,8,0.1,0.9,98.50247365,94.55463813,183.5396825,103.1428571,350,50.28735632,700,-161280,17920,-143360,28
608,94,22,8,0.133903134,0.866096866,198.0593,228.9498661,354.8634868,329.7446809,702,118.7817259,1404,-311296,48128,-263168,28
614,90,21,9,0.127840909,0.872159091,198.3896147,232.0784746,356.1091205,327.8777778,704,72.27926078,1408,-314368,46080,-268288,28
47,14,20,10,0.229508197,0.770491803,17.29398559,17.87541922,32.36170213,26.42857143,61,9.791332263,122,-24064,7168,-16896,28
605,91,22,8,0.130747126,0.869252874,195.9950332,230.2729567,351.0561983,331.5054945,696,91.09947644,1392,-309760,46592,-263168,28
592,88,22,8,0.129411765,0.870588235,191.6732667,222.5541834,345.0489865,309.8977273,680,60.17699115,1360,-303104,45056,-258048,28
596,93,22,8,0.134978229,0.865021771,194.3309435,224.9536153,348.1208054,325,689,115.993266,1378,-305152,47616,-257536,28
76,17,22,8,0.182795699,0.817204301,25.94643427,29.52659935,48.57894737,39.94117647,93,1.512933138,186,-38912,8704,-30208,28
607,91,22,8,0.130372493,0.869627507,196.6039543,230.6091339,352.3228995,330.6703297,698,63.3969119,1396,-310784,46592,-264192,28
610,92,22,8,0.131054131,0.868945869,197.6197045,232.4443799,354.2622951,333.1847826,702,95.64032698,1404,-312320,47104,-265216,28
613,86,22,8,0.123032904,0.876967096,197.7593038,227.8023113,352.2137031,334.2209302,699,56.64505673,1398,-313856,44032,-269824,28
616,92,22,8,0.129943503,0.870056497,199.7775719,231.6884693,357.7727273,332.5869565,708,92.1875,1416,-315392,47104,-268288,28
616,100,22,8,0.139664804,0.860335196,199.5920808,245.7512352,357.0357143,367.52,716,12.53281988,1432,-315392,51200,-264192,28
601,88,21,9,0.127721335,0.872278665,193.5833819,230.2467547,348.8419301,318.7613636,689,81.82897862,1378,-307712,45056,-262656,28
612,91,22,8,0.129445235,0.870554765,198.2874214,231.3106569,354.1013072,337.8681319,703,87.98498123,1406,-313344,46592,-266752,28
616,88,22,8,0.125,0.875,198.5476397,232.9771849,354.3100649,339.8295455,704,89.68152866,1408,-315392,45056,-270336,28
607,85,22,8,0.12283237,0.87716763,195.48302,226.4273132,350.0098847,321.4352941,692,80.46511628,1384,-310784,43520,-267264,28
610,92,22,8,0.131054131,0.868945869,198.2651482,229.0510884,353.757377,336.5326087,702,80.50458716,1404,-312320,47104,-265216,28
607,86,22,8,0.124098124,0.875901876,195.1516624,231.4513418,348.446458,336.7906977,693,87.72151899,1386,-310784,44032,-266752,28
612,95,22,8,0.13437058,0.86562942,201.8657144,210.0656344,362.3611111,300.1368421,707,79.34904602,1414,-313344,48640,-264704,28
604,91,21,9,0.130935252,0.869064748,195.3810966,231.5597538,350.8990066,328.7582418,695,88.76117497,1390,-309248,46592,-262656,28
604,93,22,8,0.133428981,0.866571019,196.3935647,229.4518409,351.3278146,333.8817204,697,106.9018405,1394,-309248,47616,-261632,28
606,90,22,8,0.129310345,0.870689655,196.0646679,230.4536417,350.6072607,334.3111111,696,69.11618669,1392,-310272,46080,-264192,28
623,92,22,8,0.128671329,0.871328671,201.6159349,235.9880355,359.6131621,347.076087,715,87.83783784,1430,-318976,47104,-271872,28
608,92,22,8,0.131428571,0.868571429,197.5209276,229.4020282,352.6266447,336.4456522,700,78.91770011,1400,-311296,47104,-264192,28
605,89,22,8,0.128242075,0.871757925,195.9915754,226.8759699,350.1768595,329.3033708,694,66.34799235,1388,-309760,45568,-264192,28
86,24,22,8,0.218181818,0.781818182,30.59543404,35.39771552,56.41860465,52.20833333,110,2.120277564,220,-44032,12288,-31744,28
221,24,22,8,0.0979591837,0.902040816,69.11704823,62.8370357,128.7647059,69.91666667,245,18.75957121,490,-113152,12288,-100864,28
615,104,22,8,0.144645341,0.855354659,200.3071662,245.9367793,358.5886179,368.3461538,719,12.5523743,1438,-314880,53248,-261632,28
603,92,22,8,0.132374101,0.867625899,196.2805492,225.6182021,351.6533997,324.0543478,695,64.05529954,1390,-308736,47104,-261632,28
589,84,22,8,0.124814264,0.875185736,190.1116293,221.0492177,338.4074703,327.1309524,673,121.2612613,1346,-301568,43008,-258560,28
318,36,22,8,0.101694915,0.898305085,99.67663001,93.12997025,185.9842767,102.5555556,354,40,708,-162816,18432,-144384,28
608,87,22,8,0.125179856,0.874820144,196.2950585,228.0161161,350.25,332.2758621,695,72.69874477,1390,-311296,44544,-266752,28
590,89,21,9,0.13107511,0.86892489,190.9517393,224.9444578,343.9677966,313.6966292,679,49.38181818,1358,-302080,45568,-256512,28
608,94,22,8,0.133903134,0.866096866,197.8741659,230.5045286,354.0180921,335.212766,702,27.52941176,1404,-311296,48128,-263168,28
321,37,22,8,0.103351955,0.896648045,101.1191109,95.76395378,187.5638629,109.5405405,358,51.43678161,716,-164352,18944,-145408,28
610,90,22,8,0.128571429,0.871428571,197.4752577,230.1357184,352.9639344,333.8,700,52.91005291,1400,-312320,46080,-266240,28
608,92,22,8,0.131428571,0.868571429,197.6792008,228.0787027,353.3881579,331.4130435,700,81.49010477,1400,-311296,47104,-264192,28
618,96,21,9,0.134453782,0.865546218,200.9596901,235.7765391,360.3867314,338.9166667,714,94.94680851,1428,-316416,49152,-267264,28
606,84,22,8,0.12173913,0.87826087,194.4498242,229.70827,347.9570957,327.7738095,690,64.48598131,1380,-310272,43008,-267264,28
614,88,22,8,0.125356125,0.874643875,198.137819,231.50331,352.7736156,342.6136364,702,72.44582043,1404,-314368,45056,-269312,28
615,96,22,8,0.135021097,0.864978903,200.7842901,230.2196179,359.9382114,330.7708333,711,106.7567568,1422,-314880,49152,-265728,28
615,88,22,8,0.125177809,0.874822191,198.3039429,232.3036883,353.9609756,338.2954545,703,82.22222222,1406,-314880,45056,-269824,28
616,92,22,8,0.129943503,0.870056497,198.7916463,238.081873,356.3668831,342,708,71.22736419,1416,-315392,47104,-268288,28
619,103,22,8,0.14265928,0.85734072,201.340148,245.9619993,358.4749596,379.6796117,722,12.65778401,1444,-316928,52736,-264192,28
322,38,22,8,0.105555556,0.894444444,101.5138245,97.37526647,188.7857143,110.2894737,360,57.32484076,720,-164864,19456,-145408,28
615,93,22,8,0.131355932,0.868644068,199.9970087,230.4085033,357.3512195,335.6451613,708,56.50438947,1416,-314880,47616,-267264,28
609,93,22,8,0.132478632,0.867521368,198.3514342,228.3097463,353.6502463,337.4193548,702,41.78571429,1404,-311808,47616,-264192,28
618,98,22,8,0.136871508,0.863128492,201.5198459,236.404285,360.2831715,347.255102,716,50.24561404,1432,-316416,50176,-266240,28
623,95,22,8,0.132311978,0.867688022,202.4756682,235.8311349,361.6195827,345.6,718,62.38053866,1436,-318976,48640,-270336,28
615,94,22,8,0.1325811,0.8674189,200.3716066,229.6590955,358.304065,333.3829787,709,85.93939394,1418,-314880,48128,-266752,28
601,90,22,8,0.13024602,0.86975398,194.933827,225.8252545,349.828619,320.4333333,691,67.81157998,1382,-307712,46080,-261632,28
610,89,22,8,0.12732475,0.87267525,197.474737,227.2780304,353.9803279,322.7191011,699,48.34024896,1398,-312320,45568,-266752,28
614,90,22,8,0.127840909,0.872159091,198.5887488,231.2145338,355.728013,330.4777778,704,79.72819932,1408,-314368,46080,-268288,28
324,38,21,9,0.104972376,0.895027624,101.9469745,96.32498159,190.191358,107.3947368,362,47.07412224,724,-165888,19456,-146432,28
4427,2082,22,8,0.319864803,0.680135197,1830.555163,1311.75532,2680.779083,4475.977906,6509,146.072711,13018,-2266624,1065984,-1200640,28
4150,516,22,8,0.110587227,0.889412773,1329.761016,1431.470544,2290.350843,2680.532946,4666,88.12086874,9332,-2124800,264192,-1860608,28
3819,454,22,8,0.106248537,0.893751463,1221.199594,1306.696586,2107.637601,2383.993392,4273,94.01540154,8546,-1955328,232448,-1722880,28
3768,1831,22,8,0.327022683,0.672977317,1318.128147,1281.604561,2136.485669,4165.440743,5599,219.7409733,11198,-1929216,937472,-991744,28
4471,609,22,8,0.11988189,0.88011811,1442.537004,1564.53502,2481.402147,2974.369458,5080,92.41404402,10160,-2289152,311808,-1977344,28
3615,445,22,8,0.109605911,0.890394089,1151.122207,1283.83182,1990.292946,2357.125843,4060,154.3726236,8120,-1850880,227840,-1623040,28
3795,2067,22,8,0.352610031,0.647389969,1305.620402,1273.23654,2126.967062,4408.617804,5862,198.7118644,11724,-1943040,1058304,-884736,28
4322,2122,22,8,0.329298572,0.670701428,1633.363538,1413.934438,2517.352846,4658.713949,6444,143.1363838,12888,-2212864,1086464,-1126400,28
47,13,21,9,0.216666667,0.783333333,16.87181722,18.14471739,31.74468085,26,60,9.160305344,120,-24064,6656,-17408,28
3762,1806,22,8,0.324353448,0.675646552,1299.361084,1279.004606,2122.735779,4162.992248,5568,180.0776197,11136,-1926144,924672,-1001472,28
48,13,21,9,0.213114754,0.786885246,17.21008617,18.14471739,32.35416667,26,61,15.4040404,122,-24576,6656,-17920,28
3627,453,22,8,0.111029412,0.888970588,1150.609157,1301.965028,1987.982355,2460.988962,4080,150.2209131,8160,-1857024,231936,-1625088,28
3662,475,22,8,0.114817501,0.885182499,1167.028972,1326.517314,2019.865647,2447.8,4137,154.308094,8274,-1874944,243200,-1631744,28
4322,2088,22,8,0.32574103,0.67425897,1626.203585,1394.808028,2507.948635,4649.377874,6410,143.7219731,12820,-2212864,1069056,-1143808,28
4193,508,22,8,0.108062114,0.891937886,1338.620143,1443.592853,2304.103744,2738.07874,4701,105.8545373,9402,-2146816,260096,-1886720,28
3249,368,22,8,0.101741775,0.898258225,1034.685636,1105.786468,1787.278547,2000.774457,3617,122.5686208,7234,-1663488,188416,-1475072,28
4229,523,22,8,0.110058923,0.889941077,1350.760692,1481.707452,2331.442185,2740.839388,4752,107.877412,9504,-2165248,267776,-1897472,28
4013,2114,22,8,0.345030194,0.654969806,1389.217677,1366.082588,2262.19063,4586.072375,6127,168.8343896,12254,-2054656,1082368,-972288,28
4239,507,22,8,0.106826802,0.893173198,1350.695621,1462.082062,2325.585751,2774.108481,4746,97.21425645,9492,-2170368,259584,-1910784,28
4544,3674,22,8,0.447067413,0.552932587,1953.868137,1668.213127,2753.864437,5786.148884,8218,184.7156664,16436,-2326528,1881088,-445440,28
619,90,22,8,0.126939351,0.873060649,199.699369,235.3463001,357.4588045,338.0888889,709,23.34540665,1418,-316928,46080,-270848,28
626,93,22,8,0.129346314,0.870653686,202.9761943,235.1833778,362.8674121,340.6989247,719,104.0520984,1438,-320512,47616,-272896,28
612,90,22,8,0.128205128,0.871794872,198.0183975,231.5408867,352.6813725,343.4666667,702,62.5111309,1404,-313344,46080,-267264,28
600,87,22,8,0.126637555,0.873362445,193.7298053,225.4671995,348.0766667,315.8850575,687,73.08510638,1374,-307200,44544,-262656,28
608,90,22,8,0.128939828,0.871060172,196.4227758,232.2806521,351.8157895,333.8555556,698,40.39351852,1396,-311296,46080,-265216,28
609,90,22,8,0.128755365,0.871244635,197.2773969,228.8088104,353.180624,328.4777778,699,110.0787402,1398,-311808,46080,-265728,28
600,94,21,9,0.135446686,0.864553314,195.5605133,227.2573858,350.975,325.3191489,694,102.8148148,1388,-307200,48128,-259072,28
320,38,21,9,0.106145251,0.893854749,100.9522222,95.84831911,187.909375,108.6842105,358,35.16699411,716,-163840,19456,-144384,28
601,101,22,8,0.143874644,0.856125356,195.4922063,240.6348114,349.8036606,361.5940594,702,12.38969291,1404,-307712,51712,-256000,28
608,91,22,8,0.13018598,0.86981402,198.2573506,222.8150241,353.1069079,329.2417582,699,48.47434119,1398,-311296,46592,-264704,28
610,91,22,8,0.129814551,0.870185449,198.273355,226.9143404,353.9114754,331.4835165,701,94.72972973,1402,-312320,46592,-265728,28
617,97,21,9,0.135854342,0.864145658,201.1031369,234.788346,360.1799028,340.4536082,714,102.7338129,1428,-315904,49664,-266240,28
575,79,22,8,0.120795107,0.879204893,185.1847508,206.6256772,334.2817391,278.1392405,654,86.73740053,1308,-294400,40448,-253952,28
522,79,22,8,0.131447587,0.868552413,166.4413442,214.33573,300.9061303,301.6202532,601,49.75165563,1202,-267264,40448,-226816,28
617,93,22,8,0.130985915,0.869014085,200.2951046,233.0566116,357.643436,341.2795699,710,52.5147929,1420,-315904,47616,-268288,28
612,93,21,9,0.131914894,0.868085106,199.8131899,221.4415896,359.6552288,309.2043011,705,72.23360656,1410,-313344,47616,-265728,28
599,83,22,8,0.12170088,0.87829912,192.0792152,227.0950282,344.8196995,317.5421687,682,97.15099715,1364,-306688,42496,-264192,28
603,91,22,8,0.131123919,0.868876081,195.2497383,230.5121016,350.1111111,330.1978022,694,68.30708661,1388,-308736,46592,-262144,28
604,90,22,8,0.129682997,0.870317003,195.9159196,226.0516558,351.4387417,321.0666667,694,81.16959064,1388,-309248,46080,-263168,28
318,36,22,8,0.101694915,0.898305085,99.82405039,92.82064878,185.8459119,103.7777778,354,58.31960461,708,-162816,18432,-144384,28
3708,339,23,7,0.0837657524,0.916234248,1148.344606,1367.270942,2022.561219,2039.737463,4047,266.0749507,8094,-1898496,173568,-1724928,28
3765,354,22,8,0.0859431901,0.91405681,1158.380097,1470.445135,2048.13413,2186.200565,4119,251.1585366,8238,-1927680,181248,-1746432,28
3742,350,22,8,0.0855327468,0.914467253,1154.484636,1432.385472,2036.598343,2152.362857,4092,209.8461538,8184,-1915904,179200,-1736704,28
3639,342,23,7,0.0859080633,0.914091937,1127.438826,1359.25037,1993.319318,1966.321637,3981,239.8192771,7962,-1863168,175104,-1688064,28
3704,355,23,7,0.0874599655,0.912540034,1147.406682,1399.440897,2035.13067,1976.467606,4059,238.9052384,8118,-1896448,181760,-1714688,28
4548,397,23,7,0.0802831143,0.919716886,1392.483344,1748.076158,2501.16117,2150.387909,4945,290.5405405,9890,-2328576,203264,-2125312,28
3681,353,23,7,0.0875061973,0.912493803,1141.183773,1383.571635,2022.343928,1966.988669,4034,194.035594,8068,-1884672,180736,-1703936,28
3724,359,23,7,0.0879255449,0.912074455,1147.996121,1459.00634,2039.694146,2065.91922,4083,194.613918,8166,-1906688,183808,-1722880,28
4516,363,23,7,0.0744004919,0.925599508,1374.016079,1720.285922,2475.954384,1992.699725,4879,214.2731664,9758,-2312192,185856,-2126336,28
3712,349,23,7,0.0859394238,0.914060576,1150.310659,1382.698267,2037.911099,1957.492837,4061,104.6379799,8122,-1900544,178688,-1721856,28
3637,360,23,7,0.0900675507,0.909932449,1127.625221,1390.122055,2004.166346,1946.805556,3997,231.9791062,7994,-1862144,184320,-1677824,28
3644,366,23,7,0.0912718204,0.90872818,1129.759349,1403.751476,2010.939901,1951.338798,4010,275.4120879,8020,-1865728,187392,-1678336,28
3635,365,23,7,0.09125,0.90875,1129.602565,1377.516132,2008.358184,1922.241096,4000,251.2562814,8000,-1861120,186880,-1674240,28
4400,372,23,7,0.077954736,0.922045264,1343.657743,1667.423546,2423.568182,1948.05914,4772,326.8493151,9544,-2252800,190464,-2062336,28
3639,356,23,7,0.0891113892,0.910888611,1133.268978,1339.985885,2001.753504,1959.632022,3995,256.254009,7990,-1863168,182272,-1680896,28
3622,356,23,7,0.0894922071,0.910507793,1122.866169,1380.944773,1991.725842,1966.853933,3978,244.0490798,7956,-1854464,182272,-1672192,28
3685,362,23,7,0.0894489745,0.910551025,1137.266423,1439.00473,2010.188874,2164.59116,4047,250.2782931,8094,-1886720,185344,-1701376,28
3620,334,23,7,0.0844714213,0.915528579,1119.414701,1354.291676,1969.612155,2062.991018,3954,212.4664159,7908,-1853440,171008,-1682432,28
4587,385,23,7,0.0774336283,0.922566372,1402.27762,1778.55864,2495.676695,2377.166234,4972,227.7599634,9944,-2348544,197120,-2151424,28
3624,353,23,7,0.0887603721,0.911239628,1124.775189,1363.744544,1992.702815,1950.985836,3977,274.0868367,7954,-1855488,180736,-1674752,28
2355,238,23,7,0.0917855766,0.908214423,743.7777383,720.2312326,1264.794904,1615.668067,2593,92.97239154,5186,-1205760,121856,-1083904,28
2510,282,23,7,0.101002865,0.898997135,807.4155193,762.4699413,1373.248207,1603.457447,2792,50.31537214,5584,-1285120,144384,-1140736,28
1970,221,23,7,0.100867184,0.899132816,629.6722947,617.3215835,1072.06599,1309.348416,2191,84.46414803,4382,-1008640,113152,-895488,28
1987,234,23,7,0.105357947,0.894642053,638.3747543,622.0360775,1085.051837,1331.337607,2221,77.30595197,4442,-1017344,119808,-897536,28
1950,229,24,6,0.10509408,0.89490592,625.0885598,612.8863755,1062.325128,1325.659389,2179,85.1171875,4358,-998400,117248,-881152,28
2525,301,23,7,0.10651097,0.89348903,819.8508686,747.1820519,1387.90297,1628.225914,2826,114.2279709,5652,-1292800,154112,-1138688,28
1958,225,23,7,0.103069171,0.896930829,627.7594276,602.5199221,1065.216547,1325.075556,2183,87.11093376,4366,-1002496,115200,-887296,28
2512,280,23,7,0.100286533,0.899713467,807.5496091,756.5630214,1371.815287,1617.957143,2792,74.63245122,5584,-1286144,143360,-1142784,28
1970,212,23,7,0.0971585701,0.90284143,627.5729036,605.1749978,1066.961929,1319.518868,2182,86.72496025,4364,-1008640,108544,-900096,28
2899,1496,23,7,0.340386803,0.659613197,1205.528591,857.0249195,1743.078303,3079.562834,4395,88.16449348,8790,-1484288,765952,-718336,28
1934,218,23,7,0.101301115,0.898698885,617.3026686,603.0788052,1049.180972,1318.862385,2152,75.1396648,4304,-990208,111616,-878592,28
2357,250,23,7,0.0958956655,0.904104334,746.0626174,719.893258,1266.24353,1659.968,2607,91.6989096,5214,-1206784,128000,-1078784,28
2557,292,23,7,0.102492102,0.897507898,825.8629023,753.2941663,1398.615956,1656.041096,2849,65.50931249,5698,-1309184,149504,-1159680,28
2313,225,23,7,0.0886524823,0.911347518,727.6529838,711.8177697,1239.375703,1579.177778,2538,81.19001919,5076,-1184256,115200,-1069056,28
2123,276,23,7,0.115047937,0.884952063,686.0316971,636.2998922,1153.648139,1556.539855,2399,89.98499625,4798,-1086976,141312,-945664,28
2089,286,23,7,0.120421053,0.879578947,678.1853578,657.0987942,1144.997128,1502.101399,2375,97.25634726,4750,-1069568,146432,-923136,28
2526,293,22,8,0.103937567,0.896062433,804.7388794,776.2774974,1362.682502,1817.931741,2819,69.60493827,5638,-1293312,150016,-1143296,28
1937,217,23,7,0.100742804,0.899257196,619.2273869,602.327177,1053.178627,1294.599078,2154,86.22898319,4308,-991744,111104,-880640,28
2331,226,23,7,0.088384826,0.911615174,731.9918437,717.3595757,1246.467181,1614.548673,2557,87.03199455,5114,-1193472,115712,-1077760,28
1099,69,23,7,0.0590753425,0.940924658,336.6337208,345.4114326,583.7352138,596.6811594,1168,18.55735621,2336,-562688,35328,-527360,28
1102,132,22,8,0.106969206,0.893030794,348.6306099,408.0193746,625.5880218,549.9772727,1234,146.9047619,2468,-564224,67584,-496640,29
1056,131,21,9,0.110362258,0.889637742,333.8418918,396.6289212,604.5776515,508.7328244,1187,125.0790306,2374,-540672,67072,-473600,29
1143,145,21,9,0.11257764,0.88742236,364.1520658,422.6757243,652.0936133,584.6413793,1288,33.99313803,2576,-585216,74240,-510976,29
1085,120,22,8,0.0995850622,0.900414938,340.0113803,411.8268446,604.3834101,590.4916667,1205,90.60150376,2410,-555520,61440,-494080,29
90,8,23,7,0.0816326531,0.918367347,27.33578354,18.25342434,52.27777778,18.25,98,44.14414414,196,-46080,4096,-41984,29
1085,131,22,8,0.107730263,0.892269737,343.3510985,400.3705723,618.0967742,529.0152672,1216,102.443134,2432,-555520,67072,-488448,29
1044,126,22,8,0.107692308,0.892307692,329.1740693,392.7994308,595.1551724,505.5,1170,122.8991597,2340,-534528,64512,-470016,29
1061,131,22,8,0.109899329,0.890100671,335.4727512,399.35465,605.8256362,520.9694656,1192,111.9248826,2384,-543232,67072,-476160,29
1058,116,21,9,0.0988074957,0.901192504,331.1657325,399.0477103,593.1172023,536.2672414,1174,87.41623232,2348,-541696,59392,-482304,29
1084,125,22,8,0.103391232,0.896608768,341.2824542,404.9933472,611.9354244,544.856,1209,25.43121582,2418,-555008,64000,-491008,29
1047,117,21,9,0.100515464,0.899484536,329.2753546,386.5529443,588.8815664,525.3931624,1164,84.28674873,2328,-536064,59904,-476160,29
1051,135,21,9,0.113827993,0.886172007,333.0385126,402.7821821,601.1874405,533.6518519,1186,77.97501644,2372,-538112,69120,-468992,29
1066,128,22,8,0.10720268,0.89279732,336.2057183,404.3876049,604.032833,543.09375,1194,132.2259136,2388,-545792,65536,-480256,29
1114,134,21,9,0.107371795,0.892628205,353.8898543,405.0548039,631.3007181,567.9626866,1248,96.073903,2496,-570368,68608,-501760,29
1064,130,21,9,0.108877722,0.891122278,336.3228313,401.3637198,605.0451128,535.7461538,1194,102.8423773,2388,-544768,66560,-478208,29
1054,133,22,8,0.112047178,0.887952822,333.2978985,403.1024136,602.4573055,526.9774436,1187,81.69304886,2374,-539648,68096,-471552,29
1100,128,22,8,0.104234528,0.895765472,348.0827419,402.3975095,619.9454545,567.703125,1228,100.1631321,2456,-563200,65536,-497664,29
1041,118,22,8,0.101811907,0.898188093,328.0719628,384.3739714,585.0489914,535.4576271,1159,136.3529412,2318,-532992,60416,-472576,29
988,123,21,9,0.110711071,0.889288929,314.0054481,358.6091172,566.812753,469.1463415,1111,16.89220009,2222,-505856,62976,-442880,29
954,115,21,9,0.107577175,0.892422825,301.6739607,354.2204536,542.8805031,469.626087,1069,17.26421189,2138,-488448,58880,-429568,29
1252,143,22,8,0.102508961,0.897491039,393.0327014,474.4749895,705.1813099,635.1258741,1395,98.79603399,2790,-641024,73216,-567808,29
1256,168,21,9,0.117977528,0.882022472,399.1924365,483.1504938,723.3917197,631.0714286,1424,121.7094017,2848,-643072,86016,-557056,29
1260,160,21,9,0.112676056,0.887323944,399.3650306,476.2916704,721.4880952,623.96875,1420,50.42613636,2840,-645120,81920,-563200,29
2166,314,21,9,0.126612903,0.873387097,716.0227894,715.1617313,1240.194367,1242.60828,2480,58.67045186,4960,-1108992,160768,-948224,29
1276,167,21,9,0.115731116,0.884268884,405.1926809,486.9037261,732.8738245,638.9161677,1443,100.8385744,2886,-653312,85504,-567808,29
1262,135,22,8,0.0966356478,0.903364352,393.8834989,478.5341315,705.1465927,641.5407407,1397,105.116629,2794,-646144,69120,-577024,29
1282,140,21,9,0.0984528833,0.901547117,399.7454459,494.7093694,717.6630265,655.0642857,1422,121.5384615,2844,-656384,71680,-584704,29
1318,158,22,8,0.10704607,0.89295393,414.540955,508.9301247,745.1866464,682.721519,1476,26.27269491,2952,-674816,80896,-593920,29
1307,144,22,8,0.0992419021,0.900758098,410.8725232,485.0615413,728.027544,707.5972222,1451,95.9021811,2902,-669184,73728,-595456,29
1304,165,21,9,0.112321307,0.887678693,411.9236267,502.1149125,745.6081288,651.1636364,1469,108.0147059,2938,-667648,84480,-583168,29
2189,306,21,9,0.122645291,0.877354709,723.2569478,698.3100742,1247.657835,1250.447712,2495,48.68292683,4990,-1120768,156672,-964096,29
2069,276,22,8,0.117697228,0.882302772,674.6882322,689.8802642,1182.004833,1105.496377,2345,57.50367827,4690,-1059328,141312,-918016,29
1297,148,21,9,0.102422145,0.897577855,406.6038103,499.8812899,724.311488,711.5067568,1445,58.78763222,2890,-664064,75776,-588288,29
1306,168,21,9,0.113975577,0.886024423,414.079042,499.9003988,746.676876,666.1607143,1474,98.85982562,2948,-668672,86016,-582656,29
1308,154,21,9,0.105335157,0.894664843,412.1352751,497.501883,734.6674312,704.5974026,1462,39.55627706,2924,-669696,78848,-590848,29
1272,168,21,9,0.116666667,0.883333333,404.4467215,483.6571118,732.081761,632.8095238,1440,80.53691275,2880,-651264,86016,-565248,29
2121,269,21,9,0.112552301,0.887447699,687.5251451,706.0336255,1202.749646,1138.33829,2390,48.33164813,4780,-1085952,137728,-948224,29
1265,136,22,8,0.0970735189,0.902926481,395.6272503,478.6311621,701.3913043,697.3602941,1401,101.0822511,2802,-647680,69632,-578048,29
1330,163,21,9,0.109176155,0.890823845,419.7595418,501.5958789,759.7383459,643.0613497,1493,108.0318379,2986,-680960,83456,-597504,29
996,106,21,9,0.0961887477,0.903811252,312.0552917,329.2522408,568.6415663,390.4339623,1102,17.73129525,2204,-509952,54272,-455680,29
1518,177,21,9,0.104424779,0.895575221,476.1995505,587.1101951,854.2740448,794.1920904,1695,46.36214442,3390,-777216,90624,-686592,29
1391,168,21,9,0.107761386,0.892238614,437.8982195,529.5026562,792.2156722,678.8571429,1559,107.1477663,3118,-712192,86016,-626176,29
1397,150,22,8,0.0969618617,0.903038138,436.0103664,530.9013681,780.8153185,710.5266667,1547,115.3616704,3094,-715264,76800,-638464,29
1650,240,21,9,0.126984127,0.873015873,523.7584477,675.7195892,940.0248485,983.1416667,1890,32.82959875,3780,-844800,122880,-721920,29
1423,140,22,8,0.0895713372,0.910428663,442.5154163,521.5659576,791.588194,684.5428571,1563,190.6097561,3126,-728576,71680,-656896,29
1415,148,21,9,0.0946896993,0.905310301,441.0467503,538.6598327,782.5646643,776.6013514,1563,46.22892635,3126,-724480,75776,-648704,29
1405,153,22,8,0.0982028241,0.901797176,439.5646236,532.0610359,784.5857651,732.7973856,1558,112.1670266,3116,-719360,78336,-641024,29
1545,178,21,9,0.103308183,0.896691817,486.8418065,577.5024704,868.8763754,802.3146067,1723,37.54630638,3446,-791040,91136,-699904,29
1431,176,21,9,0.109520846,0.890479154,450.787618,550.3032569,815.5443746,710.1363636,1607,70.42068361,3214,-732672,90112,-642560,29
1388,148,21,9,0.0963541667,0.903645833,432.473583,532.7705906,773.6253602,720.4324324,1536,112.6099707,3072,-710656,75776,-634880,29
1541,171,21,9,0.0998831776,0.900116822,482.7869934,584.3380986,862.6229721,801.3216374,1712,41.16374128,3424,-788992,87552,-701440,29
1388,156,21,9,0.101036269,0.898963731,434.3554215,528.2790734,782.3400576,684.9487179,1544,108.0475857,3088,-710656,79872,-630784,29
1424,176,22,8,0.11,0.89,448.6754553,540.1500622,816.5098315,670.9659091,1600,63.74501992,3200,-729088,90112,-638976,29
1029,129,21,9,0.111398964,0.888601036,327.1386037,347.4592777,599.5296404,419.7286822,1158,22.86729858,2316,-526848,66048,-460800,29
1432,161,21,9,0.101067169,0.898932831,447.8976736,551.1901971,803.9399441,735.2732919,1593,142.2321429,3186,-733184,82432,-650752,29
1383,166,22,8,0.107165913,0.892834087,435.7222683,521.9130703,787.25235,672.9216867,1549,87.41534989,3098,-708096,84992,-623104,29
1438,166,22,8,0.103491272,0.896508728,448.6859706,549.9345375,819.8852573,651.8975904,1604,105.8047493,3208,-736256,84992,-651264,29
1536,180,21,9,0.104895105,0.895104895,487.7081154,548.2092248,869.0761719,768.25,1716,112.2302158,3432,-786432,92160,-694272,29
1438,169,21,9,0.105164904,0.894835096,452.8720268,541.8984354,813.6808067,721.6272189,1607,97.63061968,3214,-736256,86528,-649728,29
1399,173,22,8,0.110050891,0.889949109,441.6486888,526.1365892,801.7469621,663.2023121,1572,125.5591054,3144,-716288,88576,-627712,29
1426,166,21,9,0.104271357,0.895728643,453.3984998,468.5614763,818.5518934,607.0662651,1592,112.2708039,3184,-730112,84992,-645120,29
1379,171,22,8,0.110322581,0.889677419,433.4748582,531.3123359,790.8259608,651.9064327,1550,107.6388889,3100,-706048,87552,-618496,29
1529,189,22,8,0.110011641,0.889988359,481.8647667,592.3714769,868.8489209,783.8677249,1718,42.69383698,3436,-782848,96768,-686080,29
1400,130,22,8,0.0849673203,0.91503268,432.6253328,529.1378639,766.9735714,749.6307692,1530,121.9123506,3060,-716800,66560,-650240,29
1423,184,22,8,0.114499067,0.885500933,453.751869,495.2196103,828.9325369,611.1793478,1607,137.3504274,3214,-728576,94208,-634368,29
1381,149,21,9,0.0973856209,0.902614379,431.9329236,517.589685,773.4663287,691.6644295,1530,47.30983302,3060,-707072,76288,-630784,29
1425,166,22,8,0.104336895,0.895663105,446.7363256,547.8730035,806.074386,709.5180723,1591,116.0466813,3182,-729600,84992,-644608,29
1404,145,21,9,0.0936087799,0.90639122,436.9193376,535.7855029,777.2578348,753.137931,1549,114.7407407,3098,-718848,74240,-644608,29
1392,157,22,8,0.101355713,0.898644287,434.9307349,534.7418747,785.4899425,681.9936306,1549,118.4250765,3098,-712704,80384,-632320,29
1578,216,22,8,0.120401338,0.879598662,501.3195814,623.7178324,891.0703422,944.4722222,1794,44.20896994,3588,-807936,110592,-697344,29
1424,171,22,8,0.107210031,0.892789969,448.6994725,533.0105383,812.690309,675.6666667,1595,106.3333333,3190,-729088,87552,-641536,29
1440,159,21,9,0.0994371482,0.900562852,450.3268792,549.054952,807.1361111,735.3710692,1599,57.58012243,3198,-737280,81408,-655872,29
1449,148,22,8,0.0926737633,0.907326237,450.0982123,549.2173379,807.8461008,712.3918919,1597,39.74614236,3194,-741888,75776,-666112,29
1398,139,22,8,0.0904359141,0.909564086,434.6223076,521.1684006,775.9556509,699.0431655,1537,120.5490196,3074,-715776,71168,-644608,29
1339,132,21,9,0.0897348742,0.910265126,417.5375776,476.8655441,746.970127,624.719697,1471,26.26316729,2942,-685568,67584,-617984,29
1392,140,21,9,0.091383812,0.908616188,431.3071639,533.772141,773.7507184,694.4071429,1532,101.7940199,3064,-712704,71680,-641024,29
1418,167,21,9,0.105362776,0.894637224,444.609471,550.8404299,800.9196051,725.754491,1585,54.24366872,3170,-726016,85504,-640512,29
1391,154,22,8,0.0996763754,0.900323625,436.6852705,514.2935773,782.8037383,684.4480519,1545,112.6914661,3090,-712192,78848,-633344,29
1383,143,22,8,0.0937090433,0.906290957,429.1656457,532.1566318,771.3449024,687.6293706,1526,65.21367521,3052,-708096,73216,-634880,29
1420,181,21,9,0.113054341,0.886945659,458.6112207,444.2954268,825.5725352,608.2209945,1601,123.2486528,3202,-727040,92672,-634368,29
1692,177,21,9,0.0947030498,0.90529695,524.4044728,647.4472295,950.9816785,782.2259887,1869,149.4004796,3738,-866304,90624,-775680,29
1669,177,21,9,0.0958829902,0.90411701,518.7765702,629.7035523,940.2067106,765.9661017,1846,112.7672572,3692,-854528,90624,-763904,29
1741,184,20,10,0.0955844156,0.904415584,542.060968,664.8585472,972.2274555,875.6902174,1925,38.21719277,3850,-891392,94208,-797184,29
1692,153,21,9,0.0829268293,0.917073171,519.0935558,661.4104567,928.0171395,867.5163399,1845,32.28911446,3690,-866304,78336,-787968,29
1657,167,21,9,0.0915570175,0.908442982,512.1318502,639.1090283,925.1388051,787.0958084,1824,125.9668508,3648,-848384,85504,-762880,29
1676,165,21,9,0.0896252037,0.910374796,518.3755328,640.7025751,931.0167064,819.2545455,1841,125.1529572,3682,-858112,84480,-773632,29
1638,178,20,10,0.0980176211,0.901982379,507.2525281,644.0610014,923.5250305,770.2359551,1816,152.0938023,3632,-838656,91136,-747520,29
1634,154,21,9,0.0861297539,0.913870246,502.7473644,639.1327937,899.2906977,843.6688312,1788,124.4258873,3576,-836608,78848,-757760,29
1628,151,21,9,0.0848791456,0.915120854,500.6959076,633.3711201,894.9963145,836.1324503,1779,171.0576923,3558,-833536,77312,-756224,29
1662,162,21,9,0.0888157895,0.911184211,512.5529248,646.8737607,920.7936221,827.4135802,1824,150.4950495,3648,-850944,82944,-768000,29
1636,179,21,9,0.0986225895,0.90137741,507.9519595,638.3157419,921.900978,780.9497207,1815,124.8280605,3630,-837632,91648,-745984,29
1842,212,21,9,0.103213242,0.896786758,572.9753582,743.6806391,1024.517915,1053.410377,2054,46.46007691,4108,-943104,108544,-834560,29
1646,161,21,9,0.0890979524,0.910902048,507.8550622,636.3143039,914.3335358,798.3540373,1807,143.5266084,3614,-842752,82432,-760320,29
1657,178,21,9,0.0970027248,0.902997275,513.4498455,645.5421574,933.0935425,777.494382,1835,140.0763359,3670,-848384,91136,-757248,29
1728,176,21,9,0.0924369748,0.907563025,535.1544399,671.0248175,960.0659722,878.2159091,1904,41.29256127,3808,-884736,90112,-794624,29
1628,152,21,9,0.0853932584,0.914606742,503.325284,614.1426782,893.8783784,854.3157895,1780,133.4332834,3560,-833536,77824,-755712,29
1638,154,21,9,0.0859375,0.9140625,505.9966012,618.8784861,904.3803419,812.6818182,1792,127.4537696,3584,-838656,78848,-759808,29
1625,141,21,9,0.0798414496,0.92015855,498.0022136,628.4937117,887.1495385,841.4397163,1766,133.7878788,3532,-832000,72192,-759808,29
1630,162,21,9,0.0904017857,0.909598214,502.5483562,636.5140365,907.6705521,784.1049383,1792,162.0253165,3584,-834560,82944,-751616,29
1816,236,20,10,0.115009747,0.884990253,568.1657104,752.8559722,1024.904736,1038.775424,2052,52.75064267,4104,-929792,120832,-808960,29
1637,228,22,8,0.122252011,0.877747989,519.6121145,657.035323,929.5137447,958.0307018,1865,44.2152679,3730,-838144,116736,-721408,29
1444,151,21,9,0.0946708464,0.905329154,449.0639485,554.0558388,804.2444598,738.2847682,1595,131.383855,3190,-739328,77312,-662016,29
1442,149,22,8,0.0936517913,0.906348209,449.7481785,542.552009,798.0894591,775.7785235,1591,132.1428571,3182,-738304,76288,-662016,29
1681,214,21,9,0.11292876,0.88707124,531.1488906,644.8680645,931.92326,1074.285047,1895,48.77734878,3790,-860672,109568,-751104,29
1428,136,22,8,0.0869565217,0.913043478,442.4746963,535.5815817,786.1358543,744.3235294,1564,116.7164179,3128,-731136,69632,-661504,29
1542,160,22,8,0.0940070505,0.905992949,482.1841552,571.9407814,850.8365759,857.89375,1702,45.75268817,3404,-789504,81920,-707584,29
1426,174,22,8,0.10875,0.89125,449.2094958,544.4208593,812.8786816,699.0517241,1600,106.5246338,3200,-730112,89088,-641024,29
1609,217,21,9,0.118838992,0.881161008,509.8272789,637.7174867,905.3573648,973.875576,1826,44.56919697,3652,-823808,111104,-712704,29
1631,227,22,8,0.122174381,0.877825619,517.5230911,654.0191192,922.8988351,976.9295154,1858,44.53499521,3716,-835072,116224,-718848,29
1469,174,21,9,0.105903834,0.894096166,461.8272045,545.1216127,840.1695031,668.6034483,1643,118.2865371,3286,-752128,89088,-663040,29
1442,148,22,8,0.093081761,0.906918239,449.5941358,541.4740078,798.0644938,770.5135135,1590,84.57446809,3180,-738304,75776,-662528,29
1643,234,21,9,0.124667022,0.875332978,522.8192043,660.1507943,939.3335362,936.6581197,1877,67.46944644,3754,-841216,119808,-721408,29
1450,147,22,8,0.0920475892,0.907952411,451.0377051,545.2129335,805.8503448,731.4285714,1597,28.51785714,3194,-742400,75264,-667136,29
1445,173,21,9,0.106922126,0.893077874,455.3671987,540.8419202,823.7515571,690.4624277,1618,133.4983498,3236,-739840,88576,-651264,29
1739,208,21,9,0.106831022,0.893168978,547.8475516,646.9248166,954.6894767,1135.447115,1947,44.70723307,3894,-890368,106496,-783872,29
1601,205,21,9,0.11351052,0.88648948,506.0043759,625.6055099,896.3454091,959.3756098,1806,42.30498946,3612,-819712,104960,-714752,29
1634,220,21,9,0.118662352,0.881337648,516.3123433,657.4958624,922.3176255,965.9909091,1854,44.71780029,3708,-836608,112640,-723968,29
1512,160,21,9,0.0956937799,0.90430622,471.8251259,558.8972524,850.1395503,707.60625,1672,133.76,3344,-774144,81920,-692224,29
1416,179,21,9,0.112225705,0.887774295,447.5969866,538.2603507,812.3460452,684.5139665,1595,70.3573004,3190,-724992,91648,-633344,29
1094,130,21,9,0.10620915,0.89379085,345.7567259,368.1067121,633.1992687,438.3076923,1224,19.51219512,2448,-560128,66560,-493568,29
1357,162,22,8,0.106649111,0.893350889,426.4999929,523.4273803,768.1628592,691.6234568,1519,92.73504274,3038,-694784,82944,-611840,29
1362,143,21,9,0.0950166113,0.904983389,423.7534925,524.8306609,755.8017621,726.3146853,1505,111.9791667,3010,-697344,73216,-624128,29
136,13,23,7,0.0872483221,0.912751678,41.03905642,58.46811704,76.17647059,62.69230769,149,17.86570743,298,-69632,6656,-62976,29
3295,566,21,9,0.146594147,0.853405853,1095.517603,1176.391824,1879.931108,2228.300353,3861,67.51180276,7722,-1687040,289792,-1397248,29
1371,144,23,7,0.095049505,0.904950495,429.6701078,504.1220779,760.1539023,737.4930556,1515,100.731383,3030,-701952,73728,-628224,29
1391,168,22,8,0.107761386,0.892238614,437.2318645,541.1250947,787.0790798,721.3869048,1559,27.33648957,3118,-712192,86016,-626176,29
1418,168,21,9,0.10592686,0.89407314,445.9714049,537.5938961,805.3236953,693.702381,1586,111.4546732,3172,-726016,86016,-640000,29
1371,153,22,8,0.100393701,0.899606299,429.961092,516.6466923,769.5339168,699.4705882,1524,95.54858934,3048,-701952,78336,-623616,29
1370,155,21,9,0.101639344,0.898360656,429.5554717,524.261489,766.410219,732.8580645,1525,80.30542391,3050,-701440,79360,-622080,29
1367,145,21,9,0.0958994709,0.904100529,427.5741765,512.0067742,759.4923189,728.2896552,1512,132.9815303,3024,-699904,74240,-625664,29
1366,156,21,9,0.102496715,0.897503285,428.7657319,520.6255298,766.9633968,713.6602564,1522,90.91995221,3044,-699392,79872,-619520,29
1424,159,20,10,0.100442198,0.899557802,445.9757467,543.9629839,796.5646067,751.1194969,1583,121.117062,3166,-729088,81408,-647680,29
1366,166,22,8,0.108355091,0.891644909,430.3903305,520.1350592,778.0944363,671.0903614,1532,118.8518231,3064,-699392,84992,-614400,29
1384,158,22,8,0.102464332,0.897535668,434.0419241,531.4266861,775.2109827,738.9936709,1542,110.7758621,3084,-708608,80896,-627712,29
1446,168,22,8,0.104089219,0.895910781,453.1153828,560.8701555,814.2863071,749.0892857,1614,114.6306818,3228,-740352,86016,-654336,29
950,121,21,9,0.112978525,0.887021475,301.4997734,339.7487848,551.6115789,413.4297521,1071,19.79667283,2142,-486400,61952,-424448,29
1359,143,22,8,0.0952063915,0.904793609,423.7803418,517.0953104,753.8292862,729.3636364,1502,113.1876413,3004,-695808,73216,-622592,29
1372,146,21,9,0.0961791831,0.903820817,428.4909916,520.5457711,760.9533528,745.8424658,1518,108.1196581,3036,-702464,74752,-627712,29
1460,150,22,8,0.0931677019,0.906832298,454.7643408,551.2679202,809.4568493,766.9866667,1610,131.5359477,3220,-747520,76800,-670720,29
3199,511,21,9,0.137735849,0.862264151,1054.036515,1144.664444,1818.501719,2087.119374,3710,78.90259464,7420,-1637888,261632,-1376256,29
1473,159,21,9,0.0974264706,0.902573529,458.2898442,570.0474864,825.3503055,734.509434,1632,138.071066,3264,-754176,81408,-672768,29
1458,168,21,9,0.103321033,0.896678967,455.0903195,570.9514197,823.8689986,723.5119048,1626,111.6758242,3252,-746496,86016,-660480,29
1472,149,21,9,0.0919185688,0.908081431,457.6247563,558.7186101,814.2649457,778.7449664,1621,75.11584801,3242,-753664,76288,-677376,29
1490,144,20,10,0.088127295,0.911872705,460.118151,573.3580657,824.2677852,747.4722222,1634,135.9400998,3268,-762880,73728,-689152,29
1494,157,21,9,0.0950938825,0.904906118,466.4877729,562.460846,829.9504685,788.4076433,1651,78.06146572,3302,-764928,80384,-684544,29
1468,154,21,9,0.0949445129,0.905055487,457.4364518,560.4528035,813.4523161,792.8896104,1622,144.5632799,3244,-751616,78848,-672768,29
1469,149,21,9,0.0920889988,0.907911001,456.3069623,559.8665296,814.5684139,759.5302013,1618,162.77666,3236,-752128,76288,-675840,29
1457,157,20,10,0.0972738538,0.902726146,453.4882082,566.3606847,812.5202471,760.910828,1614,110.4722793,3228,-745984,80384,-665600,29
1441,152,21,9,0.0954174513,0.904582549,448.5570347,554.6718926,800.3962526,764.8026316,1593,112.5795053,3186,-737792,77824,-659968,29
1478,169,21,9,0.102610808,0.897389192,461.9131354,568.7893923,836.5778078,714,1647,136.9077307,3294,-756736,86528,-670208,29
1582,175,21,9,0.0996015936,0.900398406,497.3002237,587.7420013,883.3653603,839.5371429,1757,87.93793794,3514,-809984,89600,-720384,29
1443,154,21,9,0.0964308078,0.903569192,448.908622,560.4673598,794.9133749,837.2922078,1597,27.68244063,3194,-738816,78848,-659968,29
1483,145,21,9,0.0890663391,0.910933661,458.0278461,577.2321307,811.6291301,843.862069,1628,43.6110367,3256,-759296,74240,-685056,29
1457,158,21,9,0.0978328173,0.902167183,453.7928009,560.8772668,817.2793411,722.4303797,1615,104.4631307,3230,-745984,80896,-665088,29
4075,593,21,9,0.127035133,0.872964867,1346.559285,1328.120348,2298.521718,2581.736931,4668,84.01727862,9336,-2086400,303616,-1782784,29
5061,800,21,9,0.136495479,0.863504521,1703.975045,1604.65606,2906.066785,3088.73375,5861,106.4281823,11722,-2591232,409600,-2181632,29
4172,593,21,9,0.124449108,0.875550892,1373.431307,1386.127964,2368.752637,2483.236088,4765,92.34496124,9530,-2136064,303616,-1832448,29
1487,151,21,9,0.0921855922,0.907814408,460.5504872,580.0894982,818.3712172,830.615894,1638,29.21869426,3276,-761344,77312,-684032,29
1502,152,20,10,0.0918984281,0.908101572,466.5585348,571.2085342,833.1817577,771.3552632,1654,95.22164652,3308,-769024,77824,-691200,29
1476,144,21,9,0.0888888889,0.911111111,456.5335806,569.1496276,811.4674797,800.5833333,1620,79.92106561,3240,-755712,73728,-681984,29
1088,126,21,9,0.103789127,0.896210873,342.5509997,382.7119704,624.3511029,461.9920635,1214,85.31271961,2428,-557056,64512,-492544,29
1111,129,21,9,0.104032258,0.895967742,350.4173829,413.9267988,626.3114311,570.4496124,1240,124.1241241,2480,-568832,66048,-502784,29
1081,121,22,8,0.100665557,0.899334443,340.6044299,398.5312069,604.4699352,574.9669421,1202,85.97997139,2404,-553472,61952,-491520,29
1111,131,22,8,0.10547504,0.89452496,349.9824193,421.5016056,626.8145815,576.4274809,1242,102.3907667,2484,-568832,67072,-501760,29
1082,123,22,8,0.102074689,0.897925311,340.5046289,402.6218911,609.2781885,547.7723577,1205,94.80723839,2410,-553984,62976,-491008,29
1106,128,22,8,0.103727715,0.896272285,349.1903773,409.7792225,622.2188065,576.7265625,1234,100.081103,2468,-566272,65536,-500736,29
1070,125,22,8,0.10460251,0.89539749,335.8520417,414.7988147,598.8719626,590.536,1195,21.55872271,2390,-547840,64000,-483840,29
1102,130,22,8,0.105519481,0.894480519,348.0622557,414.0424159,618.4428312,600.0307692,1232,92.70127916,2464,-564224,66560,-497664,29
1085,127,22,8,0.104785479,0.895214521,343.1204326,401.0478092,610.8709677,569.1574803,1212,77.44408946,2424,-555520,65024,-490496,29
66,22,21,9,0.25,0.75,25.31442313,25.64651636,44.75757576,43.72727273,88,1.739474204,176,-33792,11264,-22528,29
1074,116,22,8,0.0974789916,0.902521008,336.7256684,398.1957536,600.3789572,550.3275862,1190,96.20048504,2380,-549888,59392,-490496,29
1099,113,22,8,0.0932343234,0.906765677,343.5819111,405.4361406,608.6232939,585.8495575,1212,91.81818182,2424,-562688,57856,-504832,29
1089,120,21,9,0.0992555831,0.900744417,342.3307158,403.936029,607.4205693,583.0333333,1209,84.72319552,2418,-557568,61440,-496128,29
3675,571,21,9,0.13447951,0.86552049,1217.311833,1265.56892,2097.308027,2292.073555,4246,73.90774587,8492,-1881600,292352,-1589248,29
1098,122,22,8,0.1,0.9,344.6325574,413.4638543,612.7003643,590.6967213,1220,21.3884993,2440,-562176,62464,-499712,29
1144,127,20,10,0.0999213218,0.900078678,359.3637706,427.4409072,639.7333916,602.3700787,1271,97.09702063,2542,-585728,65024,-520704,29
1101,135,21,9,0.109223301,0.890776699,349.5758435,408.7891071,623.4514078,578.1185185,1236,85.59556787,2472,-563712,69120,-494592,29
1085,133,21,9,0.109195402,0.890804598,342.1766326,414.3249992,617.9474654,540.5864662,1218,101.5846539,2436,-555520,68096,-487424,29
1226,134,21,9,0.0985294118,0.901470588,386.9575375,437.0643145,686.4959217,625.641791,1360,93.53507565,2720,-627712,68608,-559104,29
1090,123,21,9,0.101401484,0.898598516,342.8249976,404.5938174,613.7486239,547.195122,1213,91.54716981,2426,-558080,62976,-495104,29
1327,159,22,8,0.106998654,0.893001346,417.1720748,505.2879541,755.9155991,639.8805031,1486,103.9888034,2972,-679424,81408,-598016,29
1352,153,22,8,0.10166113,0.89833887,423.9483058,513.6080146,760.3247041,688.2745098,1505,121.1755233,3010,-692224,78336,-613888,29
1423,180,21,9,0.112289457,0.887710543,450.0552802,543.1583771,814.3239635,704.5722222,1603,42.91834003,3206,-728576,92160,-636416,29
1365,143,22,8,0.0948275862,0.905172414,424.3805696,519.7877697,764.0153846,663.6713287,1508,113.5542169,3016,-698880,73216,-625664,29
1400,169,21,9,0.107711918,0.892288082,444.4709736,477.4359358,807.8328571,595.852071,1569,122.9623824,3138,-716800,86528,-630272,29
1340,145,21,9,0.0976430976,0.902356902,418.261594,511.4395642,749.3044776,684.737931,1485,138.3970177,2970,-686080,74240,-611840,29
1316,140,22,8,0.0961538462,0.903846154,410.8471745,496.5135387,734.9559271,667.8142857,1456,117.6090468,2912,-673792,71680,-602112,29
1343,136,22,8,0.091954023,0.908045977,418.043279,505.6069723,743.0089352,710.2867647,1479,106.4794816,2958,-687616,69632,-617984,29
1324,139,22,8,0.0950102529,0.904989747,412.2306686,508.3324019,733.6049849,716.7122302,1463,115.0157233,2926,-677888,71168,-606720,29
1329,157,22,8,0.105652759,0.894347241,417.669657,511.3488325,750.1414597,687.2802548,1486,123.4219269,2972,-680448,80384,-600064,29
1615,213,22,8,0.116520788,0.883479212,511.8762862,631.8250497,906.6860681,973.7464789,1828,41.46064867,3656,-826880,109056,-717824,29
1370,170,22,8,0.11038961,0.88961039,430.6531148,529.943516,784.7759124,655.4529412,1540,27.62827413,3080,-701440,87040,-614400,29
140,29,21,9,0.171597633,0.828402367,45.95629912,60.59167247,84.7,86.44827586,169,3.414831279,338,-71680,14848,-56832,29
1318,137,22,8,0.0941580756,0.905841924,410.9108747,498.5617928,730.599393,702.9927007,1455,83.95845355,2910,-674816,70144,-604672,29
1513,222,22,8,0.12795389,0.87204611,483.0050476,608.6909334,868.4646398,864.8333333,1735,40.51844932,3470,-774656,113664,-660992,29
1746,208,22,8,0.106448311,0.893551689,550.6513543,650.5411504,961.3591065,1112.990385,1954,42.01247044,3908,-893952,106496,-787456,29
1436,158,21,9,0.0991217064,0.900878294,452.4643821,519.1506707,805.5557103,724.2848101,1594,114.924297,3188,-735232,80896,-654336,29
1362,144,22,8,0.0956175299,0.90438247,424.4129956,520.8316862,757.6387665,714.3541667,1506,107.6483202,3012,-697344,73728,-623616,29
1426,146,21,9,0.0928753181,0.907124682,446.7699976,517.2937794,787.6949509,774.8287671,1572,100.3831418,3144,-730112,74752,-655360,29
1310,141,22,8,0.0971743625,0.902825637,409.4477796,494.7575043,731.7458015,672.6170213,1451,100.3457815,2902,-670720,72192,-598528,29
104,27,22,8,0.20610687,0.79389313,36.16257566,43.02352054,67.63461538,59.7037037,131,3.996339231,262,-53248,13824,-39424,30
107,28,22,8,0.207407407,0.792592593,37.1282076,44.91765425,69.41121495,62.60714286,135,3.9543058,270,-54784,14336,-40448,30
80,27,22,8,0.252336449,0.747663551,30.79771704,30.15833844,56.275,47.25925926,107,2.042374499,214,-40960,13824,-27136,30
96,27,22,8,0.219512195,0.780487805,34.13564236,39.73754776,63.13541667,57.96296296,123,3.692584809,246,-49152,13824,-35328,30
148,34,22,8,0.186813187,0.813186813,51.16354883,57.31477614,93.52702703,82.67647059,182,3.755674783,364,-75776,17408,-58368,30
97,27,22,8,0.217741935,0.782258065,34.58434234,39.69734609,63.32989691,59.51851852,124,3.734939759,248,-49664,13824,-35840,30
97,31,22,8,0.2421875,0.7578125,36.43242084,38.0940017,66.09278351,59.51612903,128,3.0776629,256,-49664,15872,-33792,30
144,34,22,8,0.191011236,0.808988764,49.91091553,56.28963041,91.65972222,80.35294118,178,3.23342416,356,-73728,17408,-56320,30
41,21,22,8,0.338709677,0.661290323,15.40818791,20.33037784,28.04878049,38.23809524,62,1.795020266,124,-20992,10752,-10240,30
2004,113,22,8,0.0533774209,0.946622579,599.6104372,694.5734268,1079.401198,697.1946903,2117,41.09881576,4234,-1026048,57856,-968192,30
100,21,22,8,0.173553719,0.826446281,34.85925272,25.98045664,65.55,39.33333333,121,3.45418213,242,-51200,10752,-40448,30
107,28,22,8,0.207407407,0.792592593,37.16872601,44.85685851,69.28971963,63.07142857,135,3.947368421,270,-54784,14336,-40448,30
100,21,22,8,0.173553719,0.826446281,35.11623414,28.62423691,64.51,44.28571429,121,3.674460978,242,-51200,10752,-40448,30
108,28,22,8,0.205882353,0.794117647,37.19899773,45.75065518,70.22222222,61.85714286,136,4.052443385,272,-55296,14336,-40960,30
105,28,22,8,0.210526316,0.789473684,36.78950851,42.95263172,69.13333333,59,133,3.835063437,266,-53760,14336,-39424,30
107,28,22,8,0.207407407,0.792592593,37.16652406,44.82828633,69.35514019,62.82142857,135,3.857142857,270,-54784,14336,-40448,30
41,21,22,8,0.338709677,0.661290323,16.91216769,19.18450811,29.68292683,35.04761905,62,1.75091782,124,-20992,10752,-10240,30
2113,146,22,8,0.0646303674,0.935369633,634.5488366,865.4984148,1126.152863,1185.678082,2259,42.00446263,4518,-1081856,74752,-1007104,30
94,28,22,8,0.229508197,0.770491803,34.01699173,38.82330131,62.40425532,58.46428571,122,3.615886189,244,-48128,14336,-33792,30
109,28,22,8,0.204379562,0.795620438,37.77523799,45.71685261,69.62385321,66.57142857,137,4.124021674,274,-55808,14336,-41472,30
145,36,22,8,0.198895028,0.801104972,50.40893698,58.88089568,92.08965517,86.61111111,181,3.422844175,362,-74240,18432,-55808,30
103,27,22,8,0.207692308,0.792307692,36.09169207,41.94911674,67.17475728,59.11111111,130,3.723861358,260,-52736,13824,-38912,30
97,21,22,8,0.177966102,0.822033898,34.19261427,27.09971509,63.35051546,41.71428571,118,3.485967504,236,-49664,10752,-38912,30
104,27,22,8,0.20610687,0.79389313,36.08295013,42.95881206,68.03846154,58.14814815,131,3.814793244,262,-53248,13824,-39424,30
104,27,22,8,0.20610687,0.79389313,36.01573456,43.17552779,68.03846154,58.14814815,131,3.893016345,262,-53248,13824,-39424,30
98,26,22,8,0.209677419,0.790322581,34.09650171,40.76415063,64.42857143,55.23076923,124,3.717026379,248,-50176,13312,-36864,30
2004,126,13,17,0.0591549296,0.94084507,598.8809302,823.8394713,1059.984531,1153.222222,2130,39.91754123,4260,-1026048,64512,-961536,30
78,27,22,8,0.257142857,0.742857143,30.36180308,29.29168386,55.14102564,46.81481481,105,2.152080344,210,-39936,13824,-26112,30
134,34,22,8,0.202380952,0.797619048,47.42388586,51.85656956,86.37313433,77.11764706,168,3.217774373,336,-68608,17408,-51200,30
104,27,22,8,0.20610687,0.79389313,36.37467339,42.28682517,67.69230769,59.48148148,131,3.98782344,262,-53248,13824,-39424,30
2203,158,22,8,0.0669207963,0.933079204,663.7460019,860.5696391,1197.703586,948.1012658,2361,56.16079924,4722,-1127936,80896,-1047040,30
106,27,22,8,0.203007519,0.796992481,36.70506797,43.79782708,68.66037736,60.48148148,133,3.952451709,266,-54272,13824,-40448,30
95,27,22,8,0.221311475,0.778688525,34.01841444,38.97559998,62.41052632,58.2962963,122,3.694730466,244,-48640,13824,-34816,30
8353,417,22,8,0.0475484607,0.952451539,2513.460445,2737.813053,4427.838142,3537.417266,8770,155.7449831,17540,-4276736,213504,-4063232,30
104,27,22,8,0.20610687,0.79389313,35.85842374,43.69365861,68.01923077,58.22222222,131,3.908114558,262,-53248,13824,-39424,30
104,27,22,8,0.20610687,0.79389313,36.08220065,42.8468418,68.16346154,57.66666667,131,3.811463486,262,-53248,13824,-39424,30
98,21,22,8,0.176470588,0.823529412,34.50996874,27.34809623,63.79591837,42.28571429,119,3.588661037,238,-50176,10752,-39424,30
2043,131,22,8,0.0602575897,0.93974241,612.0145617,779.2580761,1105.888889,800.7175573,2174,31.88618363,4348,-1046016,67072,-978944,30
103,27,22,8,0.207692308,0.792307692,35.71603055,42.69617035,67.72815534,57,130,3.680634202,260,-52736,13824,-38912,30
107,28,22,8,0.207407407,0.792592593,36.87119263,45.46453821,69.80373832,61.10714286,135,3.788941903,270,-54784,14336,-40448,30
877,161,22,8,0.155105973,0.844894027,297.441793,303.1147708,531.5188141,454.0310559,1038,29.80189492,2076,-449024,82432,-366592,30
835,154,22,8,0.155712841,0.844287159,282.7821736,296.206668,502.8479042,452.4480519,989,31.41677255,1978,-427520,78848,-348672,30
932,179,22,8,0.161116112,0.838883888,314.6030708,350.824037,555.4420601,558.9050279,1111,45.92806945,2222,-477184,91648,-385536,30
2718,250,22,8,0.0842318059,0.915768194,844.2275999,766.4714268,1538.679912,895.456,2968,142.1455939,5936,-1391616,128000,-1263616,30
915,171,22,8,0.157458564,0.842541436,308.9005801,335.4407115,549.147541,513.2807018,1086,52.61627907,2172,-468480,87552,-380928,30
926,180,22,8,0.162748644,0.837251356,315.8370086,335.9299392,556.6760259,537.1611111,1106,46.62731872,2212,-474112,92160,-381952,30
2716,254,22,8,0.0855218855,0.914478114,843.986674,787.5969915,1539.020987,913.2047244,2970,136.6774045,5940,-1390592,130048,-1260544,30
2684,237,22,8,0.0811365971,0.918863403,830.8570344,772.3932625,1510.990686,894.8607595,2921,145.5406079,5842,-1374208,121344,-1252864,30
2759,249,22,8,0.0827792553,0.917220745,857.1930074,779.5411363,1556.313157,930.3935743,3008,81.14378203,6016,-1412608,127488,-1285120,30
54,20,22,8,0.27027027,0.72972973,20.13082214,24.00395801,36.16666667,41.1,74,1.328068916,148,-27648,10240,-17408,30
795,143,22,8,0.152452026,0.847547974,270.0512592,265.3169428,481.3371069,403.6923077,938,13.13909511,1876,-407040,73216,-333824,30
669,130,22,8,0.162703379,0.837296621,230.1522922,228.8340092,407.9880419,358.8923077,799,11.6285839,1598,-342528,66560,-275968,30
775,146,22,8,0.158523344,0.841476656,265.1719134,258.1331738,474.4090323,389.8219178,921,12.8201559,1842,-396800,74752,-322048,30
451,74,22,8,0.140952381,0.859047619,146.3975983,172.6502543,270.6407982,216.4324324,525,29.86348123,1050,-230912,37888,-193024,30
145,24,22,8,0.142011834,0.857988166,47.75172912,47.55638101,89.11724138,60.125,169,3.372580323,338,-74240,12288,-61952,30
934,182,22,8,0.163082437,0.836917563,317.9585288,341.6589846,563.7376874,531.6208791,1116,49.35869084,2232,-478208,93184,-385024,30
2742,252,22,8,0.0841683367,0.915831663,852.7324234,781.516664,1549.697666,929.5396825,2994,99.40239044,5988,-1403904,129024,-1274880,30
923,185,22,8,0.166967509,0.833032491,314.4059771,344.0059101,560.8331528,522.9027027,1108,56.90806369,2216,-472576,94720,-377856,30
882,162,22,8,0.155172414,0.844827586,300.417162,298.6774074,534.1519274,459.0617284,1044,28.1098546,2088,-451584,82944,-368640,30
162,30,22,8,0.15625,0.84375,53.19395224,64.96190337,98.65432099,84.86666667,192,14.54545455,384,-82944,15360,-67584,30
103,27,22,8,0.207692308,0.792307692,35.70628288,42.84456867,67.60194175,57.48148148,130,3.837072019,260,-52736,13824,-38912,30
4075,240,22,8,0.0556199305,0.94438007,1236.66206,1355.615187,2175.361718,1863.2125,4315,98.06818182,8630,-2086400,122880,-1963520,30
4188,347,22,8,0.0765159868,0.923484013,1293.494875,1473.19896,2282.90234,2088.14121,4535,80.89546914,9070,-2144256,177664,-1966592,30
131,33,22,8,0.201219512,0.798780488,46.68056086,48.49363557,85.12977099,72.06060606,164,5.710306407,328,-67072,16896,-50176,30
91,27,22,8,0.228813559,0.771186441,32.82963309,37.75162493,60.43956044,56.33333333,118,3.04280557,236,-46592,13824,-32768,30
147,33,22,8,0.183333333,0.816666667,51.04557203,53.90354614,93.46938776,77.27272727,180,3.556609366,360,-75264,16896,-58368,30
90,28,22,8,0.237288136,0.762711864,32.9991414,37.13859866,60.36666667,56.71428571,118,3.56065178,236,-46080,14336,-31744,30
103,27,22,8,0.207692308,0.792307692,36.16899568,41.75708707,67.08737864,59.44444444,130,3.938200545,260,-52736,13824,-38912,30
105,27,22,8,0.204545455,0.795454545,36.70821888,42.46247436,68.2,59.88888889,132,4.101926663,264,-53760,13824,-39936,30
4210,324,22,8,0.0714600794,0.928539921,1300.486065,1400.876317,2281.239667,2088.969136,4534,79.95062599,9068,-2155520,165888,-1989632,30
2100,141,22,8,0.06291834,0.93708166,631.3230205,800.2836882,1138.8,855.893617,2241,42.90637565,4482,-1075200,72192,-1003008,30
91,28,22,8,0.235294118,0.764705882,32.57217006,39.44247943,60.9010989,57.07142857,119,3.513433717,238,-46592,14336,-32256,30
104,27,22,8,0.20610687,0.79389313,36.33544689,42.31977036,67.81730769,59,131,3.701610624,262,-53248,13824,-39424,30
83,24,22,8,0.224299065,0.775700935,30.81757204,28.82947951,56.98795181,43.66666667,107,1.961143695,214,-42496,12288,-30208,30
96,27,22,8,0.219512195,0.780487805,34.13941367,39.54237539,63.47916667,56.74074074,123,3.588098016,246,-49152,13824,-35328,30
92,26,22,8,0.220338983,0.779661017,32.99324521,37.11177743,61.01086957,54.15384615,118,3.584447145,236,-47104,13312,-33792,30
152,33,22,8,0.178378378,0.821621622,52.41718835,55.49612616,96.13157895,78.57575758,185,3.26739668,370,-77824,16896,-60928,30
103,27,22,8,0.207692308,0.792307692,36.17961914,41.72872744,67.0776699,59.48148148,130,3.942978465,260,-52736,13824,-38912,30
4243,349,22,8,0.0760017422,0.923998258,1311.042579,1479.134385,2311.477728,2114.406877,4592,82.19080007,9184,-2172416,178688,-1993728,30
74,12,23,7,0.139534884,0.860465116,24.16677582,25.35525367,45.47297297,31.33333333,86,4.01119403,172,-37888,6144,-31744,30
9592,382,22,8,0.0382995789,0.961700421,2866.717597,3056.951404,5021.382819,4136.704188,9974,622.985634,19948,-4911104,195584,-4715520,30
96,27,22,8,0.219512195,0.780487805,34.30013945,39.34602571,62.85416667,58.96296296,123,3.532452613,246,-49152,13824,-35328,30
106,27,22,8,0.203007519,0.796992481,36.6228663,43.609503,69.19811321,58.37037037,133,3.985615823,266,-54272,13824,-40448,30
104,27,22,8,0.20610687,0.79389313,36.37096731,42.34148199,67.63461538,59.7037037,131,3.909280812,262,-53248,13824,-39424,30
106,27,22,8,0.203007519,0.796992481,36.84908076,43.2632228,68.73584906,60.18518519,133,3.973707798,266,-54272,13824,-40448,30
9533,442,22,8,0.0443107769,0.955689223,2865.258817,3009.362153,5033.422637,4008.330317,9975,665.4436291,19950,-4880896,226304,-4654592,30
104,27,22,8,0.20610687,0.79389313,36.28990229,42.47003301,67.81730769,59,131,3.95889997,262,-53248,13824,-39424,30
104,27,22,8,0.20610687,0.79389313,36.47258738,42.08431018,67.51923077,60.14814815,131,4.024577573,262,-53248,13824,-39424,30
102,27,22,8,0.209302326,0.790697674,35.82291767,41.61374417,66.58823529,59,129,3.842716711,258,-52224,13824,-38400,30
127,30,22,8,0.191082803,0.808917197,45.35706603,42.7302261,82.11023622,65.83333333,157,4.966782664,314,-65024,15360,-49664,30
110,21,22,8,0.160305344,0.839694656,37.51318115,25.25174833,71.28181818,38.33333333,131,3.860890068,262,-56320,10752,-45568,30
98,27,22,8,0.216,0.784,34.59739285,40.51777371,64.57142857,57.2962963,125,3.66568915,250,-50176,13824,-36352,30
142,34,22,8,0.193181818,0.806818182,48.88113394,57.16031756,90.80985915,78.85294118,176,5.835543767,352,-72704,17408,-55296,30
139,30,22,8,0.177514793,0.822485207,48.5311818,46.23471519,88.69784173,67.86666667,169,3.442656345,338,-71168,15360,-55808,30
133,34,22,8,0.203592814,0.796407186,47.1872535,51.62592526,85.43609023,78.38235294,167,5.88028169,334,-68096,17408,-50688,30
112,32,22,8,0.222222222,0.777777778,40.5181198,44.78890374,73.72321429,68.21875,144,2.197131523,288,-57344,16384,-40960,30
125,32,22,8,0.203821656,0.796178344,43.36240141,51.85277197,80.512,73.09375,157,2.516025641,314,-64000,16384,-47616,30
9586,392,22,8,0.0392864301,0.96071357,2869.790104,3032.469878,5020.360734,4234.829082,9978,498.9,19956,-4908032,200704,-4707328,30
93,28,22,8,0.231404959,0.768595041,33.2391072,39.84374775,62.02150538,57.60714286,121,1.654361498,242,-47616,14336,-33280,30
105,28,22,8,0.210526316,0.789473684,36.70563915,43.93478469,68.02857143,63.14285714,133,2.095478179,266,-53760,14336,-39424,30
6746,384,22,8,0.0538569425,0.946143058,2044.493071,2199.660692,3600.064779,2958.276042,7130,128.9097812,14260,-3453952,196608,-3257344,30
103,27,22,8,0.207692308,0.792307692,36.16899568,41.75708707,67.08737864,59.44444444,130,3.940588057,260,-52736,13824,-38912,30
6670,382,22,8,0.0541690301,0.94583097,2014.54362,2269.394988,3565.603748,2843.719895,7052,128.1948737,14104,-3415040,195584,-3219456,30
97,21,22,8,0.177966102,0.822033898,34.2864931,25.65212946,63.57731959,40.66666667,118,3.608562691,236,-49664,10752,-38912,30
139,34,22,8,0.196531792,0.803468208,48.41713363,54.93321677,89.0647482,78.55882353,173,5.198317308,346,-71168,17408,-53760,30
109,21,22,8,0.161538462,0.838461538,37.53832932,25.46207887,70.34862385,40.33333333,130,3.889886296,260,-55808,10752,-45056,30
103,27,22,8,0.207692308,0.792307692,35.81716698,42.5421924,67.54368932,57.7037037,130,3.854135784,260,-52736,13824,-38912,30
141,34,22,8,0.194285714,0.805714286,49.06868378,55.17621974,90.22695035,78.76470588,175,3.546817998,350,-72192,17408,-54784,30
4865,328,22,8,0.0631619488,0.936838051,1484.308802,1659.251882,2622.124152,2224.35061,5193,93.85505151,10386,-2490880,167936,-2322944,30
94,27,22,8,0.223140496,0.776859504,33.67153707,38.8481621,61.84042553,58.07407407,121,3.621670159,242,-48128,13824,-34304,30
143,34,22,8,0.192090395,0.807909605,49.29089224,57.07058702,91.29370629,79.35294118,177,4.239520958,354,-73216,17408,-55808,30
95,28,22,8,0.227642276,0.772357724,34.44606527,38.72219213,62.92631579,58.85714286,123,3.580786026,246,-48640,14336,-34304,30
79,35,22,8,0.307017544,0.692982456,31.32856412,35.22610349,54.39240506,64.51428571,114,2.940417849,228,-40448,17920,-22528,30
91,27,22,8,0.228813559,0.771186441,32.81634425,37.8175535,60.36263736,56.59259259,118,3.151709402,236,-46592,13824,-32768,30
103,27,22,8,0.207692308,0.792307692,35.81716698,42.5421924,67.54368932,57.7037037,130,3.913305238,260,-52736,13824,-38912,30
41,21,22,8,0.338709677,0.661290323,16.83799703,19.19963152,29.48780488,35.42857143,62,1.72174396,124,-20992,10752,-10240,30
135,32,22,8,0.191616766,0.808383234,47.06872423,50.95341009,86.9037037,71.75,167,2.470779701,334,-69120,16384,-52736,30
103,28,22,8,0.213740458,0.786259542,36.10392567,42.6494222,68.10679612,58.25,131,3.832650673,262,-52736,14336,-38400,30
37,22,22,8,0.372881356,0.627118644,16.63657864,16.93302314,27.62162162,34,59,2.540913006,118,-18944,11264,-7680,30
6684,367,22,8,0.0520493547,0.947950645,2027.215447,2093.2796,3558.535308,2933.449591,7051,130.5257312,14102,-3422208,187904,-3234304,30
101,28,22,8,0.217054264,0.782945736,35.47708647,42.22224665,66.99009901,57.82142857,129,9.612518629,258,-51712,14336,-37376,30
95,21,22,8,0.181034483,0.818965517,33.64353794,26.74478354,62.28421053,41.38095238,116,10.06071119,232,-48640,10752,-37888,30
99,27,22,8,0.214285714,0.785714286,34.82002644,41.11004336,64.98989899,58.03703704,126,9.354120267,252,-50688,13824,-36864,30
102,28,22,8,0.215384615,0.784615385,36.02668924,42.00976259,67.1372549,59.53571429,130,9.643916914,260,-52224,14336,-37888,30
135,34,22,8,0.201183432,0.798816568,47.28110838,53.27233843,87.42222222,75.38235294,169,3.496069508,338,-69120,17408,-51712,30
99,27,22,8,0.214285714,0.785714286,34.25690228,42.58093238,65.33333333,56.77777778,126,9.538228615,252,-50688,13824,-36864,30
126,34,22,8,0.2125,0.7875,45.07708188,49.64172678,82.0952381,74.58823529,160,5.396290051,320,-64512,17408,-47104,30
125,32,22,8,0.203821656,0.796178344,44.58442132,46.69850105,81.624,68.75,157,5.933484505,314,-64000,16384,-47616,30
99,26,22,8,0.208,0.792,34.31681381,41.65512463,64.48484848,57.34615385,125,8.802816901,250,-50688,13312,-37376,30
139,32,22,8,0.187134503,0.812865497,48.4269224,51.56363635,88.74820144,74.0625,171,6.842737095,342,-71168,16384,-54784,30
132,26,22,8,0.164556962,0.835443038,44.16591298,47.45681625,83.46969697,59.34615385,158,2.776313477,316,-67584,13312,-54272,30
138,33,22,8,0.192982456,0.807017544,47.48485647,55.77162208,88,77.63636364,171,3.270849273,342,-70656,16896,-53760,30
126,31,22,8,0.197452229,0.802547771,44.6353955,46.86589454,81.29365079,69.67741935,157,2.884438729,314,-64512,15872,-48640,30
95,27,22,8,0.221311475,0.778688525,33.72079264,39.84737687,62.48421053,58.03703704,122,4.364937388,244,-48640,13824,-34816,30
140,34,22,8,0.195402299,0.804597701,48.78339463,54.82823919,89.74285714,78.26470588,174,3.106588109,348,-71680,17408,-54272,30
89,27,22,8,0.232758621,0.767241379,32.04007007,37.78424055,59.13483146,56.40740741,116,8.676140613,232,-45568,13824,-31744,30
2134,115,22,8,0.0511338373,0.948866163,638.1652066,811.0530994,1133.789128,961.9043478,2249,33.3976834,4498,-1092608,58880,-1033728,30
2188,142,22,8,0.060944206,0.939055794,656.011047,839.2246403,1184.154936,878.056338,2330,34.24959577,4660,-1120256,72704,-1047552,30
2113,113,22,8,0.0507637017,0.949236298,631.0941093,791.765436,1126.246096,875.159292,2226,33.80923451,4452,-1081856,57856,-1024000,30
123,32,22,8,0.206451613,0.793548387,44.01044528,45.91530076,80.7804878,67.3125,155,2.431754001,310,-62976,16384,-46592,30
170,31,22,8,0.154228856,0.845771144,55.03469462,72.00171983,101.9941176,95.5483871,201,5.52957359,402,-87040,15872,-71168,30
267,50,22,8,0.157728707,0.842271293,89.12291572,101.3093796,155.5093633,177.64,317,5.675917637,634,-136704,25600,-111104,30
5420,657,22,8,0.108112556,0.891887444,1765.493497,1654.922917,3025.905166,3147.027397,6077,123.215734,12154,-2775040,336384,-2438656,30
113,10,23,7,0.081300813,0.918699187,34.04271915,41.85498776,64.17699115,37.4,123,3.614457831,246,-57856,5120,-52736,30
257,46,22,8,0.151815182,0.848184818,84.54802365,102.2514599,151.7898833,153.173913,303,5.844907407,606,-131584,23552,-108032,30
275,41,22,8,0.129746835,0.870253165,89.51546219,101.3413959,156.9854545,168.6585366,316,8.040712468,632,-140800,20992,-119808,30
220,38,22,8,0.147286822,0.852713178,71.17435175,91.25889704,129.8272727,127.6052632,258,9.129511677,516,-112640,19456,-93184,30
192,25,22,8,0.115207373,0.884792627,61.52590829,53.28864795,114.6770833,65.4,217,5.795940171,434,-98304,12800,-85504,30
117,22,22,8,0.158273381,0.841726619,37.67961489,50.48909546,71.47008547,62.18181818,139,4.136904762,278,-59904,11264,-48640,30
6215,666,22,8,0.0967882575,0.903211742,2014.579054,1688.246309,3461.975221,3245.262763,6881,149.4569939,13762,-3182080,340992,-2841088,30
181,31,22,8,0.146226415,0.853773585,58.2902547,74.5906484,108.7955801,93.09677419,212,6.422296274,424,-92672,15872,-76800,30
3716,234,22,8,0.0592405063,0.940759494,1126.978445,1280.81545,1998.202368,1614.978632,3950,112.889397,7900,-1902592,119808,-1782784,30
172,31,22,8,0.15270936,0.84729064,56.61664804,68.56965894,102.0930233,101.483871,203,5.648302727,406,-88064,15872,-72192,30
173,31,22,8,0.151960784,0.848039216,56.51081387,70.60107624,103.1387283,98.93548387,204,6.178073895,408,-88576,15872,-72704,30
2917,195,22,8,0.0626606684,0.937339332,878.5082081,1129.948672,1572.065821,1323.651282,3112,45.4704851,6224,-1493504,99840,-1393664,30
2913,184,22,8,0.0594123345,0.940587665,878.7628424,1087.760728,1561.916924,1344.505435,3097,43.8172043,6194,-1491456,94208,-1397248,30
210,29,22,8,0.121338912,0.878661088,67.17500683,77.19660032,123.152381,97.17241379,239,3.692830655,478,-107520,14848,-92672,30
171,31,22,8,0.153465347,0.846534653,55.82250362,70.41278618,102.0116959,98.67741935,202,5.664610208,404,-87552,15872,-71680,30
276,44,22,8,0.1375,0.8625,88.07736175,115.7453991,160.6847826,159.3409091,320,9.042102289,640,-141312,22528,-118784,30
186,30,22,8,0.138888889,0.861111111,59.8203744,74.90115709,110.5967742,95.5,216,6.4,432,-95232,15360,-79872,30
113,28,22,8,0.19858156,0.80141844,38.87924159,47.10035963,72.07964602,66.64285714,141,4,282,-57856,14336,-43520,30
121,22,22,8,0.153846154,0.846153846,40.97449317,34.07745189,76.36363636,48,143,4.255952381,286,-61952,11264,-50688,30
84,13,23,7,0.134020619,0.865979381,26.33671295,36.50419446,49.85714286,43.46153846,97,1.902333791,194,-43008,6656,-36352,30
116,28,22,8,0.194444444,0.805555556,39.71626104,48.1531888,73.74137931,67.35714286,144,4.280618312,288,-59392,14336,-45056,30
7485,396,22,8,0.0502474305,0.949752569,2262.897174,2350.210149,3983.972478,3128.755051,7881,140.3561888,15762,-3832320,202752,-3629568,30
118,28,22,8,0.191780822,0.808219178,40.67165912,47.81462664,73.94915254,71.60714286,146,4.439039222,292,-60416,14336,-46080,30
143,34,22,8,0.192090395,0.807909605,50.44493218,53.43557548,90.22377622,83.85294118,177,3.567110036,354,-73216,17408,-55808,30
106,21,22,8,0.165354331,0.834645669,36.97035485,29.57737077,67.40566038,46.80952381,127,3.873132052,254,-54272,10752,-43520,30
103,27,22,8,0.207692308,0.792307692,35.77062693,43.2615106,66.72815534,60.81481481,130,3.896882494,260,-52736,13824,-38912,30
113,28,22,8,0.19858156,0.80141844,38.60318598,47.83532285,72.40707965,65.32142857,141,4.232963074,282,-57856,14336,-43520,30
120,22,22,8,0.154929577,0.845070423,40.89858392,33.39337911,75.65,48.86363636,142,3.441589918,284,-61440,11264,-50176,30
87,23,22,8,0.209090909,0.790909091,32.41640162,24.6840144,59.12643678,41.7826087,110,1.941404871,220,-44544,11776,-32768,30
140,34,22,8,0.195402299,0.804597701,49.37905447,53.40477572,88.45714286,83.55882353,174,5.944653229,348,-71680,17408,-54272,30
150,33,22,8,0.180327869,0.819672131,51.70351202,56.0972853,94.65333333,79.93939394,183,2.694743042,366,-76800,16896,-59904,30
50,19,22,8,0.275362319,0.724637681,18.35669905,23.04566105,33.46,39.05263158,69,2.065249925,138,-25600,9728,-15872,30
134,24,22,8,0.151898734,0.848101266,45.86352543,42.28302457,81.60447761,67.75,158,4.006085193,316,-68608,12288,-56320,30
51,21,22,8,0.291666667,0.708333333,19.40249333,23.34130087,34.88235294,40.42857143,72,2.112056322,144,-26112,10752,-15360,30
114,28,22,8,0.197183099,0.802816901,39.53100711,46.41531404,71.96491228,69.60714286,142,3.942254303,284,-58368,14336,-44032,30
7451,403,22,8,0.0513114337,0.948688566,2254.536181,2345.006644,3971.722722,3109.873449,7854,139.6266667,15708,-3814912,206336,-3608576,30
51,21,22,8,0.291666667,0.708333333,19.68506363,23.11991808,35.70588235,38.42857143,72,2.113916618,144,-26112,10752,-15360,30
2073,133,22,8,0.0602901179,0.939709882,621.2782303,805.3846124,1118.936324,862.9022556,2206,44.00558548,4412,-1061376,68096,-993280,30
87,28,22,8,0.243478261,0.756521739,31.37174765,38.24869946,58.63218391,56.03571429,115,3.318903319,230,-44544,14336,-30208,30
102,27,22,8,0.209302326,0.790697674,35.51695449,42.02755644,67.2745098,56.40740741,129,3.878532772,258,-52224,13824,-38400,30
101,27,22,8,0.2109375,0.7890625,35.49770486,41.33632008,66.17821782,58.22222222,128,3.67816092,256,-51712,13824,-37888,30
3005,285,22,8,0.0866261398,0.91337386,919.3109514,1211.684261,1662.094509,1470.529825,3290,57.73955774,6580,-1538560,145920,-1392640,30
125,33,22,8,0.208860759,0.791139241,45.06720599,46.10458427,82.288,68.93939394,158,5.614783227,316,-64000,16896,-47104,30
99,29,22,8,0.2265625,0.7734375,34.82510415,43.38153056,65,62.79310345,128,3.843843844,256,-50688,14848,-35840,30
2107,116,22,8,0.0521817364,0.947818264,629.7815274,768.507741,1128.696725,808.7241379,2223,56.03730779,4446,-1078784,59392,-1019392,30
93,22,22,8,0.191304348,0.808695652,33.54423051,23.79005973,62.4516129,39.18181818,115,3.542821935,230,-47616,11264,-36352,30
94,21,22,8,0.182608696,0.817391304,33.12132006,25.86989951,62.30851064,38.71428571,115,2.728351127,230,-48128,10752,-37376,30
106,29,22,8,0.214814815,0.785185185,36.81479849,45.80065891,69.02830189,64.24137931,135,3.930131004,270,-54272,14848,-39424,30
2095,140,22,8,0.062639821,0.937360179,627.8191721,853.7349938,1126.750358,987.0571429,2235,48.01288937,4470,-1072640,71680,-1000960,30
142,32,22,8,0.183908046,0.816091954,49.21939153,51.65214745,91.02816901,71.84375,174,2.588900461,348,-72704,16384,-56320,30
2090,130,22,8,0.0585585586,0.941441441,626.6693003,754.4302644,1132.317703,759.7384615,2220,43.19906597,4440,-1070080,66560,-1003520,30
2914,195,22,8,0.0627211322,0.937278868,886.8561071,1026.724584,1567.102951,1374.138462,3109,77.39606672,6218,-1491968,99840,-1392128,30
3077,287,22,8,0.0853151011,0.914684899,950.3904146,1165.433993,1672.932402,1785.076655,3364,62.22715501,6728,-1575424,146944,-1428480,30
99,27,22,8,0.214285714,0.785714286,34.73065719,40.92570806,65.60606061,55.77777778,126,3.578528827,252,-50688,13824,-36864,30
98,27,22,8,0.216,0.784,34.67026808,40.1176596,64.81632653,56.40740741,125,3.614806246,250,-50176,13824,-36352,30
94,21,22,8,0.182608696,0.817391304,33.10981495,25.89232895,62.31914894,38.66666667,115,2.90110999,230,-48128,10752,-37376,30
99,27,22,8,0.214285714,0.785714286,34.85625737,40.78156204,65.3030303,56.88888889,126,3.671328671,252,-50688,13824,-36864,30
9607,374,23,7,0.0374711953,0.962528805,2875.77037,2985.780592,5008.063183,4552.695187,9981,795.2988048,19962,-4918784,191488,-4727296,31
9620,362,23,7,0.0362652775,0.963734723,2878.817299,2942.738527,5000.754782,4745.558011,9982,961.6570328,19964,-4925440,185344,-4740096,31
9593,384,23,7,0.0384885236,0.961511476,2876.702379,2938.444455,5004.248306,4608.070313,9977,1036.033229,19954,-4911616,196608,-4715008,31
9617,365,22,8,0.0365658185,0.963434182,2875.433336,3024.385306,5002.363939,4705.257534,9982,942.5873466,19964,-4923904,186880,-4737024,31
9603,376,21,9,0.0376791262,0.962320874,2872.964003,3017.027321,5012.101739,4425.523936,9979,807.3624595,19958,-4916736,192512,-4724224,31
9563,412,24,6,0.0413032581,0.958696742,2874.16873,2966.854574,5007.149953,4543.507282,9975,381.4531549,19950,-4896256,210944,-4685312,31
9584,395,23,7,0.0395831246,0.960416875,2867.201762,3124.21981,5016.132721,4355.934177,9979,899.009009,19958,-4907008,202240,-4704768,31
1090,67,23,7,0.0579083838,0.942091616,331.4896066,337.4564787,588.4,426.0746269,1157,24.66425069,2314,-558080,34304,-523776,31
9565,411,22,8,0.0411988773,0.958801123,2875.79784,2924.600904,5010.734762,4471.041363,9976,252.556962,19952,-4897280,210432,-4686848,31
9579,398,21,9,0.039891751,0.960108249,2868.066272,3100.284974,5013.076313,4409.535176,9977,866.8114683,19954,-4904448,203776,-4700672,31
9602,380,22,8,0.0380685233,0.961931477,2876.683115,2979.07769,5005.88492,4628.015789,9982,1104.20354,19964,-4916224,194560,-4721664,31
2200,122,21,9,0.052540913,0.947459087,668.1652274,688.1596656,1170.427727,1000.508197,2322,44.43168772,4644,-1126400,62464,-1063936,31
9604,376,23,7,0.0376753507,0.962324649,2873.108014,3060.106664,5002.176801,4692.244681,9980,1378.453039,19960,-4917248,192512,-4724736,31
9602,377,22,8,0.0377793366,0.962220663,2874.946635,3003.298098,5003.362945,4649.65252,9979,1035.165975,19958,-4916224,193024,-4723200,31
9607,374,23,7,0.0374711953,0.962528805,2878.25555,2934.344716,5005.125221,4628.163102,9981,784.0534171,19962,-4918784,191488,-4727296,31
4128,210,23,7,0.0484094053,0.951590595,1240.737511,1455.723101,2175.443556,2052.666667,4338,110.9179238,8676,-2113536,107520,-2006016,31
9590,387,23,7,0.0387892152,0.961210785,2872.845817,3029.58789,5004.449426,4606.157623,9977,581.0716366,19954,-4910080,198144,-4711936,31
9605,376,23,7,0.037671576,0.962328424,2875.338849,3020.437552,4999.615825,4770.906915,9981,1033.229814,19962,-4917760,192512,-4725248,31
6571,269,23,7,0.0393274854,0.960672515,1964.781592,2168.837266,3435.175468,3062.01487,6840,106.0300729,13680,-3364352,137728,-3226624,31
6581,273,23,7,0.0398307558,0.960169244,1969.861808,2125.625874,3446.834524,2961.417582,6854,106.71026,13708,-3369472,139776,-3229696,31
9629,351,23,7,0.0351703407,0.964829659,2878.306695,2914.509542,5007.585419,4521.794872,9980,1374.655647,19960,-4930048,179712,-4750336,31
9621,359,23,7,0.0359719439,0.964028056,2880.867535,2861.171581,5003.748259,4635.454039,9980,401.9331454,19960,-4925952,183808,-4742144,31
9616,364,23,7,0.0364729459,0.963527054,2880.590701,2866.329922,5004.556364,4619.164835,9980,1176.886792,19960,-4923392,186368,-4737024,31
9626,354,23,7,0.0354709419,0.964529058,2879.636392,2885.540117,5005.984937,4569.432203,9980,1668.896321,19960,-4928512,181248,-4747264,31
9642,340,23,7,0.0340613104,0.96593869,2877.272392,2962.056019,5008.085356,4521.158824,9982,888.0782918,19964,-4936704,174080,-4762624,31
9616,363,23,7,0.0363763904,0.96362361,2876.615931,2931.812348,5011.095154,4431.181818,9979,1079.978355,19958,-4923392,185856,-4737536,31
9538,423,23,7,0.0424656159,0.957534384,2867.406604,3051.284429,4977.852694,5051.966903,9961,922.3148148,19922,-4883456,216576,-4666880,31
9615,365,23,7,0.0365731463,0.963426854,2877.253581,2920.759939,5012.03765,4423.145205,9980,1057.20339,19960,-4922880,186880,-4736000,31
9611,368,23,7,0.0368774426,0.963122557,2878.043907,2899.74288,5010.155551,4463.600543,9979,1311.30092,19958,-4920832,188416,-4732416,31
9627,353,23,7,0.0353707415,0.964629259,2877.918894,2921.312198,5008.376337,4502.977337,9980,1230.579531,19960,-4929024,180736,-4748288,31
9622,357,23,7,0.0357751278,0.964224872,2882.520265,2815.162218,5000.856787,4697.383754,9979,701.2649332,19958,-4926464,182784,-4743680,31
9618,362,23,7,0.0362725451,0.963727455,2878.200344,2917.048353,5007.666771,4534.395028,9980,1723.661485,19960,-4924416,185344,-4739072,31
9645,337,23,7,0.0337607694,0.966239231,2877.510367,2961.669548,5006.804458,4553.48368,9982,1519.330289,19964,-4938240,172544,-4765696,31
9637,344,21,9,0.0344654844,0.965534516,2877.940998,2940.128305,5006.444433,4558.331395,9981,1361.664393,19962,-4934144,176128,-4758016,31
9612,367,23,7,0.0367772322,0.963222768,2876.886096,2929.366675,5010.202767,4460.874659,9979,615.2281134,19958,-4921344,187904,-4733440,31
9622,357,21,9,0.0357751278,0.964224872,2878.209639,2911.407486,5006.573374,4543.308123,9979,1525.840979,19958,-4926464,182784,-4743680,31
9580,389,23,7,0.039020965,0.960979035,2871.791636,3021.471684,4982.624948,5043.491003,9969,1519.664634,19938,-4904960,199168,-4705792,31
3355,150,21,9,0.0427960057,0.957203994,1012.874225,977.321649,1759.222057,1613.833333,3505,62.77986745,7010,-1717760,76800,-1640960,31
9613,367,23,7,0.0367735471,0.963226453,2882.449621,2822.146093,5003.114116,4660.092643,9980,1141.87643,19960,-4921856,187904,-4733952,31
9633,349,22,8,0.0349629333,0.965037067,2882.433558,2839.923832,5002.666978,4683.272206,9982,1224.785276,19964,-4932096,178688,-4753408,31
4541,280,23,7,0.0580792367,0.941920763,1386.128637,1442.308222,2391.360713,2729.507143,4821,271.2999437,9642,-2324992,143360,-2181632,31
4309,260,21,9,0.0569052309,0.943094769,1308.164965,1448.57166,2265.464145,2608.769231,4569,241.2354805,9138,-2206208,133120,-2073088,31
5542,516,23,7,0.0851766259,0.914823374,1716.911806,1782.538272,2937.486467,4017.753876,6058,113.3819951,12116,-2837504,264192,-2573312,31
4703,289,23,7,0.0578926282,0.942107372,1435.707025,1485.943675,2475.878588,2832.079585,4992,241.8604651,9984,-2407936,147968,-2259968,31
4221,257,22,8,0.0573916927,0.942608307,1282.135223,1409.951173,2218.242833,2588.63035,4478,219.4022538,8956,-2161152,131584,-2029568,31
5646,506,21,9,0.0822496749,0.917750325,1747.052537,1837.16062,2994.4226,3992.328063,6152,186.4242424,12304,-2890752,259072,-2631680,31
4267,258,22,8,0.0570165746,0.942983425,1296.93647,1409.323972,2242.550504,2601.209302,4525,254.9295775,9050,-2184704,132096,-2052608,31
4540,287,22,8,0.0594572198,0.94054278,1385.339818,1467.962668,2390.850441,2780.198606,4827,295.4100367,9654,-2324480,146944,-2177536,31
4262,249,23,7,0.0551984039,0.944801596,1291.685957,1415.891584,2233.397466,2642.875502,4511,264.264792,9022,-2182144,127488,-2054656,31
4789,310,22,8,0.0607962346,0.939203765,1463.705425,1543.390107,2525.00877,2936.074194,5099,264.3338517,10198,-2451968,158720,-2293248,31
4542,289,21,9,0.059821983,0.940178017,1385.580098,1476.814322,2391.510788,2800.878893,4831,267.2013274,9662,-2325504,147968,-2177536,31
4573,283,22,8,0.0582784185,0.941721582,1392.568092,1503.50628,2407.551279,2767.010601,4856,262.4864865,9712,-2341376,144896,-2196480,31
4554,280,23,7,0.0579230451,0.942076955,1388.611185,1449.773948,2393.976943,2800.085714,4834,253.6201469,9668,-2331648,143360,-2188288,31
4564,274,23,7,0.0566349731,0.943365027,1389.370247,1473.576292,2399.719763,2748.978102,4838,267.5884956,9676,-2336768,140288,-2196480,31
4596,298,22,8,0.0608908868,0.939109113,1404.557624,1485.090142,2423.364447,2819.738255,4894,87.54919499,9788,-2353152,152576,-2200576,31
4771,276,23,7,0.0546859521,0.945314048,1451.022961,1543.56578,2513.079857,2712.768116,5047,270.3267274,10094,-2442752,141312,-2301440,31
4557,263,23,7,0.0545643154,0.945435685,1391.271039,1381.520544,2400.102041,2590.665399,4820,211.8681319,9640,-2333184,134656,-2198528,31
4548,286,23,7,0.0591642532,0.940835747,1389.989256,1449.2619,2399.296614,2706.972028,4834,300.2484472,9668,-2328576,146432,-2182144,31
4543,282,22,8,0.0584455959,0.941554404,1387.428708,1433.459893,2391.416905,2760.702128,4825,290.1383043,9650,-2326016,144384,-2181632,31
2775,151,22,8,0.0516062884,0.948393712,844.170353,849.7122136,1459.147027,1543.496689,2926,44.58326985,5852,-1420800,77312,-1343488,31
4144,189,23,7,0.0436187399,0.95638126,1247.556397,1314.795768,2161.50555,2287.470899,4333,316.7397661,8666,-2121728,96768,-2024960,31
4958,343,23,7,0.0647047727,0.935295227,1509.426454,1610.703044,2596.520573,3438.489796,5301,96.11967362,10602,-2538496,175616,-2362880,31
4137,190,21,9,0.0439103305,0.95608967,1245.644791,1320.041451,2160.739183,2235,4327,261.4501511,8654,-2118144,97280,-2020864,31
4151,181,23,7,0.0417820868,0.958217913,1249.078315,1283.04749,2164.863406,2204.033149,4332,244.1939121,8664,-2125312,92672,-2032640,31
4201,189,22,8,0.0430523918,0.956947608,1264.068314,1333.338083,2191.292549,2289.021164,4390,292.0825017,8780,-2150912,96768,-2054144,31
4154,189,21,9,0.0435183053,0.956481695,1251.078854,1310.084945,2170.850746,2197.259259,4343,282.3797139,8686,-2126848,96768,-2030080,31
4343,193,22,8,0.0425485009,0.957451499,1307.347389,1354.349367,2270.882109,2214.896373,4536,281.2151271,9072,-2223616,98816,-2124800,31
4145,189,21,9,0.0436086756,0.956391324,1247.468186,1325.637601,2163.516526,2254.862434,4334,276.7560664,8668,-2122240,96768,-2025472,31
4303,196,22,8,0.0435652367,0.956434763,1295.31867,1361.303811,2257.583779,2083.505102,4499,123.0916553,8998,-2203136,100352,-2102784,31
3836,164,22,8,0.041,0.959,1151.183479,1232.780346,1998.103233,2056.560976,4000,282.2865208,8000,-1964032,83968,-1880064,31
3823,162,23,7,0.0406524467,0.959347553,1146.570388,1235.940239,1991.247973,2034.345679,3985,195.5348381,7970,-1957376,82944,-1874432,31
5020,350,23,7,0.0651769088,0.934823091,1532.007935,1609.305101,2632.558167,3444.837143,5370,95.87573648,10740,-2570240,179200,-2391040,31
3830,164,23,7,0.0410615924,0.958938408,1150.106431,1216.649479,1995.190078,2051.445122,3994,277.7468707,7988,-1960960,83968,-1876992,31
4153,192,21,9,0.0441887227,0.955811277,1250.938523,1322.426978,2169.430532,2250.208333,4345,350.9693053,8690,-2126336,98304,-2028032,31
4137,190,21,9,0.0439103305,0.95608967,1247.042054,1280.56191,2155.953348,2339.205263,4327,288.6591061,8654,-2118144,97280,-2020864,31
4147,187,23,7,0.0431472081,0.956852792,1248.118306,1311.623703,2162.832891,2271,4334,311.7985612,8668,-2123264,95744,-2027520,31
4147,182,21,9,0.042042042,0.957957958,1247.62814,1295.367312,2164.455028,2177.417582,4329,343.0269414,8658,-2123264,93184,-2030080,31
4165,187,23,7,0.04296875,0.95703125,1253.309322,1318.160007,2172.394238,2267.946524,4352,214.2786805,8704,-2132480,95744,-2036736,31
4170,192,22,8,0.0440165062,0.955983494,1256.229037,1318.771121,2177.279616,2273.161458,4362,255.9859155,8724,-2135040,98304,-2036736,31
2669,127,22,8,0.0454220315,0.954577969,801.2810846,910.9247324,1391.994755,1535.212598,2796,41.45292809,5592,-1366528,65024,-1301504,31
1223,54,23,7,0.0422866092,0.957713391,364.6706014,411.8558607,646.7489779,463.5,1277,40.64290261,2554,-626176,27648,-598528,31
1207,57,22,8,0.0450949367,0.954905063,359.4802318,440.4668583,639.3504557,487.4385965,1264,22.11336599,2528,-617984,29184,-588800,31
1220,57,21,9,0.0446358653,0.955364135,363.4353169,425.2121655,647.7377049,451.9824561,1277,83.02990897,2554,-624640,29184,-595456,31
57,18,23,7,0.24,0.76,20.88973529,23.89224783,37.92982456,38.22222222,75,4.947229551,150,-29184,9216,-19968,31
1223,53,23,7,0.0415360502,0.95846395,364.2501209,413.5744963,646.3156173,458.1509434,1276,103.152789,2552,-626176,27136,-599040,31
1219,56,21,9,0.0439215686,0.956078431,363.1512529,423.9536264,646.2674323,458.0357143,1275,102,2550,-624128,28672,-595456,31
1219,54,23,7,0.0424194815,0.957580518,363.1662755,413.6150805,645.1296144,453.4814815,1273,109.7413793,2546,-624128,27648,-596480,31
1212,55,23,7,0.043409629,0.956590371,361.02617,422.0846314,641.8514851,460.9818182,1267,89.73087819,2534,-620544,28160,-592384,31
1224,56,21,9,0.04375,0.95625,364.7467522,423.3762164,648.7050654,461.1607143,1280,96.74981104,2560,-626688,28672,-598016,31
1230,57,22,8,0.0442890443,0.955710956,366.6971855,423.2780466,652.5682927,459.1052632,1287,104.2105263,2574,-629760,29184,-600576,31
1220,54,23,7,0.0423861852,0.957613815,363.3844756,423.8319335,644.7606557,473.462963,1274,90.0990099,2548,-624640,27648,-596992,31
1228,54,23,7,0.0421216849,0.957878315,365.7767525,423.7929976,648.8786645,473.7037037,1282,91.18065434,2564,-628736,27648,-601088,31
1195,47,22,8,0.03784219,0.96215781,355.715967,394.682965,627.4711297,469.6808511,1242,167.8378378,2484,-611840,24064,-587776,31
1220,55,23,7,0.0431372549,0.956862745,363.4219205,425.4738364,645.6008197,469.4,1275,89.41093969,2550,-624640,28160,-596480,31
1225,55,22,8,0.04296875,0.95703125,364.877311,424.4701339,648.3616327,465.4,1280,95.59372666,2560,-627200,28160,-599040,31
1231,56,22,8,0.0435120435,0.956487956,366.7105074,433.8861943,651.4313566,480.6428571,1287,88.81987578,2574,-630272,28672,-601600,31
1222,54,23,7,0.0423197492,0.957680251,363.9770154,423.9180014,645.792144,473.4814815,1276,103.152789,2552,-625664,27648,-598016,31
1222,53,23,7,0.0415686275,0.958431373,363.9340949,422.9576723,644.8756137,479.4716981,1275,54.14012739,2550,-625664,27136,-598528,31
1216,55,22,8,0.0432730134,0.956726987,362.1216867,432.0933913,642.9991776,481.2545455,1271,94.85074627,2542,-622592,28160,-594432,31
1207,56,22,8,0.0443388757,0.955661124,359.5937219,421.7412883,640.2584921,454,1263,88.44537815,2526,-617984,28672,-589312,31
3941,184,22,8,0.0446060606,0.955393939,1188.436022,1234.765278,2057.792692,2174.532609,4125,335.09342,8250,-2017792,94208,-1923584,31
4923,388,23,7,0.0730559217,0.926944078,1509.122618,1531.164267,2582.677839,3586.322165,5311,101.9581494,10622,-2520576,198656,-2321920,31
3960,183,21,9,0.0441708907,0.955829109,1194.150845,1232.440268,2068.465152,2148.491803,4143,291.1454673,8286,-2027520,93696,-1933824,31
3661,160,21,9,0.041873855,0.958126145,1100.312526,1161.863059,1908.423382,1969.95625,3821,262.0713306,7642,-1874432,81920,-1792512,31
4921,389,22,8,0.0732580038,0.926741996,1507.300279,1589.871251,2587.215403,3519.326478,5310,102.6682135,10620,-2519552,199168,-2320384,31
3939,177,24,6,0.0430029155,0.956997085,1185.578765,1234.11911,2051.342473,2217.785311,4116,236.0091743,8232,-2016768,90624,-1926144,31
4917,385,24,6,0.0726141079,0.927385892,1504.378072,1580.7004,2581.629245,3543.849351,5302,96.13780598,10604,-2517504,197120,-2320384,31
3637,161,21,9,0.042390732,0.957609268,1094.72546,1133.290487,1899.679131,1895.453416,3798,206.1889251,7596,-1862144,82432,-1779712,31
3652,154,24,6,0.0404624277,0.959537572,1097.16523,1133.104635,1901.236857,1957.168831,3806,283.1845238,7612,-1869824,78848,-1790976,31
4816,386,23,7,0.0742022299,0.92579777,1475.287809,1528.307911,2528.342193,3514.266839,5202,100.7944197,10404,-2465792,197632,-2268160,31
5149,241,22,8,0.0447124304,0.95528757,1553.909672,1591.998332,2688.606137,2842.788382,5390,183.3333333,10780,-2636288,123392,-2512896,31
3633,156,23,7,0.0411718131,0.958828187,1092.105924,1131.340022,1893.037435,1940.705128,3789,288.1368821,7578,-1860096,79872,-1780224,31
3934,185,24,6,0.044913814,0.955086186,1187.509019,1221.021248,2058.565328,2090.508108,4119,272.0607662,8238,-2014208,94720,-1919488,31
3965,185,23,7,0.0445783133,0.955421687,1195.862175,1233.738189,2068.602522,2223.32973,4150,334.6774194,8300,-2030080,94720,-1935360,31
3957,172,24,6,0.0416565754,0.958343425,1191.116314,1210.129255,2066.616376,2027.813953,4129,248.4356197,8258,-2025984,88064,-1937920,31
3641,158,23,7,0.0415898921,0.958410108,1094.553566,1144.484616,1900.351277,1891.905063,3799,319.5121951,7598,-1864192,80896,-1783296,31
3936,182,24,6,0.0441962118,0.955803788,1186.757071,1220.816786,2052.227642,2216.774725,4118,307.0842655,8236,-2015232,93184,-1922048,31
4942,202,24,6,0.0392690513,0.960730949,1483.07382,1524.124426,2567.129502,2703.891089,5144,334.677944,10288,-2530304,103424,-2426880,31
5206,222,24,6,0.040899042,0.959100958,1564.117055,1616.019292,2705.144641,2933.887387,5428,335.0617284,10856,-2665472,113664,-2551808,31
2496,119,23,7,0.0455066922,0.954493308,751.2958401,819.779667,1303.067308,1411.462185,2615,39.60321066,5230,-1277952,60928,-1217024,31
4938,316,22,8,0.0601446517,0.939855348,1507.950654,1629.369705,2642.572701,2391.96519,5254,512.5853659,10508,-2528256,161792,-2366464,31
4588,263,22,8,0.0542156256,0.945784374,1393.922294,1442.07913,2450.641892,1996.125475,4851,277.2,9702,-2349056,134656,-2214400,31
4594,270,22,8,0.0555098684,0.944490132,1398.363068,1432.507635,2457.64323,2004.692593,4864,361.9047619,9728,-2352128,138240,-2213888,31
4864,279,22,8,0.0542484931,0.945751507,1475.461419,1591.364794,2593.333882,2200.071685,5143,307.2281959,10286,-2490368,142848,-2347520,31
4915,294,22,8,0.0564407756,0.943559224,1497.419052,1548.11979,2629.653713,2192.846939,5209,214.6271117,10418,-2516480,150528,-2365952,31
4934,297,22,8,0.0567769069,0.943223093,1501.754396,1589.045935,2640.157884,2214.670034,5231,434.1078838,10462,-2526208,152064,-2374144,31
5053,306,22,8,0.0571002053,0.942899795,1541.497894,1592.148955,2701.957055,2317.421569,5359,356.5535595,10718,-2587136,156672,-2430464,31
4937,318,22,8,0.0605137964,0.939486204,1507.98513,1614.783493,2649.311323,2297.138365,5255,408.3139083,10510,-2527744,162816,-2364928,31
4910,291,22,8,0.0559507787,0.944049221,1494.381199,1573.974699,2621.886151,2248.591065,5201,457.834507,10402,-2513920,148992,-2364928,31
4988,302,22,8,0.0570888469,0.942911153,1519.860149,1591.622323,2669.211508,2253.86755,5290,433.6065574,10580,-2553856,154624,-2399232,31
4954,308,22,8,0.0585328772,0.941467123,1511.664307,1598.968884,2651.388171,2311.61039,5262,498.2954545,10524,-2536448,157696,-2378752,31
4953,315,22,8,0.0597949886,0.940205011,1512.165171,1621.264313,2653.316576,2338.631746,5268,439,10536,-2535936,161280,-2374656,31
5002,313,22,8,0.0588899341,0.941110066,1524.695611,1651.268313,2676.939024,2355.338658,5315,353.3909574,10630,-2561024,160256,-2400768,31
4927,301,22,8,0.0575745983,0.942425402,1499.269341,1649.067386,2627.351938,2404.129568,5228,395.4614221,10456,-2522624,154112,-2368512,31
4975,295,22,8,0.0559772296,0.94402277,1516.18112,1534.807273,2662.64,2177.8,5270,455.8823529,10540,-2547200,151040,-2396160,31
4960,306,22,8,0.0581086213,0.941891379,1508.623559,1680.854989,2647.173387,2411.866013,5266,392.1072226,10532,-2539520,156672,-2382848,31
4926,294,22,8,0.0563218391,0.943678161,1500.798974,1527.258213,2639.188388,2129.823129,5220,437.5523889,10440,-2522112,150528,-2371584,31
4925,302,22,8,0.0577769275,0.942223073,1500.947575,1547.913952,2645.005076,2108.370861,5227,330.6135357,10454,-2521600,154624,-2366976,31
4593,258,22,8,0.0531849103,0.94681509,1394.185378,1436.006854,2450.822121,1984.108527,4851,430.8170515,9702,-2351616,132096,-2219520,31
4558,269,22,8,0.0557281956,0.944271804,1385.170961,1454.445623,2440.611672,1963.085502,4827,286.6389549,9654,-2333696,137728,-2195968,31
474,29,24,6,0.0576540755,0.942345924,144.4626224,156.6598897,252.4135021,245.2413793,503,112.0267261,1006,-242688,14848,-227840,31
375,18,24,6,0.0458015267,0.954198473,111.5466078,144.9957854,198.296,170,393,90.13761468,786,-192000,9216,-182784,31
370,18,24,6,0.0463917526,0.953608247,110.1024167,143.1164272,195.8027027,167.7222222,388,69.28571429,776,-189440,9216,-180224,31
370,18,24,6,0.0463917526,0.953608247,110.2561832,140.8364453,195.7594595,168.6111111,388,97.24310777,776,-189440,9216,-180224,31
372,18,24,6,0.0461538462,0.953846154,110.8148598,141.0473719,196.9516129,165.5,390,122.6415094,780,-190464,9216,-181248,31
474,30,24,6,0.0595238095,0.94047619,143.6055275,172.2659733,251.8586498,262.6333333,504,65.03225806,1008,-242688,15360,-227328,31
373,18,24,6,0.0460358056,0.953964194,111.0686926,142.118582,197.4209115,166.5555556,391,137.1929825,782,-190976,9216,-181760,31
465,29,24,6,0.0587044534,0.941295547,141.3919021,160.5521759,246.944086,256.4137931,494,66.93766938,988,-238080,14848,-223232,31
621,38,24,6,0.0576631259,0.942336874,190.6638513,179.7128982,332.0869565,295.8947368,659,54.23868313,1318,-317952,19456,-298496,31
371,18,24,6,0.0462724936,0.953727506,110.5038834,141.8655358,196.2587601,169.0555556,389,153.7549407,778,-189952,9216,-180736,31
371,18,24,6,0.0462724936,0.953727506,110.5123562,141.0830681,196.4123989,165.8888889,389,79.3877551,778,-189952,9216,-180736,31
371,18,24,6,0.0462724936,0.953727506,110.4767592,141.7984572,196.3800539,166.5555556,389,117.5226586,778,-189952,9216,-180736,31
626,38,24,6,0.0572289157,0.942771084,191.6886023,186.6974681,335.0223642,290.9473684,664,40.43848965,1328,-320512,19456,-301056,31
475,29,24,6,0.0575396825,0.942460317,144.6882327,157.7925534,253.0610526,243.3103448,504,134.7593583,1008,-243200,14848,-228352,31
475,29,24,6,0.0575396825,0.942460317,144.6547886,158.5767555,252.5052632,252.4137931,504,177.4647887,1008,-243200,14848,-228352,31
623,41,24,6,0.061746988,0.938253012,190.5967571,207.4428055,332.576244,331.3414634,664,62.52354049,1328,-318976,20992,-297984,31
374,18,24,6,0.0459183673,0.954081633,111.3506161,142.7080353,197.8957219,167.5,392,97.75561097,784,-191488,9216,-182272,31
372,18,24,6,0.0461538462,0.953846154,110.7677032,141.9929576,196.9112903,166.3333333,390,138.7900356,780,-190464,9216,-181248,31
370,18,24,6,0.0463917526,0.953608247,110.2216039,140.7088426,195.9216216,165.2777778,388,67.01208981,776,-189440,9216,-180224,31
378,23,24,6,0.0573566085,0.942643392,112.9043502,154.7180984,200.1904762,214.3043478,401,5.840372852,802,-193536,11776,-181760,31
4384,314,22,8,0.0668369519,0.933163048,1342.645544,1486.068678,2323.47833,2712.808917,4698,236.080402,9396,-2244608,160768,-2083840,31
284,19,22,8,0.0627062706,0.937293729,85.91556706,80.92039794,156.6373239,82.68421053,303,5.968091393,606,-145408,9728,-135680,31
5687,556,23,7,0.0890597469,0.910940253,1760.361844,1911.448339,3023.301037,4131.534173,6243,126.7614213,12486,-2911744,284672,-2627072,31
5598,548,21,9,0.0891636837,0.910836316,1736.527353,1879.417298,2981.650589,4011.771898,6146,115.2447028,12292,-2866176,280576,-2585600,31
4701,285,23,7,0.0571600481,0.942839952,1442.040659,1393.933178,2493.573708,2492.284211,4986,123.0807208,9972,-2406912,145920,-2260992,31
4668,335,21,9,0.0669598241,0.933040176,1431.627917,1565.150233,2475.913453,2865.498507,5003,288.8568129,10006,-2390016,171520,-2218496,31
4738,271,23,7,0.0541026153,0.945897385,1448.219402,1405.664016,2507.018362,2469.712177,5009,232.6521133,10018,-2425856,138752,-2287104,31
5076,320,22,8,0.0593031875,0.940696812,1556.691866,1568.328106,2690.739953,2821.59375,5396,277.8578785,10792,-2598912,163840,-2435072,31
4652,332,21,9,0.0666131621,0.933386838,1424.735961,1584.590045,2468.450559,2829.481928,4984,289.9360093,9968,-2381824,169984,-2211840,31
4651,333,23,7,0.0668138042,0.933186196,1424.942476,1566.759034,2464.165986,2888.24024,4984,318.8739603,9968,-2381312,170496,-2210816,31
4804,296,22,8,0.0580392157,0.941960784,1473.418898,1453.002379,2549.98189,2558.908784,5100,196.380439,10200,-2459648,151552,-2308096,31
4641,335,21,9,0.0673231511,0.932676849,1420.476486,1575.940672,2456.409825,2933.068657,4976,322.4886585,9952,-2376192,171520,-2204672,31
4607,276,23,7,0.0565226295,0.94347737,1412.751753,1355.84074,2441.138702,2456.376812,4883,179.7864507,9766,-2358784,141312,-2217472,31
4889,348,22,8,0.0664502578,0.933549742,1502.209212,1593.782019,2592.264062,2994.609195,5237,299.9427262,10474,-2503168,178176,-2324992,31
4314,298,21,9,0.0646140503,0.93538595,1317.693143,1460.805446,2279.520862,2697.063758,4612,267.672664,9224,-2208768,152576,-2056192,31
4835,346,22,8,0.0667824744,0.933217526,1483.77846,1597.08174,2561.712513,3000.263006,5181,113.0975769,10362,-2475520,177152,-2298368,31
5656,576,22,8,0.0924261874,0.907573813,1758.290308,1904.284622,3017.892504,4084.770833,6232,119.1586998,12464,-2895872,294912,-2600960,31
4882,357,22,8,0.0681427753,0.931857225,1500.279131,1608.250488,2588.520279,3050.487395,5239,255.0632911,10478,-2499584,182784,-2316800,31
2843,185,22,8,0.0610964333,0.938903567,875.280122,844.9452839,1505.894126,1646.751351,3028,41.8289819,6056,-1455616,94720,-1360896,31
2841,184,21,9,0.0608264463,0.939173554,873.3268736,863.3670724,1505.347061,1631.163043,3025,46.15501984,6050,-1454592,94208,-1360384,31
3032,186,24,6,0.0577998757,0.942200124,919.1225085,990.9335823,1634.57091,1200.817204,3218,415.2258065,6436,-1552384,95232,-1457152,31
2805,192,24,6,0.0640640641,0.935935936,848.2163879,1070.097486,1509.980749,1338.578125,2997,180.8690404,5994,-1436160,98304,-1337856,31
3022,192,24,6,0.0597386434,0.940261357,918.9705279,987.7347978,1630.707148,1242.229167,3214,177.7654867,6428,-1547264,98304,-1448960,31
3067,229,24,6,0.0694781553,0.930521845,931.0411925,1184.479111,1658.015324,1521.061135,3296,181.7981247,6592,-1570304,117248,-1453056,31
3034,191,24,6,0.0592248062,0.940775194,921.190916,994.3306596,1637.874423,1217.874346,3225,553.1732419,6450,-1553408,97792,-1455616,31
3033,187,24,6,0.0580745342,0.941925466,920.2631083,993.8709422,1634.012529,1229.144385,3220,285.9680284,6440,-1552896,95744,-1457152,31
3031,185,24,6,0.0575248756,0.942475124,917.9707141,987.858535,1635.057737,1173.383784,3216,381.042654,6432,-1551872,94720,-1457152,31
3021,190,24,6,0.0591715976,0.940828402,915.3911622,998.336092,1633.330354,1171.447368,3211,221.7541436,6422,-1546752,97280,-1449472,31
2840,203,24,6,0.0667104831,0.933289517,857.7051596,1114.444347,1534.592606,1345.827586,3043,201.6567263,6086,-1454080,103936,-1350144,31
3025,189,24,6,0.0588052271,0.941194773,917.7966504,981.1200132,1634.181818,1180.449735,3214,440.2739726,6428,-1548800,96768,-1452032,31
2794,192,24,6,0.064300067,0.935699933,844.9865925,1066.826446,1504.444882,1334.229167,2986,254.1276596,5972,-1430528,98304,-1332224,31
3063,191,24,6,0.0586969883,0.941303012,931.7182297,955.6797692,1654.421482,1195.769634,3254,365.2076319,6508,-1568256,97792,-1470464,31
3030,189,24,6,0.0587138863,0.941286114,920.0020294,980.2194421,1635.438614,1202.174603,3219,530.3130148,6438,-1551360,96768,-1454592,31
2846,207,24,6,0.0678021618,0.932197838,861.1406705,1116.611523,1535.149684,1414.951691,3053,216.2181303,6106,-1457152,105984,-1351168,31
3025,191,24,6,0.0593905473,0.940609453,918.9579016,1000.511007,1631.125289,1250.167539,3216,147.9981592,6432,-1548800,97792,-1451008,31
3047,189,24,6,0.0584054388,0.941594561,923.0164286,1017.459483,1643.378405,1217.417989,3236,542.9530201,6472,-1560064,96768,-1463296,31
2844,203,24,6,0.0666229078,0.933377092,859.5629934,1108.555012,1536.494726,1348.950739,3047,317.3958333,6094,-1456128,103936,-1352192,31
2811,181,24,6,0.0604946524,0.939505348,854.8835166,932.1945442,1517.457844,1171.016575,2992,129.355815,5984,-1439232,92672,-1346560,31
3102,199,24,6,0.0602847622,0.939715238,941.2693639,1024.301345,1679.002579,1214.497487,3301,247.6369092,6602,-1588224,101888,-1486336,31
3068,195,24,6,0.0597609562,0.940239044,929.8074213,1007.005558,1661.602021,1166.261538,3263,402.8395062,6526,-1570816,99840,-1470976,31
4949,460,20,10,0.0850434461,0.914956554,1535.872731,1796.258062,2727.434027,2463.63913,5409,451.8796992,10818,-2533888,235520,-2298368,32
5021,460,21,9,0.0839262908,0.916073709,1555.595639,1811.294459,2773.197969,2389.552174,5481,451.8549052,10962,-2570752,235520,-2335232,32
7710,1163,20,10,0.131071791,0.868928209,2549.064512,2575.194113,4354.096109,4986.603611,8873,171.6911765,17746,-3947520,595456,-3352064,32
7188,1110,21,9,0.133767173,0.866232827,2347.475506,2504.092004,4010.129382,5052.018919,8298,145.9887403,16596,-3680256,568320,-3111936,32
5096,486,19,11,0.0870655679,0.912934432,1602.806311,1589.23095,2846.174843,2218.201646,5582,350.1882058,11164,-2609152,248832,-2360320,32
4777,451,20,10,0.0862662586,0.913733741,1481.072309,1752.260832,2642.741679,2315.363636,5228,412.3028391,10456,-2445824,230912,-2214912,32
4887,443,20,10,0.0831144465,0.916885553,1515.301676,1753.383373,2689.937999,2395.909707,5330,412.2196442,10660,-2502144,226816,-2275328,32
8294,1152,19,11,0.121956384,0.878043616,2735.873129,2613.787521,4658.705811,5189.99566,9446,174.3769614,18892,-4246528,589824,-3656704,32
4913,448,21,9,0.0835664988,0.916433501,1524.185503,1773.922768,2697.690006,2497.96875,5361,449.7483221,10722,-2515456,229376,-2286080,32
5058,485,20,10,0.0874977449,0.912502255,1593.13515,1589.476428,2819.310992,2278.6,5543,488.3700441,11086,-2589696,248320,-2341376,32
4809,459,19,11,0.0871298405,0.912870159,1495.095942,1745.633647,2659.593263,2371.594771,5268,501.2369172,10536,-2462208,235008,-2227200,32
4930,509,20,10,0.0935833793,0.906416621,1541.984438,1766.190948,2763.227181,2301.316306,5439,280.9400826,10878,-2524160,260608,-2263552,32
4955,458,21,9,0.0846111214,0.915388879,1537.385717,1806.064557,2721.102926,2554.423581,5413,504.9440299,10826,-2536960,234496,-2302464,32
4949,449,21,9,0.0831789552,0.916821045,1538.107676,1722.075146,2733.225702,2327.766147,5398,339.7105098,10796,-2533888,229888,-2304000,32
7028,1118,20,10,0.137245274,0.862754726,2301.647229,2405.832801,3911.544963,5091.585868,8146,143.3650123,16292,-3598336,572416,-3025920,32
4913,417,20,10,0.0782363977,0.921763602,1520.854704,1716.304054,2685.912274,2425.007194,5330,414.1414141,10660,-2515456,213504,-2301952,32
4510,354,21,9,0.0727796053,0.927220395,1386.682313,1467.882917,2482.447672,1796.161017,4864,191.496063,9728,-2309120,181248,-2127872,32
6935,994,21,9,0.125362593,0.874637407,2246.075769,2447.480707,3860.819178,4691.855131,7929,143.3815552,15858,-3550720,508928,-3041792,32
5025,480,20,10,0.0871934605,0.91280654,1577.389499,1629.492,2799.557612,2265.6,5505,336.9033048,11010,-2572800,245760,-2327040,32
848,105,20,10,0.110178384,0.889821616,275.2018589,274.159112,478.1698113,467.552381,953,15.03866183,1906,-434176,53760,-380416,32
4715,830,23,7,0.1496844,0.8503156,1592.468127,1582.727559,2699.215483,3192.149398,5545,108.3219379,11090,-2414080,424960,-1989120,32
2821,389,23,7,0.121183801,0.878816199,926.0366377,931.060314,1605.241758,1607.372751,3210,249.6111975,6420,-1444352,199168,-1245184,32
5785,930,23,7,0.138495905,0.861504095,1963.385743,1774.515684,3349.093518,3413.402151,6715,139.6921157,13430,-2961920,476160,-2485760,32
2454,320,23,7,0.115356885,0.884643115,795.4332595,839.7515518,1392.377343,1350.096875,2774,260.7142857,5548,-1256448,163840,-1092608,32
2501,337,23,7,0.118745595,0.881254405,813.3320571,857.8075805,1430.215514,1339.976261,2838,234.9337748,5676,-1280512,172544,-1107968,32
4591,897,24,6,0.163447522,0.836552478,1558.766713,1640.977224,2659.365062,3180.235229,5488,100.9565857,10976,-2350592,459264,-1891328,32
7280,1034,20,10,0.124368535,0.875631465,2449.169046,2002.053722,4193.857418,3901.521277,8314,147.8570158,16628,-3727360,529408,-3197952,32
2689,350,21,9,0.115169464,0.884830536,869.3088918,932.6789221,1509.941614,1597.277143,3039,53.15725031,6078,-1376768,179200,-1197568,32
2503,351,21,9,0.122985284,0.877014716,826.3614465,805.9280978,1428.3336,1421.555556,2854,293.6213992,5708,-1281536,179712,-1101824,32
2491,354,23,7,0.124428822,0.875571178,822.0188764,815.7527873,1426.013649,1401.793785,2845,206.1594203,5690,-1275392,181248,-1094144,32
2462,346,21,9,0.123219373,0.876780627,799.2848525,886.7901426,1402.257108,1420.459538,2808,49.08232826,5616,-1260544,177152,-1083392,32
2517,334,22,8,0.117151877,0.882848123,824.9413257,807.8145078,1429.603099,1398.847305,2851,195.4078136,5702,-1288704,171008,-1117696,32
2440,313,21,9,0.113694152,0.886305848,789.0091961,837.9098484,1377.648361,1371.945687,2753,299.5647443,5506,-1249280,160256,-1089024,32
2474,330,21,9,0.117689016,0.882310984,802.7012478,856.9597361,1408.545271,1357.178788,2804,287.5897436,5608,-1266688,168960,-1097728,32
2535,362,22,8,0.124956852,0.875043148,836.8674802,832.2024454,1447.818935,1457.270718,2897,312.5134844,5794,-1297920,185344,-1112576,32
4541,837,21,9,0.155634065,0.844365935,1532.798967,1609.956199,2624.349262,3042.964158,5378,93.57925874,10756,-2324992,428544,-1896448,32
2503,342,23,7,0.120210896,0.879789104,817.3370712,845.5832831,1433.556932,1345.736842,2845,284.7847848,5690,-1281536,175104,-1106432,32
4784,887,23,7,0.156409804,0.843590196,1624.69587,1654.92234,2768.083403,3202.305524,5671,103.1278414,11342,-2449408,454144,-1995264,32
5843,995,23,7,0.145510383,0.854489617,1998.7329,1808.727089,3385.333733,3620.136683,6838,120.5783812,13676,-2991616,509440,-2482176,32
778,94,23,7,0.107798165,0.892201835,253.4901795,227.2733712,444.0089974,374.3510638,872,14.05771401,1744,-398336,48128,-350208,32
3670,452,23,7,0.109655507,0.890344493,1184.969434,1216.071232,2082.455858,1891.349558,4122,256.0248447,8244,-1879040,231424,-1647616,32
3713,402,23,7,0.097691373,0.902308627,1185.908584,1186.59002,2080.231349,1852.664179,4115,333.1983806,8230,-1901056,205824,-1695232,32
3642,461,21,9,0.112356812,0.887643188,1169.698749,1294.123695,2057.564525,2008.039046,4103,74.37012869,8206,-1864704,236032,-1628672,32
4937,738,22,8,0.130044053,0.869955947,1614.279799,1776.698689,2807.361353,3042.963415,5675,109.197614,11350,-2527744,377856,-2149888,32
3769,445,24,6,0.10560038,0.89439962,1212.163371,1243.015103,2124.602547,1962.647191,4214,303.3837293,8428,-1929728,227840,-1701888,32
6699,1288,21,9,0.161262051,0.838737949,2269.284581,2395.524386,3876.836543,4603.377329,7987,139.0978753,15974,-3429888,659456,-2770432,32
1809,215,23,7,0.106225296,0.893774704,573.5800855,659.2376518,1024.290768,913.2930233,2024,145.2979182,4048,-926208,110080,-816128,32
3664,426,23,7,0.104156479,0.895843521,1177.809636,1200.409183,2057.186408,1944.985915,4090,324.088748,8180,-1875968,218112,-1657856,32
6875,1224,22,8,0.151129769,0.848870231,2307.927468,2361.892195,3915.549382,4805.186275,8099,142.6382529,16198,-3520000,626688,-2893312,32
3684,436,23,7,0.105825243,0.894174757,1186.511829,1206.414509,2074.612921,1941.252294,4120,276.695769,8240,-1886208,223232,-1662976,32
3751,438,23,7,0.104559561,0.895440439,1205.445243,1236.34416,2107.428686,1988.561644,4189,351.4261745,8378,-1920512,224256,-1696256,32
6337,1161,21,9,0.154841291,0.845158709,2136.987187,2227.007672,3646.900584,4309.510767,7498,132.5437511,14996,-3244544,594432,-2650112,32
3591,415,21,9,0.103594608,0.896405392,1156.575904,1152.564171,2012.019772,1929.778313,4006,153.0760413,8012,-1838592,212480,-1626112,32
6647,1262,23,7,0.159565052,0.840434948,2253.434716,2329.158323,3832.257861,4601.487322,7909,140.5544695,15818,-3403264,646144,-2757120,32
3777,461,23,7,0.108777725,0.891222275,1223.972748,1213.255217,2132.814138,2010.416486,4238,274.3042071,8476,-1933824,236032,-1697792,32
3764,425,23,7,0.101456195,0.898543805,1208.00229,1211.987021,2110.259033,1959.858824,4189,260.3480423,8378,-1927168,217600,-1709568,32
3751,441,22,8,0.105200382,0.894799618,1205.208087,1238.519826,2116.241536,1928.585034,4192,334.557063,8384,-1920512,225792,-1694720,32
4010,442,23,7,0.0992812219,0.900718778,1284.791477,1286.716926,2234.006484,2158.39819,4452,294.4444444,8904,-2053120,226304,-1826816,32
7455,1227,22,8,0.141326883,0.858673117,2502.757129,2479.824858,4266.934004,4794.547677,8682,154.5940171,17364,-3816960,628224,-3188736,32
925,122,21,9,0.1165234,0.8834766,297.4686883,299.007074,543.0659459,379.442623,1047,17.14706846,2094,-473600,62464,-411136,32
2605,332,24,6,0.113040518,0.886959482,848.2629923,740.3627304,1517.762764,1086.388554,2937,51.51727767,5874,-1333760,169984,-1163776,32
5199,526,23,7,0.0918777293,0.908122271,1627.627409,1882.168308,2860.780535,2884.937262,5725,427.877429,11450,-2661888,269312,-2392576,32
5250,545,22,8,0.0940465919,0.905953408,1663.099338,1739.355288,2927.178667,2616.921101,5795,203.1907433,11590,-2688000,279040,-2408960,32
7779,1199,22,8,0.133548675,0.866451325,2535.845962,2806.995399,4369.740069,5266.491243,8978,160.3787067,17956,-3982848,613888,-3368960,32
5708,512,24,6,0.0823151125,0.917684887,1776.620129,1987.580249,3124.826034,2950.787109,6220,268.9148292,12440,-2922496,262144,-2660352,32
5213,517,23,7,0.0902268761,0.909773124,1631.954819,1862.286878,2861.268368,2908.168279,5730,581.7258883,11460,-2669056,264704,-2404352,32
5412,566,21,9,0.0946804951,0.905319505,1704.73582,1912.814995,2981.277162,3068.125442,5978,437.3079737,11956,-2770944,289792,-2481152,32
5204,566,24,6,0.0980935875,0.901906412,1638.006652,1899.461066,2893.691968,2810.180212,5770,432.2097378,11540,-2664448,289792,-2374656,32
5805,585,24,6,0.0915492958,0.908450704,1813.512644,2117.355219,3174.196382,3406.897436,6390,113.2376396,12780,-2972160,299520,-2672640,32
5178,545,22,8,0.0952297746,0.904770225,1627.45392,1869.739488,2865.206643,2831.533945,5723,547.6555024,11446,-2651136,279040,-2372096,32
5181,503,23,7,0.0884940183,0.911505982,1615.250271,1881.697922,2833.50608,2935.139165,5684,500.3521127,11368,-2652672,257536,-2395136,32
5553,547,23,7,0.0896721311,0.910327869,1744.992092,1914.568263,3046.200792,3094.144424,6100,615.5398587,12200,-2843136,280064,-2563072,32
8701,1165,23,7,0.118082303,0.881917697,2828.67357,2927.690528,4857.801172,5498.869528,9866,393.6951317,19732,-4454912,596480,-3858432,32
5209,532,24,6,0.0926667828,0.907333217,1632.504896,1882.294937,2875.040507,2831.43797,5741,438.579068,11482,-2667008,272384,-2394624,32
7554,1117,23,7,0.128820205,0.871179795,2443.236373,2723.820888,4208.839158,5195.957923,8671,155.3664218,17342,-3867648,571904,-3295744,32
5213,519,24,6,0.0905443126,0.909455687,1635.827898,1832.469977,2871.96432,2811.614644,5732,515.4676259,11464,-2669056,265728,-2403328,32
4358,362,23,7,0.0766949153,0.923305085,1352.289744,1444.217449,2386.485773,2047.665746,4720,167.9117752,9440,-2231296,185344,-2045952,32
8173,1120,23,7,0.120520822,0.879479178,2667.981634,2639.447563,4531.837514,5487.377679,9293,192.7208627,18586,-4184576,573440,-3611136,32
2056,167,23,7,0.0751237067,0.924876293,640.1389818,575.4203078,1137.399805,799.2934132,2223,35.33619456,4446,-1052672,85504,-967168,32
645,72,23,7,0.10041841,0.89958159,208.6880597,190.9103875,358.3906977,364.4583333,717,11.36111551,1434,-330240,36864,-293376,32
3162,393,23,7,0.110548523,0.889451477,1023.304919,1049.546023,1777.437698,1782.524173,3555,302.8109029,7110,-1618944,201216,-1417728,32
2797,370,24,6,0.116829807,0.883170193,914.4913819,911.2705977,1578.648194,1624.456757,3167,314.1865079,6334,-1432064,189440,-1242624,32
2682,319,23,7,0.106297901,0.893702099,860.6739872,912.3148538,1500.037286,1509.094044,3001,263.7082601,6002,-1373184,163328,-1209856,32
8799,1080,22,8,0.109322806,0.890677194,2900.723153,2311.50436,5021.742016,4274.02963,9879,184.0693125,19758,-4505088,552960,-3952128,32
2671,327,23,7,0.109072715,0.890927285,856.9385384,931.7808593,1502.090603,1478.33945,2998,304.6747967,5996,-1367552,167424,-1200128,32
2654,317,22,8,0.106698081,0.893301919,851.1625726,910.1341703,1484.911454,1495.113565,2971,297.3973974,5942,-1358848,162304,-1196544,32
2926,323,24,6,0.0994152047,0.900584795,939.3567574,914.9648075,1611.013329,1751.702786,3249,233.7410072,6498,-1498112,165376,-1332736,32
5621,989,24,6,0.149621785,0.850378215,1908.194719,1863.268407,3238.975093,3683.595551,6610,131.8571714,13220,-2877952,506368,-2371584,32
2677,345,21,9,0.114162806,0.885837194,862.9080665,940.4096685,1519.320134,1450.82029,3022,225.3542133,6044,-1370624,176640,-1193984,32
5591,932,24,6,0.142879043,0.857120957,1878.121073,1865.675224,3197.299231,3650.135193,6523,123.7995825,13046,-2862592,477184,-2385408,32
4885,886,23,7,0.153526252,0.846473748,1642.073371,1697.156464,2790.081883,3414.848758,5771,114.1641939,11542,-2501120,453632,-2047488,32
2801,354,24,6,0.112202853,0.887797147,902.597724,972.8956285,1579.818279,1563.612994,3155,263.1359466,6310,-1434112,181248,-1252864,32
1926,240,24,6,0.110803324,0.889196676,623.7135424,616.651297,1102.558671,930.5541667,2166,38.10696692,4332,-986112,122880,-863232,32
6202,1064,24,6,0.146435453,0.853564547,2125.048912,1922.808633,3608.620929,3778.518797,7266,142.1639601,14532,-3175424,544768,-2630656,32
2637,343,21,9,0.115100671,0.884899329,856.7612028,885.4131552,1496.180129,1446.830904,2980,234.4610543,5960,-1350144,175616,-1174528,32
2715,344,22,8,0.112455051,0.887544949,881.5628862,894.6890173,1528.623573,1540.863372,3059,232.0940819,6118,-1390080,176128,-1213952,32
4550,755,23,7,0.142318567,0.857681433,1515.981434,1593.197602,2606.761538,2931.655629,5305,92.9234542,10610,-2329600,386560,-1943040,32
6048,1035,22,8,0.146124524,0.853875476,2048.355441,1933.956874,3448.074901,4090.849275,7083,129.8203812,14166,-3096576,529920,-2566656,32
623,91,23,7,0.12745098,0.87254902,206.8282097,201.1523048,357.6436597,356.5164835,714,10.5,1428,-318976,46592,-272384,32
2713,329,23,7,0.108152531,0.891847469,871.7877376,928.5366916,1518.318098,1547.738602,3042,258.893617,6084,-1389056,168448,-1220608,32
2255,297,23,7,0.11637931,0.88362069,734.1817814,752.7362739,1284.546341,1215.407407,2552,272.0682303,5104,-1154560,152064,-1002496,32
2330,345,22,8,0.128971963,0.871028037,762.6247947,833.7182478,1334.816309,1359.501449,2675,187.8511236,5350,-1192960,176640,-1016320,32
2196,313,21,9,0.124750897,0.875249103,721.9417963,731.3187229,1270.520492,1146.108626,2509,67.55519655,5018,-1124352,160256,-964096,32
2202,298,21,9,0.1192,0.8808,718.3402214,742.2261715,1259.965486,1180.557047,2500,351.1235955,5000,-1127424,152576,-974848,32
2218,299,23,7,0.118792213,0.881207787,723.1186448,747.5363556,1269.216411,1183.214047,2517,241.3231064,5034,-1135616,153088,-982528,32
8577,1283,21,9,0.130121704,0.869878296,2916.270513,2169.708981,5047.217559,4150.22993,9860,239.262315,19720,-4391424,656896,-3734528,32
2367,312,23,7,0.116461366,0.883538634,774.3261202,765.9741655,1340.721166,1334.528846,2679,228,5358,-1211904,159744,-1052160,32
2241,317,23,7,0.123924941,0.876075059,734.8803028,759.0288626,1289.871932,1206.176656,2558,247.6282672,5116,-1147392,162304,-985088,32
2231,289,23,7,0.11468254,0.88531746,724.6140737,747.6369108,1266.158225,1216.820069,2520,125.4355401,5040,-1142272,147968,-994304,32
276,74,24,6,0.211428571,0.788571429,103.8946293,89.54915994,175.9855072,173.6891892,350,13.13320826,700,-141312,37888,-103424,32
2268,301,23,7,0.117166213,0.882833787,739.902708,753.8121698,1288.449295,1259.009967,2569,195.9572845,5138,-1161216,154112,-1007104,32
2233,309,24,6,0.121557828,0.878442172,731.9398398,744.797578,1279.269592,1215.352751,2542,177.7622378,5084,-1143296,158208,-985088,32
1099,120,23,7,0.0984413454,0.901558655,346.6303748,368.9014984,625.1737944,471.0333333,1219,28.0875576,2438,-562688,61440,-501248,32
5849,1216,22,8,0.172116065,0.827883935,2030.077582,2007.059011,3426.752436,4044.054276,7065,125.2659574,14130,-2994688,622592,-2372096,32
2306,328,21,9,0.124525437,0.875474563,760.350181,758.6044061,1324.663053,1267.140244,2634,163.7041641,5268,-1180672,167936,-1012736,32
6129,1145,23,7,0.157409953,0.842590047,2123.351438,1941.526744,3581.185022,3938.944978,7274,133.910162,14548,-3138048,586240,-2551808,32
2240,294,23,7,0.116022099,0.883977901,728.4734533,748.8457558,1278.553125,1183.285714,2534,199.0573449,5068,-1146880,150528,-996352,32
8565,1291,21,9,0.130986201,0.869013799,2903.460836,2320.299033,5026.717104,4276.889233,9856,433.9938353,19712,-4385280,660992,-3724288,32
5917,1083,23,7,0.154714286,0.845285714,2044.579938,1856.969854,3445.925638,3798.668513,7000,128.0878317,14000,-3029504,554496,-2475008,32
805,93,23,7,0.103563474,0.896436526,255.9678191,259.4886462,462.6322981,335.827957,898,14.49322143,1796,-412160,47616,-364544,32
2693,304,24,6,0.101434768,0.898565232,860.5380583,902.4949595,1506.296695,1434.361842,2997,217.6470588,5994,-1378816,155648,-1223168,32
6060,994,21,9,0.140912957,0.859087043,2046.578824,1942.871616,3475.647195,3843.624748,7054,131.2127976,14108,-3102720,508928,-2593792,32
2906,359,24,6,0.109954058,0.890045942,937.2689379,979.2649122,1644.275292,1541.729805,3265,305.4256314,6530,-1487872,183808,-1304064,32
2777,342,23,7,0.109650529,0.890349471,893.6072227,950.5133552,1568.872524,1487.95614,3119,297.3307912,6238,-1421824,175104,-1246720,32
6073,1019,24,6,0.143683023,0.856316977,2074.25536,1876.90858,3534.394369,3618.646712,7092,140.0197433,14184,-3109376,521728,-2587648,32
2965,336,24,6,0.101787337,0.898212663,948.1512334,993.7421336,1648.674199,1671.52381,3301,376.826484,6602,-1518080,172032,-1346048,32
2821,352,22,8,0.110936023,0.889063977,909.1051468,956.3915404,1605.476427,1438.926136,3173,273.2988803,6346,-1444352,180224,-1264128,32
2886,329,24,6,0.102332815,0.897667185,921.1245839,975.7596825,1624.108108,1466.699088,3215,266.5837479,6430,-1477632,168448,-1309184,32
2887,364,22,8,0.111965549,0.888034451,941.1140639,915.4067832,1633.083824,1569.815934,3251,198.5949908,6502,-1478144,186368,-1291776,32
2176,251,23,7,0.10341986,0.89658014,688.315608,798.4521758,1209.87454,1249.76494,2427,248.6680328,4854,-1114112,128512,-985600,32
6133,1017,23,7,0.142237762,0.857762238,2072.857695,1963.007834,3509.17414,3975.476893,7150,124.9781507,14300,-3140096,520704,-2619392,32
8725,1115,20,10,0.113313008,0.886686992,2876.535665,2461.423906,4996.692493,4324.285202,9840,203.4739454,19680,-4467200,570880,-3896320,32
2899,388,22,8,0.118040767,0.881959233,948.2328901,952.9055997,1648.766816,1608.384021,3287,322.8880157,6574,-1484288,198656,-1285632,32
4958,884,21,9,0.151318042,0.848681958,1659.673688,1686.687776,2805.181323,3573.884615,5842,109.4212399,11684,-2538496,452608,-2085888,32
5163,933,22,8,0.153051181,0.846948819,1735.064969,1799.764121,2952.203564,3581.381565,6096,122.5572979,12192,-2643456,477696,-2165760,32
3223,396,23,7,0.109422492,0.890577508,1043.992859,1049.482614,1804.442755,1855.229798,3619,263.9679066,7238,-1650176,202752,-1447424,32
2816,330,24,6,0.104895105,0.895104895,904.7714087,932.3149125,1583.523082,1487.969697,3146,299.9046711,6292,-1441792,168960,-1272832,32
6684,1050,23,7,0.135764158,0.864235842,2245.918715,2090.724113,3796.83827,4317.312381,7734,136.9091875,15468,-3422208,537600,-2884608,32
2909,315,23,7,0.0977047146,0.902295285,930.4272366,931.3601501,1618.356136,1558.419048,3224,276.2639246,6448,-1489408,161280,-1328128,32
3150,358,24,6,0.102052452,0.897947548,1010.638233,1030.282002,1752.841905,1769.089385,3508,238.3152174,7016,-1612800,183296,-1429504,32
2175,269,23,7,0.110065466,0.889934534,702.0337926,729.327904,1231.184368,1152.282528,2444,261.9506967,4888,-1113600,137728,-975872,32
2263,294,23,7,0.11497849,0.88502151,734.5227279,762.9405178,1286.539107,1220.969388,2557,267.7486911,5114,-1158656,150528,-1008128,32
7707,1341,23,7,0.148209549,0.851790451,2639.452948,2447.491262,4530.493318,4490.055183,9048,164.7187329,18096,-3945984,686592,-3259392,32
2208,296,24,6,0.118210863,0.881789137,720.7860767,735.7321198,1259.779891,1198.195946,2504,200.8019246,5008,-1130496,151552,-978944,32
2257,306,23,7,0.119391338,0.880608662,735.404844,771.5206251,1285.607444,1255.392157,2563,44.41941075,5126,-1155584,156672,-998912,32
6254,1326,23,7,0.174934037,0.825065963,2199.000748,2083.214075,3699.373681,4220.291855,7580,135.0436487,15160,-3202048,678912,-2523136,32
2079,282,21,9,0.119440915,0.880559085,676.841036,708.1500256,1193.935546,1085.634752,2361,341.6787265,4722,-1064448,144384,-920064,32
5915,1117,23,7,0.158845279,0.841154721,2061.091456,1844.185791,3479.605748,3711.871083,7032,126.8398268,14064,-3028480,571904,-2456576,32
2128,295,21,9,0.121749897,0.878250103,695.0546417,725.3947671,1223.145207,1131.60339,2423,169.3221523,4846,-1089536,151040,-938496,32
2137,289,22,8,0.119126134,0.880873866,696.8965544,720.8329737,1223.563407,1139.086505,2426,191.9303797,4852,-1094144,147968,-946176,32
5930,1129,23,7,0.159937668,0.840062332,2064.074018,1875.83796,3484.927993,3766.737821,7059,123.0863121,14118,-3036160,578048,-2458112,32
6655,1171,23,7,0.14962944,0.85037056,2287.946876,2086.811472,3901.509391,3981.644748,7826,156.7394352,15652,-3407360,599552,-2807808,32
2161,272,23,7,0.111796136,0.888203864,700.0458351,718.2113948,1223.601573,1164.551471,2433,240.4150198,4866,-1106432,139264,-967168,32
2176,281,23,7,0.114367114,0.885632886,708.5970525,714.2939718,1231.089614,1212.818505,2457,300,4914,-1114112,143872,-970240,32
2275,293,23,7,0.114096573,0.885903427,738.2202718,757.3396795,1297.53978,1183.25256,2568,234.5205479,5136,-1164800,150016,-1014784,32
8601,1260,22,8,0.127776088,0.872223912,2910.328166,2286.773764,5014.283572,4362.490476,9861,399.3924666,19722,-4403712,645120,-3758592,32
2424,314,23,7,0.11468225,0.88531775,786.8402244,815.7912348,1375.540842,1322.866242,2738,140.6988695,5476,-1241088,160768,-1080320,32
2278,300,21,9,0.116369279,0.883630721,744.6700634,739.0423282,1295.555312,1243.52,2578,63.40383669,5156,-1166336,153600,-1012736,32
7157,1202,23,7,0.143797105,0.856202895,2440.614516,2241.000678,4170.642588,4235.716306,8359,150.4770477,16718,-3664384,615424,-3048960,32
2133,307,21,9,0.125819672,0.874180328,702.294477,716.7277726,1227.482888,1171.983713,2440,288.0755608,4880,-1092096,157184,-934912,32
2421,317,23,7,0.11577794,0.88422206,791.5606551,778.7892013,1377.377943,1309.334385,2738,166.0400243,5476,-1239552,162304,-1077248,32
8653,1123,23,7,0.114873159,0.885126841,2864.208589,2384.445379,4968.856235,4269.334817,9776,175.7957202,19552,-4430336,574976,-3855360,32
2419,313,23,7,0.114568082,0.885431918,785.5867516,810.5464795,1372.458867,1320.447284,2732,254.1395349,5464,-1238528,160256,-1078272,32
2454,305,23,7,0.1105473,0.8894527,792.8944084,821.4673479,1388.337001,1312.921311,2759,229.5341098,5518,-1256448,156160,-1100288,32
2508,321,23,7,0.113467656,0.886532344,813.9229267,833.9365224,1424.626396,1339.788162,2829,226.1390887,5658,-1284096,164352,-1119744,32
2448,312,22,8,0.113043478,0.886956522,795.4466714,802.1893779,1390.88848,1298.990385,2760,320.1856148,5520,-1253376,159744,-1093632,32
4320,787,23,7,0.154102213,0.845897787,1440.266732,1576.819038,2473.470833,2996.040661,5107,105.7568855,10214,-2211840,402944,-1808896,32
2461,309,23,7,0.111552347,0.888447653,798.3050436,808.7661341,1391.011377,1341.605178,2770,194.5224719,5540,-1260032,158208,-1101824,32
2521,322,23,7,0.11326064,0.88673936,820.2809391,821.6978597,1429.408171,1364,2843,326.7816092,5686,-1290752,164864,-1125888,32
5075,1022,22,8,0.167623421,0.832376579,1743.351044,1737.060402,2937.098325,3604.676125,6097,108.6034913,12194,-2598400,523264,-2075136,32
1931,258,21,9,0.117862037,0.882137963,626.6381794,665.7548871,1104.50492,1023.860465,2189,211.9070668,4378,-988672,132096,-856576,32
2458,302,23,7,0.10942029,0.89057971,795.032127,807.633026,1388.447518,1315.81457,2760,326.6272189,5520,-1258496,154624,-1103872,32
2459,330,23,7,0.118321979,0.881678021,804.1747139,808.7954988,1404.203335,1326.421212,2789,279.4589178,5578,-1259008,168960,-1090048,32
4376,780,21,9,0.151280062,0.848719938,1471.33796,1532.664396,2514.951782,2935.021795,5156,105.5259926,10312,-2240512,399360,-1841152,32
2466,312,24,6,0.112311015,0.887688985,801.4700851,803.6834958,1396.188564,1336.634615,2778,278.9156627,5556,-1262592,159744,-1102848,32
2523,334,24,6,0.116905845,0.883094155,826.4929761,810.8877307,1432.647642,1401.446108,2857,130.1001821,5714,-1291776,171008,-1120768,32
2419,317,24,6,0.115862573,0.884137427,786.4641887,798.0168163,1388.853245,1213.18612,2736,145.9978655,5472,-1238528,162304,-1076224,32
2521,328,22,8,0.115128115,0.884871885,817.0251832,862.8030488,1426.470448,1413.698171,2849,214.6948003,5698,-1290752,167936,-1122816,32
2537,313,23,7,0.109824561,0.890175439,823.9056178,812.0906823,1430.176587,1387.594249,2850,119.047619,5700,-1298944,160256,-1138688,32
772,88,23,7,0.102325581,0.897674419,246.0217954,219.1966759,446.9831606,285.8977273,860,14.28096978,1720,-395264,45056,-350208,32
4791,981,23,7,0.16995842,0.83004158,1636.543677,1711.145356,2779.791067,3407.644241,5772,107.4860335,11544,-2452992,502272,-1950720,32
2449,333,20,10,0.119698059,0.880301941,799.1404897,827.1925565,1402.400572,1311.333333,2782,261.7121355,5564,-1253888,170496,-1083392,32
2430,339,21,9,0.122426869,0.877573131,793.660487,831.4337335,1399.631276,1280.120944,2769,288.1373569,5538,-1244160,173568,-1070592,32
2491,333,21,9,0.117917847,0.882082153,813.253504,819.4299853,1428.895624,1289.852853,2824,123.9139974,5648,-1275392,170496,-1104896,32
5003,995,23,7,0.16588863,0.83411137,1710.621995,1707.727617,2878.667,3607.065327,5998,108.0720721,11996,-2561536,509440,-2052096,32
2482,329,23,7,0.117040199,0.882959801,810.1953735,818.3529079,1414.183723,1344.261398,2811,303.8918919,5622,-1270784,168448,-1102336,32
2500,329,22,8,0.116295511,0.883704489,808.0540223,878.65704,1410.768,1447.158055,2829,50.1506825,5658,-1280000,168448,-1111552,32
2344,319,22,8,0.119789711,0.880210289,767.8380045,774.5080857,1327.385666,1365.905956,2663,134.5629106,5326,-1200128,163328,-1036800,32
2488,314,23,7,0.112062812,0.887937188,801.5801382,852.1629069,1384.234325,1538.305732,2802,48.84085759,5604,-1273856,160768,-1113088,32
5228,1086,22,8,0.171998733,0.828001267,1816.323131,1774.501203,3056.593726,3643.262431,6314,108.4693352,12628,-2676736,556032,-2120704,32
5382,1154,23,7,0.176560588,0.823439412,1858.587932,1896.94527,3137.399294,3879.92461,6536,118.4057971,13072,-2755584,590848,-2164736,32
4977,858,21,9,0.147043702,0.852956298,1680.272508,1688.871441,2877.122162,3155.120047,5835,107.3992269,11670,-2548224,439296,-2108928,32
2514,320,23,7,0.112914608,0.887085392,815.5295836,834.6503256,1426.560859,1346.315625,2834,279.76308,5668,-1287168,163840,-1123328,32
2502,335,23,7,0.118082481,0.881917519,819.2693038,812.3773547,1429.603118,1339.808955,2837,73.72661123,5674,-1281024,171520,-1109504,32
5188,1130,23,7,0.178854068,0.821145932,1808.24613,1763.882757,3023.421357,3784.257522,6318,114.3529412,12636,-2656256,578560,-2077696,32
6407,1207,23,7,0.158523772,0.841476228,2231.884546,1989.807208,3760.388013,4057.57995,7614,133.9785325,15228,-3280384,617984,-2662400,32
2588,347,23,7,0.118228279,0.881771721,841.5467533,886.0657803,1459.35085,1532.507205,2935,51.99291408,5870,-1325056,177664,-1147392,32
6308,1187,23,7,0.158372248,0.841627752,2174.962875,2059.050779,3674.750634,4137.264532,7495,134.2468207,14990,-3229696,607744,-2621952,32
2495,311,23,7,0.110833927,0.889166073,805.6634975,843.7887775,1406.51022,1379.350482,2806,249.4222222,5612,-1277440,159232,-1118208,32
2601,346,22,8,0.117407533,0.882592467,850.2555024,850.8100347,1483.572472,1402.040462,2947,249.7457627,5894,-1331712,177152,-1154560,32
8202,925,21,9,0.10134765,0.89865235,2563.372689,3046.857326,4459.914777,5486.926486,9127,216.4848197,18254,-4199424,473600,-3725824,33
9025,882,22,8,0.08902796,0.91097204,2848.002491,2959.848925,4985.424266,4632.453515,9907,323.5467015,19814,-4620800,451584,-4169216,33
6975,837,21,9,0.107142857,0.892857143,2183.00071,2638.9344,3805.761864,4745.984468,7812,168.8715953,15624,-3571200,428544,-3142656,33
8122,912,22,8,0.100951959,0.899048041,2534.73995,3038.530585,4415.452844,5426.301535,9034,208.1087307,18068,-4158464,466944,-3691520,33
8133,892,21,9,0.0988365651,0.901163435,2534.005694,3046.31439,4417.125907,5387.152466,9025,208.6705202,18050,-4164096,456704,-3707392,33
9190,740,22,8,0.0745216516,0.925478348,2849.372931,3025.064147,5006.851795,4451.955405,9930,881.8827709,19860,-4705280,378880,-4326400,33
8474,758,21,9,0.0821057192,0.917894281,2650.567078,2688.289267,4690.030328,3794.473615,9232,164.3581983,18464,-4338688,388096,-3950592,33
8182,929,21,9,0.101964658,0.898035342,2555.262417,3121.473022,4473.171596,5285.496233,9111,231.5963396,18222,-4189184,475648,-3713536,33
8081,928,21,9,0.103008103,0.896991897,2524.009446,3107.651465,4426.027719,5192.688578,9009,166.0951327,18018,-4137472,475136,-3662336,33
8216,885,21,9,0.0972420613,0.902757939,2558.402292,3072.578022,4460.889849,5387.548023,9101,214.2924417,18202,-4206592,453120,-3753472,33
7062,843,22,8,0.106641366,0.893358634,2201.842124,2749.094483,3861.344662,4720.817319,7905,171.7358245,15810,-3615744,431616,-3184128,33
9326,626,21,9,0.0629019293,0.937098071,2852.825396,3015.758365,5037.131353,4073.228435,9952,266.1674244,19904,-4774912,320512,-4454400,33
8130,884,21,9,0.0980696694,0.901930331,2516.865801,3113.927393,4399.788561,5498.104072,9014,216.578568,18028,-4162560,452608,-3709952,33
9095,617,22,8,0.063529654,0.936470346,2782.743883,3007.216885,4904.535569,4148.423015,9712,169.9090273,19424,-4656640,315904,-4340736,33
7822,887,22,8,0.101848662,0.898151338,2445.905067,2934.15617,4265.545257,5143.855693,8709,157.0604148,17418,-4004864,454144,-3550720,33
9098,815,21,9,0.0822152729,0.917784727,2850.318722,2950.724182,4995.747857,4524.450307,9913,679.9039781,19826,-4658176,417280,-4240896,33
7988,876,22,8,0.0988267148,0.901173285,2495.796206,2931.384646,4336.000751,5312.449772,8864,200.3616637,17728,-4089856,448512,-3641344,33
9110,820,22,8,0.0825780463,0.917421954,2811.890594,3358.396197,4911.927552,5560.676829,9930,657.180675,19860,-4664320,419840,-4244480,33
9062,860,21,9,0.0866760734,0.913323927,2796.032452,3466.994617,4916.007062,5440.868605,9922,246.9387755,19844,-4639744,440320,-4199424,33
8223,886,21,9,0.0972664398,0.90273356,2544.945126,3138.755525,4446.397057,5562.948081,9109,200.3739551,18218,-4210176,453632,-3756544,33
5489,806,21,9,0.128038125,0.871961875,1836.426312,1645.107057,3100.951722,3468.406948,6295,150.9592326,12590,-2810368,412672,-2397696,33
5501,820,21,9,0.129726309,0.870273691,1826.264058,1764.406998,3102.244137,3555.165854,6321,118.9275635,12642,-2816512,419840,-2396672,33
8812,1072,21,9,0.108458114,0.891541886,2846.99507,2818.527923,4862.027236,5603.998134,9884,524.6284501,19768,-4511744,548864,-3962880,33
9063,849,21,9,0.085653753,0.914346247,2877.100316,2622.491383,5009.106256,4394.932862,9912,823.255814,19824,-4640256,434688,-4205568,33
5326,781,21,9,0.127886032,0.872113968,1766.271428,1708.967865,3009.167293,3359.734955,6107,112.7584934,12214,-2726912,399872,-2327040,33
8433,1003,21,9,0.10629504,0.89370496,2711.255218,2800.943041,4674.352781,5089.67996,9436,248.905302,18872,-4317696,513536,-3804160,33
5625,823,21,9,0.127636476,0.872363524,1876.767933,1710.949771,3172.615111,3579.120292,6448,115.5555556,12896,-2880000,421376,-2458624,33
5568,818,20,10,0.128092703,0.871907297,1872.002158,1614.506605,3157.096085,3441.295844,6386,136.1040068,12772,-2850816,418816,-2432000,33
5442,800,21,9,0.12816405,0.87183595,1827.76486,1583.152148,3077.633223,3419.90375,6242,161.5842609,12484,-2786304,409600,-2376704,33
5491,813,21,9,0.128965736,0.871034264,1841.492197,1630.669968,3105.354944,3470.917589,6304,135.6866121,12608,-2811392,416256,-2395136,33
8721,1149,21,9,0.116413374,0.883586626,2826.610367,2932.997548,4848.828231,5593.345518,9870,446.4043419,19740,-4465152,588288,-3876864,33
5433,808,20,10,0.129466432,0.870533568,1823.231953,1622.901382,3080.471747,3393.512376,6241,109.6258563,12482,-2781696,413696,-2368000,33
5426,823,21,9,0.131701072,0.868298928,1798.192957,1777.706884,3057.188905,3572.075334,6249,136.6200262,12498,-2778112,421376,-2356736,33
5523,836,21,9,0.131467212,0.868532788,1833.730203,1793.448772,3116.806989,3597.482057,6359,111.6789603,12718,-2827776,428032,-2399744,33
5596,826,21,9,0.128620367,0.871379633,1875.518315,1665.498745,3164.565225,3529.474576,6422,111.5899218,12844,-2865152,422912,-2442240,33
5558,829,21,9,0.129794896,0.870205104,1865.930817,1670.367005,3160.452681,3418.916767,6387,125.753101,12774,-2845696,424448,-2421248,33
5599,832,20,10,0.129373348,0.870626652,1869.775311,1726.736483,3165.775674,3553.987981,6431,122.4019794,12862,-2866688,425984,-2440704,33
5469,771,20,10,0.123557692,0.876442308,1827.56809,1552.301151,3067.735418,3494.779507,6240,108.7297439,12480,-2800128,394752,-2405376,33
5651,830,21,9,0.128066656,0.871933344,1897.052751,1659.458668,3203.278181,3497.826506,6481,139.7369556,12962,-2893312,424960,-2468352,33
2266,215,21,9,0.0866586054,0.913341395,715.0633475,721.4233068,1249.924095,1146.944186,2481,38.79593432,4962,-1160192,110080,-1050112,33
5339,792,21,9,0.129179579,0.870820421,1794.55401,1580.075287,3037.425173,3258.627525,6131,114.5981308,12262,-2733568,405504,-2328064,33
5336,795,21,9,0.129668896,0.870331104,1770.758549,1722.539654,3013.236507,3420.145912,6131,115.2227025,12262,-2732032,407040,-2324992,33
8966,930,21,9,0.0939773646,0.906022635,2836.449254,3044.870295,4953.696074,4898.405376,9896,774.3348983,19792,-4590592,476160,-4114432,33
5332,811,21,9,0.132020186,0.867979814,1801.24488,1564.24769,3043.019505,3262.535142,6143,123.8508065,12286,-2729984,415232,-2314752,33
5325,828,20,10,0.134568503,0.865431497,1803.649872,1569.587864,3041.629296,3304.474638,6153,142.1344421,12306,-2726400,423936,-2302464,33
1573,199,21,9,0.112302483,0.887697517,506.2094656,548.5638441,879.3846154,942.7437186,1772,31.09317424,3544,-805376,101888,-703488,33
5365,789,21,9,0.128209295,0.871790705,1796.996127,1614.377415,3046.22013,3290.195184,6154,133.2034632,12308,-2746880,403968,-2342912,33
5300,783,21,9,0.128719382,0.871280618,1777.610146,1584.737675,3009.496226,3262.012771,6083,110.7611071,12166,-2713600,400896,-2312704,33
5372,789,21,9,0.128063626,0.871936374,1803.479505,1576.327011,3044.763775,3327.718631,6161,127.3460107,12322,-2750464,403968,-2346496,33
5339,807,21,9,0.131304914,0.868695086,1803.456243,1548.353828,3039.618468,3297.655514,6146,158.9756855,12292,-2733568,413184,-2320384,33
5403,803,21,9,0.129390912,0.870609088,1812.92956,1619.496094,3067.477142,3345.880448,6206,117.5378788,12412,-2766336,411136,-2355200,33
5398,775,20,10,0.125546736,0.874453264,1798.405992,1640.150348,3049.973879,3344.892903,6173,133.8464874,12346,-2763776,396800,-2366976,33
3048,386,21,9,0.112405358,0.887594642,998.0310881,936.3715175,1719.6729,1700.341969,3434,60.41520056,6868,-1560576,197632,-1362944,33
5383,788,21,9,0.127694053,0.872305947,1805.251792,1585.306506,3048.26175,3343.798223,6171,123.2720735,12342,-2756096,403456,-2352640,33
2875,299,20,10,0.0942028986,0.905797101,908.0314953,975.4810372,1569.736696,1758.301003,3174,55.64516129,6348,-1472000,153088,-1318912,33
5245,768,21,9,0.127723266,0.872276734,1757.279039,1563.617673,2974.69571,3227.619792,6013,135.397433,12026,-2685440,393216,-2292224,33
5326,796,21,9,0.130022868,0.869977132,1797.268167,1534.958582,3029.815434,3273.5,6122,136.8962433,12244,-2726912,407552,-2319360,33
9019,882,21,9,0.0890819109,0.910918089,2856.922589,2860.256848,4974.076062,4715.03288,9901,838.3573243,19802,-4617728,451584,-4166144,33
5331,786,21,9,0.12849436,0.87150564,1769.49945,1703.329457,3009.617333,3393.935115,6117,115.8303352,12234,-2729472,402432,-2327040,33
2080,201,21,9,0.0881192459,0.911880754,659.1658556,647.5605531,1147.345673,1075.333333,2281,35.83660644,4562,-1064960,102912,-962048,33
2732,552,21,9,0.168087698,0.831912302,919.7392812,933.2862856,1543.424963,2132.849638,3284,72.6709449,6568,-1398784,282624,-1116160,33
6862,1175,21,9,0.14619883,0.85380117,2300.385486,2315.013943,3901.130428,4707.358298,8037,168.490566,16074,-3513344,601600,-2911744,33
2667,562,21,9,0.174047693,0.825952307,901.6888464,916.2456329,1511.107987,2108.024911,3229,78.81376617,6458,-1365504,287744,-1077760,33
7248,1369,21,9,0.158871997,0.841128003,2480.314497,2376.920307,4161.26628,5091.157779,8617,173.2756887,17234,-3710976,700928,-3010048,33
2735,545,21,9,0.166158537,0.833841463,917.8651177,926.2578084,1539.211335,2148.801835,3280,80.37245773,6560,-1400320,279040,-1121280,33
2752,544,21,9,0.165048544,0.834951456,928.5090084,912.6902714,1551.112645,2141.165441,3296,84.64304058,6592,-1409024,278528,-1130496,33
5308,746,20,10,0.123224315,0.876775685,1743.422683,1744.326523,2982.619819,3346.835121,6054,107.378503,12108,-2717696,381952,-2335744,33
2752,573,21,9,0.172330827,0.827669173,933.4861708,943.6358033,1564.474201,2136.198953,3325,75.96527302,6650,-1409024,293376,-1115648,33
2661,524,22,8,0.164521193,0.835478807,892.3010242,878.7830842,1490.753476,2112.232824,3185,73.0169647,6370,-1362432,268288,-1094144,33
2688,538,21,9,0.166769994,0.833230006,900.8249937,909.8384517,1510.457961,2128.327138,3226,76.4817449,6452,-1376256,275456,-1100800,33
2604,530,21,9,0.169112955,0.830887045,874.2711407,892.1846166,1467.843702,2057.132075,3134,76.96463654,6268,-1333248,271360,-1061888,33
2703,558,21,9,0.171113155,0.828886845,910.8795096,941.2101741,1532.642249,2107.453405,3261,72.67662135,6522,-1383936,285696,-1098240,33
7053,1214,21,9,0.146848917,0.853151083,2362.754757,2411.727279,4017.886998,4808.58402,8267,161.2443924,16534,-3611136,621568,-2989568,33
2757,562,22,8,0.169328111,0.830671889,934.8529013,945.1815098,1568.867972,2107.065836,3319,82.87141074,6638,-1411584,287744,-1123840,33
2705,541,21,9,0.166666667,0.833333333,908.1409162,927.530698,1526.144177,2110.279113,3246,75.734951,6492,-1384960,276992,-1107968,33
1906,217,20,10,0.102213848,0.897786152,620.2009831,539.4773682,1069.644806,994.8525346,2123,37.36360436,4246,-975872,111104,-864768,33
2707,550,20,10,0.168867056,0.831132944,910.4184656,933.1959415,1530.192833,2115.310909,3257,79.75024486,6514,-1385984,281600,-1104384,33
2674,515,21,9,0.161492631,0.838507369,896.6694967,900.8133638,1504.785714,2063.413592,3189,75.47928994,6378,-1369088,263680,-1105408,33
1325,128,21,9,0.0880935994,0.911906401,410.2791371,502.8628179,730.8996226,686.6328125,1453,21.91223043,2906,-678400,65536,-612864,33
1307,141,20,10,0.0973756906,0.902624309,410.0730109,485.2611214,723.4514155,734.2198582,1448,22.63914947,2896,-669184,72192,-596992,33
9105,823,21,9,0.0828968574,0.917103143,2832.604235,3070.054774,4882.752663,5868.885784,9928,383.6166924,19856,-4661760,421376,-4240384,33
9236,696,21,9,0.0700765203,0.92992348,2846.777992,3115.076625,4984.181897,4731.859195,9932,1123.529412,19864,-4728832,356352,-4372480,33
9077,853,20,10,0.0859013092,0.914098691,2829.021471,3096.549713,4880.139473,5873.84408,9930,506.116208,19860,-4647424,436736,-4210688,33
9087,844,20,10,0.0849864062,0.915013594,2832.414449,3021.90421,4868.724001,6013.330569,9931,464.9344569,19862,-4652544,432128,-4220416,33
9087,843,21,9,0.0848942598,0.91510574,2833.227882,3030.073817,4873.159789,5960.868327,9930,437.4449339,19860,-4652544,431616,-4220928,33
9072,858,21,9,0.0864048338,0.913595166,2829.660535,3087.183362,4879.369158,5876.198135,9930,412.8898129,19860,-4644864,439296,-4205568,33
9274,660,20,10,0.0664384941,0.933561506,2846.760958,3145.62377,4974.371792,4870.940909,9934,738.5873606,19868,-4748288,337920,-4410368,33
9112,828,21,9,0.0832997988,0.916700201,2844.362558,2848.790029,4857.253183,6216.762077,9940,426.0608658,19880,-4665344,423936,-4241408,33
9069,861,21,9,0.0867069486,0.913293051,2829.726862,3052.277435,4869.923917,5972.212544,9930,570.361861,19860,-4643328,440832,-4202496,33
9244,685,21,9,0.0689898278,0.931010172,2838.709052,3209.762608,4978.102012,4788.189781,9929,744.3028486,19858,-4732928,350720,-4382208,33
9257,677,21,9,0.0681497886,0.931850211,2840.005769,3140.44803,4916.465378,5665.324963,9934,790.9235669,19868,-4739584,346624,-4392960,33
9045,885,21,9,0.0891238671,0.910876133,2826.527812,3122.637578,4882.260807,5816.232768,9930,466.6353383,19860,-4631040,453120,-4177920,33
9069,859,21,9,0.0865229654,0.913477035,2827.793327,3076.919483,4872.133422,5939.671711,9928,548.2054114,19856,-4643328,439808,-4203520,33
9073,857,21,9,0.0863041289,0.913695871,2828.2498,3068.063651,4870.25405,5973.86231,9930,562.2876557,19860,-4645376,438784,-4206592,33
9089,845,21,9,0.0850614053,0.914938595,2835.035508,3077.035866,4890.020354,5800.887574,9934,493.4923,19868,-4653568,432640,-4220928,33
9088,847,21,9,0.085254152,0.914745848,2832.767076,3088.852153,4886.367958,5843.881936,9935,505.8553971,19870,-4653056,433664,-4219392,33
4779,325,21,9,0.0636755486,0.936324451,1468.843296,1404.812614,2593.829253,1944.769231,5104,89.73277075,10208,-2446848,166400,-2280448,33
9105,828,22,8,0.083358502,0.916641498,2830.246016,3131.86742,4892.00615,5791.660628,9933,410.1156069,19866,-4661760,423936,-4237824,33
9057,873,21,9,0.0879154079,0.912084592,2829.007116,3110.716267,4885.325605,5797.274914,9930,465.9784139,19860,-4637184,446976,-4190208,33
3071,238,20,10,0.0719250529,0.928074947,956.0222256,851.4818317,1685.583198,1260.37395,3309,49.90950226,6618,-1572352,121856,-1450496,33
8400,1446,21,9,0.14686167,0.85313833,2859.603898,2651.811985,4814.121429,5558.894191,9846,332.6351351,19692,-4300800,740352,-3560448,33
3337,584,21,9,0.148941597,0.851058403,1100.094438,1123.216812,1855.729697,2562.518836,3921,83.9614561,7842,-1708544,299008,-1409536,33
3406,610,22,8,0.15189243,0.84810757,1127.175175,1158.185238,1902.503817,2600.340984,4016,90.40972535,8032,-1743872,312320,-1431552,33
3395,626,20,10,0.155682666,0.844317334,1128.660411,1157.349132,1902.976141,2596.848243,4021,95.37476281,8042,-1738240,320512,-1417728,33
8509,1341,20,10,0.136142132,0.863857868,2853.318341,2707.196152,4832.907627,5513.023117,9850,248.925954,19700,-4356608,686592,-3670016,33
8326,1498,21,9,0.152483713,0.847516287,2803.370965,2851.765374,4752.683161,5800.774366,9824,310.4930468,19648,-4262912,766976,-3495936,33
2194,223,21,9,0.0922631361,0.907736864,695.6038437,718.1801195,1207.788514,1220.919283,2417,42.69563681,4834,-1123328,114176,-1009152,33
3439,628,22,8,0.154413573,0.845586427,1144.944873,1160.834279,1927.751963,2615.826433,4067,107.9352442,8134,-1760768,321536,-1439232,33
3428,604,21,9,0.149801587,0.850198413,1128.498565,1186.874965,1912.83168,2604.869205,4032,81.55339806,8064,-1755136,309248,-1445888,33
3283,574,21,9,0.148820327,0.851179673,1078.242065,1116.688468,1822.773378,2536.56446,3857,89.84393198,7714,-1680896,293888,-1387008,33
3390,619,20,10,0.154402594,0.845597406,1125.186804,1147.949407,1895.80059,2603.038772,4009,103.913945,8018,-1735680,316928,-1418752,33
3359,624,21,9,0.15666583,0.84333417,1116.329723,1158.600374,1885.752307,2563.932692,3983,101.2970498,7966,-1719808,319488,-1400320,33
3347,629,21,9,0.158199195,0.841800805,1112.711183,1138.377517,1873.710487,2599.311606,3976,98.73354855,7952,-1713664,322048,-1391616,33
8457,1398,21,9,0.141856925,0.858143075,2863.218992,2661.149832,4833.737377,5498.228183,9855,327.5174477,19710,-4329984,715776,-3614208,33
9160,766,22,8,0.0771710659,0.922828934,2878.731736,2493.609268,5046.825437,3967.075718,9926,193.5270033,19852,-4689920,392192,-4297728,33
3260,613,21,9,0.158275239,0.841724761,1081.237487,1138.008402,1829.904908,2506.54323,3873,88.91184573,7746,-1669120,313856,-1355264,33
3337,613,21,9,0.155189873,0.844810127,1103.964414,1166.373815,1870.969134,2544.536705,3950,101.72547,7900,-1708544,313856,-1394688,33
1942,205,22,8,0.095482068,0.904517932,611.7603188,684.6963861,1064.501545,1163.980488,2147,33.37478626,4294,-994304,104960,-889344,33
3423,639,21,9,0.157311669,0.842688331,1140.794288,1163.32235,1920.998539,2623.435055,4062,88.86458105,8124,-1752576,327168,-1425408,33
3108,415,21,9,0.117797332,0.882202668,1004.066253,1066.040132,1723.618726,2049.443373,3523,62.50887154,7046,-1591296,212480,-1378816,33
8622,1237,21,9,0.125469115,0.874530885,2870.987903,2547.356161,4824.598121,5664.660469,9859,316.3992298,19718,-4414464,633344,-3781120,33
8690,1169,21,9,0.118571863,0.881428137,2835.103808,2810.505945,4827.144879,5694.594525,9859,382.7251553,19718,-4449280,598528,-3850752,33
4112,624,21,9,0.131756757,0.868243243,1324.51415,1381.729275,2248.810068,3157.225962,4736,91.25240848,9472,-2105344,319488,-1785856,33
4250,647,22,8,0.132121707,0.867878293,1370.892781,1415.818019,2324.085882,3269.53323,4897,114.8452158,9794,-2176000,331264,-1844736,33
4355,650,21,9,0.12987013,0.87012987,1396.751611,1484.97789,2378.670034,3336.010769,5005,119.8228394,10010,-2229760,332800,-1896960,33
4128,646,21,9,0.135316297,0.864683703,1332.631508,1388.264271,2260.62282,3198.256966,4774,113.4236161,9548,-2113536,330752,-1782784,33
4117,626,21,9,0.131983976,0.868016024,1325.228201,1383.461144,2250.165169,3173.268371,4743,99.30904523,9486,-2107904,320512,-1787392,33
8667,1195,21,9,0.121172176,0.878827824,2837.900867,2714.525709,4795.449637,5918.235146,9862,448.4765803,19724,-4437504,611840,-3825664,33
4020,561,21,9,0.122462344,0.877537656,1276.383828,1341.420514,2173.583831,3132.377897,4581,115.0715901,9162,-2058240,287232,-1771008,33
4174,628,21,9,0.130778842,0.869221158,1343.787648,1386.999147,2278.592956,3218.401274,4802,122.2505092,9604,-2137088,321536,-1815552,33
4132,624,21,9,0.131202691,0.868797309,1328.993407,1383.752864,2256.074298,3189.177885,4756,110.1180829,9512,-2115584,319488,-1796096,33
4166,651,21,9,0.135146357,0.864853643,1346.119019,1394.451271,2281.710754,3223.572965,4817,123.8940329,9634,-2132992,333312,-1799680,33
4148,635,21,9,0.132761865,0.867238135,1335.944653,1382.51639,2265.296528,3219.662992,4783,101.1205074,9566,-2123776,325120,-1798656,33
4221,649,21,9,0.133264887,0.866735113,1362.911094,1417.655209,2312.375503,3236.283513,4870,112.4711316,9740,-2161152,332288,-1828864,33
4096,624,20,10,0.13220339,0.86779661,1318.103211,1382.005988,2239.36084,3155.669872,4720,114.4519884,9440,-2097152,319488,-1777664,33
4119,642,21,9,0.134845621,0.865154379,1327.765467,1401.559844,2256.902161,3177.197819,4761,110.4896728,9522,-2108928,328704,-1780224,33
4202,619,21,9,0.128396598,0.871603402,1350.029759,1412.648632,2294.556402,3201.462036,4821,120.1944652,9642,-2151424,316928,-1834496,33
4148,638,21,9,0.133305474,0.866694526,1332.942438,1396.880017,2264.130183,3234.606583,4786,128.7597525,9572,-2123776,326656,-1797120,33
3603,295,20,10,0.0756798358,0.924320164,1118.188798,1207.848782,1947.09159,1978.915254,3898,68.69933028,7796,-1844736,151040,-1693696,33
4068,621,20,10,0.13243762,0.86756238,1305.420012,1383.796758,2221.328417,3155.138486,4689,92.03140334,9378,-2082816,317952,-1764864,33
3585,647,20,10,0.152882798,0.847117202,1185.746794,1231.825455,2004.537796,2736.877898,4232,102.8932653,8464,-1835520,331264,-1504256,33
3483,677,21,9,0.162740385,0.837259615,1163.104174,1222.951624,1967.165662,2663.577548,4160,106.940874,8320,-1783296,346624,-1436672,33
3295,632,21,9,0.160937102,0.839062898,1097.919202,1147.091977,1855.022155,2532.167722,3927,94.76351351,7854,-1687040,323584,-1363456,33
8613,1241,21,9,0.125938705,0.874061295,2821.113577,2896.919867,4821.145362,5665.640612,9854,656.9333333,19708,-4409856,635392,-3774464,33
3329,666,22,8,0.166708385,0.833291615,1116.935881,1164.854665,1884.644338,2564.608108,3995,106.1652936,7990,-1704448,340992,-1363456,33
9004,892,21,9,0.0901374293,0.909862571,2856.789863,2829.031715,4985.58052,4574.202915,9896,675.9562842,19792,-4610048,456704,-4153344,33
3325,646,20,10,0.162679426,0.837320574,1111.212057,1159.068963,1876.599098,2549.092879,3971,88.6977887,7942,-1702400,330752,-1371648,33
3561,658,20,10,0.155961128,0.844038872,1180.696677,1240.834153,1999.088177,2710.238602,4219,99.97630332,8438,-1823232,336896,-1486336,33
3539,645,21,9,0.1541587,0.8458413,1175.253931,1219.530178,1986.841198,2672.231008,4184,90.44530912,8368,-1811968,330240,-1481728,33
3457,637,21,9,0.155593552,0.844406448,1152.004356,1193.163598,1947.193231,2591.864992,4094,100.0977995,8188,-1769984,326144,-1443840,33
3403,649,20,10,0.160167818,0.839832182,1137.967768,1160.019722,1915.042609,2610.921418,4052,85.37715971,8104,-1742336,332288,-1410048,33
3442,648,21,9,0.158435208,0.841564792,1145.111488,1181.919029,1931.3957,2651.591049,4090,90.62707733,8180,-1762304,331776,-1430528,33
2963,425,21,9,0.125442739,0.874557261,960.9753549,1043.722712,1652.56058,1986.891765,3388,77.36926239,6776,-1517056,217600,-1299456,33
3466,639,20,10,0.155663825,0.844336175,1155.855154,1187.521773,1950.7588,2607.56651,4105,96.02339181,8210,-1774592,327168,-1447424,33
3510,658,21,9,0.157869482,0.842130518,1168.737835,1214.159874,1974.411111,2671.75228,4168,92.17160548,8336,-1797120,336896,-1460224,33
9040,859,21,9,0.0867764421,0.913223558,2858.917329,2785.796311,5001.818695,4404.667055,9899,611.4268067,19798,-4628480,439808,-4188672,33
3353,666,21,9,0.165712864,0.834287136,1126.879091,1173.730217,1902.378467,2551.824324,4019,93.42166434,8038,-1716736,340992,-1375744,33
8569,1277,21,9,0.129697339,0.870302661,2816.027054,2924.094203,4822.699732,5599.89585,9846,414.3939394,19692,-4387328,653824,-3733504,33
3414,650,21,9,0.159940945,0.840059055,1143.950094,1156.599321,1922.922964,2608.032308,4064,97.57503001,8128,-1747968,332800,-1415168,33
3450,664,21,9,0.161400097,0.838599903,1151.03,1200.551306,1944.155072,2646.415663,4114,101.9831433,8228,-1766400,339968,-1426432,33
2513,536,21,9,0.175795343,0.824204657,854.9120215,841.5267152,1424.009948,1998.485075,3049,66.68853893,6098,-1286656,274432,-1012224,33
2667,589,21,9,0.180896806,0.819103194,916.2366416,895.086492,1522.473941,2108.587436,3256,81.46109582,6512,-1365504,301568,-1063936,33
2544,537,21,9,0.17429406,0.82570594,867.8632126,865.8333743,1450.882469,1967.925512,3081,68.02826231,6162,-1302528,274944,-1027584,33
2540,540,21,9,0.175324675,0.824675325,865.2750475,871.0557943,1448.199606,1974.653704,3080,76.38888889,6160,-1300480,276480,-1024000,33
2546,571,20,10,0.183188964,0.816811036,872.2678087,888.3539763,1460.113119,1999.921191,3117,75.7840992,6234,-1303552,292352,-1011200,33
2555,568,21,9,0.181876401,0.818123599,876.3803737,881.8484769,1464.263014,2001.644366,3123,62.01350278,6246,-1308160,290816,-1017344,33
2512,532,21,9,0.174770039,0.825229961,855.0753377,860.1298764,1431.046178,1954.327068,3044,71.9962157,6088,-1286144,272384,-1013760,33
2537,534,21,9,0.173884728,0.826115272,858.3557493,874.8484059,1439.573118,1994.117978,3071,75.21430321,6142,-1298944,273408,-1025536,33
6491,1246,20,10,0.161044332,0.838955668,2202.092004,2210.031538,3708.869512,4703.195024,7737,154.0007962,15474,-3323392,637952,-2685440,33
2567,545,21,9,0.175128535,0.824871465,875.7386032,880.9925018,1466.077522,1982.398165,3112,81.31695845,6224,-1314304,279040,-1035264,33
857,86,21,9,0.0911983033,0.908801697,263.0368195,327.4434667,484.0513419,351.9069767,943,18.85622875,1886,-438784,44032,-394752,33
2499,534,20,10,0.176063304,0.823936696,846.9396393,875.0509385,1423.672269,1953.752809,3033,74.1202346,6066,-1279488,273408,-1006080,33
2511,537,21,9,0.176181102,0.823818898,855.3924348,854.9441101,1429.017125,1970.975791,3048,77.43902439,6096,-1285632,274944,-1010688,33
6792,1298,22,8,0.160444994,0.839555006,2289.514453,2386.734829,3882.404741,4898.922958,8090,188.7100537,16180,-3477504,664576,-2812928,33
2547,527,20,10,0.171437866,0.828562134,865.0718477,833.8272995,1437.627405,2020.185958,3074,70.35934997,6148,-1304064,269824,-1034240,33
2576,547,21,9,0.175152097,0.824847903,877.1338597,874.0769457,1464.973214,2018.93053,3123,65.63682219,6246,-1318912,280064,-1038848,33
2450,537,21,9,0.179779043,0.820220957,827.2894638,883.0440969,1398.096327,1931.549348,2987,52.75521017,5974,-1254400,274944,-979456,33
2544,495,21,9,0.162882527,0.837117473,853.5888966,881.0756924,1439.570362,1933.359596,3039,59.553204,6078,-1302528,253440,-1049088,33
2535,529,21,9,0.172650131,0.827349869,858.5511591,852.6230693,1433.483629,2006.992439,3064,70.71313178,6128,-1297920,270848,-1027072,33
1144,131,21,9,0.102745098,0.897254902,359.3191447,435.3923407,633.8994755,673.8091603,1275,19.64560863,2550,-585728,67072,-518656,33
5582,804,21,9,0.125900407,0.874099593,1855.082564,1732.0728,3150.833035,3489.727612,6386,131.453273,12772,-2857984,411648,-2446336,33
5643,823,21,9,0.127281163,0.872718837,1888.076634,1682.949323,3190.805777,3526.238153,6466,155.8072289,12932,-2889216,421376,-2467840,33
2429,225,21,9,0.084777694,0.915222306,762.2382173,789.0634005,1342.53767,1165.16,2654,46.4880014,5308,-1243648,115200,-1128448,33
8653,1203,21,9,0.12205763,0.87794237,2803.502589,2946.708175,4791.539582,5913.63591,9856,367.3499814,19712,-4430336,615936,-3814400,33
5669,826,21,9,0.12717475,0.87282525,1889.260546,1736.881541,3199.141648,3583.324455,6495,125.8964916,12990,-2902528,422912,-2479616,33
5763,819,21,9,0.124430264,0.875569736,1922.61493,1709.261102,3253.433281,3559.361416,6582,170.6950207,13164,-2950656,419328,-2531328,33
5824,807,21,9,0.121701101,0.878298899,1932.629847,1748.542045,3275.919128,3605.257745,6631,133.5548842,13262,-2981888,413184,-2568704,33
5595,798,21,9,0.124824026,0.875175974,1866.882214,1667.233686,3161.78445,3443.906015,6393,129.3344123,12786,-2864640,408576,-2456064,33
5703,806,21,9,0.123828545,0.876171455,1906.945777,1638.102793,3213.537612,3548.37469,6509,161.6339707,13018,-2919936,412672,-2507264,33
5743,828,21,9,0.126008218,0.873991782,1920.861104,1690.167771,3241.992687,3591.2343,6571,126.7798572,13142,-2940416,423936,-2516480,33
5671,817,21,9,0.125924784,0.874075216,1890.986969,1697.421513,3191.524599,3612.215422,6488,129.2945397,12976,-2903552,418304,-2485248,33
5686,771,21,9,0.119405297,0.880594703,1875.612835,1721.090855,3173.346289,3639.437095,6457,139.6108108,12914,-2911232,394752,-2516480,33
5676,794,21,9,0.122720247,0.877279753,1889.909162,1659.005311,3186.426004,3586.311083,6470,143.618202,12940,-2906112,406528,-2499584,33
5649,797,21,9,0.123642569,0.876357431,1877.58696,1697.571972,3174.789166,3568.754078,6446,132.8250567,12892,-2892288,408064,-2484224,33
5561,763,21,9,0.120651486,0.879348514,1844.125524,1662.167249,3127.507283,3417.538663,6324,148.5204321,12648,-2847232,390656,-2456576,33
5763,797,21,9,0.121493902,0.878506098,1911.036756,1732.84638,3238.166927,3586.604768,6560,149.7716895,13120,-2950656,408064,-2542592,33
5707,795,21,9,0.122270071,0.877729929,1903.059217,1643.081787,3207.198879,3569.520755,6502,120.9224475,13004,-2921984,407040,-2514944,33
5578,788,21,9,0.123782595,0.876217405,1858.006112,1637.171228,3129.66081,3564.610406,6366,152.1510516,12732,-2855936,403456,-2452480,33
5635,801,20,10,0.124456184,0.875543816,1878.271907,1675.188205,3174.290506,3529.51186,6436,123.3186434,12872,-2885120,410112,-2475008,33
5563,759,20,10,0.120056944,0.879943056,1826.225624,1752.751636,3100.681467,3607.262187,6322,118.3230395,12644,-2848256,388608,-2459648,33
5319,420,22,8,0.0731834814,0.926816519,1656.90904,1600.891947,2838.351946,3270.8,5739,171.2623098,11478,-2723328,215040,-2508288,34
6850,781,22,8,0.102345695,0.897654305,2214.568175,1973.722563,3739.292993,4488.78233,7631,184.6358577,15262,-3507200,399872,-3107328,34
5093,470,22,8,0.0844867877,0.915513212,1609.534677,1506.869674,2744.371098,3189.753191,5563,159.4439668,11126,-2607616,240640,-2366976,34
5156,492,21,9,0.0871104816,0.912889518,1638.59379,1492.35057,2788.980217,3196.735772,5648,135.3787152,11296,-2639872,251904,-2387968,34
5903,568,22,8,0.0877762324,0.912223768,1866.142415,1805.014241,3185.31611,3762.737676,6471,207.2709801,12942,-3022336,290816,-2731520,34
5734,529,21,9,0.0844643142,0.915535686,1806.408615,1747.699182,3085.660098,3634.293006,6263,206.9729015,12526,-2935808,270848,-2664960,34
6123,583,21,9,0.0869370713,0.913062929,1934.793982,1868.172828,3303.616038,3877.409949,6706,218.7214612,13412,-3134976,298496,-2836480,34
8613,1230,22,8,0.124961902,0.875038098,2806.34568,2721.827412,4730.59863,6262.276423,9843,526.0823089,19686,-4409856,629760,-3780096,34
5416,454,22,8,0.0773424191,0.922657581,1698.897524,1602.160125,2906.75997,3278.354626,5870,177.7710478,11740,-2772992,232448,-2540544,34
8603,1238,22,8,0.125800224,0.874199776,2851.332569,2568.202102,4782.460886,5883.723748,9841,860.2272727,19682,-4404736,633856,-3770880,34
5785,512,22,8,0.0813085596,0.91869144,1815.776361,1770.222518,3106.31236,3631.320313,6297,189.5544852,12594,-2961920,262144,-2699776,34
4324,482,22,8,0.100291303,0.899708697,1408.475902,1145.74803,2373.081637,2676.381743,4806,84.40463646,9612,-2213888,246784,-1967104,34
8333,1186,21,9,0.124592919,0.875407081,2752.116205,2443.386668,4601.437898,5874.079258,9519,176.3104279,19038,-4266496,607232,-3659264,34
247,29,22,8,0.105072464,0.894927536,77.70820103,69.47816362,145.659919,77.51724138,276,23.03839733,552,-126464,14848,-111616,34
8538,1286,22,8,0.130903909,0.869096091,2828.43265,2653.869091,4753.509019,5968.07154,9824,327.0306258,19648,-4371456,658432,-3713024,34
8723,1136,22,8,0.115224668,0.884775332,2869.853088,2504.592273,4821.660782,5761.904049,9859,675.736806,19718,-4466176,581632,-3884544,34
2747,115,22,8,0.0401816911,0.959818309,821.4619675,928.2946905,1434.898799,1350.313043,2862,70.87667162,5724,-1406464,58880,-1347584,34
6857,782,22,8,0.10236942,0.89763058,2214.443821,1973.638479,3735.682514,4559.341432,7639,173.4953441,15278,-3510784,400384,-3110400,34
5815,537,22,8,0.0845403023,0.915459698,1834.595591,1764.265249,3135.749441,3617.774674,6352,162.4137049,12704,-2977280,274944,-2702336,34
5910,606,22,8,0.0930018416,0.906998158,1884.894967,1753.417852,3203.178849,3798.018152,6516,188.2692863,13032,-3025920,310272,-2715648,34
9438,517,21,9,0.0519337017,0.948066298,2876.303673,2777.065492,5006.198241,4463.232108,9955,859.671848,19910,-4832256,264704,-4567552,34
9475,487,22,8,0.0488857659,0.951114234,2879.887794,2752.756903,5005.677361,4511.10883,9962,1115.56551,19924,-4851200,249344,-4601856,34
9015,865,23,7,0.0875506073,0.912449393,2861.952651,2738.161263,4919.82629,5155.960694,9880,208.7912088,19760,-4615680,442880,-4172800,34
9452,507,21,9,0.0509087258,0.949091274,2877.9378,2749.414957,5012.286183,4378.088757,9959,1451.749271,19918,-4839424,259584,-4579840,34
9025,858,23,7,0.0868157442,0.913184256,2868.825887,2660.695201,4912.385485,5253.504662,9883,314.9458254,19766,-4620800,439296,-4181504,34
2309,131,22,8,0.0536885246,0.946311475,698.1120939,805.4692503,1222.956258,1177.206107,2440,42.37582494,4880,-1182208,67072,-1115136,34
9076,815,22,8,0.0823981397,0.91760186,2876.084421,2611.10019,4953.360952,4864.026994,9891,664.271323,19782,-4646912,417280,-4229632,34
9443,512,22,8,0.0514314415,0.948568559,2876.477992,2780.129282,5003.936461,4499.644531,9955,1133.826879,19910,-4834816,262144,-4572672,34
9443,516,22,8,0.051812431,0.948187569,2882.943997,2639.879754,5015.702531,4326.629845,9959,814.309076,19918,-4834816,264192,-4570624,34
9463,499,22,8,0.0500903433,0.949909657,2881.012472,2693.145385,5015.823946,4330.583166,9962,1509.393939,19924,-4845056,255488,-4589568,34
9418,538,22,8,0.0540377662,0.945962234,2874.27798,2847.23097,4998.567636,4627.204461,9956,1278.04878,19912,-4822016,275456,-4546560,34
1967,99,24,6,0.0479186834,0.952081317,593.8890695,644.2708273,1033.12303,1040.989899,2066,38.14623338,4132,-1007104,50688,-956416,34
8988,892,24,6,0.0902834008,0.909716599,2868.227921,2673.319853,4917.530374,5171.947309,9880,594.1070355,19760,-4601856,456704,-4145152,34
9373,570,23,7,0.0573267625,0.942673237,2884.164143,2573.278072,5004.589139,4436.108772,9943,1817.73309,19886,-4798976,291840,-4507136,34
9188,717,24,6,0.072387683,0.927612317,2872.692539,2680.076762,4945.04027,5055,9905,1191.937425,19810,-4704256,367104,-4337152,34
9402,549,22,8,0.0551703346,0.944829665,2878.631441,2736.859556,4999.265475,4577.562842,9951,796.08,19902,-4813824,281088,-4532736,34
9020,864,23,7,0.0874140024,0.912585998,2872.648859,2635.74998,4925.325831,5121.795139,9884,372.6998492,19768,-4618240,442368,-4175872,34
9448,511,22,8,0.0513103725,0.948689627,2879.324422,2700.154131,5017.445279,4287.665362,9959,851.924722,19918,-4837376,261632,-4575744,34
9368,574,23,7,0.0577348622,0.942265138,2882.839974,2624.42473,4994.114539,4602.418118,9942,1791.351351,19884,-4796416,293888,-4502528,34
9458,497,21,9,0.049924661,0.950075339,2873.810032,2845.725474,4998.163882,4594.277666,9955,695.1815642,19910,-4842496,254464,-4588032,34
5653,471,21,9,0.076910516,0.923089484,1760.847386,1801.35181,3028.837078,3466.526539,6124,181.8829819,12248,-2894336,241152,-2653184,34
8458,1151,21,9,0.119783536,0.880216464,2783.921035,2533.09863,4686.070702,5678.939183,9609,168.6085278,19218,-4330496,589312,-3741184,34
8645,1195,22,8,0.121443089,0.878556911,2836.100856,2685.839165,4788.475419,5875.606695,9840,349.4318182,19680,-4426240,611840,-3814400,34
6576,722,22,8,0.098931214,0.901068786,2123.188188,1904.891805,3605.711679,4048.325485,7298,141.4889492,14596,-3366912,369664,-2997248,34
2700,118,21,9,0.0418736693,0.958126331,807.429761,926.4754905,1416.663333,1245.59322,2818,223.8284353,5636,-1382400,60416,-1321984,34
5363,408,22,8,0.0706983192,0.929301681,1663.065153,1675.779258,2863.620921,3180.164216,5771,184.9679487,11542,-2745856,208896,-2536960,34
5764,466,22,8,0.0747993579,0.925200642,1788.420789,1859.105128,3078.784004,3569.643777,6230,126.9614836,12460,-2951168,238592,-2712576,34
7957,1125,21,9,0.123871394,0.876128606,2591.106411,2497.341468,4365.604751,5785.587556,9082,191.8867526,18164,-4073984,576000,-3497984,34
6561,674,22,8,0.0931582585,0.906841742,2084.792972,2007.779978,3549.932023,4280.602374,7235,151.2965286,14470,-3359232,345088,-3014144,34
8724,1140,22,8,0.115571776,0.884428224,2843.494293,2659.956329,4797.491747,5965.668421,9864,362.1145374,19728,-4466688,583680,-3883008,34
3152,155,22,8,0.0468702752,0.953129725,950.5681817,1009.252285,1664.826459,1433.83871,3307,66.84859511,6614,-1613824,79360,-1534464,34
5320,398,21,9,0.0696047569,0.930395243,1646.976211,1671.41534,2837.530827,3153.158291,5718,185.3484603,11436,-2723840,203776,-2520064,34
8604,1231,22,8,0.125165226,0.874834774,2837.502717,2609.11871,4764.411901,5991.49472,9835,641.9712794,19670,-4405248,630272,-3774976,34
3412,315,22,8,0.0845183794,0.915481621,1083.234242,946.2372101,1837.430832,2151.790476,3727,65.54695744,7454,-1746944,161280,-1585664,34
5768,497,20,10,0.0793296089,0.920670391,1803.69692,1815.418939,3098.065187,3538.440644,6265,193.7828642,12530,-2953216,254464,-2698752,34
5045,400,21,9,0.0734618916,0.926538108,1564.933019,1613.031851,2694.25114,3085.595,5445,166.8198529,10890,-2583040,204800,-2378240,34
5238,405,22,8,0.0717703349,0.928229665,1628.191157,1615.838898,2801.396716,3088.469136,5643,171.2075243,11286,-2681856,207360,-2474496,34
5854,456,22,8,0.0722662441,0.927733756,1811.931215,1897.666511,3125.016057,3546.844298,6310,204.5380875,12620,-2997248,233472,-2763776,34
8093,1156,21,9,0.124986485,0.875013515,2674.340078,2465.78738,4499.334857,5504.764706,9249,197.7549711,18498,-4143616,591872,-3551744,34
8583,1251,22,8,0.127211714,0.872788286,2803.408148,2764.912307,4735.550623,6165.838529,9834,586.7541766,19668,-4394496,640512,-3753984,34
8983,900,21,9,0.091065466,0.908934534,2848.345936,2762.352185,4858.053434,5779.88,9883,975.6169793,19766,-4599296,460800,-4138496,34
9152,763,21,9,0.0769541099,0.92304589,2852.469573,2887.759635,4900.182255,5651.50983,9915,679.109589,19830,-4685824,390656,-4295168,34
9008,872,22,8,0.0882591093,0.911740891,2850.250232,2762.504774,4868.150089,5687.894495,9880,890.0900901,19760,-4612096,446464,-4165632,34
8969,905,22,8,0.0916548511,0.908345149,2867.417647,2586.008147,4871.454231,5592.046409,9874,458.8289963,19748,-4592128,463360,-4128768,34
9342,605,22,8,0.0608223585,0.939177641,2872.735328,2851.363484,4971.92614,5006.02314,9947,423.2765957,19894,-4783104,309760,-4473344,34
9315,627,22,8,0.0630657815,0.936934218,2863.660872,2949.015356,4952.964788,5246.867624,9942,247.559761,19884,-4769280,321024,-4448256,34
9308,634,22,8,0.0637698652,0.936230135,2865.978587,2911.544545,4950.742694,5276.246057,9942,597.1171171,19884,-4765696,324608,-4441088,34
9280,598,22,8,0.0605385706,0.939461429,2845.340285,2933.640284,4922.686315,5200.421405,9878,212.1563574,19756,-4751360,306176,-4445184,34
9151,766,22,8,0.0772411011,0.922758899,2875.677875,2647.569371,4914.773795,5487.347258,9917,857.8719723,19834,-4685312,392192,-4293120,34
8819,568,22,8,0.0605092149,0.939490785,2707.0245,2752.327631,4692.530332,4716.818662,9387,280.8797127,18774,-4515328,290816,-4224512,34
8854,556,22,8,0.0590860786,0.940913921,2712.775711,2772.814609,4700.511633,4784.93705,9410,199.1112992,18820,-4533248,284672,-4248576,34
722,47,22,8,0.0611183355,0.938881664,220.1309864,225.1907757,391.6759003,282.4468085,769,21.07426692,1538,-369664,24064,-345600,34
9316,627,22,8,0.0630594388,0.936940561,2862.148387,2971.560092,4951.146522,5281.842105,9943,476.882494,19886,-4769792,321024,-4448768,34
9074,820,22,8,0.0828785122,0.917121488,2867.796049,2622.99998,4883.909301,5651.185366,9894,799.1922456,19788,-4645888,419840,-4226048,34
9211,626,22,8,0.0636372878,0.936362712,2834.01451,2907.112184,4899.602758,5204.412141,9837,250.1144165,19674,-4716032,320512,-4395520,34
9376,571,22,8,0.0574042425,0.942595758,2871.073235,2877.013371,4970.40305,5033.063047,9947,698.0350877,19894,-4800512,292352,-4508160,34
8881,569,22,8,0.0602116402,0.93978836,2727.398253,2734.898233,4718.769733,4830.546573,9450,245.3271028,18900,-4547072,291328,-4255744,34
9336,610,22,8,0.0613311884,0.938668812,2861.575923,2993.805165,4951.402099,5311.706557,9946,437.7640845,19892,-4780032,312320,-4467712,34
9156,761,22,8,0.0767369164,0.923263084,2860.956146,2830.68238,4914.592726,5493.287779,9917,738.9716841,19834,-4687872,389632,-4298240,34
9300,628,22,8,0.0632554392,0.936744561,2858.057295,2965.438938,4944.85043,5255.488854,9928,275.1662971,19856,-4761600,321536,-4440064,34
9244,689,22,8,0.0693647438,0.930635256,2856.449935,2978.495404,4935.470143,5390.021771,9933,727.6923077,19866,-4732928,352768,-4380160,34
9248,686,22,8,0.0690557681,0.930944232,2867.04239,2863.068336,4947.60359,5235.72449,9934,529.2488013,19868,-4734976,351232,-4383744,34
9177,751,21,9,0.0756446414,0.924355359,2849.129535,2996.016226,4913.905852,5582.745672,9928,688.9659958,19856,-4698624,384512,-4314112,34
8960,924,22,8,0.0934844193,0.906515581,2880.235373,2525.314415,4892.010603,5432.094156,9884,667.3869007,19768,-4587520,473088,-4114432,34
7502,560,22,8,0.069461672,0.930538328,2335.829159,2207.15505,4039.358038,3926.230357,8062,146.3157895,16124,-3841024,286720,-3554304,34
9179,742,22,8,0.0747908477,0.925209152,2885.186809,2581.39296,4948.002288,5121.789757,9921,801.3731826,19842,-4699648,379904,-4319744,34
9262,674,21,9,0.0678341385,0.932165862,2861.870164,2941.657902,4948.867739,5238.283383,9936,594.9700599,19872,-4742144,345088,-4397056,34
8936,933,22,8,0.0945384537,0.905461546,2878.482968,2489.387295,4880.718778,5454.889603,9869,480.0097276,19738,-4575232,477696,-4097536,34
1711,98,22,8,0.0541735766,0.945826423,519.8517656,527.4625676,915.7802455,716.7857143,1809,32.44843049,3618,-876032,50176,-825856,34
9270,668,22,8,0.0672167438,0.932783256,2869.181116,2863.971837,4966.469579,5011.553892,9938,460.3056971,19876,-4746240,342016,-4404224,34
9212,715,21,9,0.0720257883,0.927974212,2848.181921,3015.286361,4916.231654,5579.443357,9927,368.8963211,19854,-4716544,366080,-4350464,34
9288,652,22,8,0.0655935614,0.934406439,2871.279248,2838.903158,4960.186585,5117.418712,9940,435.2014011,19880,-4755456,333824,-4421632,34
9269,669,21,9,0.0673173677,0.932682632,2869.758245,2847.970776,4954.316971,5179.860987,9938,729.1269259,19876,-4745728,342528,-4403200,34
9087,805,21,9,0.081378892,0.918621108,2870.328936,2654.226146,4912.993617,5324.726708,9892,827.090301,19784,-4652544,412160,-4240384,34
9299,639,22,8,0.0642986516,0.935701348,2869.092846,2864.354438,4964.435101,5043.206573,9938,422.5340136,19876,-4761088,327168,-4433920,34
9164,752,22,8,0.0758370311,0.924162969,2872.322171,2698.650153,4921.083479,5414.464096,9916,517.2665623,19832,-4691968,385024,-4306944,34
9183,736,21,9,0.0742010283,0.925798972,2868.184877,2781.767741,4933.70881,5288.032609,9919,719.2893401,19838,-4701696,376832,-4324864,34
8901,958,22,8,0.0971700984,0.902829902,2875.666415,2475.352227,4865.478486,5529.484342,9859,413.8958858,19718,-4557312,490496,-4066816,34
9168,739,22,8,0.0745937216,0.925406278,2860.878397,2788.218251,4909.067408,5511.431664,9907,500.1009591,19814,-4694016,378368,-4315648,34
3076,134,21,9,0.0417445483,0.958255452,922.68204,999.1098982,1612.734395,1439.432836,3210,49.31633123,6420,-1574912,68608,-1506304,34
9059,854,22,8,0.0861495007,0.913850499,2853.314319,2844.504258,4887.061927,5698.884075,9913,742.5468165,19826,-4638208,437248,-4200960,34
8998,890,23,7,0.0900080906,0.909991909,2882.523665,2488.491759,4890.704712,5488.376404,9888,572.5535611,19776,-4606976,455680,-4151296,34
9201,732,22,8,0.0736937481,0.926306252,2846.779134,3026.886101,4910.638192,5675.449454,9933,637.9576108,19866,-4710912,374784,-4336128,34
9233,700,21,9,0.0704721635,0.929527837,2851.284316,3023.235315,4927.067909,5493.704286,9933,555.5369128,19866,-4727296,358400,-4368896,34
9011,875,23,7,0.0885090026,0.911490997,2886.967932,2461.897798,4910.71335,5281.146286,9886,1075.734494,19772,-4613632,448000,-4165632,34
9025,875,22,8,0.0883838384,0.911616162,2823.377046,2947.414028,4837.04,6120.758857,9900,628.9707751,19800,-4620800,448000,-4172800,34
9044,834,23,7,0.0844300466,0.915569953,2881.044642,2497.474443,4918.01747,5172.459233,9878,951.6377649,19756,-4630528,427008,-4203520,34
8979,905,23,7,0.0915621206,0.908437879,2860.186381,2696.522644,4876.114489,5601.146961,9884,564.8,19768,-4597248,463360,-4133888,34
9176,746,22,8,0.0751864543,0.924813546,2848.057662,2960.789399,4902.255667,5690.22118,9922,484.7093307,19844,-4698112,381952,-4316160,34
9130,753,22,8,0.0761914398,0.92380856,2835.278146,2974.595841,4885.284666,5629.664011,9883,263.8985314,19766,-4674560,385536,-4289024,34
8052,634,22,8,0.07299102,0.92700898,2498.068477,2577.711418,4306.524714,4813.097792,8686,216.8789014,17372,-4122624,324608,-3798016,34
2458,161,22,8,0.061473845,0.938526155,749.807315,845.2867073,1311.234744,1291.149068,2619,49.35921598,5238,-1258496,82432,-1176064,34
9231,702,22,8,0.0706735125,0.929326487,2851.850634,2995.602231,4919.569602,5590.689459,9933,430.5591678,19866,-4726272,359424,-4366848,34
9206,729,21,9,0.0733769502,0.92662305,2851.910213,2999.556801,4920.438627,5568.617284,9935,414.4764289,19870,-4713472,373248,-4340224,34
9231,707,21,9,0.0711410747,0.928858925,2856.494341,2974.813902,4928.754956,5501.490806,9938,588.7440758,19876,-4726272,361984,-4364288,34
9290,648,22,8,0.0652042665,0.934795734,2875.727716,2765.925144,4961.566631,5083.236111,9938,595.8033573,19876,-4756480,331776,-4424704,34
9202,730,22,8,0.0734997986,0.926500201,2854.489048,2957.431222,4919.115301,5563.806849,9932,668.8215488,19864,-4711424,373760,-4337664,34
9286,653,22,8,0.0657007747,0.934299225,2869.059835,2855.052115,4949.908572,5255.710567,9939,745.6114029,19878,-4754432,334336,-4420096,34
9280,658,22,8,0.0662105051,0.933789495,2870.528754,2833.008059,4951.530496,5222.930091,9938,443.8588656,19876,-4751360,336896,-4414464,34
2723,136,23,7,0.0475690801,0.95243092,824.7233516,833.4960875,1433.845391,1353.007353,2859,38.94034323,5718,-1394176,69632,-1324544,34
9160,749,23,7,0.0755878494,0.924412151,2855.880542,2874.88981,4916.562445,5425.077437,9909,1172.662722,19818,-4689920,383488,-4306432,34
7438,394,24,6,0.0503064351,0.949693565,2247.419581,2470.36572,3936.927534,3530.865482,7832,193.4782609,15664,-3808256,201728,-3606528,34
8097,424,24,6,0.0497594179,0.950240582,2441.75201,2781.7206,4258.67173,4305.462264,8521,236.0387812,17042,-4145664,217088,-3928576,34
7455,358,23,7,0.0458210675,0.954178933,2247.308542,2398.23075,3921.523541,3604.561453,7813,209.3515541,15626,-3816960,183296,-3633664,34
9144,780,23,7,0.0785973398,0.92140266,2857.073412,2817.874443,4889.915245,5813.416667,9924,1018.89117,19848,-4681728,399360,-4282368,34
7903,412,24,6,0.0495490078,0.950450992,2385.209071,2673.912709,4158.687207,4144.817961,8315,215.3029518,16630,-4046336,210944,-3835392,34
8931,590,23,7,0.0619682806,0.938031719,2745.501661,2792.872976,4758.663643,4796.366102,9521,226.5825797,19042,-4572672,302080,-4270592,34
381,35,24,6,0.0841346154,0.915865385,119.3606434,104.2364032,214.992126,137.8285714,416,7.729468599,832,-195072,17920,-177152,34
7485,389,24,6,0.0494030988,0.950596901,2263.010177,2423.91907,3958.122111,3540.696658,7874,186.5876777,15748,-3832320,199168,-3633152,34
8079,434,24,6,0.0509808528,0.949019147,2442.388687,2723.255942,4258.379007,4231.329493,8513,298.3876621,17026,-4136448,222208,-3914240,34
8054,431,24,6,0.0507955215,0.949204478,2432.823217,2740.112626,4246.502359,4177.552204,8485,247.8819749,16970,-4123648,220672,-3902976,34
7719,386,24,6,0.0476249229,0.952375077,2329.001137,2501.504401,4075.718098,3598.696891,8105,196.1994674,16210,-3952128,197632,-3754496,34
8098,441,24,6,0.0516453917,0.948354608,2444.995116,2806.734008,4267.721783,4311.834467,8539,291.5329464,17078,-4146176,225792,-3920384,34
7900,429,24,6,0.0515067835,0.948493216,2385.454983,2729.271845,4166.620127,4135.165501,8329,236.4849517,16658,-4044800,219648,-3825152,34
9083,813,24,6,0.0821544058,0.917845594,2840.914168,3014.109243,4923.832104,5224.094711,9896,520.8421053,19792,-4650496,416256,-4234240,34
7961,442,23,7,0.0526002618,0.947399738,2408.156449,2718.011834,4210.924256,4041.262443,8403,240.2229846,16806,-4076032,226304,-3849728,34
7513,382,24,6,0.0483850538,0.951614946,2264.175498,2550.307025,3955.503261,3800.429319,7895,181.7449355,15790,-3846656,195584,-3651072,34
9080,813,23,7,0.0821793187,0.917820681,2841.237095,2878.119395,4870.132379,5805.496925,9893,596.3230862,19786,-4648960,416256,-4232704,34
8234,449,23,7,0.0517102384,0.948289762,2483.039912,2904.394583,4342.435754,4334.008909,8683,153.0044053,17366,-4215808,229888,-3985920,34
7697,421,24,6,0.0518600641,0.948139936,2321.576138,2697.098294,4074.968299,3776.698337,8118,184.5839018,16236,-3940864,215552,-3725312,34
5809,525,22,8,0.082886012,0.917113988,1815.891204,1962.257241,3167.444655,3168.112381,6334,167.433254,12668,-2974208,268800,-2705408,34
6505,549,21,9,0.0778281826,0.922171817,2016.975357,2250.339576,3518.870561,3629.748634,7054,184.2256464,14108,-3330560,281088,-3049472,34
6998,557,22,8,0.0737260093,0.926273991,2168.031758,2330.259651,3791.644041,3606.579892,7555,185.2623835,15110,-3582976,285184,-3297792,34
5656,501,22,8,0.0813707975,0.918629203,1767.576193,1884.074843,3082.153289,3043.401198,6157,146.7699642,12314,-2895872,256512,-2639360,34
6203,527,22,8,0.0783060921,0.921693908,1931.641017,2069.004249,3368.933742,3325.083491,6730,140.6772575,13460,-3175936,269824,-2906112,34
8762,1100,23,7,0.111539242,0.888460758,2827.569574,2868.547654,4828.970326,5748.195455,9862,568.4149856,19724,-4486144,563200,-3922944,34
6830,576,22,8,0.0777747772,0.922225223,2121.237761,2324.963905,3710.833089,3616.546875,7406,189.8974359,14812,-3496960,294912,-3202048,34
6931,562,21,9,0.0750033364,0.924996664,2151.262179,2297.193898,3760.157553,3584.731317,7493,159.2222694,14986,-3548672,287744,-3260928,34
6963,572,22,8,0.0759124088,0.924087591,2163.775412,2306.661766,3776.777251,3661.153846,7535,186.6022784,15070,-3565056,292864,-3272192,34
7683,771,20,10,0.0911994322,0.908800568,2433.398652,2500.687167,4207.129507,4430.491569,8454,166.8442866,16908,-3933696,394752,-3538944,34
6687,718,22,8,0.0969615125,0.903038488,2094.833361,2415.003586,3636.512188,4322.225627,7405,174.4405183,14810,-3423744,367616,-3056128,34
8696,1161,23,7,0.117784316,0.882215684,2801.818832,2922.690428,4780.570492,6040.751077,9857,849.0094746,19714,-4452352,594432,-3857920,34
8708,1149,24,6,0.116566907,0.883433093,2812.736874,2973.623711,4828.401585,5691.411662,9857,288.7229057,19714,-4458496,588288,-3870208,34
8752,1118,24,6,0.113272543,0.886727457,2830.471065,2899.447455,4846.692413,5630.709302,9870,327.3631841,19740,-4481024,572416,-3908608,34
5838,481,22,8,0.0761196392,0.923880361,1819.258112,1879.486417,3168.233642,3060.066528,6319,157.2281662,12638,-2989056,246272,-2742784,34
5941,503,22,8,0.0780571074,0.921942893,1848.826558,1989.640757,3219.937216,3252.769384,6444,180.0502934,12888,-3041792,257536,-2784256,34
6358,563,21,9,0.0813466262,0.918653374,1977.478458,2206.658426,3444.007864,3652.893428,6921,122.235959,13842,-3255296,288256,-2967040,34
8724,1129,23,7,0.114584391,0.885415609,2809.301601,2901.754062,4793.625172,5957.612932,9853,759.6761758,19706,-4466688,578048,-3888640,34
6554,555,22,8,0.078070052,0.921929948,2037.036635,2222.906479,3551.362222,3597.958559,7109,216.0133698,14218,-3355648,284160,-3071488,34
6170,545,22,8,0.0811615786,0.918838421,1904.12977,2280.735913,3339.25624,3570.2,6715,173.6039297,13430,-3159040,279040,-2880000,34
9175,755,21,9,0.0760322256,0.923967774,2847.260271,3044.108618,4922.943215,5482.663576,9930,455.5045872,19860,-4697600,386560,-4311040,34
9215,715,22,8,0.0720040282,0.927995972,2842.868556,3112.858224,4926.710364,5465.425175,9930,663.7700535,19860,-4718080,366080,-4352000,34
4354,253,21,9,0.0549164315,0.945083568,1322.48277,1339.38434,2335.680753,1758.790514,4607,81.74237048,9214,-2229248,129536,-2099712,34
8968,908,22,8,0.0919400567,0.908059943,2873.174618,2587.50454,4897.953167,5338.96696,9876,777.6377953,19752,-4591616,464896,-4126720,34
9025,858,22,8,0.0868157442,0.913184256,2864.748447,2678.169714,4895.776399,5428.20979,9883,722.9700073,19766,-4620800,439296,-4181504,34
8914,954,21,9,0.0966761248,0.903323875,2857.499966,2697.838089,4873.097599,5508.232704,9868,755.0114767,19736,-4563968,488448,-4075520,34
9193,733,22,8,0.0738464638,0.926153536,2849.315617,3043.328192,4939.156858,5268.802183,9926,609.7051597,19852,-4706816,375296,-4331520,34
9127,778,21,9,0.0785461888,0.921453811,2866.972134,2742.809103,4922.473102,5311.122108,9905,703.9800995,19810,-4673024,398336,-4274688,34
8984,894,22,8,0.0905041506,0.909495849,2853.346489,2802.941925,4900.280944,5333.620805,9878,659.4125501,19756,-4599808,457728,-4142080,34
8933,943,22,8,0.0954840016,0.904515998,2855.795351,2738.546221,4877.705474,5514.40403,9876,842.662116,19752,-4573696,482816,-4090880,34
8949,936,22,8,0.0946889226,0.905311077,2876.032137,2557.543094,4882.435244,5522.053419,9885,838.4223919,19770,-4581888,479232,-4102656,34
9219,715,21,9,0.0719750352,0.928024965,2849.837861,3066.933299,4940.116824,5320.570629,9934,645.4840806,19868,-4720128,366080,-4354048,34
9090,805,22,8,0.0813542193,0.918645781,2868.926943,2698.36756,4925.413751,5203.042236,9895,976.8015795,19790,-4654080,412160,-4241920,34
9238,698,22,8,0.0702495974,0.929750403,2854.47986,3040.798383,4956.868695,5122.439828,9936,702.1908127,19872,-4729856,357376,-4372480,34
9096,803,22,8,0.081119305,0.918880695,2853.471566,2789.78377,4881.788478,5722.667497,9899,1116.009019,19798,-4657152,411136,-4246016,34
9171,758,22,8,0.0763420284,0.923657972,2844.540642,3093.840484,4934.862719,5329.629288,9929,689.9930507,19858,-4695552,388096,-4307456,34
9077,834,22,8,0.0841489254,0.915851075,2847.817875,2940.06457,4902.919577,5533.711031,9911,862.5761532,19822,-4647424,427008,-4220416,34
9048,845,21,9,0.085413929,0.914586071,2868.699097,2657.852231,4897.677608,5475.128994,9893,860.2608696,19786,-4632576,432640,-4199936,34
9248,689,22,8,0.069336822,0.930663178,2854.820675,3041.35763,4955.621324,5148.573295,9937,626.5447667,19874,-4734976,352768,-4382208,34
3174,232,22,8,0.068115091,0.931884909,980.3438397,1017.887087,1709.853182,1616.581897,3406,46.89522236,6812,-1625088,118784,-1506304,34
9568,419,22,8,0.0419545409,0.958045459,2877.030071,2878.684282,5032.574728,4113.133652,9987,336.9433198,19974,-4898816,214528,-4684288,34
9550,436,21,9,0.0436611256,0.956338874,2883.232806,2775.618003,5026.305969,4274.928899,9986,833.5559265,19972,-4889600,223232,-4666368,34
9568,418,22,8,0.041858602,0.958141398,2876.440344,2878.063096,5033.001254,4089.318182,9986,974.2439024,19972,-4898816,214016,-4684800,34
9586,401,21,9,0.0401521979,0.959847802,2873.958237,2945.637666,5032.42489,4075.44389,9987,779.6252927,19974,-4908032,205312,-4702720,34
9524,461,22,8,0.0461692539,0.953830746,2876.090661,2801.319412,5045.088618,3916.878525,9985,509.6988259,19970,-4876288,236032,-4640256,34
9510,476,22,8,0.0476667334,0.952333267,2874.642447,2802.819859,5050.925342,3846.19958,9986,915.3070577,19972,-4869120,243712,-4625408,34
9518,467,22,8,0.0467701552,0.953229845,2877.074154,2789.175959,5044.51639,3943.036403,9985,876.6461809,19970,-4873216,239104,-4634112,34
9530,454,22,8,0.0454727564,0.954527244,2876.624869,2809.454786,5040.856558,3977.438326,9984,779.3911007,19968,-4879360,232448,-4646912,34
9547,443,22,8,0.0443443443,0.955655656,2874.423822,2865.110769,5046.808107,3889.769752,9990,733.4801762,19980,-4888064,226816,-4661248,34
9494,490,22,8,0.0490785256,0.950921474,2874.768612,2750.553037,5055.412155,3773.544898,9984,337.6394995,19968,-4860928,250880,-4610048,34
9582,405,22,8,0.0405527185,0.959447281,2878.99761,2872.430071,5026.23565,4231.328395,9987,1137.471526,19974,-4905984,207360,-4698624,34
9505,480,22,8,0.0480721082,0.951927892,2878.904444,2755.998563,5045.004524,3963.202083,9985,1091.256831,19970,-4866560,245760,-4620800,34
9596,390,22,8,0.0390546765,0.960945323,2874.736979,2939.113644,5029.158608,4116.115385,9986,442.0540062,19972,-4913152,199680,-4713472,34
9515,471,22,8,0.0471660324,0.952833968,2878.944443,2770.812145,5043.502785,3983.358811,9986,930.6616962,19972,-4871680,241152,-4630528,34
9610,377,22,8,0.0377490738,0.962250926,2875.893452,2964.961348,5022.892612,4257.506631,9987,451.0840108,19974,-4920320,193024,-4727296,34
9536,449,21,9,0.0449674512,0.955032549,2875.255355,2834.595336,5042.337668,3945.151448,9985,600.420926,19970,-4882432,229888,-4652544,34
9507,476,21,9,0.0476810578,0.952318942,2879.089823,2737.823338,5043.852319,3956.369748,9983,658.9438944,19966,-4867584,243712,-4623872,34
9593,394,22,8,0.0394512867,0.960548713,2877.558741,2911.554886,5025.11498,4236.42132,9987,1038.149688,19974,-4911616,201728,-4709888,34
9527,458,22,8,0.0458688032,0.954131197,2873.892232,2826.26997,5047.394773,3861.517467,9985,517.6257128,19970,-4877824,234496,-4643328,34
9552,434,21,9,0.0434608452,0.956539155,2879.29718,2830.727194,5031.461683,4157.993088,9986,557.877095,19972,-4890624,222208,-4668416,34
5932,342,22,8,0.054510679,0.945489321,1785.463834,1983.001106,3192.146662,2189.652047,6274,757.7294686,12548,-3037184,175104,-2862080,35
5937,349,21,9,0.0555202036,0.944479796,1789.637157,1883.077549,3208.086407,2044.790831,6286,607.3429952,12572,-3039744,178688,-2861056,35
6473,391,21,9,0.0569638695,0.943036131,1951.103226,2152.768733,3498.567125,2338.759591,6864,347.7203647,13728,-3314176,200192,-3113984,35
3247,263,23,7,0.0749287749,0.925071225,997.0290369,918.9575161,1815.073606,1020.003802,3510,61.20313862,7020,-1662464,134656,-1527808,35
6356,387,21,9,0.0573928518,0.942607148,1913.083511,2280.785614,3421.725771,2555.315245,6743,118.7566044,13486,-3254272,198144,-3056128,35
5969,380,21,9,0.0598519452,0.940148055,1807.950811,1858.852773,3246.048919,2058.971053,6349,413.0774236,12698,-3056128,194560,-2861568,35
6461,382,21,9,0.0558234692,0.944176531,1947.404039,2130.099549,3485.524687,2347.568063,6843,450.7905138,13686,-3308032,195584,-3112448,35
5938,367,20,10,0.0582077716,0.941792228,1795.269026,2031.434086,3200.921691,2377.634877,6305,560.4444444,12610,-3040256,187904,-2852352,35
6509,364,21,9,0.0529608613,0.947039139,1955.610699,2195.308108,3494.636657,2406.348901,6873,511.7647059,13746,-3332608,186368,-3146240,35
5947,354,22,8,0.0561815585,0.943818442,1792.003878,1976.350363,3209.881285,2161.827684,6301,478.435839,12602,-3044864,181248,-2863616,35
6020,381,21,9,0.0595219497,0.94047805,1819.832478,1952.083467,3268.933056,2127.622047,6401,704.9559471,12802,-3082240,195072,-2887168,35
5877,331,21,9,0.053318299,0.946681701,1768.010728,1901.331923,3162.466565,2075.287009,6208,738.1688466,12416,-3009024,169472,-2839552,35
6046,355,22,8,0.0554600844,0.944539916,1826.125802,1973.453505,3254.429706,2291.039437,6401,455.5871886,12802,-3095552,181760,-2913792,35
5876,342,20,10,0.0550016082,0.944998392,1769.939524,1859.210355,3173.989449,2001.488304,6218,579.4967381,12436,-3008512,175104,-2833408,35
6450,391,21,9,0.0571553866,0.942844613,1945.553887,2139.270375,3485.923876,2350.005115,6841,581.2234494,13682,-3302400,200192,-3102208,35
5878,351,21,9,0.0563493338,0.943650666,1772.719914,1846.4325,3182.278666,1988.321937,6229,626.6599598,12458,-3009536,179712,-2829824,35
3741,308,21,9,0.076068165,0.923931835,1147.904314,1208.171891,2080.723069,1348.181818,4049,349.3528904,8098,-1915392,157696,-1757696,35
5911,344,20,10,0.0549960032,0.945003997,1780.131974,1867.014394,3193.678396,1999.438953,6255,789.7727273,12510,-3026432,176128,-2850304,35
5957,362,21,9,0.0572875455,0.942712455,1798.704267,1856.540697,3229.738459,2012.39779,6319,728.8350634,12638,-3049984,185344,-2864640,35
5859,333,21,9,0.0537790698,0.94622093,1762.349929,1912.38452,3154.674176,2072.948949,6192,480.7453416,12384,-2999808,170496,-2829312,35
4500,315,23,7,0.0654205607,0.934579439,1372.457527,1400.997577,2462.991333,1622.409524,4815,129.644588,9630,-2304000,161280,-2142720,35
4450,318,20,10,0.0666946309,0.933305369,1353.425841,1456.339433,2440.214607,1604.845912,4768,127.931312,9536,-2278400,162816,-2115584,35
4446,310,23,7,0.0651808242,0.934819176,1352.000773,1422.438315,2434.088169,1581.258065,4756,117.9856115,9512,-2276352,158720,-2117632,35
4519,316,23,7,0.0653567735,0.934643226,1377.346475,1452.577623,2468.937154,1689.566456,4835,108.1655481,9670,-2313728,161792,-2151936,35
4416,312,21,9,0.0659898477,0.934010152,1343.189777,1429.692706,2419.518795,1585.772436,4728,131.0784586,9456,-2260992,159744,-2101248,35
4455,309,23,7,0.064861461,0.935138539,1357.29828,1455.680956,2428.943883,1712.89644,4764,128.4097035,9528,-2280960,158208,-2122752,35
3910,263,21,9,0.0630242032,0.936975797,1187.143502,1215.625953,2137.248593,1339.958175,4173,112.5101105,8346,-2001920,134656,-1867264,35
4413,310,21,9,0.0656362481,0.934363752,1340.982417,1455.210711,2414.806254,1610.277419,4723,107.8310502,9446,-2259456,158720,-2100736,35
4429,303,22,8,0.0640321217,0.935967878,1343.81706,1435.227242,2421.286746,1565.673267,4732,124.3953733,9464,-2267648,155136,-2112512,35
4435,318,23,7,0.0669051126,0.933094887,1351.229431,1415.266321,2433.746561,1585.581761,4753,124.3915205,9506,-2270720,162816,-2107904,35
3904,289,23,7,0.0689243978,0.931075602,1191.451735,1184.272319,2155.810707,1302.546713,4193,109.7643979,8386,-1998848,147968,-1850880,35
4449,330,21,9,0.069052103,0.930947897,1351.05951,1591.997286,2436.30771,1765.687879,4779,83.91571554,9558,-2277888,168960,-2108928,35
4027,289,21,9,0.0669601483,0.933039852,1226.885077,1271.677488,2211.796374,1415.854671,4316,103.1055901,8632,-2061824,147968,-1913856,35
4438,302,23,7,0.0637130802,0.93628692,1350.985318,1402.62296,2421.404236,1622.443709,4740,93.50956796,9480,-2272256,154624,-2117632,35
4432,305,21,9,0.0643867427,0.935613257,1346.102854,1448.566507,2421.137635,1611.380328,4737,127.2702848,9474,-2269184,156160,-2113024,35
4388,306,21,9,0.0651896037,0.934810396,1335.321044,1434.801998,2396.966955,1638.150327,4694,118.5952501,9388,-2246656,156672,-2089984,35
3944,290,21,9,0.0684931507,0.931506849,1202.846643,1208.908192,2175.692698,1326.07931,4234,117.7419355,8468,-2019328,148480,-1870848,35
3947,291,21,9,0.0686644644,0.931335536,1205.916028,1193.643313,2176.784393,1342.5189,4238,116.9103448,8476,-2020864,148992,-1871872,35
3948,289,22,8,0.0682086382,0.931791362,1207.789803,1190.858653,2173.130446,1379.529412,4237,107.1031345,8474,-2021376,147968,-1873408,35
4397,325,20,10,0.0688267683,0.931173232,1335.371711,1577.250167,2405.674551,1763.852308,4722,83.13380282,9444,-2251264,166400,-2084864,35
3996,312,20,10,0.0724233983,0.927576602,1223.797854,1247.371503,2213.558308,1398.099359,4308,122.3863636,8616,-2045952,159744,-1886208,35
3954,294,21,9,0.0692090395,0.93079096,1208.510989,1187.186794,2183.508093,1330.901361,4248,119.1919192,8496,-2024448,150528,-1873920,35
4422,290,21,9,0.0615449915,0.938455008,1338.441039,1486.875949,2403.028042,1647.027586,4712,122.4532225,9424,-2264064,148480,-2115584,35
4469,315,20,10,0.0658444816,0.934155518,1359.70451,1441.612659,2447.755874,1608.568254,4784,131.0684932,9568,-2288128,161280,-2126848,35
2029,225,20,10,0.0998225377,0.900177462,640.2645644,640.9101931,1165.983243,780.4666667,2254,39.50920245,4508,-1038848,115200,-923648,35
4015,284,21,9,0.0660618749,0.933938125,1221.967073,1212.358708,2208.546451,1322.309859,4299,112.3334204,8598,-2055680,145408,-1910272,35
3955,288,21,9,0.0678765025,0.932123498,1207.455106,1218.96539,2176.246271,1377.055556,4243,126.5811456,8486,-2024960,147456,-1877504,35
4470,317,20,10,0.0662210152,0.933778985,1359.700245,1453.37831,2449.464206,1611.902208,4787,127.857906,9574,-2288640,162304,-2126336,35
4467,330,21,9,0.0687929956,0.931207004,1365.598158,1327.352749,2465.481307,1499.084848,4797,109.495549,9594,-2287104,168960,-2118144,35
4478,317,21,9,0.0661105318,0.933889468,1360.95384,1467.128727,2453.782046,1610.012618,4795,120.0250313,9590,-2292736,162304,-2130432,35
4423,304,20,10,0.0643114026,0.935688597,1341.450837,1472.221946,2415.701108,1611.782895,4727,131.781433,9454,-2264576,155648,-2108928,35
4440,304,21,9,0.0640809444,0.935919056,1348.198946,1444.700149,2425.191441,1602.927632,4744,139.8172709,9488,-2273280,155648,-2117632,35
4548,313,21,9,0.0643900432,0.935609957,1382.79439,1490.792851,2481.466359,1697.70607,4861,137.2388481,9722,-2328576,160256,-2168320,35
3939,267,21,9,0.0634807418,0.936519258,1196.219467,1217.034644,2155.618177,1334.610487,4206,119.0489669,8412,-2016768,136704,-1880064,35
4443,320,23,7,0.0671845476,0.932815452,1353.704027,1454.247983,2435.020707,1645.840625,4763,119.8842185,9526,-2274816,163840,-2110976,35
3988,301,20,10,0.070179529,0.929820471,1219.504061,1208.204484,2204.998746,1350.066445,4289,101.6350711,8578,-2041856,154112,-1887744,35
4449,305,20,10,0.0641564998,0.9358435,1351.007223,1452.584151,2429.790739,1614.740984,4754,116.9495695,9508,-2277888,156160,-2121728,35
4500,323,21,9,0.0669707651,0.933029235,1376.056475,1412.716786,2464.271111,1683.764706,4823,113.3490012,9646,-2304000,165376,-2138624,35
4451,321,21,9,0.0672673931,0.932732607,1356.416477,1444.13169,2441.059313,1629.978193,4772,135.645253,9544,-2278912,164352,-2114560,35
3965,296,20,10,0.0694672612,0.930532739,1212.59425,1227.563091,2185.705422,1398.206081,4261,107.8734177,8522,-2030080,151552,-1878528,35
4698,360,21,9,0.0711743772,0.928825623,1437.002187,1569.137153,2583.956577,1818.841667,5058,342.9152542,10116,-2405376,184320,-2221056,35
4697,392,20,10,0.0770288858,0.922971114,1449.229143,1472.594066,2611.278901,1750.836735,5089,136.2152034,10178,-2404864,200704,-2204160,35
4723,366,22,8,0.0719198271,0.928080173,1450.008225,1563.469523,2594.049333,1912.04918,5089,456.4125561,10178,-2418176,187392,-2230784,35
4675,365,22,8,0.0724206349,0.927579365,1435.982131,1497.013253,2577.621604,1788.873973,5040,296.9946965,10080,-2393600,186880,-2206720,35
4611,357,22,8,0.0718599034,0.928140097,1414.121429,1451.651732,2546.271525,1686.661064,4968,504.3654822,9936,-2360832,182784,-2178048,35
4702,376,22,8,0.0740448996,0.9259551,1445.031249,1483.981896,2604.156104,1730.954787,5078,289.0153671,10156,-2407424,192512,-2214912,35
3696,298,22,8,0.0746119179,0.925388082,1136.300185,1071.971181,2060.199134,1219.862416,3994,359.4959496,7988,-1892352,152576,-1739776,35
4649,372,23,7,0.0740888269,0.925911173,1428.687721,1514.652786,2568.260056,1795.403226,5021,545.7608696,10042,-2380288,190464,-2189824,35
4069,318,22,8,0.0724868931,0.927513107,1248.937929,1293.261314,2246.894814,1517.179245,4387,398.8181818,8774,-2083328,162816,-1920512,35
4673,343,24,6,0.0683811802,0.93161882,1424.700408,1591.624359,2557.331907,1843.218659,5016,466.1710037,10032,-2392576,175616,-2216960,35
4090,347,22,8,0.078205995,0.921794005,1260.584464,1397.161904,2263.288753,1696.979827,4437,504.778157,8874,-2094080,177664,-1916416,35
4234,351,22,8,0.0765539804,0.92344602,1306.956792,1299.351001,2354.236183,1554.327635,4585,146.2519936,9170,-2167808,179712,-1988096,35
262,99,20,10,0.274238227,0.725761773,90.45262433,130.6902804,171.5152672,206.1010101,361,8.667466987,722,-134144,50688,-83456,35
4695,356,22,8,0.0704810929,0.929518907,1437.760049,1534.749879,2580.083706,1812.733146,5051,164.5812968,10102,-2403840,182272,-2221568,35
4254,355,23,7,0.0770232154,0.922976785,1315.144843,1331.752754,2360.752938,1636.907042,4609,369.9036918,9218,-2178048,181760,-1996288,35
5131,428,20,10,0.0769922648,0.923007735,1574.244399,1881.760066,2815.532255,2354.028037,5559,97.56054756,11118,-2627072,219136,-2407936,35
4773,404,21,9,0.0780374734,0.921962527,1470.635224,1580.231811,2650.429918,1863.24505,5177,358.7664588,10354,-2443776,206848,-2236928,35
4743,386,23,7,0.075258335,0.924741665,1462.542891,1488.402367,2627.138942,1801.463731,5129,182.721767,10258,-2428416,197632,-2230784,35
4715,373,21,9,0.0733097484,0.926690252,1448.974644,1542.483893,2598.804666,1858.048257,5088,460.8695652,10176,-2414080,190976,-2223104,35
4720,383,21,9,0.0750538899,0.92494611,1451.591284,1551.149252,2609.323941,1845.553525,5103,292.4355301,10206,-2416640,196096,-2220544,35
4789,226,22,8,0.0450648056,0.954935194,1431.404554,1642.621858,2536.879307,1896.039823,5015,193.405322,10030,-2451968,115712,-2336256,35
150,34,22,8,0.184782609,0.815217391,51.39373459,56.81513304,96.52666667,74.73529412,184,8.163265306,368,-76800,17408,-59392,35
4797,234,21,9,0.0465116279,0.953488372,1434.26874,1617.043398,2551.736294,1783.405983,5031,203.2727273,10062,-2456064,119808,-2336256,35
4969,227,22,8,0.0436874519,0.956312548,1482.938315,1694.649739,2629.746428,1914.519824,5196,199.0042129,10392,-2544128,116224,-2427904,35
4776,228,22,8,0.0455635492,0.954436451,1429.306368,1654.724655,2526.509841,1999.557018,5004,87.32984293,10008,-2445312,116736,-2328576,35
4762,220,22,8,0.0441589723,0.955841028,1423.173815,1619.434777,2519.165687,1892.663636,4982,181.8248175,9964,-2438144,112640,-2325504,35
4796,231,21,9,0.04595186,0.95404814,1434.53094,1626.92664,2545.764804,1854.502165,5027,196.7514677,10054,-2455552,118272,-2337280,35
151,37,21,9,0.196808511,0.803191489,52.02019172,61.17481447,97.43708609,82.51351351,188,8.051391863,376,-77312,18944,-58368,35
150,37,21,9,0.197860963,0.802139037,52.05857428,58.84011591,97.68666667,79.05405405,187,7.482993197,374,-76800,18944,-57856,35
4787,225,21,9,0.0448922586,0.955107741,1430.182759,1619.476715,2538.661792,1822.24,5012,179.0639514,10024,-2450944,115200,-2335744,35
4811,231,21,9,0.0458151527,0.954184847,1435.802186,1652.105101,2557.070464,1780.679654,5042,196.2631374,10084,-2463232,118272,-2344960,35
4779,223,22,8,0.0445821671,0.955417833,1427.109633,1621.670383,2533.477087,1816.215247,5002,189.6852484,10004,-2446848,114176,-2332672,35
4776,226,21,9,0.0451819272,0.954818073,1428.57453,1624.367266,2530.002303,1899.168142,5002,194.7819315,10004,-2445312,115712,-2329600,35
4761,228,21,9,0.0457005412,0.954299459,1423.701888,1610.505176,2526.972905,1827.355263,4989,200.2810116,9978,-2437632,116736,-2320896,35
4822,231,22,8,0.0457154166,0.954284583,1440.419722,1647.013007,2560.741808,1822.658009,5053,212.0436425,10106,-2468864,118272,-2350592,35
4785,231,20,10,0.0460526316,0.953947368,1431.003915,1626.421806,2540.642215,1842.69697,5016,196.7830522,10032,-2449920,118272,-2331648,35
4797,230,21,9,0.0457529342,0.954247066,1434.002989,1639.180771,2545.488639,1857.256522,5027,195.1475155,10054,-2456064,117760,-2338304,35
149,37,22,8,0.198924731,0.801075269,51.13668005,62.27353126,95.53691275,85.2972973,186,3.266596417,372,-76288,18944,-57344,35
4782,222,21,9,0.0443645084,0.955635492,1430.840935,1565.379768,2534.077164,1822.310811,5004,169.0540541,10008,-2448384,113664,-2334720,35
4782,224,22,8,0.0447463044,0.955253696,1430.134516,1601.114539,2534.000836,1852.361607,5006,154.5061728,10012,-2448384,114688,-2333696,35
2804,230,21,9,0.0758075148,0.924192485,853.2664058,1065.890018,1543.274251,1203.278261,3034,99.93412385,6068,-1435648,117760,-1317888,35
61,11,21,9,0.152777778,0.847222222,20.17776415,19.19452401,38.85245902,23.45454545,72,45,144,-31232,5632,-25600,35
2807,224,22,8,0.0739030023,0.926096998,857.3444995,1055.034194,1530.406484,1335.46875,3031,103.3060668,6062,-1437184,114688,-1322496,35
2850,224,22,8,0.0728692258,0.927130774,866.8333292,1082.512007,1558.138947,1274.90625,3074,87.4786568,6148,-1459200,114688,-1344512,35
2830,236,21,9,0.0769732551,0.923026745,864.1775502,1073.492131,1554.604594,1280.423729,3066,95.93241552,6132,-1448960,120832,-1328128,35
2808,220,21,9,0.072655218,0.927344782,856.3906282,1053.594338,1530.565527,1309.445455,3028,100.5980066,6056,-1437696,112640,-1325056,35
2812,235,21,9,0.077125041,0.922874959,858.5239416,1070.008535,1544.775605,1275.4,3047,106.7250438,6094,-1439744,120320,-1319424,35
2914,235,22,8,0.0746268657,0.925373134,888.4494485,1100.206013,1596.215854,1311.923404,3149,112.9078523,6298,-1491968,120320,-1371648,35
2820,226,22,8,0.0741956664,0.925804334,859.0991586,1054.811014,1547.742199,1221.00885,3046,82.21322537,6092,-1443840,115712,-1328128,35
2833,229,22,8,0.0747877204,0.92521228,862.7437052,1085.532091,1550.639252,1294.724891,3062,101.4243127,6124,-1450496,117248,-1333248,35
2839,229,21,9,0.0746414602,0.92535854,864.7133324,1082.669674,1554.53223,1286.152838,3068,105.8661146,6136,-1453568,117248,-1336320,35
2862,228,22,8,0.0737864078,0.926213592,872.2440325,1077.528403,1566.109364,1286.798246,3090,107.4782609,6180,-1465344,116736,-1348608,35
2807,225,20,10,0.0742084433,0.925791557,854.9827415,1079.816175,1531.504097,1329.315556,3032,100.8649368,6064,-1437184,115200,-1321984,35
71,9,23,7,0.1125,0.8875,22.3891304,20.55945909,42.77464789,22.55555556,80,18.95734597,160,-36352,4608,-31744,35
2814,226,22,8,0.0743421053,0.925657895,855.8762275,1087.624595,1538.701848,1293.862832,3040,105.6656239,6080,-1440768,115712,-1325056,35
2732,176,21,9,0.060522696,0.939477304,827.2546596,999.410107,1445.270132,1597.772727,2908,89.50446291,5816,-1398784,90112,-1308672,35
2803,220,21,9,0.0727753887,0.927224611,854.0539136,1021.210728,1539.051374,1167.340909,3023,59.10068426,6046,-1435136,112640,-1322496,35
2842,231,20,10,0.0751708428,0.924829157,866.6733539,1083.640782,1555.059113,1314.818182,3073,80.08861089,6146,-1455104,118272,-1336832,35
2792,232,22,8,0.0767195767,0.923280423,852.9283205,1057.728891,1531.924069,1278.741379,3024,102.1966881,6048,-1429504,118784,-1310720,35
2808,231,21,9,0.076011846,0.923988154,856.790701,1059.732313,1542.165242,1250.562771,3039,75.88014981,6078,-1437696,118272,-1319424,35
6137,342,21,9,0.0527859238,0.947214076,1846.874089,2091.71552,3284.960078,2433.216374,6479,386.8059701,12958,-3142144,175104,-2967040,35
6339,393,21,9,0.0583778966,0.941622103,1915.51184,2069.970395,3433.092917,2292.371501,6732,341.7258883,13464,-3245568,201216,-3044352,35
6129,367,21,9,0.0564963054,0.943503695,1844.184548,2061.60826,3312.078969,2186.713896,6496,371.8374356,12992,-3138048,187904,-2950144,35
6110,358,21,9,0.0553494125,0.944650588,1839.39217,2032.939358,3294.482324,2210.77933,6468,626.1374637,12936,-3128320,183296,-2945024,35
6147,369,21,9,0.0566298343,0.943370166,1854.663275,2014.262034,3320.213275,2230.447154,6516,569.5804196,13032,-3147264,188928,-2958336,35
6154,370,20,10,0.0567136726,0.943286327,1856.944062,2024.288848,3323.458076,2248.618919,6524,312.4521073,13048,-3150848,189440,-2961408,35
6254,391,21,9,0.058841234,0.941158766,1888.606959,2047.90626,3391.901343,2220.930946,6645,546.9135802,13290,-3202048,200192,-3001856,35
6249,390,21,9,0.0587437867,0.941256213,1889.450415,2049.422551,3384.174428,2291.728205,6639,576.3020833,13278,-3199488,199680,-2999808,35
6154,361,21,9,0.0554105909,0.944589409,1856.564166,1979.119946,3319.379428,2211.65928,6515,380.3269119,13030,-3150848,184832,-2966016,35
6107,372,21,9,0.0574162679,0.942583732,1842.772205,2008.682094,3303.224005,2202.072581,6479,601.5784587,12958,-3126784,190464,-2936320,35
6138,374,21,9,0.0574324324,0.942567568,1855.052456,2043.826874,3311.891496,2347.427807,6512,325.9259259,13024,-3142656,191488,-2951168,35
6105,351,21,9,0.0543680297,0.94563197,1835.436679,2019.474743,3290.066994,2157.655271,6456,382.0118343,12912,-3125760,179712,-2946048,35
6149,373,23,7,0.0571910457,0.942808954,1852.472615,2061.87818,3324.856887,2217.045576,6522,528.097166,13044,-3148288,190976,-2957312,35
6195,368,21,9,0.0560719183,0.943928082,1871.044139,2075.141131,3332.802421,2426.779891,6563,435.7901726,13126,-3171840,188416,-2983424,35
6192,396,21,9,0.0601092896,0.93989071,1873.71524,2084.685342,3354.240795,2360.371212,6588,574.3679163,13176,-3170304,202752,-2967552,35
6185,377,21,9,0.0574519963,0.942548004,1868.664424,2003.583742,3345.117866,2237.795756,6562,581.2223206,13124,-3166720,193024,-2973696,35
6197,360,21,9,0.0549031569,0.945096843,1868.252172,2014.910333,3338.636114,2252.430556,6557,425.226978,13114,-3172864,184320,-2988544,35
6123,366,23,7,0.0564031438,0.943596856,1845.025352,2029.828227,3307.053242,2206.879781,6489,445.6730769,12978,-3134976,187392,-2947584,35
6155,381,20,10,0.0582925337,0.941707466,1858.059278,2036.381172,3332.935987,2227.545932,6536,550.631845,13072,-3151360,195072,-2956288,35
5543,356,22,8,0.0603492117,0.939650788,1681.516495,1696.308712,3016.732095,1910.966292,5899,108.0205091,11798,-2838016,182272,-2655744,35
3949,296,21,9,0.0697290931,0.930270907,1206.070477,1218.090587,2181.097493,1347.908784,4245,107.5772935,8490,-2021888,151552,-1870336,35
3991,312,21,9,0.0725075529,0.927492447,1226.088721,1175.649366,2213.559008,1364.557692,4303,113.2964718,8606,-2043392,159744,-1883648,35
3974,305,21,9,0.0712783361,0.928721664,1217.615942,1208.938457,2198.593105,1376.560656,4279,118.2044199,8558,-2034688,156160,-1878528,35
3901,273,21,9,0.0654048874,0.934595113,1185.916875,1209.807619,2141.529864,1315.446886,4174,111.7237687,8348,-1997312,139776,-1857536,35
4431,336,21,9,0.0704845815,0.929515419,1351.059896,1437.644456,2446.375536,1561.422619,4767,126.5127389,9534,-2268672,172032,-2096640,35
3901,278,21,9,0.0665230916,0.933476908,1185.746992,1196.479905,2148.266598,1272.381295,4179,106.6887924,8358,-1997312,142336,-1854976,35
4447,321,21,9,0.0673238255,0.932676174,1356.594036,1462.531927,2434.063189,1697.872274,4768,135.9954364,9536,-2276864,164352,-2112512,35
3901,301,22,8,0.0716325559,0.928367444,1197.04078,1230.42921,2151.721353,1450.624585,4202,108.1874356,8404,-1997312,154112,-1843200,35
4819,332,21,9,0.0644535042,0.935546496,1465.688011,1546.092912,2633.034862,1748.135542,5151,137.5433912,10302,-2467328,169984,-2297344,35
4478,308,20,10,0.0643543669,0.935645633,1362.078258,1444.478489,2445.077043,1643.623377,4786,127.9679144,9572,-2292736,157696,-2135040,35
3980,298,21,9,0.069658719,0.930341281,1215.800575,1249.868409,2194.963317,1398.748322,4278,115.7780785,8556,-2037760,152576,-1885184,35
3965,287,21,9,0.0674976482,0.932502352,1207.402397,1221.393952,2184.522573,1324.898955,4252,88.03312629,8504,-2030080,146944,-1883136,35
4055,301,21,9,0.0691000918,0.930899908,1239.186823,1270.504495,2233.134895,1442.471761,4356,117.2859451,8712,-2076160,154112,-1922048,35
4437,319,20,10,0.0670731707,0.932926829,1350.526217,1452.347046,2433.384269,1615.109718,4756,126.3213811,9512,-2271744,163328,-2108416,35
3915,274,21,9,0.0654094056,0.934590594,1192.555788,1183.665343,2148.894764,1324.934307,4189,273.0769231,8378,-2004480,140288,-1864192,35
3978,296,21,9,0.0692559663,0.930744034,1215.928644,1240.68792,2191.756159,1408.341216,4274,116.1413043,8548,-2036736,151552,-1885184,35
73,37,21,9,0.336363636,0.663636364,32.38378184,30.44042428,56.05479452,54.40540541,110,2.080574995,220,-37376,18944,-18432,35
3929,283,21,9,0.0671889839,0.932811016,1197.661319,1249.008538,2157.122678,1403.685512,4212,110.1464435,8424,-2011648,144896,-1866752,35
228,59,23,7,0.205574913,0.794425087,82.33415704,82.47691345,148.5570175,126.3898305,287,4.524672868,574,-116736,30208,-86528,35
457,96,23,7,0.173598553,0.826401447,158.5728934,159.711555,284.6105033,240.7708333,553,8.926553672,1106,-233984,49152,-184832,35
4470,342,21,9,0.0710723192,0.928927681,1367.434982,1409.714024,2469.203579,1586.953216,4812,219.1256831,9624,-2288640,175104,-2113536,35
4469,339,23,7,0.0705074875,0.929492512,1368.109239,1438.211301,2460.139852,1671.0059,4808,400,9616,-2288128,173568,-2114560,35
4405,321,23,7,0.0679221329,0.932077867,1345.97301,1397.141451,2417.543019,1621.88162,4726,369.21875,9452,-2255360,164352,-2091008,35
4619,321,21,9,0.0649797571,0.935020243,1403.06279,1524.334635,2524.512882,1693.286604,4940,399.0306947,9880,-2364928,164352,-2200576,35
4291,301,23,7,0.0655487805,0.93445122,1304.967248,1393.726972,2348.511303,1555.036545,4592,340.9057164,9184,-2196992,154112,-2042880,35
4342,310,21,9,0.0666380052,0.933361995,1321.269263,1410.636787,2380.869415,1564.977419,4652,413.5111111,9304,-2223104,158720,-2064384,35
4397,325,21,9,0.0688267683,0.931173232,1342.462885,1413.212662,2417.535592,1603.381538,4722,371.5184894,9444,-2251264,166400,-2084864,35
4280,305,23,7,0.066521265,0.933478735,1299.859148,1393.651299,2349.887617,1494.708197,4585,427.7052239,9170,-2191360,156160,-2035200,35
4358,318,21,9,0.0680068435,0.931993157,1329.332186,1401.005798,2393.627811,1583.006289,4676,313.6150235,9352,-2231296,162816,-2068480,35
4401,327,21,9,0.0691624365,0.930837563,1342.585223,1541.19777,2403.70234,1836.88685,4728,84.0981857,9456,-2253312,167424,-2085888,35
4408,309,23,7,0.065507738,0.934492262,1342.798917,1428.673122,2408.867287,1647.624595,4717,384.4335778,9434,-2256896,158208,-2098688,35
4319,314,23,7,0.06777466,0.93222534,1317.242608,1381.285702,2372.181292,1557.993631,4633,246.9616205,9266,-2211328,160768,-2050560,35
4412,318,22,8,0.067230444,0.932769556,1345.409106,1410.277217,2420.69311,1599.738994,4730,208.8300221,9460,-2258944,162816,-2096128,35
4296,301,21,9,0.0654774853,0.934522515,1301.979466,1402.325957,2357.061918,1470.315615,4597,300.0652742,9194,-2199552,154112,-2045440,35
4374,329,20,10,0.0699553477,0.930044652,1338.008451,1408.601717,2406.406493,1628.674772,4703,342.2852984,9406,-2239488,168448,-2071040,35
4422,303,21,9,0.0641269841,0.935873016,1343.169897,1439.195442,2414.846676,1606.346535,4725,368.5647426,9450,-2264064,155136,-2108928,35
4354,305,21,9,0.065464692,0.934535308,1327.488244,1405.739547,2377.8096,1647.498361,4659,342.8256071,9318,-2229248,156160,-2073088,35
4325,310,20,10,0.0668824164,0.933117584,1315.421696,1432.681033,2370.450867,1586.225806,4635,292.7984839,9270,-2214400,158720,-2055680,35
4395,313,21,9,0.0664825828,0.933517417,1336.434618,1394.967811,2414.422298,1513.099042,4708,128.2484337,9416,-2250240,160256,-2089984,35
358,80,23,7,0.182648402,0.817351598,125.4882712,123.1744672,228.2765363,180.225,438,6.972301815,876,-183296,40960,-142336,35
3980,296,23,7,0.0692235734,0.930776427,1215.549832,1214.594287,2197.168342,1349.648649,4276,115.5675676,8552,-2037760,151552,-1886208,35
2092,217,21,9,0.093980078,0.906019922,658.1611573,567.1385361,1202.32935,698.718894,2309,381.0231023,4618,-1071104,111104,-960000,35
3948,277,21,9,0.0655621302,0.93443787,1203.196146,1203.884955,2165.818642,1360.191336,4225,114.3746616,8450,-2021376,141824,-1879552,35
4453,325,21,9,0.0680200921,0.931979908,1359.706796,1377.291771,2450.128228,1558.8,4778,124.6218049,9556,-2279936,166400,-2113536,35
3908,264,21,9,0.0632790029,0.936720997,1184.154025,1244.163702,2137.843654,1326.458333,4172,116.40625,8344,-2000896,135168,-1865728,35
4096,305,23,7,0.0693024313,0.930697569,1251.886756,1284.00148,2256.389893,1457.140984,4401,108.8278932,8802,-2097152,156160,-1940992,35
4465,327,21,9,0.0682387312,0.931761269,1358.507502,1464.243757,2455.602016,1589.495413,4792,136.1750497,9584,-2286080,167424,-2118656,35
4482,309,21,9,0.0644959299,0.93550407,1360.702428,1485.443298,2447.451138,1649.708738,4791,117.4840608,9582,-2294784,158208,-2136576,35
4422,327,21,9,0.0688566014,0.931143399,1349.627065,1416.718386,2432.778155,1593.669725,4749,133.2865563,9498,-2264064,167424,-2096640,35
4382,305,23,7,0.0650736079,0.934926392,1329.980716,1444.684521,2397.488361,1575.521311,4687,129.2608935,9374,-2243584,156160,-2087424,35
4053,311,22,8,0.0712648946,0.928735105,1240.232703,1339.612658,2230.950901,1551.080386,4364,96.08102158,8728,-2075136,159232,-1915904,35
3882,273,21,9,0.0657039711,0.934296029,1177.456657,1337.85832,2120.558733,1472.824176,4155,290.7627712,8310,-1987584,139776,-1847808,35
4063,308,21,9,0.0704644246,0.929535575,1243.762364,1251.498618,2243.642875,1425.600649,4371,76.87302146,8742,-2080256,157696,-1922560,35
4469,303,20,10,0.0634953898,0.93650461,1356.101281,1486.696451,2435.270307,1667.178218,4772,127.7301927,9544,-2288128,155136,-2132992,35
3877,268,23,7,0.0646562123,0.935343788,1179.215708,1220.235479,2122.073768,1363.078358,4145,106.2548065,8290,-1985024,137216,-1847808,35
4020,295,21,9,0.0683661645,0.931633835,1229.829246,1203.46136,2214.504726,1388.00339,4315,119.8944151,8630,-2058240,151040,-1907200,35
4060,315,20,10,0.072,0.928,1240.955155,1354.888389,2239.200493,1528.08254,4375,393.081761,8750,-2078720,161280,-1917440,35
4487,329,21,9,0.0683139535,0.931686047,1366.82703,1441.60912,2469.204591,1580.592705,4816,122.9198571,9632,-2297344,168448,-2128896,35
4461,293,21,9,0.0616323096,0.93836769,1352.907331,1463.960459,2424.573638,1660.791809,4754,124.1577435,9508,-2284032,150016,-2134016,35
4494,332,21,9,0.0687940323,0.931205968,1371.268989,1435.891019,2473.047619,1607.454819,4826,126.9331931,9652,-2300928,169984,-2130944,35
1682,202,18,12,0.107218684,0.892781316,537.5806104,477.1247364,982.5743163,608.8118812,1884,34.48654585,3768,-861184,103424,-757760,36
9528,449,18,12,0.0450035081,0.954996492,2852.167398,3223.945243,5041.515638,3874.592428,9977,1056.885593,19954,-4878336,229888,-4648448,36
3675,263,18,12,0.0667851701,0.93321483,1116.061764,1184.734934,2020.380136,1258.532319,3938,482.5980392,7876,-1881600,134656,-1746944,36
3666,218,18,12,0.0561277034,0.943872297,1107.330182,1215.503696,1974.142935,1410.376147,3884,297.1690895,7768,-1876992,111616,-1765376,36
3638,254,18,12,0.0652620761,0.934737924,1101.548262,1358.717496,1969.542881,1616.46063,3892,90.68033551,7784,-1862656,130048,-1732608,36
6382,347,18,12,0.0515678407,0.948432159,1929.12982,2024.127329,3406.958007,2593.311239,6729,495.5081001,13458,-3267584,177664,-3089920,36
9507,466,18,12,0.0467261606,0.953273839,2850.196506,3216.073304,5041.710003,3870.845494,9973,950.7149666,19946,-4867584,238592,-4628992,36
9451,519,18,12,0.0520561685,0.947943831,2855.229005,3136.780833,5034.236695,4098.003854,9970,952.2445081,19940,-4838912,265728,-4573184,36
500,109,18,12,0.178981938,0.821018062,180.7415711,130.3528474,320.092,235.7706422,609,20.70020394,1218,-256000,55808,-200192,36
9443,526,18,12,0.0527635671,0.947236433,2848.769974,3226.504984,5035.161813,4084.471483,9969,1195.323741,19938,-4834816,269312,-4565504,36
3690,243,18,12,0.061784897,0.938215103,1119.995969,1227.353101,2002.446612,1428.736626,3933,487.9652605,7866,-1889280,124416,-1764864,36
6756,337,18,12,0.0475116312,0.952488369,2035.341626,2142.534937,3584.810687,2788.991098,7093,725.9979529,14186,-3459072,172544,-3286528,36
9450,520,18,12,0.0521564694,0.947843531,2849.925286,3216.912993,5035.377354,4079.075,9970,719.3362193,19940,-4838400,266240,-4572160,36
3713,245,18,12,0.0618999495,0.938100051,1120.457374,1244.063463,2025.425263,1283.497959,3958,333.4456613,7916,-1901056,125440,-1775616,36
9423,544,18,12,0.0545801144,0.945419886,2852.956363,3086.635966,5044.455694,3936.805147,9967,1034.994808,19934,-4824576,278528,-4546048,36
3657,212,18,12,0.0547945205,0.945205479,1101.439526,1256.10405,1963.773311,1438.660377,3869,265.5456417,7738,-1872384,108544,-1763840,36
3677,236,18,12,0.0603117812,0.939688219,1113.305611,1275.365679,1986.070982,1504.059322,3913,384.0039254,7826,-1882624,120832,-1761792,36
9451,521,18,12,0.0522462896,0.94775371,2844.807874,3299.607201,5037.832187,4055.328215,9972,1508.623298,19944,-4838912,266752,-4572160,36
3694,228,18,12,0.0581336053,0.941866395,1116.216924,1228.315076,1997.176232,1383.482456,3922,323.8645747,7844,-1891328,116736,-1774592,36
2178,191,18,12,0.0806247362,0.919375264,668.6595202,716.3583917,1221.567493,768.0157068,2369,29.25052476,4738,-1115136,97792,-1017344,36
2008,273,21,9,0.119684349,0.880315651,635.8344756,783.9135174,1117.296315,1315.347985,2281,56.26541687,4562,-1028096,139776,-888320,36
2255,272,21,9,0.107637515,0.892362485,712.8355028,846.7884641,1250.449224,1376.341912,2527,71.32373695,5054,-1154560,139264,-1015296,36
1929,239,21,9,0.110239852,0.889760148,602.3403006,759.8317187,1059.0648,1289.790795,2168,52.44315433,4336,-987648,122368,-865280,36
1977,272,21,9,0.120942641,0.879057359,622.4849518,788.1775459,1096.88872,1329.323529,2249,59.26218709,4498,-1012224,139264,-872960,36
1939,284,21,9,0.127755286,0.872244714,612.8822359,776.2176947,1079.52656,1333.711268,2223,61.10500275,4446,-992768,145408,-847360,36
2011,293,21,9,0.127170139,0.872829861,637.4333212,768.9548803,1109.783192,1445.686007,2304,56.12667479,4608,-1029632,150016,-879616,36
2078,329,21,9,0.13668467,0.86331533,662.3326248,813.7160057,1157.635707,1496.841945,2407,62.13216314,4814,-1063936,168448,-895488,36
238,48,21,9,0.167832168,0.832167832,83.50935806,60.75268627,152.407563,99.33333333,286,17.41778319,572,-121856,24576,-97280,36
1977,291,21,9,0.128306878,0.871693122,622.0720809,789.8250526,1093.736975,1411.436426,2268,39.86640886,4536,-1012224,148992,-863232,36
1952,277,21,9,0.124270974,0.875729026,617.6391612,769.3587354,1084.845799,1327.494585,2229,63.84989974,4458,-999424,141824,-857600,36
1955,252,21,9,0.114182148,0.885817852,616.8387007,753.6027498,1081.255754,1280.448413,2207,57.63907025,4414,-1000960,129024,-871936,36
1968,253,21,9,0.113912652,0.886087348,619.9317467,736.3736038,1077.433435,1372.102767,2221,60.320478,4442,-1007616,129536,-878080,36
2073,280,21,9,0.118997025,0.881002975,662.0587303,784.1253609,1160.337192,1300.364286,2353,60.39527721,4706,-1061376,143360,-918016,36
1956,267,21,9,0.120107962,0.879892038,618.4765694,767.3932349,1087.189162,1293.7603,2223,63.62335432,4446,-1001472,136704,-864768,36
1967,278,21,9,0.123830735,0.876169265,624.1214521,760.7419873,1091.444331,1346.273381,2245,60.30083266,4490,-1007104,142336,-864768,36
89,47,20,10,0.345588235,0.654411765,38.5566083,38.58709936,63.16853933,78.59574468,136,2.649006623,272,-45568,24064,-21504,36
1979,270,21,9,0.120053357,0.879946643,623.6258113,782.5195404,1096.948459,1330.607407,2249,64.45973058,4498,-1013248,138240,-875008,36
1948,273,21,9,0.122917605,0.877082395,616.6025429,775.7599629,1088.438398,1271.989011,2221,44.06746032,4442,-997376,139776,-857600,36
1948,270,21,9,0.121731289,0.878268711,613.0323721,763.1072236,1074.159138,1364.477778,2218,62.69078575,4436,-997376,138240,-859136,36
1989,263,21,9,0.11678508,0.88321492,625.5942157,778.3693737,1097.849673,1343.174905,2252,60.19780807,4504,-1018368,134656,-883712,36
2846,307,18,12,0.0973675864,0.902632414,874.1598153,1164.180318,1550.045327,1826.879479,3153,82.82111899,6306,-1457152,157184,-1299968,36
2991,332,18,12,0.0999097201,0.90009028,924.3142194,1217.721984,1643.615513,1827.626506,3323,89.42411195,6646,-1531392,169984,-1361408,36
2958,327,18,12,0.099543379,0.900456621,911.8543093,1214.564751,1622.733604,1826.327217,3285,91.17402165,6570,-1514496,167424,-1347072,36
2900,320,18,12,0.099378882,0.900621118,890.730975,1192.591558,1580.53931,1882.01875,3220,87.42872658,6440,-1484800,163840,-1320960,36
2853,296,18,12,0.0939980946,0.906001905,874.5350653,1153.265615,1545.461619,1859.706081,3149,84.37834941,6298,-1460736,151552,-1309184,36
2877,304,18,12,0.0955674316,0.904432568,883.0330527,1158.372934,1558.87626,1895.013158,3181,76.37454982,6362,-1473024,155648,-1317376,36
2844,322,18,12,0.101705622,0.898294378,873.8394655,1193.928935,1561.218706,1780.295031,3166,83.53562005,6332,-1456128,164864,-1291264,36
2864,324,18,12,0.101631117,0.898368883,880.8807282,1172.125182,1560.486732,1895.160494,3188,86.91384951,6376,-1466368,165888,-1300480,36
2862,328,18,12,0.102821317,0.897178683,881.4086636,1195.423283,1573.898672,1783.984756,3190,85.72964257,6380,-1465344,167936,-1297408,36
2867,318,18,12,0.0998430141,0.900156986,881.1361072,1185.098433,1566.683293,1830.264151,3185,86.80839466,6370,-1467904,162816,-1305088,36
2921,326,18,12,0.10040037,0.89959963,901.211026,1199.962991,1604.582335,1797.984663,3247,81.09390609,6494,-1495552,166912,-1328640,36
2874,307,18,12,0.0965105313,0.903489469,883.8782207,1154.349969,1560.367084,1877.771987,3181,76.61368015,6362,-1471488,157184,-1314304,36
2849,310,18,12,0.0981323204,0.90186768,876.6183722,1145.85,1547.491049,1878.767742,3159,87.65260821,6318,-1458688,158720,-1299968,36
2884,313,18,12,0.0979042853,0.902095715,884.8693364,1193.13891,1573.430652,1834.597444,3197,83.49438496,6394,-1476608,160256,-1316352,36
2973,321,18,12,0.0974499089,0.902550091,917.0994509,1216.979635,1638.401615,1731.766355,3294,92.97205758,6588,-1522176,164352,-1357824,36
3164,316,18,12,0.0908045977,0.909195402,977.9610045,1227.482989,1723.712389,1908.588608,3480,92.01480698,6960,-1619968,161792,-1458176,36
2862,289,18,12,0.0917169153,0.908283085,879.7571785,1131.255406,1549.337526,1840.041522,3151,76.74135412,6302,-1465344,147968,-1317376,36
2856,316,18,12,0.0996216898,0.90037831,878.3644858,1174.519979,1559.943978,1826.512658,3172,83.16727845,6344,-1462272,161792,-1300480,36
2868,304,18,12,0.0958385876,0.904161412,880.1540213,1146.91364,1550.879358,1922.552632,3172,81.94265048,6344,-1468416,155648,-1312768,36
2958,291,18,12,0.0895660203,0.91043398,908.3007614,1164.338066,1598.52265,1894.140893,3249,90.09983361,6498,-1514496,148992,-1365504,36
2119,295,18,12,0.122203811,0.877796189,666.9773555,858.5580789,1181.006607,1397.80339,2414,65.31385281,4828,-1084928,151040,-933888,36
2143,290,18,12,0.11919441,0.88080559,672.7211,863.572855,1189.011666,1423.824138,2433,59.91135188,4866,-1097216,148480,-948736,36
2203,289,18,12,0.115971108,0.884028892,699.4377027,851.1470965,1234.981843,1334.301038,2492,47.20591021,4984,-1127936,147968,-979968,36
2126,296,18,12,0.122213047,0.877786953,669.1870197,853.9828544,1181.119944,1429.702703,2422,63.90501319,4844,-1088512,151552,-936960,36
2108,300,18,12,0.124584718,0.875415282,662.6018106,863.4808348,1175.347723,1409.343333,2408,61.60143259,4816,-1079296,153600,-925696,36
2131,283,18,12,0.117232809,0.882767191,667.5173683,858.9164905,1179.779446,1416.236749,2414,62.79916753,4828,-1091072,144896,-946176,36
2128,280,18,12,0.11627907,0.88372093,667.873343,837.6268539,1173.225094,1442.189286,2408,61.53846154,4816,-1089536,143360,-946176,36
2197,304,18,12,0.121551379,0.878448621,694.5629926,881.6139934,1230.639964,1398.141447,2501,63.26840374,5002,-1124864,155648,-969216,36
2119,299,18,12,0.123655914,0.876344086,665.5408126,869.0635935,1181.236432,1409.802676,2418,63.41463415,4836,-1084928,153088,-931840,36
2116,281,18,12,0.117229871,0.882770129,666.9279153,835.6399704,1175.131853,1378.733096,2397,47.38090532,4794,-1083392,143872,-939520,36
2134,300,18,12,0.123253903,0.876746097,668.0253262,863.4854061,1179.002343,1491.346667,2434,42.45595674,4868,-1092608,153600,-939008,36
2121,289,18,12,0.119917012,0.880082988,667.7669073,840.7622115,1175.058463,1428.913495,2410,67.75372505,4820,-1085952,147968,-937984,36
2119,291,18,12,0.120746888,0.879253112,664.9196057,863.1255623,1178.470977,1402.319588,2410,62.16146505,4820,-1084928,148992,-935936,36
2090,299,18,12,0.125156969,0.874843031,661.3553218,844.9744131,1172.3,1353.672241,2389,53.17160027,4778,-1070080,153088,-916992,36
2116,293,18,12,0.121627231,0.878372769,664.2829872,865.6308541,1179.036862,1392.501706,2409,63.52848101,4818,-1083392,150016,-933376,36
2192,294,18,12,0.118262269,0.881737731,687.688442,894.6369567,1222.224909,1402.122449,2486,59.14822746,4972,-1122304,150528,-971776,36
1646,216,18,12,0.116004296,0.883995704,510.902011,696.1356397,915.4513973,1053.796296,1862,45.50342131,3724,-842752,110592,-732160,36
2231,283,18,12,0.11256961,0.88743039,701.036636,880.4787375,1237.088749,1418.409894,2514,55.36225501,5028,-1142272,144896,-997376,36
2233,281,18,12,0.111774065,0.888225935,705.4878293,861.3952767,1243.026422,1372.516014,2514,64.86068111,5028,-1143296,143872,-999424,36
2214,273,18,12,0.109770808,0.890229192,696.9517401,837.0023649,1216.559169,1466.542125,2487,62.75548827,4974,-1133568,139776,-993792,36
2875,311,18,12,0.0976145637,0.902385436,884.8531224,1160.785741,1564.418087,1862.344051,3186,78.35710772,6372,-1472000,159232,-1312768,36
2864,325,18,12,0.101912825,0.898087175,879.6813618,1203.727306,1571.578911,1801.393846,3189,84.70119522,6378,-1466368,166400,-1299968,36
3116,324,18,12,0.0941860465,0.905813953,966.1639128,1221.672322,1719.50353,1730.083333,3440,87.6656473,6880,-1595392,165888,-1429504,36
2848,299,18,12,0.0950111217,0.904988878,879.1677451,1117.038381,1546.411517,1836.782609,3147,87.44095582,6294,-1458176,153088,-1305088,36
2957,291,18,12,0.0895935961,0.910406404,914.9816409,1115.064542,1601.144403,1861.828179,3248,71.84251272,6496,-1513984,148992,-1364992,36
2840,303,18,12,0.0964047089,0.903595291,869.1107283,1183.863472,1547.653521,1800.19802,3143,77.35663303,6286,-1454080,155136,-1298944,36
2569,256,18,12,0.090619469,0.909380531,804.5816171,861.5881558,1443.101985,1110.921875,2825,49.55271005,5650,-1315328,131072,-1184256,36
2863,331,18,12,0.10363181,0.89636819,880.0878977,1205.733958,1573.002794,1809.389728,3194,87.24392243,6388,-1465856,169472,-1296384,36
2852,292,18,12,0.0928753181,0.907124682,874.4160886,1136.628333,1540.264376,1887.349315,3144,79.39393939,6288,-1460224,149504,-1310720,36
2883,300,18,12,0.0942507069,0.905749293,890.2882505,1115.157388,1561.103018,1888.92,3183,82.33316089,6366,-1476096,153600,-1322496,36
2283,214,18,12,0.0857028434,0.914297157,690.7060674,986.0283006,1246.419185,1276.53271,2497,43.77629734,4994,-1168896,109568,-1059328,36
2860,332,18,12,0.104010025,0.895989975,881.4417436,1199.41202,1576.885664,1765.466867,3192,66.18287373,6384,-1464320,169984,-1294336,36
2881,299,18,12,0.0940251572,0.905974843,884.9494666,1147.135962,1559.151336,1892.558528,3180,80.36391205,6360,-1475072,153088,-1321984,36
2978,318,18,12,0.0964805825,0.903519417,917.6033884,1186.583612,1618.022498,1933.915094,3296,85.99008609,6592,-1524736,162816,-1361920,36
2862,321,18,12,0.100848256,0.899151744,885.3598855,1157.38518,1569.81202,1789.825545,3183,66.60389203,6366,-1465344,164352,-1300992,36
2883,311,18,12,0.0973700689,0.902629931,887.5376135,1171.690337,1573.278529,1822.03537,3194,80.71771544,6388,-1476096,159232,-1316864,36
2877,340,18,12,0.10568853,0.89431147,887.6688788,1197.150581,1581.765381,1839.452941,3217,82.46603435,6434,-1473024,174080,-1298944,36
2875,319,18,12,0.0998747652,0.900125235,883.432904,1200.211551,1577.07513,1781.579937,3194,84.81147106,6388,-1472000,163328,-1308672,36
2970,341,18,12,0.102990033,0.897009967,916.3620324,1215.40549,1625.343771,1923.005865,3311,75.95778848,6622,-1520640,174592,-1346048,36
1760,158,18,12,0.0823774765,0.917622523,532.3811895,749.9842246,963.0875,919.5379747,1918,24.28770419,3836,-901120,80896,-820224,36
3923,392,18,12,0.0908458864,0.909154114,1224.314864,1417.960661,2182.83482,1909.461735,4315,101.8409252,8630,-2008576,200704,-1807872,36
3911,388,18,12,0.0902535473,0.909746453,1221.468085,1408.028138,2169.563027,1952.806701,4299,112.5098142,8598,-2002432,198656,-1803776,36
3976,390,18,12,0.0893266148,0.910673385,1240.44658,1424.353018,2207.783702,1935.930769,4366,116.488794,8732,-2035712,199680,-1836032,36
3844,381,18,12,0.0901775148,0.909822485,1195.783495,1420.806577,2134.254683,1898.55643,4225,108.5560123,8450,-1968128,195072,-1773056,36
3875,391,18,12,0.0916549461,0.908345054,1212.061773,1385.591374,2158.418839,1886.542199,4266,113.2466153,8532,-1984000,200192,-1783808,36
4303,395,18,12,0.0840783312,0.915921669,1344.568197,1404.64933,2389.598187,1912.683544,4698,126.8016194,9396,-2203136,202240,-2000896,36
3936,386,18,12,0.0893105044,0.910689496,1229.849668,1386.318301,2188.712398,1884.018135,4322,103.8942308,8644,-2015232,197632,-1817600,36
3865,371,18,12,0.0875826251,0.912417375,1205.884935,1377.980966,2133.044502,1966.978437,4236,106.3787042,8472,-1978880,189952,-1788928,36
3853,392,18,12,0.092343934,0.907656066,1208.940024,1349.655282,2149.467947,1862.844388,4245,98.4233712,8490,-1972736,200704,-1772032,36
3830,370,18,12,0.0880952381,0.911904762,1196.467524,1336.162668,2127.051697,1825.654054,4200,107.9969144,8400,-1960960,189440,-1771520,36
3890,388,18,12,0.0906965872,0.909303413,1216.580603,1393.251231,2157.421594,1959.822165,4278,112.0188531,8556,-1991680,198656,-1793024,36
3896,391,18,12,0.0912059715,0.908794028,1220.553812,1369.012139,2169.960986,1885.319693,4287,112.4311566,8574,-1994752,200192,-1794560,36
4009,391,18,12,0.0888636364,0.911136364,1253.576791,1403.812504,2225.485907,1944.314578,4400,117.5527652,8800,-2052608,200192,-1852416,36
3888,368,18,12,0.0864661654,0.913533835,1214.571541,1345.860278,2150.708848,1893.858696,4256,114.1324752,8512,-1990656,188416,-1802240,36
3909,386,18,12,0.0898719441,0.910128056,1221.51176,1400.277612,2165.323868,1972.562176,4295,102.9482263,8590,-2001408,197632,-1803776,36
3381,301,18,12,0.0817490494,0.918250951,1042.947783,1180.004596,1880.532978,1403.059801,3682,82.27932961,7364,-1731072,154112,-1576960,36
3868,387,18,12,0.0909518214,0.909048179,1210.526662,1360.889034,2156.662616,1841.521964,4255,109.2426187,8510,-1980416,198144,-1782272,36
3851,381,18,12,0.0900283554,0.909971645,1206.05154,1340.607277,2142.957154,1849.081365,4232,108.7917738,8464,-1971712,195072,-1776640,36
4050,394,18,12,0.0886588659,0.911341134,1256.634285,1514.809674,2240.128642,2041.291878,4444,114.5656097,8888,-2073600,201728,-1871872,36
3837,389,18,12,0.0920492191,0.907950781,1198.822704,1376.878834,2143.478759,1817.796915,4226,108.6934156,8452,-1964544,199168,-1765376,36
4082,420,18,12,0.0932918703,0.90670813,1268.407281,1570.949275,2250.925527,2257.083333,4502,79.66731552,9004,-2089984,215040,-1874944,36
4034,431,18,12,0.0965285554,0.903471445,1257.239621,1554.157372,2236.62469,2199.074246,4465,108.7168249,8930,-2065408,220672,-1844736,36
4003,404,18,12,0.0916723395,0.908327661,1243.850724,1524.744895,2205.192106,2192.188119,4407,98.65681666,8814,-2049536,206848,-1842688,36
4027,405,18,12,0.0913808664,0.908619134,1245.191765,1579.108631,2211.980382,2261.439506,4432,77.91842475,8864,-2061824,207360,-1854464,36
4063,427,18,12,0.0951002227,0.904899777,1267.276476,1542.579245,2238.602018,2311.135831,4490,80.35075161,8980,-2080256,218624,-1861632,36
4004,423,18,12,0.0955500339,0.904449966,1247.557413,1536.095574,2216.29046,2192.319149,4427,105.8837599,8854,-2050048,216576,-1833472,36
4103,415,18,12,0.091854803,0.908145197,1274.294589,1569.775303,2258.578357,2268.612048,4518,108.0344333,9036,-2100736,212480,-1888256,36
4018,421,18,12,0.0948411804,0.90515882,1253.40828,1522.963284,2217.711548,2241.840855,4439,78.42756184,8878,-2057216,215552,-1841664,36
4068,408,18,12,0.091152815,0.908847185,1261.595053,1563.106745,2233.081367,2292.526961,4476,80.01430104,8952,-2082816,208896,-1873920,36
4099,433,18,12,0.0955428067,0.904457193,1277.391928,1568.190186,2257.339595,2353.21709,4532,80.88524005,9064,-2098688,221696,-1876992,36
3954,387,18,12,0.0891499654,0.910850035,1227.451076,1485.306702,2182.537936,2053.116279,4341,109.6489012,8682,-2024448,198144,-1826304,36
4125,450,18,12,0.0983606557,0.901639344,1289.179161,1580.409771,2289.941818,2270.2,4575,84.56561922,9150,-2112000,230400,-1881600,36
4047,423,18,12,0.0946308725,0.905369128,1260.141841,1549.568345,2231.369904,2275.014184,4470,104.5614035,8940,-2072064,216576,-1855488,36
4018,405,18,12,0.0915668099,0.90843319,1249.165834,1523.879209,2209.272524,2239.059259,4423,107.7204092,8846,-2057216,207360,-1849856,36
4029,429,18,12,0.0962314939,0.903768506,1255.675933,1549.781924,2227.898982,2244.536131,4458,77.77390091,8916,-2062848,219648,-1843200,36
4128,427,18,12,0.0937431394,0.906256861,1284.150095,1581.158629,2273.647529,2320.077283,4555,108.5299023,9110,-2113536,218624,-1894912,36
4160,460,18,12,0.0995670996,0.9004329,1300.057929,1605.640504,2306.556971,2346.158696,4620,81.6542948,9240,-2129920,235520,-1894400,36
4106,438,18,12,0.0963908451,0.903609155,1280.769715,1572.363602,2269.279591,2302.689498,4544,115.0962513,9088,-2102272,224256,-1878016,36
4165,426,18,12,0.0927902418,0.907209758,1296.810582,1576.922311,2294.268908,2312.924883,4591,98.41371919,9182,-2132480,218112,-1914368,36
4093,457,18,12,0.10043956,0.89956044,1279.883481,1582.64151,2278.095529,2252.253829,4550,80.07743752,9100,-2095616,233984,-1861632,36
6468,459,21,9,0.0662624513,0.933737549,1960.973503,2432.969646,3430.546537,3935.409586,6927,208.1430288,13854,-3311616,235008,-3076608,36
6512,471,21,9,0.0674495203,0.93255048,1977.370014,2432.306368,3455.698403,3993.902335,6983,214.9938424,13966,-3334144,241152,-3092992,36
6424,437,21,9,0.0636933392,0.936306661,1947.323947,2402.963496,3413.590442,3686.924485,6861,243.7300178,13722,-3289088,223744,-3065344,36
8217,570,21,9,0.0648685558,0.935131444,2509.498217,2832.288394,4352.482901,4992.501754,8787,325.5650241,17574,-4207104,291840,-3915264,36
8296,569,21,9,0.0641849972,0.935815003,2531.308476,2890.568588,4399.387536,4923.068541,8865,317.1735242,17730,-4247552,291328,-3956224,36
8223,567,21,9,0.0645051195,0.935494881,2506.442781,2915.44503,4365.131217,4835.92769,8790,291.2524851,17580,-4210176,290304,-3919872,36
3593,203,21,9,0.0534773446,0.946522655,1081.111857,1191.02864,1930.954356,1324.073892,3796,67.42451155,7592,-1839616,103936,-1735680,36
6426,435,21,9,0.0634018365,0.936598164,1946.724276,2399.727883,3407.431528,3779.163218,6861,209.7523693,13722,-3290112,222720,-3067392,36
6422,442,21,9,0.0643939394,0.935606061,1941.763755,2468.176252,3411.719402,3734.429864,6864,238.1679389,13728,-3288064,226304,-3061760,36
6491,442,21,9,0.0637530651,0.936246935,1972.229131,2385.979717,3459.203513,3581.495475,6933,235.8965635,13866,-3323392,226304,-3097088,36
6434,421,21,9,0.0614150255,0.938584974,1946.146377,2403.206463,3407.624029,3739.39905,6855,208.168843,13710,-3294208,215552,-3078656,36
6488,443,21,9,0.0639157409,0.936084259,1961.382054,2465.651287,3435.612361,3911.045147,6931,208.075653,13862,-3321856,226816,-3095040,36
6471,439,21,9,0.0635311143,0.936468886,1959.863723,2420.166611,3429.643486,3836.633257,6910,244.8618001,13820,-3313152,224768,-3088384,36
6431,430,21,9,0.0626730797,0.93732692,1945.052715,2391.40628,3396.080236,3953.253488,6861,239.6437304,13722,-3292672,220160,-3072512,36
6503,463,21,9,0.0664656905,0.93353431,1971.529395,2466.134564,3455.578656,3875.665227,6966,235.3378378,13932,-3329536,237056,-3092480,36
6511,444,21,9,0.0638389648,0.936161035,1969.678683,2460.812706,3448.854861,3905.396396,6955,244.7220267,13910,-3333632,227328,-3106304,36
6472,452,21,9,0.0652801849,0.934719815,1965.986868,2412.538764,3449.5394,3648.077434,6924,147.2251754,13848,-3313664,231424,-3082240,36
8336,582,21,9,0.0652612693,0.934738731,2545.179755,2939.254075,4435.035149,4809.910653,8918,247.172949,17836,-4268032,297984,-3970048,36
5258,273,21,9,0.0493581631,0.950641837,1578.992642,1759.71241,2802.974705,2053.864469,5531,80.65033537,11062,-2692096,139776,-2552320,36
5267,265,21,9,0.0479031092,0.952096891,1576.557796,1800.867679,2804.318398,2014.841509,5532,84.62597522,11064,-2696704,135680,-2561024,36
2392,270,21,9,0.101427498,0.898572502,750.1271052,914.8961242,1332.130853,1325.911111,2662,69.6311797,5324,-1224704,138240,-1086464,36
2386,294,21,9,0.109701493,0.890298507,751.6983419,931.6225588,1346.133277,1294.782313,2680,70.3043022,5360,-1221632,150528,-1071104,36
2380,307,21,9,0.114253815,0.885746185,752.8266343,931.218681,1352.737815,1276.260586,2687,70.06518905,5374,-1218560,157184,-1061376,36
2482,297,21,9,0.106872976,0.893127024,780.3085024,961.6439281,1400.548348,1301.848485,2779,75.57791678,5558,-1270784,152064,-1118720,36
2401,305,21,9,0.112712491,0.887287509,756.4433747,951.7975591,1360.473553,1298.603279,2706,75.8195573,5412,-1229312,156160,-1073152,36
2621,300,21,9,0.102704553,0.897295447,823.698737,996.4545666,1466.303701,1414.663333,2921,74.80153649,5842,-1341952,153600,-1188352,36
2436,320,21,9,0.116110305,0.883889695,771.2583316,960.2501904,1374.43514,1409.44375,2756,62.73617118,5512,-1247232,163840,-1083392,36
2126,196,21,9,0.0844099914,0.915590009,654.6886244,797.6203337,1178.58937,976.1326531,2322,41.90579318,4644,-1088512,100352,-988160,36
2408,309,21,9,0.113728377,0.886271623,761.2261244,940.4781559,1370.428156,1269.941748,2717,75.28401219,5434,-1232896,158208,-1074688,36
2450,317,21,9,0.11456451,0.88543549,777.6576484,946.0270145,1382.231837,1397.665615,2767,66.62653503,5534,-1254400,162304,-1092096,36
2418,297,21,9,0.109392265,0.890607735,764.1292997,927.7159871,1361.492556,1329.565657,2715,74.669967,5430,-1238016,152064,-1085952,36
2408,303,21,9,0.111766876,0.888233124,762.3289701,925.43022,1364.302741,1290.016502,2711,73.96998636,5422,-1232896,155136,-1077760,36
2402,286,21,9,0.10639881,0.89360119,755.3166466,930.9817361,1347.78851,1316.881119,2688,72.88503254,5376,-1229824,146432,-1083392,36
2400,300,21,9,0.111111111,0.888888889,759.1112398,925.8939734,1352.250417,1336.496667,2700,54.61165049,5400,-1228800,153600,-1075200,36
2420,296,21,9,0.1089838,0.8910162,763.6782954,932.4411778,1352.234298,1409.726351,2716,72.8150134,5432,-1239040,151552,-1087488,36
2383,286,21,9,0.107156238,0.892843762,750.3709481,921.0638988,1334.570709,1338.576923,2669,69.30667359,5338,-1220096,146432,-1073664,36
2516,306,21,9,0.108433735,0.891566265,795.751881,953.4721397,1419.326312,1347.150327,2822,70.32145527,5644,-1288192,156672,-1131520,36
2519,301,21,9,0.106737589,0.893262411,795.6434098,951.2113134,1419.279476,1337.026578,2820,67.90272092,5640,-1289728,154112,-1135616,36
2449,282,21,9,0.10325888,0.89674112,765.112986,949.7629927,1346.111882,1538.716312,2731,50.54599297,5462,-1253888,144384,-1109504,36
2470,259,21,9,0.0949065592,0.905093441,770.7278314,917.7578401,1347.153846,1535.19305,2729,68.37885242,5458,-1264640,132608,-1132032,36
2865,302,18,12,0.0953583833,0.904641617,880.324746,1138.621356,1549.756719,1908.857616,3167,81.77123677,6334,-1466880,154624,-1312256,36
2841,294,18,12,0.0937799043,0.906220096,873.330444,1147.805962,1546.934882,1771.557823,3135,77.17872969,6270,-1454592,150528,-1304064,36
2857,298,18,12,0.0944532488,0.905546751,882.2706884,1123.650977,1554.339517,1804.838926,3155,78.63908275,6310,-1462784,152576,-1310208,36
2885,287,18,12,0.0904791929,0.909520807,884.2711493,1136.33736,1554.263432,1910.550523,3172,81.98500905,6344,-1477120,146944,-1330176,36
2843,301,18,12,0.0957379135,0.904262087,873.7062059,1128.731814,1537.645093,1901.710963,3144,68.97762176,6288,-1455616,154112,-1301504,36
2865,303,18,12,0.0956439394,0.904356061,879.4734348,1138.793181,1547.677487,1932.673267,3168,78.10650888,6336,-1466880,155136,-1311744,36
2957,333,18,12,0.101215805,0.898784195,913.9323834,1217.240099,1633.354751,1753.348348,3290,83.31223094,6580,-1513984,170496,-1343488,36
2915,297,18,12,0.0924657534,0.907534247,899.0299058,1122.465849,1575.020583,1915.464646,3212,85.10863805,6424,-1492480,152064,-1340416,36
2905,320,18,12,0.0992248062,0.900775194,894.9872666,1192.101021,1591.524269,1807.959375,3225,78.20077595,6450,-1487360,163840,-1323520,36
3002,294,18,12,0.0891990291,0.910800971,922.2492919,1182.442464,1624.442372,1894.14966,3296,85.61038961,6592,-1537024,150528,-1386496,36
2864,328,18,12,0.102756892,0.897243108,880.0000885,1160.327796,1553.828911,1969.091463,3192,56.18729097,6384,-1466368,167936,-1298432,36
2932,306,18,12,0.0945027795,0.905497221,906.7972181,1153.688269,1600.762619,1799.035948,3238,84.08205661,6476,-1501184,156672,-1344512,36
2868,318,18,12,0.0998116761,0.900188324,882.7726026,1194.29294,1578.562064,1728.22327,3186,82.58164852,6372,-1468416,162816,-1305600,36
3022,309,18,12,0.0927649355,0.907235065,930.3477838,1183.155026,1634.803772,1971.097087,3331,87.98203909,6662,-1547264,158208,-1389056,36
2964,300,18,12,0.0919117647,0.908088235,916.9508309,1143.100108,1611.908232,1835.946667,3264,89.10728911,6528,-1517568,153600,-1363968,36
2944,326,18,12,0.0996941896,0.90030581,910.9127919,1194.714339,1621.629076,1760.763804,3270,88.16392559,6540,-1507328,166912,-1340416,36
2853,316,18,12,0.0997159987,0.900284001,875.5363837,1189.129989,1559.756397,1812.911392,3169,78.87008462,6338,-1460736,161792,-1298944,36
2878,333,18,12,0.103706011,0.896293989,886.9432285,1192.349051,1578.187283,1846.375375,3211,84.94708995,6422,-1473536,170496,-1303040,36
2871,317,18,12,0.0994353827,0.900564617,882.6226629,1209.014867,1592.437478,1613.179811,3188,60.64295225,6376,-1469952,162304,-1307648,36
2281,169,18,12,0.0689795918,0.931020408,692.198957,839.1412573,1245.772907,951.8757396,2450,30.41966725,4900,-1167872,86528,-1081344,36
4638,731,19,11,0.136151984,0.863848016,1507.468869,1639.729616,2577.70332,3365.76881,5369,112.557652,10738,-2374656,374272,-2000384,37
2278,231,18,12,0.0920685532,0.907931447,706.4533828,881.0085874,1254.617208,1258.774892,2509,204.9836601,5018,-1166336,118272,-1048064,37
3043,307,18,12,0.091641791,0.908358209,941.3033643,1188.5501,1665.98324,1769.830619,3350,285.106383,6700,-1558016,157184,-1400832,37
2278,227,18,12,0.0906187625,0.909381238,704.5576888,888.0337734,1254.948639,1233.444934,2505,195.703125,5010,-1166336,116224,-1050112,37
2524,240,18,12,0.0868306802,0.91316932,779.866009,966.1801306,1386.894612,1336.283333,2764,118.7285223,5528,-1292288,122880,-1169408,37
45,25,19,11,0.357142857,0.642857143,21.10027792,18.45400769,35.97777778,34.64,70,12.21640489,140,-23040,12800,-10240,37
2335,231,19,11,0.0900233827,0.909976617,722.8166608,902.049416,1284.71349,1271.233766,2566,193.0775019,5132,-1195520,118272,-1077248,37
3005,293,18,12,0.0888417223,0.911158278,931.9016855,1135.462044,1642.03228,1726.088737,3298,158.7867116,6596,-1538560,150016,-1388544,37
2866,286,18,12,0.0907360406,0.909263959,884.4858978,1125.439653,1563.603978,1705.730769,3152,219.4986072,6304,-1467392,146432,-1320960,37
46,24,18,12,0.342857143,0.657142857,21.15546916,18.09883168,36.47826087,33.625,70,10.63829787,140,-23552,12288,-11264,37
3017,318,18,12,0.0953523238,0.904647676,939.7505004,1151.491779,1655.431223,1787.245283,3335,204.601227,6670,-1544704,162816,-1381888,37
3103,355,18,12,0.102660497,0.897339503,979.7057018,1146.48218,1724.111827,1776.597183,3458,233.3333333,6916,-1588736,181760,-1406976,37
2303,226,18,12,0.0893633847,0.910636615,715.0543322,861.4222932,1275.217108,1160.884956,2529,181.8116463,5058,-1179136,115712,-1063424,37
2313,234,19,11,0.0918727915,0.908127208,716.6432798,898.2624557,1276.790748,1246.41453,2547,205.9013743,5094,-1184256,119808,-1064448,37
49,27,18,12,0.355263158,0.644736842,22.85010825,20.04624284,39.51020408,36.66666667,76,7.183364839,152,-25088,13824,-11264,37
2943,304,18,12,0.0936248845,0.906375115,914.3402709,1135.550775,1620.614339,1656.776316,3247,239.4542773,6494,-1506816,155648,-1351168,37
738,91,18,12,0.109770808,0.890229192,231.6540173,236.7565114,435.3062331,250.3186813,829,21.70725321,1658,-377856,46592,-331264,37
2812,258,18,12,0.0840390879,0.915960912,872.4949985,1010.4712,1550.111664,1376.244186,3070,53.91640323,6140,-1439744,132096,-1307648,37
976,148,18,12,0.131672598,0.868327402,307.9440013,417.3784886,562.670082,561.3783784,1124,16.81124738,2248,-499712,75776,-423936,37
2258,232,18,12,0.0931726908,0.906827309,701.7865888,865.0560735,1251.369353,1188.375,2490,165.6686627,4980,-1156096,118784,-1037312,37
2556,151,23,7,0.0557813077,0.944218692,773.557892,899.6240594,1348.586072,1445.642384,2707,49.12885662,5414,-1308672,77312,-1231360,37
3233,332,21,9,0.0931276297,0.90687237,998.2984807,1123.899993,1720.796474,2388.73494,3565,191.6666667,7130,-1655296,169984,-1485312,37
2979,171,23,7,0.0542857143,0.945714286,907.0355882,944.0629938,1570.471299,1663.105263,3150,356.3348416,6300,-1525248,87552,-1437696,37
2977,173,23,7,0.0549206349,0.945079365,905.6204972,968.8195871,1571.921397,1637.080925,3150,301.1472275,6300,-1524224,88576,-1435648,37
2565,146,22,8,0.0538546662,0.946145334,777.0629495,874.014992,1356.838986,1341.260274,2711,382.3695346,5422,-1313280,74752,-1238528,37
3004,175,23,7,0.0550487575,0.944951243,913.5167208,985.1587919,1586.860519,1643.891429,3179,321.7611336,6358,-1538048,89600,-1448448,37
2582,146,23,7,0.0535190616,0.946480938,786.5546241,803.5135686,1362.754454,1395.369863,2728,310,5456,-1321984,74752,-1247232,37
3228,328,21,9,0.0922384702,0.90776153,995.173655,1124.882867,1716.340149,2390.243902,3556,211.4149822,7112,-1652736,167936,-1484800,37
2989,182,23,7,0.0573951435,0.942604857,912.1815472,966.132076,1584.339244,1613.274725,3171,299.4334278,6342,-1530368,93184,-1437184,37
3244,326,23,7,0.0913165266,0.908683473,1000.192567,1130.457422,1725.064735,2386.886503,3570,132.1243523,7140,-1660928,166912,-1494016,37
2619,152,21,9,0.0548538434,0.945146157,792.7262078,910.5999396,1391.063383,1298.756579,2771,259.2142189,5542,-1340928,77824,-1263104,37
1690,64,23,7,0.0364880274,0.963511973,503.262584,570.1171069,881.7840237,764.375,1754,336.6602687,3508,-865280,32768,-832512,37
3008,183,23,7,0.0573487935,0.942651207,917.5921166,975.3164424,1591.739362,1666.032787,3191,269.0556492,6382,-1540096,93696,-1446400,37
3334,340,23,7,0.0925421884,0.907457812,1028.475705,1184.8711,1777.705459,2423.838235,3674,143.0128455,7348,-1707008,174080,-1532928,37
2597,165,23,7,0.0597393193,0.940260681,785.9147593,957.4719505,1378.018483,1436.29697,2762,48.54983301,5524,-1329664,84480,-1245184,37
3202,337,23,7,0.0952246397,0.90477536,989.9808831,1122.052727,1707.524672,2363.608309,3539,144.7443763,7078,-1639424,172544,-1466880,37
3031,175,21,9,0.0545851528,0.945414847,920.0495768,1014.258797,1605.878588,1562.302857,3206,279.5117698,6412,-1551872,89600,-1462272,37
3068,192,21,9,0.0588957055,0.941104294,937.7586289,992.5547768,1631.380378,1616.432292,3260,247.5322703,6520,-1570816,98304,-1472512,37
2969,175,23,7,0.0556615776,0.944338422,902.4875558,988.9838252,1569.652071,1620.817143,3144,312.5248509,6288,-1520128,89600,-1430528,37
2610,149,21,9,0.0540050743,0.945994926,792.287006,865.2644932,1382.249425,1340.597315,2759,254.9907579,5518,-1336320,76288,-1260032,37
2228,201,19,11,0.0827501029,0.917249897,686.6223865,840.9603014,1223.004488,1126.273632,2429,147.6595745,4858,-1140736,102912,-1037824,37
2208,202,18,12,0.0838174274,0.916182573,680.6753934,836.1033599,1214.720562,1104.712871,2410,211.7750439,4820,-1130496,103424,-1027072,37
2202,200,19,11,0.0832639467,0.916736053,679.1363086,825.9259194,1211.847411,1087.575,2402,184.3438219,4804,-1127424,102400,-1025024,37
2216,201,19,11,0.0831609433,0.916839057,684.4779696,822.306594,1218.727437,1101.756219,2417,241.4585415,4834,-1134592,102912,-1031680,37
2179,198,20,10,0.0832982751,0.916701725,671.6642969,822.8614764,1197.984397,1090.126263,2377,173.8844184,4754,-1115648,101376,-1014272,37
2208,202,19,11,0.0838174274,0.916182573,683.6048858,811.6158818,1213.208786,1121.237624,2410,219.6900638,4820,-1130496,103424,-1027072,37
1473,127,19,11,0.079375,0.920625,456.005039,470.5422503,819.8071962,576.5669291,1600,139.3728223,3200,-754176,65024,-689152,37
1431,125,18,12,0.0803341902,0.91966581,443.7728208,440.8217357,799.4751922,538.376,1556,175.4227734,3112,-732672,64000,-668672,37
1469,125,20,10,0.0784190715,0.921580928,455.0413598,437.803605,819.8692988,534.616,1594,114.676259,3188,-752128,64000,-688128,37
2223,200,19,11,0.0825423029,0.917457697,686.2073307,824.3196692,1222.14215,1099.27,2423,203.2718121,4846,-1138176,102400,-1035776,37
3767,609,20,10,0.13916819,0.86083181,1227.855422,1335.793094,2098.914521,2742.635468,4376,107.5977379,8752,-1928704,311808,-1616896,37
3379,528,19,11,0.135142053,0.864857947,1098.837003,1187.077973,1877.602841,2442.912879,3907,147.7126654,7814,-1730048,270336,-1459712,37
2209,197,20,10,0.0818786367,0.918121363,681.805991,815.9465376,1213.374378,1092.77665,2406,74.19056429,4812,-1131008,100864,-1030144,37
2204,196,19,11,0.0816666667,0.918333333,681.09078,806.7647149,1209.167877,1103.030612,2400,184.3317972,4800,-1128448,100352,-1028096,37
3377,525,18,12,0.134546386,0.865453614,1086.896411,1220.463472,1866.942849,2495.40381,3902,162.5833333,7804,-1729024,268800,-1460224,37
1450,126,18,12,0.0799492386,0.920050761,448.504995,459.8591526,809.3441379,548.6269841,1576,154.8133595,3152,-742400,64512,-677888,37
3749,772,19,11,0.170758682,0.829241318,1239.507437,1340.476685,2102.22326,3032.054404,4521,109.8930481,9042,-1919488,395264,-1524224,37
2207,195,19,11,0.081182348,0.918817652,681.9507241,803.3327257,1211.391482,1089.548718,2402,198.3484723,4804,-1129984,99840,-1030144,37
2211,203,20,10,0.084092792,0.915907208,682.0067816,839.1496011,1213.418815,1143.034483,2414,149.1965389,4828,-1132032,103936,-1028096,37
2205,199,19,11,0.0827787022,0.917221298,680.155445,826.5587519,1210.615873,1112.572864,2404,175.3464624,4808,-1128960,101888,-1027072,37
592,63,21,9,0.0961832061,0.903816794,185.289455,157.8313553,343.7331081,180.1587302,655,12.03380489,1310,-303104,32256,-270848,37
4727,285,23,7,0.0568635275,0.943136472,1441.721287,1528.458707,2509.357944,2459.098246,5012,360.0574713,10024,-2420224,145920,-2274304,37
4894,278,23,7,0.0537509667,0.946249033,1488.450976,1570.904634,2588.718635,2547.442446,5172,382.5443787,10344,-2505728,142336,-2363392,37
4233,276,23,7,0.0612109115,0.938789088,1299.292217,1335.964772,2258.434207,2202.32971,4509,408.423913,9018,-2167296,141312,-2025984,37
4561,278,23,7,0.0574498863,0.942550114,1391.140491,1487.185246,2423.246218,2366.741007,4839,306.8484464,9678,-2335232,142336,-2192896,37
4928,453,23,7,0.0841850957,0.915814904,1518.325054,1767.292218,2631.313515,3340.304636,5381,320.297619,10762,-2523136,231936,-2291200,37
4685,276,23,7,0.0556339448,0.944366055,1427.878319,1501.603905,2483.520171,2438.221014,4961,218.3538732,9922,-2398720,141312,-2257408,37
4911,436,23,7,0.0815410511,0.918458949,1508.459604,1753.728966,2613.051721,3360.506881,5347,284.5662586,10694,-2514432,223232,-2291200,37
4203,250,23,7,0.0561419268,0.943858073,1280.936425,1359.111529,2228.706638,2198.308,4453,424.9045802,8906,-2151936,128000,-2023936,37
3020,144,21,9,0.0455120101,0.95448799,908.5278519,978.4371032,1594.084768,1339.541667,3164,242.6380368,6328,-1546240,73728,-1472512,37
4789,287,23,7,0.0565405831,0.943459417,1456.89298,1597.605471,2542.805179,2466.662021,5076,485.2772467,10152,-2451968,146944,-2305024,37
4072,294,23,7,0.067338525,0.932661475,1244.508835,1460.607162,2178.619843,2251.091837,4366,76.62337662,8732,-2084864,150528,-1934336,37
4745,422,20,10,0.0816721502,0.91832785,1459.09591,1688.503941,2526.722234,3228.035545,5167,236.8010999,10334,-2429440,216064,-2213376,37
5083,467,23,7,0.0841441441,0.915855856,1559.747477,1889.868538,2716.226835,3420.650964,5550,217.8178964,11100,-2602496,239104,-2363392,37
4580,439,23,7,0.087467623,0.912532377,1415.831726,1642.269498,2452.872052,3106.004556,5019,207.6541167,10038,-2344960,224768,-2120192,37
4990,292,23,7,0.0552820901,0.94471791,1520.485599,1596.002899,2643.56994,2606.126712,5282,496.8955786,10564,-2554880,149504,-2405376,37
4808,301,22,8,0.0589156391,0.941084361,1464.53144,1623.972872,2563.994176,2411.332226,5109,384.7138554,10218,-2461696,154112,-2307584,37
4655,290,21,9,0.0586450961,0.941354904,1418.77345,1543.073059,2487.214608,2244.831034,4945,412.0833333,9890,-2383360,148480,-2234880,37
2174,156,23,7,0.0669527897,0.93304721,656.688147,852.9237241,1175.287029,1029.108974,2330,37.29193342,4660,-1113088,79872,-1033216,37
2127,157,23,7,0.0687390543,0.931260946,644.8008796,825.1774883,1149.825106,1043.261146,2284,34.59033773,4568,-1089024,80384,-1008640,37
1442,122,21,9,0.0780051151,0.921994885,446.6062882,442.6248576,802.3564494,547.8032787,1564,231.0192024,3128,-738304,62464,-675840,37
3934,849,21,9,0.177503659,0.822496341,1306.398961,1395.32714,2207.870615,3245.19788,4783,118.4790686,9566,-2014208,434688,-1579520,37
2413,471,21,9,0.16331484,0.83668516,749.185348,953.231929,1321.416494,2062.828025,2884,136.1661945,5768,-1235456,241152,-994304,37
1756,138,22,8,0.0728616684,0.927138332,539.766977,608.2352734,959.5928246,793.6231884,1894,57.88508557,3788,-899072,70656,-828416,37
3860,833,21,9,0.177498402,0.822501598,1277.577204,1365.875094,2160.185233,3212.672269,4693,139.7974382,9386,-1976320,426496,-1549824,37
1429,129,21,9,0.0827984596,0.91720154,442.6462147,488.8727804,795.3393982,604.0387597,1558,140.8679928,3116,-731648,66048,-665600,37
1494,127,20,10,0.0783466996,0.9216533,462.6863486,476.4880517,829.1512718,597.4724409,1621,284.8857645,3242,-764928,65024,-699904,37
2435,465,21,9,0.160344828,0.839655172,757.5838081,960.7721605,1334.128131,2059.888172,2900,207.8853047,5800,-1246720,238080,-1008640,37
1443,122,21,9,0.0779552716,0.922044728,446.3442772,465.1615521,800.3042273,578.3278689,1565,303.2945736,3130,-738816,62464,-676352,37
3814,570,21,9,0.130018248,0.869981752,1235.587482,1349.195025,2118.375197,2688.485965,4384,146.4751086,8768,-1952768,291840,-1660928,37
2379,237,21,9,0.0905963303,0.90940367,736.3528764,922.2143265,1304.701976,1346.624473,2616,121.3921114,5232,-1218048,121344,-1096704,37
1437,121,21,9,0.0776636714,0.922336329,443.9336421,465.8248916,797.0466249,571.1157025,1558,255.8292282,3116,-735744,61952,-673792,37
1459,129,21,9,0.0812342569,0.918765743,451.1195582,502.2439743,809.8848526,620.496124,1588,233.5294118,3176,-747008,66048,-680960,37
2461,478,21,9,0.162640354,0.837359646,765.5075387,976.9709045,1350.209671,2086.74477,2939,189.6129032,5878,-1260032,244736,-1015296,37
1445,120,21,9,0.0766773163,0.923322684,447.219391,439.6547091,802.5688581,547.3583333,1565,28.63154043,3130,-739840,61440,-678400,37
3729,560,21,9,0.130566566,0.869433434,1203.497965,1329.974812,2064.907482,2678.330357,4289,132.2540857,8578,-1909248,286720,-1622528,37
3757,526,21,9,0.122811114,0.877188886,1206.393751,1339.52354,2075.419484,2617.557034,4283,110.5575632,8566,-1923584,269312,-1654272,37
2468,477,20,10,0.16196944,0.83803056,768.2273213,979.0140622,1354.278768,2087.264151,2945,172.2222222,5890,-1263616,244224,-1019392,37
3834,772,21,9,0.167607469,0.832392531,1261.294166,1362.502941,2140.120762,3114.893782,4606,144.8883297,9212,-1963008,395264,-1567744,37
3700,586,21,9,0.136724218,0.863275782,1202.767043,1306.881011,2055.908108,2696.554608,4286,139.56366,8572,-1894400,300032,-1594368,37
9271,664,21,9,0.0668344238,0.933165576,2845.818532,3099.22456,4924.862151,5570.305723,9935,869.2038495,19870,-4746752,339968,-4406784,37
9300,633,23,7,0.0637269707,0.936273029,2857.791144,2967.16874,4935.618387,5428.056872,9933,650.065445,19866,-4761600,324096,-4437504,37
9343,595,23,7,0.0598712014,0.940128799,2857.60484,2976.39588,4931.292733,5569.45042,9938,578.800233,19876,-4783616,304640,-4478976,37
9316,623,23,7,0.0626823624,0.937317638,2858.77996,3003.956528,4949.964148,5269.605136,9939,878.0035336,19878,-4769792,318976,-4450816,37
9299,635,23,7,0.0639218844,0.936078116,2847.12942,3128.103474,4941.065814,5354.604724,9934,546.4246425,19868,-4761088,325120,-4435968,37
9299,629,21,9,0.0633561644,0.936643836,2852.067577,2971.515244,4915.563179,5687.971383,9928,592.0095408,19856,-4761088,322048,-4439040,37
1859,117,23,7,0.0592105263,0.940789474,559.3471517,581.8308903,1014.80312,570.5726496,1976,36.7013373,3952,-951808,59904,-891904,37
9292,635,21,9,0.0639669588,0.936033041,2860.610014,2889.485334,4928.539604,5482.894488,9927,532.5643777,19854,-4757504,325120,-4432384,37
9319,620,23,7,0.0623805212,0.937619479,2856.800904,3040.122653,4955.341238,5190.330645,9939,704.3940468,19878,-4771328,317440,-4453888,37
9266,666,22,8,0.0670559807,0.932944019,2842.123351,3138.89008,4925.228793,5540.702703,9932,687.8116343,19864,-4744192,340992,-4403200,37
9326,607,23,7,0.0611094332,0.938890567,2856.470809,2974.547462,4930.435771,5528.775947,9933,810.8571429,19866,-4774912,310784,-4464128,37
9327,613,22,8,0.0616700201,0.93832998,2860.263427,2996.337031,4955.596012,5197.269168,9940,777.7777778,19880,-4775424,313856,-4461568,37
9312,623,23,7,0.0627075994,0.937292401,2860.426948,2936.81918,4935.75741,5449.930979,9935,655.7755776,19870,-4767744,318976,-4448768,37
9321,612,23,7,0.0616128058,0.938387194,2856.906451,2984.247899,4936.361227,5433.640523,9933,968.128655,19866,-4772352,313344,-4459008,37
9290,643,22,8,0.0647337159,0.935266284,2856.016309,3018.972939,4952.030678,5183.275272,9933,808.8762215,19866,-4756480,329216,-4427264,37
9307,624,23,7,0.0628335515,0.937166448,2854.335845,3027.531914,4943.594714,5300.176282,9931,814.6841674,19862,-4765184,319488,-4445696,37
9302,630,23,7,0.0634313331,0.936568667,2857.247571,2964.646943,4932.708235,5465.438095,9932,1018.666667,19864,-4762624,322560,-4440064,37
9325,614,22,8,0.0617768387,0.938223161,2859.206488,3007.608735,4955.646327,5187.993485,9939,562.1606335,19878,-4774400,314368,-4460032,37
9255,668,23,7,0.0673183513,0.932681649,2857.574852,2946.122264,4942.692274,5229.504491,9923,755.1750381,19846,-4738560,342016,-4396544,37
9331,603,22,8,0.0607006241,0.939299376,2863.075935,2895.823784,4936.319151,5450.001658,9934,637.2033355,19868,-4777472,308736,-4468736,37
1421,145,20,10,0.0925925926,0.907407407,448.007559,489.9237706,784.6023927,772.6965517,1566,124.6815287,3132,-727552,74240,-653312,37
3118,429,20,10,0.120947279,0.879052721,971.8958517,1239.892473,1707.479795,2257.473193,3547,236.6244163,7094,-1596416,219648,-1376768,37
1393,146,20,10,0.0948667966,0.905133203,439.3989548,488.3039403,770.3524767,766.6369863,1539,150.1463415,3078,-713216,74752,-638464,37
1418,145,19,11,0.0927703135,0.907229687,446.2143932,495.0577431,786.6149506,736.8689655,1563,149.8561841,3126,-726016,74240,-651776,37
2543,305,20,10,0.107092697,0.892907303,813.7382005,884.1918103,1413.857255,1513.236066,2848,164.0552995,5696,-1302016,156160,-1145856,37
3392,435,20,10,0.113666057,0.886333943,1061.914379,1294.10363,1851.303361,2402.889655,3827,190.5876494,7654,-1736704,222720,-1513984,37
1431,149,20,10,0.0943037975,0.905696203,451.1979552,499.2547126,794.4025157,753.0201342,1580,153.6964981,3160,-732672,76288,-656384,37
1391,143,19,11,0.093220339,0.906779661,436.6390977,497.9732612,770.6872753,736.4965035,1534,137.9496403,3068,-712192,73216,-638976,37
3733,449,19,11,0.107364897,0.892635103,1158.853242,1428.572685,2022.521564,2664.988864,4182,73.38129496,8364,-1911296,229888,-1681408,37
3003,383,19,11,0.113112817,0.886887183,929.8801106,1223.640961,1644.038628,2081.313316,3386,176.8146214,6772,-1537536,196096,-1341440,37
1392,138,19,11,0.0901960784,0.909803922,436.7851663,487.639734,767.8010057,742.2898551,1530,123.7864078,3060,-712704,70656,-642048,37
1399,144,20,10,0.0933246922,0.906675308,439.0478651,500.6061842,776.9985704,723.4375,1543,124.8381877,3086,-716288,73728,-642560,37
1446,146,20,10,0.0917085427,0.908291457,455.1342274,498.6093348,801.5788382,746.1986301,1592,112.2708039,3184,-740352,74752,-665600,37
2419,292,19,11,0.107709332,0.892290668,776.90664,827.9659721,1358.455974,1335.65411,2711,159.8466981,5422,-1238528,149504,-1089024,37
1409,141,20,10,0.0909677419,0.909032258,444.2933259,476.6082287,778.7352732,743.1702128,1550,139.1382406,3100,-721408,72192,-649216,37
2115,299,20,10,0.123860812,0.876139188,690.5189887,739.2622278,1202.631678,1241.936455,2414,164.8907104,4828,-1082880,153088,-929792,37
1373,145,19,11,0.0955204216,0.904479578,432.2656063,489.5148932,763.2425346,724.062069,1518,132.2299652,3036,-702976,74240,-628736,37
1418,152,18,12,0.0968152866,0.903184713,447.1968361,501.1434159,792.5994358,719.2697368,1570,123.427673,3140,-726016,77824,-648192,37
3004,356,19,11,0.105952381,0.894047619,926.6464893,1222.945837,1638.843209,2032.008427,3360,148.8042516,6720,-1538048,182272,-1355776,37
487,42,19,11,0.0793950851,0.920604915,148.1788528,166.1185016,273.8850103,161.9761905,529,8.610026042,1058,-249344,21504,-227840,37
4014,267,23,7,0.0623686055,0.937631395,1230.863827,1306.684774,2144.836074,2083.329588,4281,226.0295671,8562,-2055168,136704,-1918464,37
3291,212,23,7,0.0605195547,0.939480445,1004.769722,1106.584621,1752.882103,1738.306604,3503,260.639881,7006,-1684992,108544,-1576448,37
3920,250,23,7,0.0599520384,0.940047962,1197.970154,1284.105121,2093.970663,1952.68,4170,441.2698413,8340,-2007040,128000,-1879040,37
4185,433,21,9,0.093763534,0.906236466,1289.882229,1469.545444,2226.315651,3113.487298,4618,86.44702359,9236,-2142720,221696,-1921024,37
4266,399,23,7,0.0855305466,0.914469453,1313.807733,1529.574297,2275.822316,2944.328321,4665,232.552343,9330,-2184192,204288,-1979904,37
2969,202,21,9,0.0637023021,0.936297698,907.9811745,1001.364113,1573.90906,1763.712871,3171,214.8373984,6342,-1520128,103424,-1416704,37
3537,204,23,7,0.0545308741,0.945469126,1076.759288,1131.636198,1874.701159,1806.828431,3741,308.9182494,7482,-1810944,104448,-1706496,37
3580,217,23,7,0.0571503819,0.942849618,1092.573534,1145.713124,1906.465642,1775.834101,3797,306.2096774,7594,-1832960,111104,-1721856,37
4047,245,23,7,0.057082945,0.942917055,1234.236443,1314.020985,2149.612553,2095.085714,4292,340.3647898,8584,-2072064,125440,-1946624,37
4110,396,23,7,0.0878828229,0.912117177,1269.684512,1412.090389,2186.679075,2947.020202,4506,273.2565191,9012,-2104320,202752,-1901568,37
3424,212,23,7,0.0583058306,0.941694169,1047.969952,1075.668256,1820.019276,1793.962264,3636,373.3059548,7272,-1753088,108544,-1644544,37
3926,246,23,7,0.0589645254,0.941035475,1199.958798,1271.550354,2089.365003,2040.776423,4172,402.3143684,8344,-2010112,125952,-1884160,37
3499,221,22,8,0.0594086022,0.940591398,1071.129791,1113.37121,1865.519291,1781.031674,3720,291.9937206,7440,-1791488,113152,-1678336,37
3957,242,21,9,0.0576327697,0.94236723,1207.51511,1283.908113,2103.816528,2037.595041,4199,352.2651007,8398,-2025984,123904,-1902080,37
4200,460,23,7,0.0987124464,0.901287554,1299.536806,1473.954105,2241.031429,3147.386957,4660,82.93290621,9320,-2150400,235520,-1914880,37
3796,239,23,7,0.0592317224,0.940768278,1160.061352,1237.690546,2017.725501,2022.359833,4035,370.8639706,8070,-1943552,122368,-1821184,37
3227,230,21,9,0.0665316749,0.933468325,990.9397271,1090.26008,1725.320112,1780.630435,3457,182.9100529,6914,-1652224,117760,-1534464,37
3908,259,20,10,0.0621550276,0.937844972,1193.111307,1339.525417,2078.673234,2164.374517,4167,75.59869376,8334,-2000896,132608,-1868288,37
3918,251,23,7,0.0602062845,0.939793716,1198.841627,1273.798198,2085.073762,2083.848606,4169,205.1673228,8338,-2006016,128512,-1877504,37
3427,230,20,10,0.0628930818,0.937106918,1049.715598,1139.106697,1824.805953,1891.491304,3657,64.36114044,7314,-1754624,117760,-1636864,37
8446,588,22,8,0.0650874474,0.934912553,2566.434823,2978.950158,4449.911556,5488.336735,9034,305.6156969,18068,-4324352,301056,-4023296,37
6918,376,23,7,0.0515492185,0.948450781,2095.505544,2278.80983,3639.91327,3787.087766,7294,273.081243,14588,-3542016,192512,-3349504,37
7287,397,21,9,0.0516657991,0.948334201,2207.232259,2382.406452,3823.099629,4198.596977,7684,428.7946429,15368,-3730944,203264,-3527680,37
7279,395,23,7,0.0514725046,0.948527495,2202.712118,2432.378443,3830.958648,3958.043038,7674,745.7725948,15348,-3726848,202240,-3524608,37
7003,384,21,9,0.0519832138,0.948016786,2119.68205,2351.114365,3688.892903,3787.138021,7387,462.5547902,14774,-3585536,196608,-3388928,37
8519,454,23,7,0.0505962331,0.949403767,2582.866088,2725.693586,4487.225261,4482.773128,8973,585.7049608,17946,-4361728,232448,-4129280,37
8317,434,23,7,0.0495943321,0.950405668,2519.396857,2652.67628,4378.494409,4328.198157,8751,973.4149055,17502,-4258304,222208,-4036096,37
6978,378,22,8,0.0513866232,0.948613377,2105.276508,2431.06197,3670.795357,3820.730159,7356,127.8859527,14712,-3572736,193536,-3379200,37
7622,402,22,8,0.0500997009,0.949900299,2305.152945,2504.668795,4026.228943,3752.196517,8024,148.0715999,16048,-3902464,205824,-3696640,37
8178,439,22,8,0.0509458048,0.949054195,2479.687946,2629.031579,4309.354977,4302.387244,8617,495.5146636,17234,-4187136,224768,-3962368,37
7776,432,23,7,0.0526315789,0.947368421,2362.118686,2497.425437,4102.667695,4137.481481,8208,378.9473684,16416,-3981312,221184,-3760128,37
7370,385,23,7,0.0496453901,0.95035461,2230.644078,2374.046356,3865.246404,4122.14026,7755,554.72103,15510,-3773440,197120,-3576320,37
1243,83,20,10,0.0625942685,0.937405732,375.9900588,392.0129112,680.609815,407.2650602,1326,25.34888167,2652,-636416,42496,-593920,37
7744,569,22,8,0.0684470107,0.931552989,2353.37264,2683.574519,4068.487345,5361.643234,8313,305.288285,16626,-3964928,291328,-3673600,37
7611,408,23,7,0.050879162,0.949120838,2302.05444,2521.163288,4027.12771,3690.492647,8019,140.7088963,16038,-3896832,208896,-3687936,37
5598,255,23,7,0.0435674013,0.956432599,1683.121507,1819.948266,2933.817078,2777.345098,5853,108.3086603,11706,-2866176,130560,-2735616,37
1048,87,21,9,0.0766519824,0.923348018,321.9520753,338.0299144,583.4770992,381.5632184,1135,20.42836573,2270,-536576,44544,-492032,37
7726,416,23,7,0.0510930975,0.948906902,2334.616328,2626.127033,4072.712141,4048.987981,8142,232.3630137,16284,-3955712,212992,-3742720,37
7540,420,23,7,0.0527638191,0.947236181,2282.832069,2496.371661,3951.629973,4498.785714,7960,140.2643172,15920,-3860480,215040,-3645440,37
4576,234,21,9,0.0486486486,0.951351351,1376.020915,1593.573834,2418.182692,2157.482906,4810,71.26981775,9620,-2342912,119808,-2223104,37
3222,192,23,7,0.0562390158,0.943760984,984.3346666,1001.443092,1712.721601,1619.875,3414,270.3087886,6828,-1649664,98304,-1551360,37
72,28,22,8,0.28,0.72,25.86338977,32.43822622,45.79166667,62.60714286,100,3.134796238,200,-36864,14336,-22528,37
3641,218,23,7,0.056491319,0.943508681,1111.869641,1148.949276,1929.886295,1931.899083,3859,266.6897028,7718,-1864192,111616,-1752576,37
3201,181,23,7,0.053518628,0.946481372,974.866263,1000.074962,1694.227429,1643.265193,3382,183.6047774,6764,-1638912,92672,-1546240,37
3638,221,22,8,0.0572687225,0.942731278,1108.31658,1201.955092,1933.781473,1867.751131,3859,282.0906433,7718,-1862656,113152,-1749504,37
3686,218,23,7,0.0558401639,0.944159836,1124.525413,1167.202192,1954.708627,1915.155963,3904,337.716263,7808,-1887232,111616,-1775616,37
4195,384,23,7,0.083861105,0.916138895,1286.49147,1511.974374,2230.026937,2945.174479,4579,219.616307,9158,-2147840,196608,-1951232,37
3576,220,23,7,0.0579557429,0.942044257,1092.307513,1151.14383,1899.479586,1882.577273,3796,316.3333333,7592,-1830912,112640,-1718272,37
3668,239,23,7,0.0611722549,0.938827745,1120.564724,1233.942291,1952.041439,1984.058577,3907,190.0291829,7814,-1878016,122368,-1755648,37
3735,221,22,8,0.0558645096,0.94413549,1139.525698,1181.919127,1981.4249,1929.067873,3956,261.2945839,7912,-1912320,113152,-1799168,37
3954,423,23,7,0.0966415353,0.903358465,1216.224101,1429.587824,2107.064745,2954.891253,4377,77.95191451,8754,-2024448,216576,-1807872,37
3801,246,22,8,0.0607857672,0.939214233,1162.126696,1259.360791,2024.092081,2022.577236,4047,209.0392562,8094,-1946112,125952,-1820160,37
3693,223,23,7,0.0569458631,0.943054137,1126.261234,1196.412074,1961.780937,1904.165919,3916,328.248114,7832,-1890816,114176,-1776640,37
3600,213,23,7,0.0558615264,0.944138474,1096.542505,1169.030904,1907.265,1902.521127,3813,302.6190476,7626,-1843200,109056,-1734144,37
3779,375,23,7,0.0902744343,0.909725566,1164.571281,1371.309917,2019.055041,2666.469333,4154,170.9465021,8308,-1934848,192000,-1742848,37
3506,216,23,7,0.0580333154,0.941966685,1068.563792,1164.871929,1864.317171,1815.773148,3722,319.7594502,7444,-1795072,110592,-1684480,37
3240,194,21,9,0.0564938847,0.943506115,988.8580267,1011.338982,1729.275309,1520.840206,3434,202.237927,6868,-1658880,99328,-1559552,37
3476,358,23,7,0.0933750652,0.906624935,1078.046011,1193.490055,1854.699367,2527.26257,3834,197.628866,7668,-1779712,183296,-1596416,37
3553,244,23,7,0.0642612589,0.935738741,1088.536375,1200.836977,1899.277231,1894.963115,3797,180.294397,7594,-1819136,124928,-1694208,37
3646,218,21,9,0.0564182195,0.943581781,1112.888287,1157.277773,1932.865058,1926.394495,3864,213.362783,7728,-1866752,111616,-1755136,37
1849,217,20,10,0.105033882,0.894966118,580.1058215,675.5134595,1061.312061,796.5207373,2066,59.65925498,4132,-946688,111104,-835584,38
1859,215,20,10,0.103664417,0.896335583,578.3868429,743.4988426,1049.757934,931.5116279,2074,75.36337209,4148,-951808,110080,-841728,38
1882,216,20,10,0.102955195,0.897044805,590.2315867,663.5654064,1081.569075,770.0833333,2098,76.68128655,4196,-963584,110592,-852992,38
1817,214,21,9,0.105366814,0.894633186,570.2487551,676.8007958,1039.180517,819.182243,2031,68.94093686,4062,-930304,109568,-820736,38
1939,214,21,9,0.0993961914,0.900603809,606.7155575,712.147776,1098.933987,878.2616822,2153,66.92570718,4306,-992768,109568,-883200,38
1862,209,21,9,0.100917431,0.899082569,579.3025434,700.6983082,1062.267991,801.9760766,2071,70.20338983,4142,-953344,107008,-846336,38
1843,199,21,9,0.097453477,0.902546523,575.9652493,662.4997597,1045.42268,799.9447236,2042,74.09288824,4084,-943616,101888,-841728,38
1860,214,21,9,0.103182257,0.896817743,581.2942344,701.8819736,1060.473656,837.8224299,2074,58.17671809,4148,-952320,109568,-842752,38
1910,207,21,9,0.0977798772,0.902220123,595.2147139,702.2344092,1083.671728,831.352657,2117,64.85906863,4234,-977920,105984,-871936,38
1883,210,21,9,0.100334448,0.899665552,588.6397651,694.2606136,1070.523633,836.0714286,2093,79.67263038,4186,-964096,107520,-856576,38
1866,215,21,9,0.103315714,0.896684286,586.0038782,673.2889133,1067.561629,810.4697674,2081,55.65659267,4162,-955392,110080,-845312,38
1922,220,20,10,0.10270775,0.89729225,599.7258515,734.0376377,1093.62539,878.2045455,2142,79.62825279,4284,-984064,112640,-871424,38
1926,220,20,10,0.102516309,0.897483691,602.5173721,727.8188929,1093.94756,894.4909091,2146,67.88990826,4292,-986112,112640,-873472,38
1939,202,20,10,0.0943484353,0.905651565,599.9080075,748.9282788,1089.074781,897.5,2141,81.49980967,4282,-992768,103424,-889344,38
1849,206,21,9,0.100243309,0.899756691,573.3916242,728.5164909,1045.961601,866.7815534,2055,61.41661686,4110,-946688,105472,-841216,38
1870,209,21,9,0.100529101,0.899470899,582.1556668,711.8758141,1062.191979,841.4401914,2079,77.83601647,4158,-957440,107008,-850432,38
1854,213,20,10,0.103047896,0.896952104,582.1494975,658.13956,1063.217368,779.685446,2067,64.77593231,4134,-949248,109056,-840192,38
1859,217,20,10,0.104527938,0.895472062,582.3844223,709.9619706,1056.391608,885.2258065,2076,57.98882682,4152,-951808,111104,-840704,38
1942,211,21,9,0.0980027868,0.901997213,604.6084316,739.5965695,1094.902678,912.2274882,2153,42.5409998,4306,-994304,108032,-886272,38
1949,217,21,9,0.100184672,0.899815328,606.6392615,750.973911,1102.727553,910.8064516,2166,62.67361111,4332,-997888,111104,-886784,38
1840,202,23,7,0.0989226249,0.901077375,569.7375658,727.7202852,1038.403261,867.529703,2042,78.23754789,4084,-942080,103424,-838656,38
1916,200,23,7,0.0945179584,0.905482042,598.4496991,697.6746117,1075.667537,894.035,2116,81.47862919,4232,-980992,102400,-878592,38
1834,198,24,6,0.0974409449,0.902559055,568.6780854,695.1123468,1040.012541,798.7121212,2032,62.63871763,4064,-939008,101376,-837632,38
1836,198,21,9,0.0973451327,0.902654867,570.3497295,702.1470735,1035.896514,846.9141414,2034,46.09109449,4068,-940032,101376,-838656,38
1835,196,21,9,0.0965041851,0.903495815,568.3822441,702.2846185,1037.352589,816.0918367,2031,73.08384311,4062,-939520,100352,-839168,38
1541,164,21,9,0.0961876833,0.903812317,481.2691706,507.7180848,882.3893576,576.847561,1705,30.45730618,3410,-788992,83968,-705024,38
2346,198,21,9,0.0778301887,0.922169811,717.5562798,896.9494076,1285.15942,1122.505051,2544,85.51260504,5088,-1201152,101376,-1099776,38
1867,204,23,7,0.0985031386,0.901496861,582.2248124,696.5105648,1057.007499,843.7401961,2071,77.79864763,4142,-955904,104448,-851456,38
1801,201,23,7,0.1003996,0.8996004,557.3226542,719.7841124,1018.40533,850.0248756,2002,78.29487681,4004,-922112,102912,-819200,38
1912,220,21,9,0.103189493,0.896810507,596.1877438,745.3122386,1084.133368,913.25,2132,73.82271468,4264,-978944,112640,-866304,38
1886,209,23,7,0.0997613365,0.900238663,590.6442834,679.663877,1072.933722,823,2095,61.92728348,4190,-965632,107008,-858624,38
1859,212,21,9,0.102366007,0.897633993,577.6170087,712.2637694,1062.157612,806.6273585,2071,80.99335158,4142,-951808,108544,-843264,38
1833,201,24,6,0.098820059,0.901179941,568.9677717,713.9167361,1034.587561,861.6716418,2034,75.27757217,4068,-938496,102912,-835584,38
1937,196,21,9,0.0918893577,0.908110642,601.0484668,727.3045805,1082.810532,910.75,2133,63.48214286,4266,-991744,100352,-891392,38
1856,211,21,9,0.10208031,0.89791969,578.2649346,699.5222627,1059.753233,807.4691943,2067,46.00489651,4134,-950272,108032,-842240,38
1912,210,21,9,0.0989632422,0.901036758,594.7556906,733.1654721,1080.586297,887.7238095,2122,46.20074026,4244,-978944,107520,-871424,38
1935,217,22,8,0.100836431,0.899163569,602.7144348,740.2549753,1097.771576,886.8202765,2152,86.25250501,4304,-990720,111104,-879616,38
1835,191,24,6,0.0942744324,0.905725568,565.8095771,722.4720517,1030.840327,846.9057592,2026,73.14079422,4052,-939520,97792,-841728,38
1908,203,21,9,0.0961629559,0.903837044,592.5034647,732.6683192,1072.10587,904.6206897,2111,80.38842346,4222,-976896,103936,-872960,38
1974,221,23,7,0.100683371,0.899316629,619.6735864,724.1705898,1117.417933,924.5565611,2195,63.49435927,4390,-1010688,113152,-897536,38
2060,219,20,10,0.0960947784,0.903905222,666.2056786,567.9278919,1148.281553,1062.100457,2279,57.27569741,4558,-1054720,112128,-942592,38
2058,209,22,8,0.0921923247,0.907807675,664.2336919,540.2874046,1143.189504,1043.511962,2267,88.38206628,4534,-1053696,107008,-946688,38
2200,213,23,7,0.0882718608,0.911728139,705.9882984,581.4023216,1216.603182,1107.812207,2413,83.93043478,4826,-1126400,109056,-1017344,38
2048,205,22,8,0.0909897914,0.909010209,659.5439594,538.7702484,1137.826172,1018.843902,2253,64.890553,4506,-1048576,104960,-943616,38
2203,222,22,8,0.0915463918,0.908453608,711.2510829,572.6913939,1219.810259,1145.418919,2425,78.63164721,4850,-1127936,113664,-1014272,38
734,30,22,8,0.0392670157,0.960732984,218.4095793,258.5837689,385.2574932,315.0333333,764,24.60547504,1528,-375808,15360,-360448,38
1975,207,22,8,0.0948670944,0.905132906,639.1838624,532.2513515,1094.532152,1062.570048,2182,85.87170405,4364,-1011200,105984,-905216,38
2079,212,21,9,0.0925360105,0.90746399,673.667125,519.1793728,1153.920154,1068.330189,2291,76.69902913,4582,-1064448,108544,-955904,38
1958,204,20,10,0.0943570768,0.905642923,636.0142648,495.195562,1083.457099,1062.715686,2162,77.90990991,4324,-1002496,104448,-898048,38
2048,216,21,9,0.0954063604,0.90459364,661.8037517,568.3045636,1136.20459,1097.375,2264,85.95292331,4528,-1048576,110592,-937984,38
2221,206,21,9,0.0848784508,0.915121549,708.7411401,592.4118531,1225.371004,1091.402913,2427,95.85308057,4854,-1137152,105472,-1031680,38
2086,219,22,8,0.095010846,0.904989154,675.0809313,564.639991,1151.340364,1168.808219,2305,47.6830782,4610,-1068032,112128,-955904,38
2063,222,23,7,0.0971553611,0.902844639,672.29615,527.3391353,1141.739215,1154.716216,2285,76.75512261,4570,-1056256,113664,-942592,38
1863,204,21,9,0.0986937591,0.901306241,597.3745203,573.7842033,1048.465915,901.8921569,2067,69.87829615,4134,-953856,104448,-849408,38
2049,196,22,8,0.0873051225,0.912694878,658.3020805,522.343991,1130.912152,1040.285714,2245,84.68502452,4490,-1049088,100352,-948736,38
2007,206,22,8,0.0930863082,0.906913692,646.5600325,556.1597423,1111.47434,1063.407767,2213,46.73706441,4426,-1027584,105472,-922112,38
2077,229,22,8,0.0993061578,0.900693842,672.3749873,601.5815519,1154.19066,1147.235808,2306,84.46886447,4612,-1063424,117248,-946176,38
2057,211,21,9,0.0930335097,0.90696649,666.6199423,524.3225242,1136.421001,1115.772512,2268,59.6214511,4536,-1053184,108032,-945152,38
2934,236,23,7,0.0744479495,0.92555205,928.1644852,730.4360631,1580.314247,1649.970339,3170,108.4131327,6340,-1502208,120832,-1381376,38
2173,205,23,7,0.0862068966,0.913793103,697.2387083,535.8390932,1204.086056,1034.887805,2378,63.85606874,4756,-1112576,104960,-1007616,38
2310,307,23,7,0.117309897,0.882690103,743.859719,820.4649884,1330.064935,1150.498371,2617,83.82447149,5234,-1182720,157184,-1025536,38
2441,310,23,7,0.112686296,0.887313704,789.5862022,821.538008,1389.426055,1270.280645,2751,96.76398171,5502,-1249792,158720,-1091072,38
2215,281,22,8,0.112580128,0.887419872,711.392233,780.1460378,1262.495711,1138.177936,2496,81.97044335,4992,-1134080,143872,-990208,38
2479,310,22,8,0.11115095,0.88884905,799.8260412,835.5596972,1410.786204,1268.76129,2789,94.79945615,5578,-1269248,158720,-1110528,38
2260,286,22,8,0.112333071,0.887666929,724.3627582,796.258305,1293.604425,1114.632867,2546,53.89500423,5092,-1157120,146432,-1010688,38
2296,303,24,6,0.116583301,0.883416699,735.6937559,849.4694558,1309.107578,1230.986799,2599,96.01034355,5198,-1175552,155136,-1020416,38
2326,294,23,7,0.11221374,0.88778626,745.3957686,827.1730814,1326.350387,1185.098639,2620,94.58483755,5240,-1190912,150528,-1040384,38
2294,298,23,7,0.114969136,0.885030864,735.588191,823.4992558,1316.320401,1143.922819,2592,97.2972973,5184,-1174528,152576,-1021952,38
2346,306,22,8,0.115384615,0.884615385,752.1281334,843.7231893,1347.955243,1162.009804,2652,91.38525155,5304,-1201152,156672,-1044480,38
2185,269,21,9,0.109616952,0.890383048,700.6418073,721.0157586,1258.426545,976.2936803,2454,47.76177501,4908,-1118720,137728,-980992,38
2331,311,21,9,0.117713853,0.882286147,750.472748,824.9597422,1346.427284,1134.665595,2642,91.10344828,5284,-1193472,159232,-1034240,38
2251,291,21,9,0.11447679,0.88552321,721.3943722,811.6414459,1288.487783,1140.092784,2542,50,5084,-1152512,148992,-1003520,38
2286,301,23,7,0.116350986,0.883649014,734.9875999,813.5758491,1314.994313,1134.554817,2587,82.86354901,5174,-1170432,154112,-1016320,38
2463,304,23,7,0.109866281,0.890133719,793.0143204,838.4568351,1395.148599,1293.674342,2767,95.57858377,5534,-1261056,155648,-1105408,38
2458,309,22,8,0.111673292,0.888326708,790.1702673,861.0244167,1392.611066,1315.501618,2767,72.68190176,5534,-1258496,158208,-1100288,38
2411,296,22,8,0.10934614,0.89065386,774.1401416,832.9275622,1365.24803,1262.381757,2707,47.81840664,5414,-1234432,151552,-1082880,38
2304,306,21,9,0.117241379,0.882758621,741.4703021,823.1941002,1325.142361,1157.604575,2610,47.03550189,5220,-1179648,156672,-1022976,38
2488,314,21,9,0.112062812,0.887937188,801.7359271,858.7405486,1412.03336,1318.038217,2802,76.87242798,5604,-1273856,160768,-1113088,38
2239,273,23,7,0.108678344,0.891321656,716.9981863,734.0971424,1289.740956,983.8754579,2512,47.92978439,5024,-1146368,139776,-1006592,38
987,163,24,6,0.14173913,0.85826087,331.8580439,314.0641808,592.2928065,473.8159509,1150,18.3735421,2300,-505344,83456,-421888,38
2383,350,23,7,0.128064398,0.871935602,763.8267758,942.2993643,1368.440621,1357.191429,2733,73.60624832,5466,-1220096,179200,-1040896,38
2428,336,22,8,0.121562952,0.878437048,775.7812997,942.0610153,1379.149918,1406.708333,2764,76.22724766,5528,-1243136,172032,-1071104,38
2374,322,23,7,0.119436202,0.880563798,757.2732153,918.3268445,1347.505055,1355.835404,2696,65.07361815,5392,-1215488,164864,-1050624,38
310,20,22,8,0.0606060606,0.939393939,93.66255125,107.6998027,168.4064516,120.45,330,65.73705179,660,-158720,10240,-148480,38
2388,345,23,7,0.126234907,0.873765093,767.0220182,926.261946,1370.40201,1343.452174,2733,69.33028919,5466,-1222656,176640,-1046016,38
2479,338,21,9,0.1199858,0.8800142,797.9644696,916.8549137,1412.327148,1384.597633,2817,74.78099283,5634,-1269248,173056,-1096192,38
2395,327,23,7,0.120132256,0.879867744,764.8599621,923.9636142,1366.028392,1328.333333,2722,73.03461229,5444,-1226240,167424,-1058816,38
2045,252,23,7,0.109708315,0.890291685,646.4602781,770.9178277,1166.269438,1008.857143,2297,53.98354877,4594,-1047040,129024,-918016,38
2503,340,22,8,0.11959198,0.88040802,805.2172819,926.7542783,1421.161007,1428.176471,2843,50.75879307,5686,-1281536,174080,-1107456,38
1283,160,20,10,0.110880111,0.889119889,416.0706669,396.9343644,738.3016368,591.28125,1443,33.02059497,2886,-656896,81920,-574976,38
2403,327,23,7,0.11978022,0.88021978,766.3012096,932.3532691,1368.620474,1342.568807,2730,72.54849854,5460,-1230336,167424,-1062912,38
1348,182,21,9,0.118954248,0.881045752,443.5329469,406.8701807,782.1862018,641.9120879,1530,28.20276498,3060,-690176,93184,-596992,38
2387,351,23,7,0.128195763,0.871804237,766.8986683,934.6268312,1369.746544,1367.823362,2738,57.9716282,5476,-1222144,179712,-1042432,38
2420,330,22,8,0.12,0.88,774.0710586,925.3380635,1380.378099,1339.727273,2750,72.21638655,5500,-1239040,168960,-1070080,38
2366,319,22,8,0.118808194,0.881191806,753.3059692,920.3836005,1346.195266,1319.30094,2685,64.94920174,5370,-1211392,163328,-1048064,38
2482,326,21,9,0.116096866,0.883903134,794.5595725,923.3079225,1407.522562,1381.48773,2808,59.7192684,5616,-1270784,166912,-1103872,38
2480,357,21,9,0.125837152,0.874162848,802.4801249,925.4331471,1419.871371,1412.946779,2837,77.3235214,5674,-1269760,182784,-1086976,38
2499,339,22,8,0.119450317,0.880549683,802.6714852,932.2395889,1422.213285,1399.498525,2838,57.51925415,5676,-1279488,173568,-1105920,38
2545,339,22,8,0.117545076,0.882454924,816.6858164,942.9478236,1444.497839,1427.501475,2884,69.62819894,5768,-1303040,173568,-1129472,38
2468,328,21,9,0.117310443,0.882689557,784.9543723,956.6596895,1392.929092,1440.417683,2796,77.2589113,5592,-1263616,167936,-1095680,38
2065,199,23,7,0.0878975265,0.912102473,635.6997381,808.8891426,1122.507022,1236.19598,2264,80.74179743,4528,-1057280,101888,-955392,38
1749,172,22,8,0.0895366996,0.9104633,543.7505079,654.053518,962.5889079,944.8430233,1921,44.06974077,3842,-895488,88064,-807424,38
131,15,22,8,0.102739726,0.897260274,40.71572252,51.10625098,75.03053435,60.13333333,146,3.092565135,292,-67072,7680,-59392,38
1546,179,21,9,0.103768116,0.896231884,482.8607619,609.6164001,855.8253558,924.9664804,1725,54.95380694,3450,-791552,91648,-699904,38
1523,162,21,9,0.0961424332,0.903857567,473.2378059,592.9063779,836.6277085,902.9074074,1685,61.25045438,3370,-779776,82944,-696832,38
1540,177,21,9,0.103086779,0.896913221,479.9870875,611.7629143,851.762987,921.9661017,1717,67.35974892,3434,-788480,90624,-697856,38
1514,163,21,9,0.0971973763,0.902802624,470.3617108,596.3470429,836.4966975,862.2515337,1677,55.0558109,3354,-775168,83456,-691712,38
1548,173,23,7,0.100522952,0.899477048,481.4494995,609.9411889,850.8074935,952.2023121,1721,68.2124455,3442,-792576,88576,-704000,38
1459,159,21,9,0.0982694685,0.901730532,453.0344612,579.1995342,805.8505826,842.9874214,1618,61.92116341,3236,-747008,81408,-665600,38
1519,154,23,7,0.0920502092,0.907949791,470.0934173,593.3304802,832.5799868,880.5974026,1673,58.45562544,3346,-777728,78848,-698880,38
1586,172,22,8,0.0978384528,0.902161547,495.6551508,605.602564,877.8026482,895.1511628,1758,36.32231405,3516,-812032,88064,-723968,38
1807,198,23,7,0.0987531172,0.901246883,568.2497222,665.5656495,997.9042612,1049.505051,2005,73.47013558,4010,-925184,101376,-823808,38
1538,176,21,9,0.102683781,0.897316219,480.3493267,604.0927842,851.6274382,908.8181818,1714,34.15022913,3428,-787456,90112,-697344,38
1540,167,23,7,0.0978324546,0.902167545,478.3301567,607.808578,848.6636364,903.2095808,1707,30.20169851,3414,-788480,85504,-702976,38
1505,160,22,8,0.0960960961,0.903903904,466.5541863,597.0781874,833.7202658,826.225,1665,51.88532253,3330,-770560,81920,-688640,38
1580,179,22,8,0.101762365,0.898237635,492.3562873,625.8622217,874.8588608,925.3798883,1759,64.6929018,3518,-808960,91648,-717312,38
1626,169,23,7,0.0941504178,0.905849582,505.303552,614.1124349,884.697417,1025.988166,1795,56.39333962,3590,-832512,86528,-745984,38
1542,157,21,9,0.0924072984,0.907592702,479.5085717,582.6894488,857.0907912,780.3566879,1699,43.64243514,3398,-789504,80384,-709120,38
1669,189,22,8,0.101722282,0.898277718,522.4979543,644.1962424,924.3618933,974.8730159,1858,60.4424203,3716,-854528,96768,-757760,38
1668,176,23,7,0.0954446855,0.904555315,521.9059791,620.8525825,918.102518,964.1761364,1844,63.5862069,3688,-854016,90112,-763904,38
2177,200,21,9,0.0841396719,0.915860328,690.1934161,635.9344015,1195.98622,1112.955,2377,95.19423308,4754,-1114624,102400,-1012224,38
2043,202,21,9,0.0899777283,0.910022272,644.5541199,680.3586699,1128.295644,1069.440594,2245,58.35716142,4490,-1046016,103424,-942592,38
2077,188,21,9,0.0830022075,0.916997792,647.6846619,689.5697971,1150.476168,939.9255319,2265,81.4162473,4530,-1063424,96256,-967168,38
2701,272,21,9,0.0914900774,0.908509923,858.0070302,859.6264796,1483.38023,1522.944853,2973,114.214368,5946,-1382912,139264,-1243648,38
4659,353,23,7,0.0704309657,0.929569034,1447.593569,1308.230235,2549.907062,1933.600567,5012,117.7078441,10024,-2385408,180736,-2204672,38
2233,232,21,9,0.0941176471,0.905882353,717.6375608,648.1722952,1238.373041,1181.284483,2465,83.98637138,4930,-1143296,118784,-1024512,38
2542,287,21,9,0.101449275,0.898550725,820.463252,781.4383109,1411.33871,1447.428571,2829,111.3779528,5658,-1301504,146944,-1154560,38
2241,242,22,8,0.0974627467,0.902537253,717.7768061,706.8855474,1239.011156,1269.677686,2483,82.02841097,4966,-1147392,123904,-1023488,38
2237,222,21,9,0.0902806019,0.909719398,715.2384159,652.4205138,1232.823424,1201.54955,2459,84.55983494,4918,-1145344,113664,-1031680,38
2532,264,22,8,0.0944206009,0.905579399,808.0169837,796.8211718,1393.165087,1449.666667,2796,51.34043335,5592,-1296384,135168,-1161216,38
2259,231,22,8,0.0927710843,0.907228916,723.406988,671.5536191,1248.131031,1219.770563,2490,47.39246289,4980,-1156608,118272,-1038336,38
2282,229,21,9,0.0911987256,0.908801274,731.3354833,655.6308042,1259.891762,1217.218341,2511,67.0493992,5022,-1168384,117248,-1051136,38
2226,236,21,9,0.0958570268,0.904142973,715.7735798,660.8204258,1233.555256,1212.114407,2462,57.05677868,4924,-1139712,120832,-1018880,38
2756,283,21,9,0.0931227377,0.906877262,883.8009023,809.8320702,1524.401669,1477.134276,3039,106.8565401,6078,-1411072,144896,-1266176,38
2340,255,22,8,0.098265896,0.901734104,763.6543275,599.3496294,1297.115385,1306.117647,2595,96.36093576,5190,-1198080,130560,-1067520,38
2563,302,21,9,0.105410122,0.894589878,835.0313109,755.2315213,1429.268045,1464.672185,2865,99.06639004,5730,-1312256,154624,-1157632,38
2888,288,22,8,0.0906801008,0.909319899,920.1341663,882.8991602,1589.989958,1573.559028,3176,79.69887077,6352,-1478656,147456,-1331200,38
1730,165,21,9,0.0870712401,0.91292876,542.205121,553.6671931,967.9473988,738.8545455,1895,49.84218832,3790,-885760,84480,-801280,38
1855,190,22,8,0.0929095355,0.907090465,593.193187,561.7294812,1023.018329,1022.821053,2045,32.4706256,4090,-949760,97280,-852480,38
1825,189,22,8,0.0938430983,0.906156902,586.125861,533.3799215,1006.291507,1019.169312,2014,32.88163265,4028,-934400,96768,-837632,38
1573,160,21,9,0.0923254472,0.907674553,489.9976235,530.2772387,892.4787031,616.5125,1733,38.12981298,3466,-805376,81920,-723456,38
1628,169,23,7,0.0940456316,0.905954368,508.4589635,533.969131,927.9422604,620.1952663,1797,50.04177109,3594,-833536,86528,-747008,38
1669,179,22,8,0.0968614719,0.903138528,524.1845109,527.1785702,956.4493709,626.603352,1848,47.76428018,3696,-854528,91648,-762880,38
1646,175,21,9,0.0961010434,0.903898957,517.0988812,520.4824763,941.2521264,626.4571429,1821,64.85042735,3642,-842752,89600,-753152,38
1620,173,23,7,0.0964863358,0.903513664,508.2366712,544.0229512,922.241358,660.6358382,1793,63.13380282,3586,-829440,88576,-740864,38
1674,175,21,9,0.0946457545,0.905354246,524.9189251,507.0376629,959.0746714,599.0514286,1849,33.6426492,3698,-857088,89600,-767488,38
1675,174,21,9,0.0941049216,0.905895078,522.805372,549.1296821,955.438806,631.9827586,1849,53.07118255,3698,-857600,89088,-768512,38
1668,178,21,9,0.0964247021,0.903575298,521.6521004,548.8534991,954.572542,632.3258427,1846,60.22838499,3692,-854016,91136,-762880,38
1618,176,21,9,0.0981047938,0.901895206,506.5604931,550.9629258,925.0797281,643.9545455,1794,54.54545455,3588,-828416,90112,-738304,38
1666,172,22,8,0.0935799782,0.906420022,521.4483446,526.0543244,950.2527011,621.627907,1838,61.2870957,3676,-852992,88064,-764928,38
1642,177,22,8,0.0973062122,0.902693788,514.9554047,555.9145121,936.0243605,668.5762712,1819,65.95358956,3638,-840704,90624,-750080,38
1669,172,21,9,0.0934274851,0.906572515,521.7525423,543.8703682,949.7351708,642.1686047,1841,44.20168067,3682,-854528,88064,-766464,38
1644,181,23,7,0.0991780822,0.900821918,515.9433938,558.1088535,940.4878345,663.3314917,1825,62.84435262,3650,-841728,92672,-749056,38
1645,170,21,9,0.0936639118,0.906336088,515.1989901,535.0202748,935.1617021,645.1705882,1815,69.91525424,3630,-842240,87040,-755200,38
1655,176,21,9,0.0961223375,0.903877662,518.0360084,532.3954539,947.8996979,616.0340909,1831,40.93449586,3662,-847360,90112,-757248,38
1622,171,22,8,0.0953708868,0.904629113,506.1128961,556.204137,923.5351418,645.3040936,1793,62.78011204,3586,-830464,87552,-742912,38
1614,167,21,9,0.0937675463,0.906232454,505.3598445,499.8375072,922.2893432,588.5988024,1781,56.90095847,3562,-826368,85504,-740864,38
1650,170,22,8,0.0934065934,0.906593407,517.1155564,537.8884099,936.5327273,657.8294118,1820,64.03940887,3640,-844800,87040,-757760,38
1634,181,22,8,0.0997245179,0.900275482,514.287431,538.9474692,936.7019584,648.8895028,1815,62.26415094,3630,-836608,92672,-743936,38
1647,175,21,9,0.0960482986,0.903951701,516.2357341,539.2336986,940.3060109,640.3942857,1822,59.07911803,3644,-843264,89600,-753664,38
3601,288,22,8,0.074055027,0.925944973,1124.976511,1091.458783,1940.189114,2005.152778,3889,81.77039529,7778,-1843712,147456,-1696256,38
2865,233,23,7,0.0752098128,0.924790187,901.0385846,796.5004329,1559.687958,1424.227468,3098,57.23258821,6196,-1466880,119296,-1347584,38
3554,307,23,7,0.0795130795,0.92048692,1109.144508,1174.507246,1926.776027,1979.899023,3861,92.50119789,7722,-1819648,157184,-1662464,38
3545,296,23,7,0.0770632648,0.922936735,1110.890307,1078.545567,1912.724965,2020.10473,3841,89.65919701,7682,-1815040,151552,-1663488,38
3629,300,21,9,0.0763553067,0.923644693,1137.935073,1086.238998,1959.993662,2025.56,3929,86.57999119,7858,-1858048,153600,-1704448,38
3560,306,22,8,0.0791515779,0.920848422,1120.654512,1059.754228,1930.030337,1973.866013,3866,93.69849733,7732,-1822720,156672,-1666048,38
3533,291,21,9,0.0760983264,0.923901674,1105.033645,1089.763079,1910.866686,1932.329897,3824,78.81286068,7648,-1808896,148992,-1659904,38
3587,303,21,9,0.0778920308,0.922107969,1119.371856,1163.719078,1948.793699,1906.508251,3890,67.77003484,7780,-1836544,155136,-1681408,38
3592,289,22,8,0.074465344,0.925534656,1120.65656,1116.451026,1940.127506,1951.844291,3881,98.67785406,7762,-1839104,147968,-1691136,38
3551,303,23,7,0.078619616,0.921380384,1112.786558,1108.559485,1923.161926,1978.339934,3854,99.48373774,7708,-1818112,155136,-1662976,38
3572,299,23,7,0.077241023,0.922758977,1119.62098,1091.225919,1934.778275,1950.595318,3871,94.83096521,7742,-1828864,153088,-1675776,38
3587,297,21,9,0.0764675592,0.923532441,1122.298877,1107.953115,1941.46111,1955.047138,3884,68.26010545,7768,-1836544,152064,-1684480,38
3536,294,23,7,0.0767624021,0.923237598,1108.449669,1067.159309,1908.186652,2003.459184,3830,97.80388151,7660,-1810432,150528,-1659904,38
3607,304,22,8,0.077729481,0.922270519,1133.357742,1075.998304,1955.051012,1967.259868,3911,92.63382283,7822,-1846784,155648,-1691136,38
3563,302,22,8,0.0781371281,0.921862872,1119.796592,1065.688094,1929.463374,1974.725166,3865,96.00099354,7730,-1824256,154624,-1669632,38
4619,329,22,8,0.0664915117,0.933508488,1430.736995,1370.401625,2456.687595,2724.577508,4948,100.9178054,9896,-2364928,168448,-2196480,38
3548,284,23,7,0.0741127349,0.925887265,1109.313542,1064.380618,1911.22717,1982.373239,3832,89.67938217,7664,-1816576,145408,-1671168,38
4663,336,22,8,0.0672134427,0.932786557,1446.428089,1348.108855,2474.799914,2849.72619,4999,115.0782689,9998,-2387456,172032,-2215424,38
4628,337,21,9,0.0678751259,0.932124874,1434.807459,1384.642029,2463.547753,2750.136499,4965,101.1819849,9930,-2369536,172544,-2196992,38
985,92,23,7,0.0854224698,0.91457753,304.8718073,328.4417476,554.0923858,377.4130435,1077,19.17735043,2154,-504320,47104,-457216,38
1189,167,22,8,0.123156342,0.876843658,389.03577,381.2110927,697.6879731,541.8862275,1356,23.74781086,2712,-608768,85504,-523264,38
1359,166,21,9,0.108852459,0.891147541,442.0497252,417.0932723,772.4297277,685.8012048,1525,54.91537631,3050,-695808,84992,-610816,38
1388,172,21,9,0.11025641,0.88974359,450.939066,439.7120291,788.8033141,713.494186,1560,59.36073059,3120,-710656,88064,-622592,38
1373,175,22,8,0.113049096,0.886950904,450.0699934,415.9754172,782.214858,713.9714286,1548,38.62275449,3096,-702976,89600,-613376,38
1502,178,21,9,0.105952381,0.894047619,491.092004,422.2632179,849.5379494,764.2359551,1680,53.4351145,3360,-769024,91136,-677888,38
1211,162,24,6,0.117989803,0.882010197,396.1720475,376.1889816,703.2039637,565.8703704,1373,47.39385571,2746,-620032,82944,-537088,38
1361,170,21,9,0.111038537,0.888961463,442.4102775,427.7925972,777.2630419,675.8294118,1531,57.81722054,3062,-696832,87040,-609792,38
1114,150,22,8,0.118670886,0.881329114,360.3618987,359.4851741,653.7558348,474.64,1264,49.76377953,2528,-570368,76800,-493568,38
1392,170,21,9,0.108834827,0.891165173,451.1687743,442.1394336,790.3742816,708.8352941,1562,59.89263804,3124,-712704,87040,-625664,38
1140,158,23,7,0.121725732,0.878274268,369.0795435,375.3683387,671.8701754,488.0949367,1298,49.76993865,2596,-583680,80896,-502784,38
1202,169,23,7,0.123267688,0.876732312,395.3780834,367.7543663,706.2321131,542.1005917,1371,50.33039648,2742,-615424,86528,-528896,38
510,129,23,7,0.201877934,0.798122066,185.2706964,180.4880034,323.7156863,305.3100775,639,19.66153846,1278,-261120,66048,-195072,38
1134,160,24,6,0.123647604,0.876352396,368.0697855,373.5657397,669.9021164,488.725,1294,22.40692641,2588,-580608,81920,-498688,38
1194,161,23,7,0.118819188,0.881180812,392.4606772,350.4693946,697.0217755,536.931677,1355,44.32450114,2710,-611328,82432,-528896,38
1380,169,22,8,0.109102647,0.890897353,450.4697767,410.1532685,784.9753623,693.5443787,1549,28.04127444,3098,-706560,86528,-620032,38
1387,175,22,8,0.112035851,0.887964149,453.4688137,422.7759936,790.8940159,707.0457143,1562,50.87947883,3124,-710144,89600,-620544,38
1123,156,24,6,0.121970289,0.878029711,366.1920066,359.28274,659.8441674,497.1474359,1279,47.0393527,2558,-574976,79872,-495104,38
1364,171,21,9,0.111400651,0.888599349,445.8788053,410.8237992,778.5608504,683.7602339,1535,57.44760479,3070,-698368,87552,-610816,38
1142,156,24,6,0.1201849,0.8798151,369.3246883,379.3494086,670.0700525,498.9166667,1298,55.0466497,2596,-584704,79872,-504832,38
1365,159,21,9,0.104330709,0.895669291,445.906823,360.7240215,777.3128205,635.3333333,1524,28.17005545,3048,-698880,81408,-617472,38
9392,565,22,8,0.0567439992,0.943256001,2851.701856,2974.34164,5052.201342,3762.173451,9957,874.1878841,19914,-4808704,289280,-4519424,39
9358,588,21,9,0.0591192439,0.940880756,2845.067294,3091.856352,5036.191173,3975.772109,9946,289.5487627,19892,-4791296,301056,-4490240,39
9410,546,21,9,0.0548413017,0.945158698,2856.510402,2919.867616,5046.81796,3801.078755,9956,601.570997,19912,-4817920,279552,-4538368,39
9392,565,22,8,0.0567439992,0.943256001,2850.285903,3020.094354,5048.859561,3817.723894,9957,1058.129649,19914,-4808704,289280,-4519424,39
9380,573,22,8,0.0575705817,0.942429418,2840.893506,3047.471342,5060.62548,3608.052356,9953,860.9861592,19906,-4802560,293376,-4509184,39
9393,558,21,9,0.0560747664,0.943925234,2844.111276,2964.974989,5061.663579,3533.996416,9951,569.6050372,19902,-4809216,285696,-4523520,39
9440,517,21,9,0.0519232701,0.94807673,2862.278476,2879.412137,5038.238242,3897.357834,9957,1032.883817,19914,-4833280,264704,-4568576,39
9393,564,21,9,0.0566435673,0.943356433,2850.473829,2928.409209,5060.679123,3618.695035,9957,316.6984733,19914,-4809216,288768,-4520448,39
9406,551,22,8,0.0553379532,0.944662047,2855.625619,2880.498589,5055.279609,3676.84755,9957,979.0560472,19914,-4815872,282112,-4533760,39
9425,528,22,8,0.0530493319,0.946950668,2862.545921,2831.809902,5039.75565,3856.787879,9953,831.4954052,19906,-4825600,270336,-4555264,39
9379,567,21,9,0.0570078423,0.942992158,2842.47131,3187.766518,5025.791342,4108.525573,9946,713.4863702,19892,-4802048,290304,-4511744,39
9395,560,22,8,0.0562531391,0.943746861,2846.801496,2905.271224,5067.805109,3471.358929,9955,870.1923077,19910,-4810240,286720,-4523520,39
9398,559,22,8,0.0561414081,0.943858592,2853.97724,2981.281524,5045.759843,3856.62254,9957,568.3219178,19914,-4811776,286208,-4525568,39
9335,607,21,9,0.0610541139,0.938945886,2828.521485,3133.237581,5061.835458,3582.23888,9942,563.286119,19884,-4779520,310784,-4468736,39
9378,573,22,8,0.0575821525,0.942417847,2855.542554,2836.904844,5055.658243,3672.273997,9951,423.8074957,19902,-4801536,293376,-4508160,39
9389,568,22,8,0.0570452948,0.942954705,2856.692223,2877.922803,5054.484077,3731.253521,9957,529.3460925,19914,-4807168,290816,-4516352,39
9370,584,22,8,0.0586698815,0.941330119,2842.58637,2893.361661,5077.191996,3377.989726,9954,1070.322581,19908,-4797440,299008,-4498432,39
9388,569,21,9,0.0571457266,0.942854273,2852.227708,2900.037803,5060.985833,3626.3058,9957,227.0177839,19914,-4806656,291328,-4515328,39
9365,588,21,9,0.059077665,0.940922335,2837.585016,3034.002614,5069.12173,3509.789116,9953,526.0570825,19906,-4794880,301056,-4493824,39
2855,239,21,9,0.0772462831,0.922753717,872.4713756,1071.83566,1570.982837,1266.983264,3094,47.61465066,6188,-1461760,122368,-1339392,39
3121,509,21,9,0.140220386,0.859779614,1029.155592,1152.094832,1830.127844,1725.807466,3630,71.28829537,7260,-1597952,260608,-1337344,39
4154,543,21,9,0.115605706,0.884394294,1333.610912,1489.01148,2383.785749,2082.88582,4697,96.36848584,9394,-2126848,278016,-1848832,39
4176,560,21,9,0.118243243,0.881756757,1356.073663,1397.1523,2416.010057,2014.210714,4736,101.7400644,9472,-2138112,286720,-1851392,39
2335,415,21,9,0.150909091,0.849090909,782.5334685,850.2265828,1389.921199,1294.359036,2750,48.93238434,5500,-1195520,212480,-983040,39
7164,1374,21,9,0.160927618,0.839072382,2408.065162,2669.713586,4160.276242,4838.989811,8538,152.9833363,17076,-3667968,703488,-2964480,39
4204,524,21,9,0.110829103,0.889170897,1347.140353,1474.637273,2396.415319,2108.446565,4728,96.9051035,9456,-2152448,268288,-1884160,39
2385,388,21,9,0.139920664,0.860079336,791.8356141,850.3840959,1394.405031,1341.481959,2773,55.48219288,5546,-1221120,198656,-1022464,39
4236,543,21,9,0.113622097,0.886377903,1362.865657,1472.384159,2426.779509,2103.07919,4779,102.7520963,9558,-2168832,278016,-1890816,39
4176,535,21,9,0.113563999,0.886436001,1337.937914,1489.927047,2392.801964,2068.738318,4711,105.2032157,9422,-2138112,273920,-1864192,39
4224,570,21,9,0.118898623,0.881101377,1361.996629,1508.751785,2434.374763,2124.238596,4794,102.919708,9588,-2162688,291840,-1870848,39
102,28,21,9,0.215384615,0.784615385,37.62812024,36.09021788,67.64705882,57.67857143,130,2.648197189,260,-52224,14336,-37888,39
4200,542,21,9,0.114297765,0.885702235,1352.969235,1460.388397,2405.223333,2110.175277,4742,95.03006012,9484,-2150400,277504,-1872896,39
4182,539,21,9,0.114170727,0.885829273,1340.648293,1503.788001,2391.041607,2127.912801,4721,99.43133951,9442,-2141184,275968,-1865216,39
4206,546,21,9,0.11489899,0.88510101,1349.868226,1502.411421,2411.903947,2103.772894,4752,105.5765385,9504,-2153472,279552,-1873920,39
4174,550,21,9,0.116426757,0.883573243,1346.319517,1449.861362,2404.515333,2043.641818,4724,102.829778,9448,-2137088,281600,-1855488,39
3978,514,21,9,0.114425646,0.885574354,1289.21806,1284.214201,2298.460784,1844.359922,4492,89.53557903,8984,-2036736,263168,-1773568,39
2324,336,21,9,0.126315789,0.873684211,764.4364421,789.9113142,1336.730207,1287.407738,2660,48.30216089,5320,-1189888,172032,-1017856,39
4185,529,21,9,0.112218922,0.887781078,1338.262167,1510.791446,2384.365591,2144.962193,4714,96.67760459,9428,-2142720,270848,-1871872,39
4159,550,21,9,0.116797622,0.883202378,1344.910399,1424.217756,2397.183458,2036.016364,4709,85.96202994,9418,-2129408,281600,-1847808,39
664,115,21,9,0.14762516,0.85237484,216.8331084,264.1026016,384.1536145,423.7565217,779,10.73002755,1558,-339968,58880,-281088,39
4936,746,21,9,0.131291799,0.868708201,1571.561162,1893.154984,2735.508104,3542.808311,5682,135.3501667,11364,-2527232,381952,-2145280,39
3919,373,21,9,0.0869058714,0.913094129,1230.845648,1296.803996,2169.659352,1903.171582,4292,140.2614379,8584,-2006528,190976,-1815552,39
4051,430,21,9,0.0959607231,0.904039277,1281.122972,1347.114289,2281.378919,1860.593023,4481,138.3878938,8962,-2074112,220160,-1853952,39
3877,391,21,9,0.0916119963,0.908388004,1220.881803,1312.752037,2159.320867,1888.386189,4268,124.8318222,8536,-1985024,200192,-1784832,39
3889,390,21,9,0.0911427904,0.90885721,1222.711266,1317.702595,2169.711494,1843.723077,4279,111.577575,8558,-1991168,199680,-1791488,39
3932,397,21,9,0.0917070917,0.908292908,1237.585405,1335.950282,2191.305951,1904.458438,4329,136.863737,8658,-2013184,203264,-1809920,39
3077,337,23,7,0.0987111892,0.901288811,964.5655104,1148.583493,1724.085798,1556.062315,3414,101.3657957,6828,-1575424,172544,-1402880,39
3938,402,20,10,0.0926267281,0.907373272,1243.764692,1308.924216,2197.753174,1903.527363,4340,137.2115081,8680,-2016256,205824,-1810432,39
3820,390,21,9,0.0926365796,0.90736342,1205.383033,1288.951125,2127.52199,1889.797436,4210,124.962897,8420,-1955840,199680,-1756160,39
4020,404,21,9,0.0913200723,0.908679928,1265.735732,1350.111793,2242.134577,1917.621287,4424,141.2065113,8848,-2058240,206848,-1851392,39
3897,397,21,9,0.0924545878,0.907545412,1226.726866,1328.22338,2175.511676,1872.534005,4294,131.5563725,8588,-1995264,203264,-1792000,39
3977,383,21,9,0.0878440367,0.912155963,1249.153739,1332.977836,2201.853659,1958.767624,4360,133.9477727,8720,-2036224,196096,-1840128,39
4833,558,21,9,0.103505843,0.896494157,1533.427395,1738.683446,2685.306435,2788.620072,5391,129.5602019,10782,-2474496,285696,-2188800,39
5036,622,21,9,0.109932838,0.890067162,1607.594864,1827.169259,2821.833797,2891.569132,5658,111.4876847,11316,-2578432,318464,-2259968,39
3901,404,21,9,0.093844367,0.906155633,1226.786326,1357.600646,2181.216098,1880.54703,4305,139.1402715,8610,-1997312,206848,-1790464,39
3895,396,21,9,0.0922861804,0.90771382,1226.587118,1316.778439,2175.748652,1853.396465,4291,139.863103,8582,-1994240,202752,-1791488,39
4996,624,21,9,0.111032028,0.888967972,1592.884229,1839.14617,2799.831865,2895.913462,5620,144.139523,11240,-2557952,319488,-2238464,39
3998,408,21,9,0.0926009986,0.907399001,1259.442836,1364.055703,2228.502251,1958.502451,4406,140.5422648,8812,-2046976,208896,-1838080,39
4987,610,21,9,0.108986957,0.891013043,1585.319787,1838.095694,2779.899739,2955.152459,5597,154.0176114,11194,-2553344,312320,-2241024,39
3977,397,21,9,0.0907636031,0.909236397,1251.86562,1341.841543,2211.919789,1942.871537,4374,124.1203178,8748,-2036224,203264,-1832960,39
4188,616,22,8,0.128226478,0.871773522,1361.184457,1543.705794,2421.256686,2274.978896,4804,83.72255141,9608,-2144256,315392,-1828864,39
4133,562,21,9,0.11970181,0.88029819,1334.730368,1477.458987,2379.651827,2115.229537,4695,96.24846248,9390,-2116096,287744,-1828352,39
4180,564,22,8,0.118887015,0.881112985,1348.597854,1499.658154,2399.970813,2168.904255,4744,103.9439089,9488,-2140160,288768,-1851392,39
4155,560,21,9,0.118769883,0.881230117,1341.193634,1485.909963,2384.497714,2161.396429,4715,102.6785714,9430,-2127360,286720,-1840640,39
4132,549,22,8,0.117282632,0.882717368,1334.897392,1453.438775,2367.444095,2141.970856,4681,91.78431373,9362,-2115584,281088,-1834496,39
4095,546,22,8,0.117647059,0.882352941,1323.986242,1431.155424,2352.048107,2088.139194,4641,95.73019802,9282,-2096640,279552,-1817088,39
4030,579,22,8,0.12562378,0.87437622,1308.21367,1463.140752,2331.477171,2120.711572,4609,95.32574974,9218,-2063360,296448,-1766912,39
4100,575,22,8,0.122994652,0.877005348,1336.138331,1418.403266,2371.840244,2096.704348,4675,101.5641973,9350,-2099200,294400,-1804800,39
4096,579,22,8,0.123850267,0.876149733,1330.009539,1459.525443,2370.843262,2105.658031,4675,91.54102213,9350,-2097152,296448,-1800704,39
114,22,22,8,0.161764706,0.838235294,38.71103816,41.77992321,69.22807018,64.72727273,136,12.08888889,272,-58368,11264,-47104,39
4042,582,22,8,0.125865052,0.874134948,1328.826785,1333.224886,2358.23528,1994.867698,4624,91.61878344,9248,-2069504,297984,-1771520,39
4071,573,21,9,0.123385013,0.876614987,1330.406261,1382.002876,2359.977892,2056.230366,4644,94.35188948,9288,-2084352,293376,-1790976,39
4097,537,22,8,0.115882607,0.884117393,1318.622004,1461.181638,2342.607274,2125.945996,4634,89.87587277,9268,-2097664,274944,-1822720,39
4133,581,21,9,0.123249894,0.876750106,1341.019262,1466.672535,2394.996371,2090.765921,4714,105.4350257,9428,-2116096,297472,-1818624,39
4184,577,21,9,0.121193027,0.878806973,1353.596298,1493.578675,2415.038958,2134.17331,4761,101.7307692,9522,-2142208,295424,-1846784,39
8284,1520,22,8,0.15503876,0.84496124,2811.111195,2904.339067,4834.892081,5270.963158,9804,256.9855832,19608,-4241408,778240,-3463168,39
4091,582,21,9,0.12454526,0.87545474,1331.524684,1431.757536,2378.81496,2043.073883,4673,92.27883096,9346,-2094592,297984,-1796608,39
4061,552,22,8,0.119661825,0.880338175,1315.260689,1418.319605,2343.296479,2039.971014,4613,90.61088195,9226,-2079232,282624,-1796608,39
4398,568,22,8,0.114377769,0.885622231,1407.973987,1610.704901,2502.203502,2338.679577,4966,107.4194246,9932,-2251776,290816,-1960960,39
764,126,21,9,0.141573034,0.858426966,249.2180123,293.7777409,454.3337696,391.9365079,890,14.01354117,1780,-391168,64512,-326656,39
8354,1470,22,8,0.14963355,0.85036645,2828.975397,2842.120726,4841.901963,5313.708163,9824,297.6969697,19648,-4277248,752640,-3524608,39
4481,554,21,9,0.110029791,0.889970209,1433.464865,1589.686946,2544.813435,2301.120939,5035,107.4935952,10070,-2294272,283648,-2010624,39
4278,524,22,8,0.1091212,0.8908788,1364.850357,1527.504105,2431.702899,2154.919847,4802,98,9604,-2190336,268288,-1922048,39
4366,552,21,9,0.112240748,0.887759252,1401.235699,1519.535663,2500.532066,2134.960145,4918,106.4732626,9836,-2235392,282624,-1952768,39
4372,539,22,8,0.109753614,0.890246386,1397.288298,1544.037184,2491.179323,2170.649351,4911,108.8913525,9822,-2238464,275968,-1962496,39
180,60,21,9,0.25,0.75,70.89081241,64.20876541,120.3222222,121.0333333,240,8.8365243,480,-92160,30720,-61440,39
4330,552,20,10,0.113068415,0.886931585,1390.453205,1515.366748,2480.217783,2137.789855,4882,102.2408377,9764,-2216960,282624,-1934336,39
6998,1216,21,9,0.148039932,0.851960068,2330.493752,2531.205551,4017.298085,4626.606086,8214,151.801885,16428,-3582976,622592,-2960384,39
4348,552,21,9,0.112653061,0.887346939,1396.671732,1507.809582,2492.321987,2121.076087,4900,100.8853202,9800,-2226176,282624,-1943552,39
4299,513,22,8,0.106608479,0.893391521,1365.081687,1565.819326,2426.765527,2236.672515,4812,105.4107338,9624,-2201088,262656,-1938432,39
4227,541,21,9,0.113464765,0.886535235,1356.014525,1489.713845,2424.561391,2071.487985,4768,98.5327547,9536,-2164224,276992,-1887232,39
4293,536,22,8,0.110996065,0.889003935,1370.58313,1551.978261,2442.206848,2197.091418,4829,97.35887097,9658,-2198016,274432,-1923584,39
4321,564,22,8,0.115455476,0.884544524,1387.908835,1534.965033,2483.690812,2131.253546,4885,108.5073301,9770,-2212352,288768,-1923584,39
4315,555,22,8,0.113963039,0.886036961,1380.962728,1559.272406,2470.643801,2162.264865,4870,109.0217148,9740,-2209280,284160,-1925120,39
4240,545,22,8,0.113897597,0.886102403,1360.189395,1501.441978,2432.051887,2089.183486,4785,106.1446318,9570,-2170880,279040,-1891840,39
8571,1266,21,9,0.128697774,0.871302226,2846.1532,2793.802028,4905.187143,5012.515008,9837,267.2371638,19674,-4388352,648192,-3740160,39
4299,555,21,9,0.11433869,0.88566131,1387.832568,1457.960704,2470.833217,2091.843243,4854,100.0412201,9708,-2201088,284160,-1916928,39
1232,281,22,8,0.185723728,0.814276272,417.4423555,497.3181153,731.1241883,870.4483986,1513,28.64445286,3026,-630784,143872,-486912,39
904,220,21,9,0.195729537,0.804270463,319.374734,344.1865839,558.7267699,578.0045455,1124,20.28880866,2248,-462848,112640,-350208,39
4349,553,20,10,0.112811098,0.887188902,1390.863444,1562.474209,2488.541274,2160.19349,4902,105.193133,9804,-2226688,283136,-1943552,39
2006,356,22,8,0.150719729,0.849280271,679.791807,670.5546151,1210.329511,1019.050562,2362,80.06779661,4724,-1027072,182272,-844800,39
2013,321,22,8,0.137532134,0.862467866,674.699984,623.9561952,1202.781421,946.2492212,2334,78.74493927,4668,-1030656,164352,-866304,39
2009,355,21,9,0.150169205,0.849830795,685.0552285,629.0737997,1218.794425,977.1042254,2364,63.20855615,4728,-1028608,181760,-846848,39
2891,656,21,9,0.184945024,0.815054976,977.1718805,1186.710874,1727.056382,1980.881098,3547,92.12987013,7094,-1480192,335872,-1144320,39
2013,342,22,8,0.14522293,0.85477707,683.9797629,606.846906,1216.665176,950.4181287,2355,64.16893733,4710,-1030656,175104,-855552,39
1980,343,22,8,0.147653896,0.852346104,673.3627733,619.1085503,1195.890909,966.361516,2323,71.65330043,4646,-1013760,175616,-838144,39
2846,530,22,8,0.156990521,0.843009479,962.5489446,1032.374638,1704.718552,1601.409434,3376,81.84242424,6752,-1457152,271360,-1185792,39
1995,369,22,8,0.156091371,0.843908629,680.6181322,673.1620492,1209.84411,1034.663957,2364,78.04555959,4728,-1021440,188928,-832512,39
2020,385,22,8,0.16008316,0.83991684,696.4091833,648.8245469,1240.207426,1007.781818,2405,79.39914163,4810,-1034240,197120,-837120,39
2029,351,21,9,0.147478992,0.852521008,683.7468428,673.487047,1224.231148,995.5128205,2380,78.80794702,4760,-1038848,179712,-859136,39
1981,372,21,9,0.158096048,0.841903952,677.1749014,655.0626926,1214.466936,977.4784946,2353,72.71322621,4706,-1014272,190464,-823808,39
1983,369,22,8,0.156887755,0.843112245,678.9414953,652.0246402,1208.927383,1002.235772,2352,68.9533861,4704,-1015296,188928,-826368,39
2018,348,22,8,0.147083686,0.852916314,677.8701331,683.2276106,1215.44004,998.2844828,2366,68.4804631,4732,-1033216,178176,-855040,39
2031,343,22,8,0.144481887,0.855518113,682.8851091,661.5258535,1223.025603,977.1428571,2374,63.8172043,4748,-1039872,175616,-864256,39
2057,364,22,8,0.150351095,0.849648905,701.5386019,654.1363355,1243.426835,1027.752747,2421,81.57008086,4842,-1053184,186368,-866816,39
2005,361,21,9,0.152578191,0.847421809,679.7068358,672.9327377,1216.073317,1002.587258,2366,64.45110324,4732,-1026560,184832,-841728,39
2043,346,22,8,0.144830473,0.855169527,688.5933551,656.4524703,1231.136074,981.6300578,2389,81.39693356,4778,-1046016,177152,-868864,39
2030,332,22,8,0.140558848,0.859441152,682.783223,633.7907599,1217.20197,963.2018072,2362,74.37027708,4724,-1039360,169984,-869376,39
2008,375,22,8,0.157364666,0.842635334,688.0963209,650.0818183,1230.050299,988.2533333,2383,78.38815789,4766,-1028096,192000,-836096,39
1870,337,22,8,0.152695967,0.847304033,641.994563,587.7289144,1130.635294,956.2017804,2207,76.07721475,4414,-957440,172544,-784896,39
3195,399,21,9,0.111018364,0.888981636,1023.613398,1098.191217,1834.649452,1500.025063,3594,79.44297082,7188,-1635840,204288,-1431552,39
3375,441,21,9,0.115566038,0.884433962,1090.976143,1148.539944,1941.552593,1655.546485,3816,74.19793895,7632,-1728000,225792,-1502208,39
3276,411,21,9,0.111472742,0.888527258,1054.475251,1096.431475,1880.899573,1549.880779,3687,80.67833698,7374,-1677312,210432,-1466880,39
3307,422,21,9,0.113167069,0.886832931,1066.248912,1127.756174,1894.083157,1637.090047,3729,82.13656388,7458,-1693184,216064,-1477120,39
3347,411,21,9,0.109366684,0.890633316,1072.435487,1145.555474,1912.790857,1608.394161,3758,85.99542334,7516,-1713664,210432,-1503232,39
3270,402,21,9,0.109477124,0.890522876,1047.142372,1114.596773,1873.54159,1535.191542,3672,74.45255474,7344,-1674240,205824,-1468416,39
3163,382,23,7,0.107757405,0.892242595,1013.624547,1069.393808,1802.6908,1527.157068,3545,67.87287,7090,-1619456,195584,-1423872,39
3235,404,21,9,0.111019511,0.888980489,1040.390829,1076.890479,1859.563833,1503.195545,3639,71.3249706,7278,-1656320,206848,-1449472,39
3301,397,21,9,0.107355327,0.892644673,1056.339958,1125.086702,1879.825204,1597.350126,3698,83.21332133,7396,-1690112,203264,-1486848,39
187,62,21,9,0.248995984,0.751004016,73.01991767,68.32472239,124.973262,125.0806452,249,11.9138756,498,-95744,31744,-64000,39
3321,406,21,9,0.1089348,0.8910652,1064.160732,1124.948393,1900.015056,1569.403941,3727,80.23681378,7454,-1700352,207872,-1492480,39
3281,390,21,9,0.106238082,0.893761918,1047.257403,1132.136385,1864.050594,1600.015385,3671,78.40666382,7342,-1679872,199680,-1480192,39
3777,567,21,9,0.130524862,0.869475138,1225.16995,1431.03881,2168.408525,2199.75485,4344,80.38490007,8688,-1933824,290304,-1643520,39
3541,417,21,9,0.105356241,0.894643759,1133.12997,1172.882766,2016.838464,1662.436451,3958,88.36793927,7916,-1812992,213504,-1599488,39
3281,403,21,9,0.109391965,0.890608035,1052.547419,1116.892864,1873.574215,1589.511166,3684,83.19783198,7368,-1679872,206336,-1473536,39
3580,427,21,9,0.106563514,0.893436486,1147.263983,1197.663066,2037.117598,1726.339578,4007,76.42571047,8014,-1832960,218624,-1614336,39
2962,382,21,9,0.11423445,0.88576555,960.4992956,959.1966806,1707.664416,1399.837696,3344,60.33922772,6688,-1516544,195584,-1320960,39
3718,544,21,9,0.127639606,0.872360394,1200.423592,1416.126144,2121.64255,2198.871324,4262,87.91254125,8524,-1903616,278528,-1625088,39
3491,423,21,9,0.108073582,0.891926418,1117.634626,1192.247869,1990.307362,1686.742317,3914,84.11777348,7828,-1787392,216576,-1570816,39
98,41,21,9,0.294964029,0.705035971,36.90950046,44.64996388,64.92857143,82.12195122,139,8.138173302,278,-50176,20992,-29184,39
4212,554,21,9,0.116240034,0.883759966,1350.407542,1531.758416,2417.013058,2128.703971,4766,104.8855634,9532,-2156544,283648,-1872896,39
4188,535,20,10,0.113275461,0.886724539,1343.657147,1483.79072,2395.140401,2102.575701,4723,101.5698925,9446,-2144256,273920,-1870336,39
4202,570,21,9,0.119446773,0.880553227,1368.402408,1390.797973,2435.581628,2024.673684,4772,97.2488282,9544,-2151424,291840,-1859584,39
4267,535,21,9,0.111411912,0.888588088,1363.138194,1541.411303,2428.385517,2187.069159,4802,93.86239249,9604,-2184704,273920,-1910784,39
4231,546,21,9,0.114297676,0.885702324,1357.116232,1509.000538,2425.144647,2108.912088,4777,96.46607431,9554,-2166272,279552,-1886720,39
4213,565,21,9,0.118250314,0.881749686,1363.976171,1458.226119,2427.124377,2108.948673,4778,84.2235149,9556,-2157056,289280,-1867776,39
3752,505,21,9,0.118628142,0.881371858,1233.040763,1116.055554,2183.885394,1721.217822,4257,75.37181303,8514,-1921024,258560,-1662464,39
4285,547,21,9,0.113203642,0.886796358,1371.796291,1543.170366,2447.046208,2177.212066,4832,104.362851,9664,-2193920,280064,-1913856,39
4221,570,21,9,0.118973075,0.881026925,1361.997145,1496.423203,2436.348022,2097.212281,4791,108.5902085,9582,-2161152,291840,-1869312,39
4247,527,21,9,0.11038961,0.88961039,1357.985219,1508.019701,2418.34024,2138.963947,4774,100.7598143,9548,-2174464,269824,-1904640,39
4175,555,21,9,0.117336152,0.882663848,1339.6205,1525.963636,2396.372455,2133.261261,4730,102.3587968,9460,-2137600,284160,-1853440,39
4292,563,21,9,0.115962925,0.884037075,1378.492562,1532.765445,2467.555685,2126.449378,4855,99.50809592,9710,-2197504,288256,-1909248,39
4120,512,21,9,0.110535406,0.889464594,1321.997761,1407.595801,2358.87233,1975.535156,4632,105.946935,9264,-2109440,262144,-1847296,39
4127,542,21,9,0.116084815,0.883915185,1325.137144,1479.98374,2371.63339,2056.059041,4669,99.23485654,9338,-2113024,277504,-1835520,39
4193,537,21,9,0.113530655,0.886469345,1345.578498,1487.989649,2397.535893,2115.357542,4730,101.480369,9460,-2146816,274944,-1871872,39
4263,543,21,9,0.11298377,0.88701623,1362.837532,1544.298629,2435.169833,2154.865562,4806,106.7525544,9612,-2182656,278016,-1904640,39
4532,552,21,9,0.108575924,0.891424076,1447.505017,1601.214319,2573.26346,2289.927536,5084,100.4544556,10168,-2320384,282624,-2037760,39
4466,540,21,9,0.107870555,0.892129445,1422.053249,1609.361391,2527.718764,2303.201852,5006,101.5209897,10012,-2286592,276480,-2010112,39
4438,537,21,9,0.107939698,0.892060302,1412.549333,1604.740862,2511.751915,2291.703911,4975,100.6881198,9950,-2272256,274944,-1997312,39
4244,549,21,9,0.11454204,0.88545796,1354.690463,1578.063691,2420.257304,2217.211293,4793,109.3543235,9586,-2172928,281088,-1891840,39
3298,479,21,9,0.126820228,0.873179772,1090.460493,1023.573475,1939.615221,1540.505219,3777,68.86052871,7554,-1688576,245248,-1443328,39
4155,582,22,8,0.122862571,0.877137429,1352.677885,1460.002836,2389.85343,2220.123711,4737,94.60754943,9474,-2127360,297984,-1829376,39
3864,592,21,9,0.132854578,0.867145422,1270.145405,1370.88356,2258.934265,2029.85473,4456,97.22888937,8912,-1978368,303104,-1675264,39
3894,574,21,9,0.128469114,0.871530886,1272.884491,1378.414315,2267.540318,2010.355401,4468,96.08602151,8936,-1993728,293888,-1699840,39
3876,590,22,8,0.13210927,0.86789073,1272.712857,1379.450508,2260.81063,2054.083051,4466,98.41339797,8932,-1984512,302080,-1682432,39
3809,571,22,8,0.130365297,0.869634703,1252.327533,1307.717247,2232.718299,1908.872154,4380,92.81627463,8760,-1950208,292352,-1657856,39
3706,513,21,9,0.121592795,0.878407205,1198.983121,1329.387836,2138.037507,1907.452242,4219,92.33968046,8438,-1897472,262656,-1634816,39
3888,539,22,8,0.12175288,0.87824712,1256.910595,1415.655983,2229.42001,2102.769944,4427,94.81687728,8854,-1990656,275968,-1714688,39
3895,563,22,8,0.126289816,0.873710184,1277.656466,1323.861343,2264.676252,1986.14032,4458,92.14551468,8916,-1994240,288256,-1705984,39
3897,554,22,8,0.124466412,0.875533588,1258.066647,1452.735318,2244.988709,2092.427798,4451,100.2703312,8902,-1995264,283648,-1711616,39
3792,550,21,9,0.126669737,0.873330263,1234.778972,1361.525197,2197.658492,1991.149091,4342,93.92169587,8684,-1941504,281600,-1659904,39
3790,571,22,8,0.130933272,0.869066728,1243.68288,1337.025513,2212.467282,1972.136602,4361,95.21834061,8722,-1940480,292352,-1648128,39
4074,569,22,8,0.122550075,0.877449925,1327.563819,1419.057379,2343.245214,2169.885764,4643,90.5774483,9286,-2085888,291328,-1794560,39
3839,549,22,8,0.125113947,0.874886053,1254.112833,1333.750058,2223.698098,1990.326047,4388,87.56735183,8776,-1965568,281088,-1684480,39
2256,386,21,9,0.146101438,0.853898562,751.5053993,820.1944394,1335.508865,1239.624352,2642,52.46227164,5284,-1155072,197632,-957440,39
4114,585,22,8,0.124494573,0.875505427,1347.342493,1399.513583,2381.271998,2130.080342,4699,86.37867647,9398,-2106368,299520,-1806848,39
3839,570,22,8,0.129281016,0.870718984,1254.942792,1375.268273,2229.803595,2037.945614,4409,156.1813673,8818,-1965568,291840,-1673728,39
103,21,21,9,0.169354839,0.830645161,35.11453057,38.77886607,63.19417476,59.0952381,124,12.5,248,-52736,10752,-41984,39
3830,569,21,9,0.129347579,0.870652421,1252.78903,1356.834958,2234.472846,1967.959578,4399,96.78767877,8798,-1960960,291328,-1669632,39
760,123,21,9,0.139297848,0.860702152,246.9659688,292.9770266,451.1842105,385.2520325,883,13.66661508,1766,-389120,62976,-326144,39
4872,579,21,9,0.106219042,0.893780958,1550.320524,1689.526769,2780.198481,2269.946459,5451,118.0125568,10902,-2494464,296448,-2198016,39
5147,562,22,8,0.098441058,0.901558942,1619.681981,1858.451257,2889.553332,2538.548043,5709,119.5101528,11418,-2635264,287744,-2347520,39
4905,577,22,8,0.105253557,0.894746443,1554.347577,1751.406291,2789.760041,2331.247834,5482,123.5519495,10964,-2511360,295424,-2215936,39
4784,583,22,8,0.108626793,0.891373207,1522.088128,1702.969328,2733.701923,2276.154374,5367,122.8708791,10734,-2449408,298496,-2150912,39
4841,556,21,9,0.103020196,0.896979804,1532.506604,1715.322319,2743.903119,2308.035971,5397,116.2144703,10794,-2478592,284672,-2193920,39
7344,1180,21,9,0.138432661,0.861567339,2405.056093,2761.117612,4211.887391,4577.499153,8524,154.252624,17048,-3760128,604160,-3155968,39
4777,554,22,8,0.103920465,0.896079535,1515.964129,1644.50675,2722.914381,2175.241877,5331,117.526455,10662,-2445824,283648,-2162176,39
4869,582,22,8,0.1067694,0.8932306,1552.78008,1667.853917,2781.123434,2264.838488,5451,119.6181698,10902,-2492928,297984,-2194944,39
4798,553,22,8,0.103345169,0.896654831,1515.686939,1742.483694,2713.845561,2347.640145,5351,115.622299,10702,-2456576,283136,-2173440,39
6025,894,22,8,0.129209423,0.870790577,1952.035333,2277.662743,3447.958506,3541.152125,6919,132.6241135,13838,-3084800,457728,-2627072,39
4887,591,22,8,0.10788609,0.89211391,1563.602793,1619.656142,2806.031921,2189.345178,5478,111.2284264,10956,-2502144,302592,-2199552,39
4873,560,22,8,0.103073808,0.896926192,1542.562332,1726.05864,2763.071824,2316.092857,5433,122.3373114,10866,-2494976,286720,-2208256,39
4866,589,21,9,0.107974335,0.892025665,1538.061635,1813.252025,2769.950884,2381.424448,5455,125.720212,10910,-2491392,301568,-2189824,39
1042,181,22,8,0.147996729,0.852003271,350.6289605,358.1411937,624.609405,539.4088398,1223,81.10079576,2446,-533504,92672,-440832,39
90,18,22,8,0.166666667,0.833333333,29.14696901,39.63977458,53.85555556,57.72222222,108,32.72727273,216,-46080,9216,-36864,39
5103,577,22,8,0.101584507,0.898415493,1615.17223,1790.646311,2886.901039,2430.12825,5680,111.0025406,11360,-2612736,295424,-2317312,39
4865,571,22,8,0.105040471,0.894959529,1533.509221,1821.506602,2751.650976,2436.049037,5436,119.2366747,10872,-2490880,292352,-2198528,39
5068,579,21,9,0.102532318,0.897467682,1605.985821,1774.4735,2871.554854,2407.751295,5647,111.4906219,11294,-2594816,296448,-2298368,39
4942,590,22,8,0.106652205,0.893347795,1577.578403,1660.144704,2829.254958,2240.847458,5532,100.8752735,11064,-2530304,302080,-2228224,39
5065,563,22,8,0.100035537,0.899964463,1603.010149,1754.419443,2860.501481,2400.650089,5628,111.1813512,11256,-2593280,288256,-2305024,39
2196,220,19,11,0.0910596026,0.908940397,681.6334471,817.6059438,1226.5,1028.827273,2416,72.53077154,4832,-1124352,112640,-1011712,40
2026,218,18,12,0.0971479501,0.90285205,633.8832696,760.4060567,1131.067127,1042.880734,2244,66.4495114,4488,-1037312,111616,-925696,40
1979,207,19,11,0.0946935041,0.905306496,619.0112516,722.7707567,1107.440121,960.2270531,2186,68.05728518,4372,-1013248,105984,-907264,40
2579,236,18,12,0.0838365897,0.91616341,797.292812,958.7840342,1417.079488,1308.779661,2815,86.88271605,5630,-1320448,120832,-1199616,40
2232,220,19,11,0.0897226754,0.910277325,692.4766611,828.9072103,1243.34319,1055.618182,2452,68.76051598,4904,-1142784,112640,-1030144,40
2326,222,18,12,0.0871271586,0.912872841,727.92756,775.8132468,1296.065778,1048.545045,2548,76.74698795,5096,-1190912,113664,-1077248,40
1690,206,18,12,0.108649789,0.891350211,537.1487578,614.3900997,961.4467456,842.2864078,1896,57.48938751,3792,-865280,105472,-759808,40
2206,226,19,11,0.0929276316,0.907072368,686.8455633,818.2630321,1233.277425,1052.734513,2432,76.50204467,4864,-1129472,115712,-1013760,40
2248,218,20,10,0.0884022709,0.911597729,697.628764,833.8386641,1246.09653,1103.605505,2466,76.25231911,4932,-1150976,111616,-1039360,40
2544,233,19,11,0.083903493,0.916096507,787.5903614,933.7520214,1399.638758,1272.841202,2777,82.13546288,5554,-1302528,119296,-1183232,40
2569,246,19,11,0.0873889876,0.912611012,796.2048751,960.8838295,1418.371351,1299.691057,2815,85.71863581,5630,-1315328,125952,-1189376,40
2083,219,19,11,0.0951346655,0.904865334,648.5510752,793.6845608,1162.098896,1050.689498,2302,57.12158809,4604,-1066496,112128,-954368,40
2339,224,19,11,0.087397581,0.912602419,725.1944462,874.8612616,1289.436511,1204.348214,2563,81.23613312,5126,-1197568,114688,-1082880,40
2212,223,18,12,0.0915811088,0.908418891,687.7833669,820.4815313,1234.579566,1053.542601,2435,76.78965626,4870,-1132544,114176,-1018368,40
2154,220,19,11,0.0926705981,0.907329402,669.8687777,802.5116092,1204.511606,1020.940909,2374,72.62159682,4748,-1102848,112640,-990208,40
2403,225,18,12,0.0856164384,0.914383562,744.2953737,892.3196154,1323.235539,1221.204444,2628,82.33082707,5256,-1230336,115200,-1115136,40
2339,225,19,11,0.0877535101,0.91224649,724.7642524,876.549437,1293.373236,1169.466667,2564,79.11138537,5128,-1197568,115200,-1082368,40
2248,221,18,12,0.089509923,0.910490077,698.943476,831.5030301,1246.371441,1119.330317,2469,72.27751756,4938,-1150976,113152,-1037824,40
2145,211,18,12,0.0895585739,0.910441426,664.8592295,809.2336103,1190.498368,1056.526066,2356,67.31428571,4712,-1098240,108032,-990208,40
2372,242,18,12,0.0925784239,0.907421576,738.6750993,881.8571783,1322.799325,1157.541322,2614,73.61306674,5228,-1214464,123904,-1090560,40
1962,269,21,9,0.120573734,0.879426266,633.4510496,714.4329317,1123.012232,1064.855019,2231,83.71482176,4462,-1004544,137728,-866816,40
2150,264,21,9,0.109362055,0.890637945,683.6702485,794.6332806,1213.277209,1160.450758,2414,74.00367872,4828,-1100800,135168,-965632,40
1765,231,21,9,0.115731463,0.884268537,568.0461836,633.3579091,1004.149008,955.3376623,1996,65.70111916,3992,-903680,118272,-785408,40
1294,185,22,8,0.125084517,0.874915483,413.7942417,509.4778577,741.2411128,731.3189189,1479,49.11989372,2958,-662528,94720,-567808,40
1241,177,20,10,0.124823695,0.875176305,394.4664418,501.363791,710.1676068,704.819209,1418,44.4096461,2836,-635392,90624,-544768,40
2097,251,21,9,0.106899489,0.893100511,655.6179955,839.1769113,1168.933238,1221.007968,2348,55.3382041,4696,-1073664,128512,-945152,40
1764,238,22,8,0.118881119,0.881118881,571.2841457,621.2479449,1010.124717,937.5756303,2002,59.02122642,4004,-903168,121856,-781312,40
1321,222,20,10,0.143875567,0.856124433,448.3616608,416.4240448,787.0598032,682.3873874,1543,31.58002456,3086,-676352,113664,-562688,40
1072,172,22,8,0.138263666,0.861736334,345.048928,434.3491228,615.8059701,664.2209302,1244,41.56364851,2488,-548864,88064,-460800,40
1738,246,22,8,0.123991935,0.876008065,565.3814901,618.4431966,1001.532221,928.6869919,1984,65.71712488,3968,-889856,125952,-763904,40
1260,184,21,9,0.127423823,0.872576177,403.8705775,493.6612735,729.9563492,671.4402174,1444,47.51563014,2888,-645120,94208,-550912,40
1251,187,22,8,0.130041725,0.869958275,400.9721493,499.3896324,721.1590727,708.4010695,1438,28.82341151,2876,-640512,95744,-544768,40
2115,250,21,9,0.105708245,0.894291755,672.8961798,760.616952,1184.539007,1169.98,2365,73.33333333,4730,-1082880,128000,-954880,40
1793,246,21,9,0.120647376,0.879352624,580.5412287,639.5885311,1030.074735,946.5691057,2039,67.36042286,4078,-918016,125952,-792064,40
1927,264,22,8,0.120492926,0.879507074,621.1065984,709.2514496,1100.333679,1064.367424,2191,66.96210269,4382,-986624,135168,-851456,40
1936,273,21,9,0.123585333,0.876414667,631.6063551,677.1742172,1111.954545,1055.681319,2209,74.95758398,4418,-991232,139776,-851456,40
1946,263,21,9,0.119058397,0.880941603,626.0949687,712.4047421,1115.972251,1023.813688,2209,69.61865742,4418,-996352,134656,-861696,40
1955,253,21,9,0.114583333,0.885416667,626.8672782,710.799877,1112.085422,1045.885375,2208,80.76079005,4416,-1000960,129536,-871424,40
1843,252,20,10,0.120286396,0.879713604,596.1802175,660.9812284,1056.448182,986.2142857,2095,65.57120501,4190,-943616,129024,-814592,40
441,77,21,9,0.148648649,0.851351351,144.4822269,162.0923237,270.4172336,196.974026,518,8.334674175,1036,-225792,39424,-186368,40
2816,314,21,9,0.100319489,0.899680511,896.5104804,963.7081176,1569.409091,1530.442675,3130,95.07897934,6260,-1441792,160768,-1281024,40
3066,335,20,10,0.098500441,0.901499559,976.1887975,1013.059297,1721.190476,1516.21194,3401,120.2191587,6802,-1569792,171520,-1398272,40
3387,347,21,9,0.092929834,0.907070166,1066.344531,1179.044487,1878.992619,1755.322767,3734,104.2725496,7468,-1734144,177664,-1556480,40
2397,238,21,9,0.0903225806,0.909677419,750.1466847,857.2879476,1323.692532,1260.668067,2635,86.70615334,5270,-1227264,121856,-1105408,40
3430,349,21,9,0.0923524742,0.907647526,1083.027874,1145.228284,1910.967347,1683.931232,3779,251.7654897,7558,-1756160,178688,-1577472,40
2542,262,22,8,0.0934379458,0.906562054,813.7649748,718.4306021,1428.653423,1148.751908,2804,77.45856354,5608,-1301504,134144,-1167360,40
3141,339,21,9,0.0974137931,0.902586207,998.1017055,1056.512524,1752.354664,1630.660767,3480,92.60244811,6960,-1608192,173568,-1434624,40
3412,354,21,9,0.0939989379,0.906001062,1079.285219,1138.458948,1905.591735,1670.570621,3766,250.0664011,7532,-1746944,181248,-1565696,40
3346,344,21,9,0.0932249322,0.906775068,1056.851614,1119.676972,1868.154214,1625.148256,3690,218.2140745,7380,-1713152,176128,-1537024,40
2342,227,21,9,0.0883612301,0.91163877,729.9190654,850.453713,1290.958155,1223.528634,2569,56.30067938,5138,-1199104,116224,-1082880,40
2993,319,20,10,0.0963164251,0.903683575,951.7081881,995.2165658,1661.171066,1612.673981,3312,124.5581046,6624,-1532416,163328,-1369088,40
3414,368,21,9,0.0973030143,0.902696986,1082.529616,1156.327462,1912.29877,1698.546196,3782,120.0253888,7564,-1747968,188416,-1559552,40
3851,390,21,9,0.0919594435,0.908040556,1207.764571,1348.782299,2147.609452,1858.248718,4241,74.2732049,8482,-1971712,199680,-1772032,40
3783,343,21,9,0.0831313621,0.916868638,1181.285064,1285.524642,2076.435633,1920.830904,4126,125.8694326,8252,-1936896,175616,-1761280,40
3402,329,21,9,0.0881801126,0.911819887,1066.79486,1172.814937,1876.033216,1762.25228,3731,117.4378344,7462,-1741824,168448,-1573376,40
2351,236,21,9,0.0912253576,0.908774642,734.5799055,851.5040691,1304.922586,1185.190678,2587,141.9868277,5174,-1203712,120832,-1082880,40
3375,321,21,9,0.0868506494,0.913149351,1054.935066,1170.76782,1865.640593,1668.283489,3696,174.0112994,7392,-1728000,164352,-1563648,40
2232,235,20,10,0.0952573976,0.904742602,707.1227917,721.5440506,1257.373208,1012.004255,2467,96.82103611,4934,-1142784,120320,-1022464,40
3014,326,21,9,0.0976047904,0.90239521,960.6299328,988.2313117,1683.544127,1549.90184,3340,104.0498442,6680,-1543168,166912,-1376256,40
923,101,21,9,0.0986328125,0.901367188,289.4236001,294.9194314,531.4983749,338.8811881,1024,40.03127443,2048,-472576,51712,-420864,40
5070,345,21,9,0.0637119114,0.936288089,1541.86262,1848.154921,2709.276331,2689.243478,5415,126.4595983,10830,-2595840,176640,-2419200,40
5221,585,21,9,0.100757837,0.899242163,1659.066299,1614.587911,2814.114921,3701.242735,5806,312.9919137,11612,-2673152,299520,-2373632,40
4681,336,21,9,0.0669722942,0.933027706,1428.998533,1693.781068,2511.818201,2469.738095,5017,127.9846939,10034,-2396672,172032,-2224640,40
5156,604,21,9,0.104861111,0.895138889,1633.075073,1764.531214,2803.182312,3540.516556,5760,304.7619048,11520,-2639872,309248,-2330624,40
5110,594,21,9,0.104137447,0.895862553,1613.14783,1777.118336,2775.379648,3515.942761,5704,333.5672515,11408,-2616320,304128,-2312192,40
5049,333,21,9,0.0618729097,0.93812709,1537.007991,1787.019126,2692.469598,2676.798799,5382,283.8607595,10764,-2585088,170496,-2414592,40
4669,329,21,9,0.0658263305,0.934173669,1425.45199,1669.509921,2500.992718,2478.316109,4998,169.5386703,9996,-2390528,168448,-2222080,40
4727,359,21,9,0.0705859221,0.929414078,1449.75648,1692.413104,2543.03279,2549.651811,5086,162.699936,10172,-2420224,183808,-2236416,40
5157,595,21,9,0.103442281,0.896557719,1632.780383,1756.353592,2802.212527,3520.366387,5752,277.4722624,11504,-2640384,304640,-2335744,40
5192,614,21,9,0.10575267,0.89424733,1651.387191,1749.21283,2829.045069,3533.092834,5806,325.4484305,11612,-2658304,314368,-2343936,40
4691,338,21,9,0.067210181,0.932789819,1430.562353,1718.111251,2518.88446,2461.088757,5029,143.3580388,10058,-2401792,173056,-2228736,40
4792,603,21,9,0.111770158,0.888229842,1529.183834,1619.673611,2614.618322,3360.628524,5395,177.2921459,10790,-2453504,308736,-2144768,40
4753,599,21,9,0.111920777,0.888079223,1522.501187,1599.212853,2603.590574,3255.028381,5352,142.1136484,10704,-2433536,306688,-2126848,40
4720,585,21,9,0.110273327,0.889726673,1502.574549,1626.988386,2578.663136,3252.777778,5305,179.5262267,10610,-2416640,299520,-2117120,40
4706,568,21,9,0.107698142,0.892301858,1496.224989,1596.239404,2563.049724,3254.336268,5274,148.7309645,10548,-2409472,290816,-2118656,40
5202,372,20,10,0.0667384284,0.933261572,1588.794485,1869.245902,2790.563629,2744.658602,5574,213.5632184,11148,-2663424,190464,-2472960,40
5103,584,21,9,0.102690346,0.897309654,1619.122565,1680.354268,2766.222418,3523.621575,5687,328.91845,11374,-2612736,299008,-2313728,40
4813,563,20,10,0.104724702,0.895275298,1529.70871,1527.103072,2598.482028,3458.049734,5376,167.8426475,10752,-2464256,288256,-2176000,40
5100,320,21,9,0.0590405904,0.94095941,1551.114747,1758.144611,2700.397255,2871.5125,5420,127.2599202,10840,-2611200,163840,-2447360,40
2105,155,21,9,0.0685840708,0.931415929,640.8010467,664.6650175,1161.285036,712.4193548,2260,32.98788498,4520,-1077760,79360,-998400,40
4681,327,21,9,0.0652955272,0.934704473,1427.425054,1685.528425,2504.338176,2506.816514,5008,113.3031674,10016,-2396672,167424,-2229248,40
4579,342,21,9,0.0694980695,0.930501931,1402.477962,1643.017213,2464.499672,2414.143275,4921,263.4368308,9842,-2344448,175104,-2169344,40
4678,343,21,9,0.068313085,0.931686915,1431.553396,1673.987239,2513.607952,2475.431487,5021,216.4224138,10042,-2395136,175616,-2219520,40
4673,580,20,10,0.110413097,0.889586903,1493.527146,1587.983401,2559.472074,3171.065517,5253,289.9006623,10506,-2392576,296960,-2095616,40
4681,344,21,9,0.0684577114,0.931542289,1430.855348,1696.414061,2511.808588,2529.212209,5025,151.3098464,10050,-2396672,176128,-2220544,40
4665,338,21,9,0.0675594643,0.932440536,1426.3467,1670.941355,2505.684673,2451.14497,5003,148.0177515,10006,-2388480,173056,-2215424,40
4697,580,21,9,0.109910934,0.890089066,1503.530644,1544.859517,2563.543538,3250.067241,5277,180.2869833,10554,-2404864,296960,-2107904,40
4664,568,21,9,0.108562691,0.891437309,1490.374014,1545.424545,2545.156947,3202.316901,5232,154.9763033,10464,-2387968,290816,-2097152,40
3906,498,21,9,0.113079019,0.886920981,1201.110782,1527.919034,2106.192012,2957.879518,4404,89.74933768,8808,-1999872,254976,-1744896,40
4816,375,21,9,0.0722404161,0.927759584,1484.398782,1669.113211,2597.256437,2579.864,5191,322.622747,10382,-2465792,192000,-2273792,40
4696,559,21,9,0.106374881,0.893625119,1498.382203,1523.664239,2552.429727,3262.844365,5255,163.2494564,10510,-2404352,286208,-2118144,40
4668,336,20,10,0.067146283,0.932853717,1423.191016,1713.688822,2503.246787,2492.125,5004,251.4572864,10008,-2390016,172032,-2217984,40
4731,338,21,9,0.0666798185,0.933320181,1444.902296,1698.93846,2539.084971,2477.822485,5069,154.3544458,10138,-2422272,173056,-2249216,40
4585,334,21,9,0.0678999797,0.93210002,1401.351626,1654.798652,2460.115812,2458.41018,4919,270.4233095,9838,-2347520,171008,-2176512,40
4643,564,21,9,0.108315729,0.891684271,1482.497436,1549.687566,2534.697825,3174.514184,5207,145.4063111,10414,-2377216,288768,-2088448,40
4695,343,21,9,0.0680825724,0.931917428,1435.428691,1691.449358,2522.93525,2472.478134,5038,132.998944,10076,-2403840,175616,-2228224,40
4718,580,21,9,0.109475274,0.890524726,1505.533349,1582.214583,2573.880458,3264.625862,5298,141.3176847,10596,-2415616,296960,-2118656,40
4717,585,21,9,0.110335722,0.889664278,1511.652887,1559.238708,2579.860505,3229.147009,5302,239.0441839,10604,-2415104,299520,-2115584,40
2332,165,21,9,0.0660792952,0.933920705,708.9963396,850.4704823,1261.838336,1067.551515,2497,30.80814312,4994,-1193984,84480,-1109504,40
2366,171,21,9,0.0674024438,0.932597556,716.7258846,898.6440976,1283.379121,1070.046784,2537,38.86335784,5074,-1211392,87552,-1123840,40
2183,149,21,9,0.0638936535,0.936106346,664.1558487,760.1009163,1181.623912,944.9194631,2332,132.8774929,4664,-1117696,76288,-1041408,40
2175,158,21,9,0.0677239606,0.932276039,660.757008,770.3828356,1188.475862,871.3670886,2333,130.3351955,4666,-1113600,80896,-1032704,40
2166,140,21,9,0.0607111882,0.939288812,656.1186655,767.7935251,1167.403047,938.4,2306,86.39940052,4612,-1108992,71680,-1037312,40
2115,147,21,9,0.0649867374,0.935013263,638.9200303,767.3373612,1152.643972,827.2857143,2262,87.742436,4524,-1082880,75264,-1007616,40
2121,141,21,9,0.0623342175,0.937665782,641.3023033,778.6525042,1145.53041,920.4468085,2262,118.4293194,4524,-1085952,72192,-1013760,40
2158,143,21,9,0.0621468927,0.937853107,653.5321693,763.9310758,1168.05051,893.6923077,2301,87.65714286,4602,-1104896,73216,-1031680,40
2126,138,21,9,0.0609540636,0.939045936,644.7507192,752.3799315,1144.643932,945.4130435,2264,89.52155002,4528,-1088512,70656,-1017856,40
2124,143,21,9,0.063078959,0.936921041,640.8611633,761.8731666,1155.496234,814.7132867,2267,79.09979065,4534,-1087488,73216,-1014272,40
2210,171,21,9,0.0718185636,0.928181436,680.0878928,724.0475587,1211.586878,924.9356725,2381,98.02387814,4762,-1131520,87552,-1043968,40
2132,136,21,9,0.0599647266,0.940035273,643.2541609,749.4534068,1154.075047,827.6323529,2268,82.53275109,4536,-1091584,69632,-1021952,40
2144,146,21,9,0.0637554585,0.936244541,651.9932128,757.4761799,1158.375,956.4315068,2290,93.62224039,4580,-1097728,74752,-1022976,40
2156,147,21,9,0.0638297872,0.936170213,653.3429359,789.2598186,1165.344156,956.2857143,2303,92.71336554,4606,-1103872,75264,-1028608,40
2115,142,21,9,0.0629153744,0.937084626,638.8987625,702.7880229,1156.076123,725.7183099,2257,81.24550036,4514,-1082880,72704,-1010176,40
2130,134,21,9,0.0591872792,0.940812721,644.4496146,730.5693891,1149.908451,855.7835821,2264,134.282325,4528,-1090560,68608,-1021952,40
2137,137,21,9,0.0602462621,0.939753738,645.0691291,760.7191299,1155.428638,857.8394161,2274,75.72427572,4548,-1094144,70144,-1024000,40
2150,143,21,9,0.0623637157,0.937636284,650.1741853,775.8296821,1163.818605,894.1328671,2293,70.10088658,4586,-1100800,73216,-1027584,40
2156,149,21,9,0.0646420824,0.935357918,651.4870534,809.3055553,1168.36039,930.738255,2305,86.68672433,4610,-1103872,76288,-1027584,40
2148,146,21,9,0.0636442895,0.936355711,653.5096718,761.1065594,1158.481378,985.9383562,2294,128.443449,4588,-1099776,74752,-1025024,40
2182,144,21,9,0.0619088564,0.938091144,661.1684341,773.128447,1179.275435,924.4583333,2326,120.4557224,4652,-1117184,73728,-1043456,40
2150,145,21,9,0.0631808279,0.936819172,652.094088,760.545444,1164.450233,904.0827586,2295,87.52860412,4590,-1100800,74240,-1026560,40
4672,341,21,9,0.0680231398,0.93197686,1427.84122,1688.883641,2509.79024,2468.771261,5013,164.6305419,10026,-2392064,174592,-2217472,40
4643,323,21,9,0.0650422876,0.934957712,1415.637411,1669.818421,2481.515184,2512.03096,4966,131.8990704,9932,-2377216,165376,-2211840,40
4722,576,21,9,0.108720272,0.891279728,1513.567019,1523.509924,2575.494282,3256.192708,5298,123.2379623,10596,-2417664,294912,-2122752,40
4630,563,21,9,0.108415174,0.891584826,1478.238724,1546.565727,2527.542765,3168.202487,5193,236.5831435,10386,-2370560,288256,-2082304,40
4683,563,21,9,0.107319863,0.892680137,1496.738764,1533.392223,2553.095879,3209.117229,5246,241.0845588,10492,-2397696,288256,-2109440,40
4661,341,21,9,0.0681727309,0.931827269,1423.857634,1694.710101,2503.336623,2476.395894,5002,217.4782609,10004,-2386432,174592,-2211840,40
4639,335,21,9,0.0673502211,0.932649779,1420.311615,1636.167659,2487.956241,2481.18209,4974,150.0452489,9948,-2375168,171520,-2203648,40
4931,353,21,9,0.0668054504,0.93319455,1503.122272,1807.579747,2641.795579,2652.339943,5284,179.4836957,10568,-2524672,180736,-2343936,40
4674,571,21,9,0.108865586,0.891134414,1496.742122,1536.837798,2553.954429,3188.182137,5245,298.690205,10490,-2393088,292352,-2100736,40
4716,588,21,9,0.110859729,0.889140271,1510.65344,1572.538134,2580.878499,3226.933673,5304,283.9400428,10608,-2414592,301056,-2113536,40
4690,602,21,9,0.113756614,0.886243386,1507.183893,1571.357226,2575.119616,3202.60299,5292,162.0826953,10584,-2401280,308224,-2093056,40
4684,563,20,10,0.107299409,0.892700591,1487.970828,1597.461193,2551.322374,3228.657194,5247,176.9049225,10494,-2398208,288256,-2109952,40
4666,350,21,9,0.0697767145,0.930223285,1430.663584,1661.862779,2508.500214,2508.497143,5016,163.6007828,10032,-2388992,179200,-2209792,40
4689,577,21,9,0.109570832,0.890429168,1493.341154,1612.196024,2563.005118,3206.377816,5266,157.7591372,10532,-2400768,295424,-2105344,40
3859,435,20,10,0.101304145,0.898695855,1179.915243,1410.213866,2050.245659,3010.268966,4294,220.3181119,8588,-1975808,222720,-1753088,40
4725,334,21,9,0.0660209528,0.933979047,1441.7807,1702.143158,2531.074074,2514.805389,5059,137.4728261,10118,-2419200,171008,-2248192,40
4703,339,21,9,0.0672352241,0.932764776,1439.221422,1664.995574,2521.473315,2521.870206,5042,234.5116279,10084,-2407936,173568,-2234368,40
4806,303,21,9,0.0593071051,0.940692895,1460.055504,1670.209036,2538.382022,2818.584158,5109,148.1728538,10218,-2460672,155136,-2305536,40
4722,309,21,9,0.061419201,0.938580799,1437.758657,1648.906986,2504.369547,2693.731392,5031,223.5006664,10062,-2417664,158208,-2259456,40
2342,176,21,9,0.0698967434,0.930103257,708.0706641,910.914048,1276.928693,1027.579545,2518,39.38682934,5036,-1199104,90112,-1108992,40
2150,219,21,9,0.0924440692,0.907555931,670.7360682,786.1996743,1200.111628,1036.643836,2369,89.09364423,4738,-1100800,112128,-988672,40
2243,220,20,10,0.0893219651,0.910678035,700.6048368,801.5576328,1242.565314,1124.281818,2463,146.4328181,4926,-1148416,112640,-1035776,40
2238,224,21,9,0.0909829407,0.909017059,698.5704775,811.9804753,1243.887399,1107.736607,2462,151.3214505,4924,-1145856,114688,-1031168,40
2355,233,21,9,0.0900309119,0.909969088,733.3880575,853.8634252,1311.93121,1118.317597,2588,143.6979456,5176,-1205760,119296,-1086464,40
2272,223,21,9,0.0893787575,0.910621242,711.2085206,800.5924554,1257.169454,1154.578475,2495,82.20757825,4990,-1163264,114176,-1049088,40
2302,234,21,9,0.0922712934,0.907728707,718.7843391,832.0255305,1286.211555,1094.260684,2536,127.1177945,5072,-1178624,119808,-1058816,40
2234,228,21,9,0.0926076361,0.907392364,696.6084408,815.0425404,1249.78872,1052.302632,2462,153.7788882,4924,-1143808,116736,-1027072,40
2257,232,21,9,0.0932101245,0.906789875,703.8109251,836.0744477,1259.070447,1108.116379,2489,164.8344371,4978,-1155584,118784,-1036800,40
136,32,21,9,0.19047619,0.80952381,46.6441281,55.66219789,84.84558824,83.03125,168,2.950474183,336,-69632,16384,-53248,40
2242,216,21,9,0.0878763222,0.912123678,698.9499763,806.3724019,1237.938448,1141.912037,2458,147.8051714,4916,-1147904,110592,-1037312,40
2244,236,21,9,0.0951612903,0.90483871,700.9333828,835.1212288,1253.516488,1116.733051,2480,148.1481481,4960,-1148928,120832,-1028096,40
2169,235,21,9,0.0977537438,0.902246256,678.3182301,818.9713557,1212.368373,1111.417021,2404,61.17048346,4808,-1110528,120320,-990208,40
2196,228,21,9,0.0940594059,0.905940594,684.9937555,817.6402673,1225.721311,1085.157895,2424,155.0863724,4848,-1124352,116736,-1007616,40
2129,231,21,9,0.0978813559,0.902118644,666.1751077,796.8233316,1193.819634,1057.74026,2360,73.54315986,4720,-1090048,118272,-971776,40
2622,234,20,10,0.0819327731,0.918067227,810.2395278,963.9326083,1437.454996,1328.15812,2856,172.1518987,5712,-1342464,119808,-1222656,40
2121,197,21,9,0.0849870578,0.915012942,659.1702914,763.4629675,1167.241396,1076.152284,2318,84.35225619,4636,-1085952,100864,-985088,40
2654,211,20,10,0.0736474695,0.926352531,816.3466253,950.4834498,1429.63263,1475.35545,2865,166.3763066,5730,-1358848,108032,-1250816,40
2511,242,20,10,0.0879041046,0.912095895,778.031464,943.6606452,1387.682597,1266.157025,2753,69.85536666,5506,-1285632,123904,-1161728,40
611,98,21,9,0.138222849,0.861777151,200.1384684,225.0581537,362.7037643,306.9693878,709,11.344,1418,-312832,50176,-262656,40
639,101,21,9,0.136486486,0.863513514,209.1066737,226.352738,382.3114241,295.7722772,740,28.41781874,1480,-327168,51712,-275456,40
2812,197,21,9,0.0654702559,0.934529744,860.1573643,964.9248484,1517.179587,1331.147208,3009,108.8245931,6018,-1439744,100864,-1338880,40
2867,188,21,9,0.0615384615,0.938461538,875.6059967,970.0434158,1532.722358,1455.984043,3055,167.8571429,6110,-1467904,96256,-1371648,40
2828,193,21,9,0.0638861304,0.93611387,858.9026023,944.0970406,1540.79703,1074.388601,3021,171.6477273,6042,-1447936,98816,-1349120,40
2816,187,21,9,0.0622710623,0.937728938,854.8073634,985.5515154,1521.661932,1205.914439,3003,197.3061761,6006,-1441792,95744,-1346048,40
2872,200,20,10,0.0651041667,0.934895833,877.4938335,967.1632276,1556.366643,1251.215,3072,193.9393939,6144,-1470464,102400,-1368064,40
2861,185,21,9,0.0607353907,0.939264609,870.0973898,1000.36643,1532.695911,1381.286486,3046,125.8677686,6092,-1464832,94720,-1370112,40
2812,178,21,9,0.0595317726,0.940468227,857.044082,932.0406452,1508.069701,1296.926966,2990,190.8104659,5980,-1439744,91136,-1348608,40
2640,188,21,9,0.0664780764,0.933521924,804.9743816,943.1246636,1427.646591,1229.888298,2828,107.8154785,5656,-1351680,96256,-1255424,40
2729,195,21,9,0.0666894665,0.933310534,827.1830941,951.3138261,1493.589227,1027.410256,2924,80.02189381,5848,-1397248,99840,-1297408,40
2709,185,21,9,0.0639253628,0.936074637,828.4136506,901.1400684,1463.236619,1217.064865,2894,105.8135283,5788,-1387008,94720,-1292288,40
2710,202,21,9,0.0693681319,0.930631868,827.5073502,983.8689443,1469.391882,1283.544554,2912,52.44012246,5824,-1387520,103424,-1284096,40
2693,167,21,9,0.0583916084,0.941608392,817.5486596,923.9941242,1442.757519,1232.838323,2860,98.24802473,5720,-1378816,85504,-1293312,40
2879,192,21,9,0.0625203517,0.937479648,875.7785028,955.4155373,1561.583883,1152.375,3071,133.0012993,6142,-1474048,98304,-1375744,40
2840,177,21,9,0.0586675505,0.941332449,859.8007379,975.1159181,1529.666549,1177.40113,3017,173.8904899,6034,-1454080,90624,-1363456,40
2823,191,21,9,0.0633709356,0.936629064,856.0819413,990.5689694,1531.342189,1155.109948,3014,174.4212963,6028,-1445376,97792,-1347584,40
2929,207,21,9,0.0660076531,0.933992347,893.1810987,1026.222317,1587.133834,1304.835749,3136,158.0645161,6272,-1499648,105984,-1393664,40
2814,194,21,9,0.0644946809,0.935505319,856.1263244,1008.994921,1518.05295,1307.912371,3008,96.13294982,6016,-1440768,99328,-1341440,40
2748,197,21,9,0.066893039,0.933106961,838.7389165,990.2348726,1480.254731,1371.80203,2945,51.32450331,5890,-1406976,100864,-1306112,40
2116,161,21,9,0.0707070707,0.929292929,649.0446968,753.6119838,1144.725898,1063.745342,2277,35.10638298,4554,-1083392,82432,-1000960,40
1733,144,21,9,0.0767181673,0.923281833,531.3517047,606.2201991,958.8153491,700.5277778,1877,28.42647282,3754,-887296,73728,-813568,40
6424,393,21,9,0.0576499927,0.942350007,1942.123392,2344.564999,3399.992217,3556.24173,6817,445.8469588,13634,-3289088,201216,-3087872,40
4913,319,21,9,0.060970948,0.939029052,1487.172599,1822.398901,2627.385711,2448.846395,5232,272.642001,10464,-2515456,163328,-2352128,40
3873,268,21,9,0.064718667,0.935281333,1178.286832,1419.89271,2071.522076,2063.455224,4141,128.8826642,8282,-1982976,137216,-1845760,40
3135,223,21,9,0.0664085765,0.933591423,957.6035564,1093.336096,1696.761722,1436.829596,3358,59.24488356,6716,-1605120,114176,-1490944,40
4758,317,21,9,0.0624630542,0.937536946,1442.327712,1766.896133,2545.873476,2419.823344,5075,310.207824,10150,-2436096,162304,-2273792,40
3858,277,21,9,0.0669891173,0.933010883,1177.203298,1403.057616,2067.365215,2076.841155,4135,136.0197368,8270,-1975296,141824,-1833472,40
4747,307,21,9,0.0607439652,0.939256035,1444.887762,1654.749989,2536.884769,2382.387622,5054,280,10108,-2430464,157184,-2273280,40
3861,279,20,10,0.0673913043,0.932608696,1178.674208,1401.958788,2066.745144,2122.462366,4140,158.0152672,8280,-1976832,142848,-1833984,40
3867,297,21,9,0.0713256484,0.928674352,1181.256962,1443.514287,2088.325058,2006.656566,4164,148.0270174,8328,-1979904,152064,-1827840,40
3821,283,21,9,0.068957115,0.931042885,1166.60334,1404.309249,2058.358545,1973.399293,4104,136.4361702,8208,-1956352,144896,-1811456,40
3854,291,21,9,0.0702050663,0.929794934,1178.697218,1411.730653,2074.846134,2048.549828,4145,150.8369723,8290,-1973248,148992,-1824256,40
5340,349,22,8,0.0613464581,0.938653542,1627.074448,1838.363501,2862.656929,2574.833811,5689,99.21520753,11378,-2734080,178688,-2555392,40
6331,392,21,9,0.0583073033,0.941692697,1916.229276,2300.4527,3358.856737,3412.765306,6723,174.0807872,13446,-3241472,200704,-3040768,40
3848,281,21,9,0.0680552192,0.931944781,1173.922707,1414.961792,2068.391372,2018.558719,4129,152.8127313,8258,-1970176,143872,-1826304,40
5569,358,21,9,0.0604015522,0.939598448,1691.097123,1993.584179,2959.515353,3033.76257,5927,198.1611501,11854,-2851328,183296,-2668032,40
4692,318,21,9,0.0634730539,0.936526946,1423.467671,1741.325711,2515.794544,2353.606918,5010,296.2743938,10020,-2402304,162816,-2239488,40
3898,288,21,9,0.0688007645,0.931199236,1190.134679,1432.438444,2095.86352,2061.510417,4186,132.00883,8372,-1995776,147456,-1848320,40
3868,279,20,10,0.06727755,0.93272245,1180.723083,1404.749356,2071.938469,2102.580645,4147,149.7652582,8294,-1980416,142848,-1837568,40
3790,281,21,9,0.0690248096,0.93097519,1158.021625,1386.01591,2037.642744,2013.843416,4071,113.4931698,8142,-1940480,143872,-1796608,40
4753,315,21,9,0.0621546961,0.937845304,1443.894925,1721.427933,2542.43867,2414.714286,5068,222.5735617,10136,-2433536,161280,-2272256,40
5292,236,22,8,0.0426917511,0.957308249,1581.565196,1883.419876,2759.482426,2877.012712,5528,106.6563766,11056,-2709504,120832,-2588672,41
5266,235,22,8,0.0427195055,0.957280494,1568.745027,1948.881552,2738.210406,3037.595745,5501,124.9659246,11002,-2696192,120320,-2575872,41
5288,244,22,8,0.0441070137,0.955892986,1578.576803,1950.874198,2762.256051,2858.47541,5532,136.5588744,11064,-2707456,124928,-2582528,41
4860,228,22,8,0.0448113208,0.955188679,1458.079302,1677.735351,2549.097737,2446.495614,5088,100.2166634,10176,-2488320,116736,-2371584,41
4326,220,23,7,0.0483941927,0.951605807,1304.873665,1425.635189,2286.886038,2010.281818,4546,106.7888184,9092,-2214912,112640,-2102272,41
5281,239,22,8,0.0432971014,0.956702899,1573.760691,1969.444321,2751.53683,2958.552301,5520,121.6662993,11040,-2703872,122368,-2581504,41
5301,248,23,7,0.0446927374,0.955307263,1583.663045,1950.315551,2773.453877,2808.048387,5549,120.5780096,11098,-2714112,126976,-2587136,41
5281,239,22,8,0.0432971014,0.956702899,1576.244125,1928.329753,2753.040144,2925.334728,5520,134.6669919,11040,-2703872,122368,-2581504,41
5278,263,22,8,0.0474643566,0.952535643,1573.502009,2033.699998,2757.138499,3049.178707,5541,98.27953175,11082,-2702336,134656,-2567680,41
5282,252,22,8,0.0455366823,0.954463318,1577.10447,1975.689901,2763.392654,2853.59127,5534,132.8053756,11068,-2704384,129024,-2575360,41
5276,250,22,8,0.0452406804,0.95475932,1577.826143,1925.936159,2764.106331,2750.704,5526,138.5656971,11052,-2701312,128000,-2573312,41
5281,246,22,8,0.0445087751,0.955491225,1575.760346,1969.439053,2759.155652,2867.995935,5527,132.0038214,11054,-2703872,125952,-2577920,41
5274,242,22,8,0.0438723713,0.956127629,1572.187009,1969.981047,2749.0876,2963.628099,5516,129.9411072,11032,-2700288,123904,-2576384,41
5272,242,22,8,0.0438882844,0.956111716,1570.964034,1981.216803,2748.418058,2955.35124,5514,115.5974843,11028,-2699264,123904,-2575360,41
5273,239,23,7,0.0433599419,0.956640058,1573.196977,1942.369409,2751.191163,2873.627615,5512,120.6126915,11024,-2699776,122368,-2577408,41
5274,240,22,8,0.0435255713,0.956474429,1572.274322,1956.368648,2746.529389,2998.579167,5514,125.7468643,11028,-2700288,122880,-2577408,41
5281,238,22,8,0.0431237543,0.956876246,1576.841586,1912.045025,2752.006059,2937.378151,5519,139.8277173,11038,-2703872,121856,-2582016,41
5297,254,22,8,0.0457575212,0.954242479,1584.842123,1933.157587,2775.491977,2786.594488,5551,112.4822695,11102,-2712064,130048,-2582016,41
5308,240,22,8,0.043258832,0.956741168,1585.155318,1922.784933,2767.535418,2928.533333,5548,129.6261682,11096,-2717696,122880,-2594816,41
4671,200,22,8,0.0410593307,0.958940669,1395.435668,1587.647014,2452.601156,2048.28,4871,173.1603271,9742,-2391552,102400,-2289152,41
3714,259,22,8,0.0651900327,0.934809967,1135.078481,1299.195716,1978.873452,2103.532819,3973,93.70283019,7946,-1901568,132608,-1768960,41
3698,265,22,8,0.0668685339,0.933131466,1129.660593,1319.356695,1971.35073,2130.607547,3963,95.72463768,7926,-1893376,135680,-1757696,41
2742,227,22,8,0.0764567194,0.923543281,853.1420383,894.742983,1475.161561,1603.84141,2969,69.99057049,5938,-1403904,116224,-1287680,41
3719,259,22,8,0.0651080945,0.934891905,1133.826029,1308.508014,1970.16456,2267.138996,3978,98.07692308,7956,-1904128,132608,-1771520,41
3718,258,22,8,0.064889336,0.935110664,1135.844575,1285.386085,1972.382464,2220.767442,3976,107.025572,7952,-1903616,132096,-1771520,41
2739,220,22,8,0.0743494424,0.925650558,850.5358105,885.3482057,1468.192041,1627.009091,2959,71.0956271,5918,-1402368,112640,-1289728,41
3650,252,23,7,0.0645822655,0.935417734,1116.251381,1238.39609,1934.453699,2198.400794,3902,87.8630939,7804,-1868800,129024,-1739776,41
2772,236,22,8,0.0784574468,0.921542553,862.34824,925.9472067,1493.437229,1634.440678,3008,78.3741532,6016,-1419264,120832,-1298432,41
2779,224,22,8,0.0745920746,0.925407925,864.4978137,880.8684631,1489.262325,1660.026786,3003,71.96261682,6006,-1422848,114688,-1308160,41
3698,251,23,7,0.063560395,0.936439605,1129.063627,1259.293618,1956.585722,2246.298805,3949,97.50617284,7898,-1893376,128512,-1764864,41
2785,247,22,8,0.0814643799,0.91853562,867.2519664,932.6668391,1496.818671,1738.412955,3032,52.81309876,6064,-1425920,126464,-1299456,41
2782,232,22,8,0.0769741208,0.923025879,866.3027484,902.8861673,1496.116822,1644,3014,78.53048463,6028,-1424384,118784,-1305600,41
2795,221,22,8,0.0732758621,0.926724138,870.0336943,858.2199418,1494.276208,1688.38914,3016,78.54166667,6032,-1431040,113152,-1317888,41
3711,265,22,8,0.0666498994,0.933350101,1135.104381,1302.69244,1977.515225,2142.328302,3976,98.70903674,7952,-1900032,135680,-1764352,41
3693,252,22,8,0.063878327,0.936121673,1127.921345,1258.828988,1954.989439,2236.940476,3945,99.62121212,7890,-1890816,129024,-1761792,41
2784,225,22,8,0.074775673,0.925224327,865.9421495,884.6339744,1491.653376,1670.142222,3009,74.5909767,6018,-1425408,115200,-1310208,41
2762,217,23,7,0.072843236,0.927156764,857.4588706,870.3899968,1475.507241,1674.465438,2979,73.37438424,5958,-1414144,111104,-1303040,41
2769,237,22,8,0.0788423154,0.921157685,863.3707339,904.9976186,1491.121705,1648.122363,3006,77.85547786,6012,-1417728,121344,-1296384,41
1160,87,22,8,0.0697674419,0.930232558,352.7258063,432.75604,631.662069,521.8390805,1247,17.55843424,2494,-593920,44544,-549376,41
1151,99,22,8,0.0792,0.9208,351.1933251,458.2406588,626.3796699,615.2727273,1250,19.31993818,2500,-589312,50688,-538624,41
9566,411,22,8,0.0411947479,0.958805252,2879.812998,2813.19902,5016.297617,4353.649635,9977,699.159075,19954,-4897792,210432,-4687360,41
9568,408,22,8,0.0408981556,0.959101844,2866.409568,3116.818315,5014.457985,4379.759804,9976,881.2720848,19952,-4898816,208896,-4689920,41
9564,412,22,8,0.0412991179,0.958700882,2869.111587,3038.714366,5017.998013,4303.745146,9976,666.3994656,19952,-4896768,210944,-4685824,41
9566,410,22,8,0.0410986367,0.958901363,2865.258219,3129.325351,5016.748798,4329.407317,9976,975.1710655,19952,-4897792,209920,-4687872,41
9458,456,22,8,0.0459955618,0.954004438,2842.847327,3176.314524,4985.716325,4372.258772,9914,238.8915663,19828,-4842496,233472,-4609024,41
9551,425,22,8,0.0426022454,0.957397755,2869.406346,2999.981835,5023.314417,4206.117647,9976,888.3348175,19952,-4890112,217600,-4672512,41
9416,457,22,8,0.0462878558,0.953712144,2832.540821,3138.78104,4964.052251,4379.617068,9873,245.1092354,19746,-4820992,233984,-4587008,41
9566,410,23,7,0.0410986367,0.958901363,2865.966538,3114.947284,5016.594501,4333.007317,9976,882.8318584,19952,-4897792,209920,-4687872,41
9559,417,22,8,0.0418003208,0.958199679,2872.041848,2970.904832,5018.485406,4301.136691,9976,264.6153846,19952,-4894208,213504,-4680704,41
9550,426,22,8,0.042702486,0.957297514,2863.775401,3115.831566,5023.721571,4198.908451,9976,854.109589,19952,-4889600,218112,-4671488,41
482,77,22,8,0.137745975,0.862254025,160.2365115,130.7635826,295.7136929,181.6363636,559,11.59270012,1118,-246784,39424,-207360,41
9567,412,22,8,0.0412867021,0.958713298,2866.138754,3147.410198,5014.364587,4424.23301,9979,1116.219239,19958,-4898304,210944,-4687360,41
9558,418,22,8,0.0419005613,0.958099439,2865.109015,3133.526705,5015.819209,4363.818182,9976,1069.239014,19952,-4893696,214016,-4679680,41
9562,414,22,8,0.041499599,0.958500401,2865.191365,3105.942622,5021.003869,4237.770531,9976,876.6256591,19952,-4895744,211968,-4683776,41
9568,408,23,7,0.0408981556,0.959101844,2865.875824,3136.256145,5012.727529,4420.340686,9976,1125.959368,19952,-4898816,208896,-4689920,41
9567,410,22,8,0.0410945174,0.958905483,2873.863479,2964.919944,5013.585659,4415.314634,9977,825.2274607,19954,-4898304,209920,-4688384,41
9563,413,22,8,0.0413993585,0.958600642,2873.548248,2959.744327,5014.193454,4393.569007,9976,831.3333333,19952,-4896256,211456,-4684800,41
9568,411,22,8,0.0411864916,0.958813508,2866.902915,3138.022185,5012.877299,4457.420925,9979,837.8673384,19958,-4898816,210432,-4688384,41
9554,422,22,8,0.0423015237,0.957698476,2869.344073,3024.180572,5019.419719,4288.483412,9976,618.0916976,19952,-4891648,216064,-4675584,41
9565,411,23,7,0.0411988773,0.958801123,2866.544474,3125.928483,5011.458233,4454.20438,9976,1090.273224,19952,-4897280,210432,-4686848,41
3020,163,23,7,0.0512095507,0.948790449,907.980225,1079.516734,1580.609603,1803.03681,3183,71.73766058,6366,-1546240,83456,-1462784,41
2485,158,23,7,0.0597805524,0.940219448,747.7220492,934.7802113,1305.623742,1579.563291,2643,65.082492,5286,-1272320,80896,-1191424,41
2900,155,23,7,0.0507364975,0.949263502,872.7824665,1016.127967,1516.997241,1733.858065,3055,80.47945205,6110,-1484800,79360,-1405440,41
2906,157,23,7,0.0512569376,0.948743062,874.1837755,1033.421177,1521.4415,1727.433121,3063,64.97666525,6126,-1487872,80384,-1407488,41
2468,163,23,7,0.0619536298,0.93804637,742.6850788,939.1172804,1298.197731,1585.546012,2631,45.87619878,5262,-1263616,83456,-1180160,41
2481,148,22,8,0.0562951693,0.943704831,746.8769121,887.7397192,1297.41717,1609.75,2629,66.91270043,5258,-1270272,75776,-1194496,41
2471,151,23,7,0.0575896262,0.942410374,745.9010513,890.3285321,1298.121004,1530.437086,2622,69.43855932,5244,-1265152,77312,-1187840,41
2619,169,23,7,0.0606169297,0.93938307,789.8129074,977.7448677,1378.83047,1637.331361,2788,75.41249662,5576,-1340928,86528,-1254400,41
2957,161,23,7,0.0516356639,0.948364336,896.2633144,964.293048,1555.218803,1638.130435,3118,83.83974187,6236,-1513984,82432,-1431552,41
2490,155,23,7,0.0586011342,0.941398866,750.0764134,931.837369,1310.593574,1522.303226,2645,68.61219196,5290,-1274880,79360,-1195520,41
2287,110,22,8,0.0458906967,0.954109303,684.9859196,811.2135124,1205.680805,1060.1,2397,79.66101695,4794,-1170944,56320,-1114624,41
2492,153,23,7,0.0578449905,0.942155009,749.086957,926.530317,1306.063804,1598.849673,2645,66.86046512,5290,-1275904,78336,-1197568,41
2482,156,23,7,0.0591357089,0.940864291,747.5254924,924.7509955,1304.458098,1558.820513,2638,70.79978529,5276,-1270784,79872,-1190912,41
2905,161,23,7,0.0525114155,0.947488584,871.869672,1084.827002,1524.930465,1688.124224,3066,59.73115137,6132,-1487360,82432,-1404928,41
2466,157,22,8,0.0598551277,0.940144872,741.9926893,940.2273235,1298.575426,1522.859873,2623,59.2366757,5246,-1262592,80384,-1182208,41
2615,157,23,7,0.0566378066,0.943362193,786.0759299,962.7532598,1369.318929,1672.66879,2772,68.83536131,5544,-1338880,80384,-1258496,41
2607,158,23,7,0.0571428571,0.942857143,783.5542409,967.0078814,1365.955504,1664.234177,2765,64.52742124,5530,-1334784,80896,-1253888,41
2471,151,22,8,0.0575896262,0.942410374,744.4626106,900.3096295,1296.022258,1564.781457,2622,70.82658023,5244,-1265152,77312,-1187840,41
2619,160,22,8,0.0575746671,0.942425333,788.409142,961.8598775,1373.415426,1661.46875,2779,69.16376307,5558,-1340928,81920,-1259008,41
2468,146,23,7,0.0558530987,0.944146901,742.1040765,871.4697869,1287.094003,1652.445205,2614,66.93982074,5228,-1263616,74752,-1188864,41
5282,256,22,8,0.0462260744,0.953773926,1580.571471,1934.361536,2771.661303,2724.90625,5538,140.9160305,11076,-2704384,131072,-2573312,41
5269,235,22,8,0.0426962209,0.957303779,1570.387029,1940.358646,2741.070981,3008.753191,5504,111.124571,11008,-2697728,120320,-2577408,41
5271,248,22,8,0.0449356768,0.955064323,1579.102231,1866.960773,2762.574843,2705.274194,5519,118.484328,11038,-2698752,126976,-2571776,41
5274,246,22,8,0.0445652174,0.955434783,1571.682687,1999.010694,2753.625142,2907.890244,5520,117.3968524,11040,-2700288,125952,-2574336,41
5282,235,22,8,0.0425956136,0.957404386,1577.799896,1888.628617,2752.027073,2915.72766,5517,115.6846299,11034,-2704384,120320,-2584064,41
5274,253,22,8,0.045775285,0.954224715,1574.15834,1986.625992,2759.411073,2859.660079,5527,137.078373,11054,-2700288,129536,-2570752,41
5302,246,23,7,0.0443403028,0.955659697,1582.633669,1964.77768,2771.552622,2838.02439,5548,136.515748,11096,-2714624,125952,-2588672,41
5288,245,22,8,0.0442797759,0.955720224,1578.501833,1955.808575,2762.393343,2866.428571,5533,142.8239546,11066,-2707456,125440,-2582016,41
5270,251,22,8,0.0454627785,0.954537222,1571.622817,2000.572693,2756.322201,2859.215139,5521,107.3706729,11042,-2698240,128512,-2569728,41
5271,262,22,8,0.0473522501,0.95264775,1575.437016,1981.75585,2760.970404,2888.305344,5533,100.1266739,11066,-2698752,134144,-2564608,41
5303,244,22,8,0.0439877411,0.956012259,1585.522256,1911.020484,2771.315859,2832.336066,5547,151.309329,11094,-2715136,124928,-2590208,41
5285,252,22,8,0.0455120101,0.95448799,1579.259059,1950.076941,2761.306339,2930.353175,5537,99.19383733,11074,-2705920,129024,-2576896,41
5301,243,22,8,0.0438311688,0.956168831,1581.863128,1956.043654,2765.68704,2921.123457,5544,129.8664793,11088,-2714112,124416,-2589696,41
5304,245,22,8,0.0441520995,0.955847901,1586.930126,1896.430361,2775.32994,2767.857143,5549,130.5954342,11098,-2715648,125440,-2590208,41
5283,244,22,8,0.0441469151,0.955853085,1578.12115,1923.075673,2754.733863,2964.627049,5527,119.1420565,11054,-2704896,124928,-2579968,41
5296,245,22,8,0.0442158455,0.955784154,1582.24966,1936.068792,2770.825718,2774.767347,5541,120.2734969,11082,-2711552,125440,-2586112,41
5276,252,23,7,0.0455861071,0.954413893,1575.303604,1974.244554,2759.962092,2859.507937,5528,136.258319,11056,-2701312,129024,-2572288,41
5298,248,22,8,0.0447169131,0.955283087,1582.995324,1944.933638,2770.414685,2839.41129,5546,137.2093023,11092,-2712576,126976,-2585600,41
5306,236,23,7,0.0425839047,0.957416095,1581.838207,1942.452262,2759.667358,3037.533898,5542,123.0735066,11084,-2716672,120832,-2595840,41
4327,188,22,8,0.0416389812,0.958361019,1294.404405,1435.48938,2275.746707,1849.542553,4515,172.856049,9030,-2215424,96256,-2119168,41
4224,250,22,8,0.0558784086,0.944121591,1272.347167,1570.589237,2227.148201,2412.404,4474,103.9498141,8948,-2162688,128000,-2034688,41
4180,251,22,8,0.0566463552,0.943353645,1258.243009,1576.367202,2205.347129,2393.406375,4431,110.9136421,8862,-2140160,128512,-2011648,41
4153,257,22,8,0.058276644,0.941723356,1251.911622,1564.255313,2194.015411,2391.085603,4410,105.4519369,8820,-2126336,131584,-1994752,41
4143,252,22,8,0.057337884,0.942662116,1249.953923,1542.529397,2192.837799,2282.869048,4395,112.3753516,8790,-2121216,129024,-1992192,41
4185,245,21,9,0.0553047404,0.94469526,1261.132443,1542.127148,2206.480526,2369.567347,4430,106.362545,8860,-2142720,125440,-2017280,41
4155,260,22,8,0.0588901472,0.941109853,1251.562593,1583.636835,2195.496992,2407.807692,4415,91.46467785,8830,-2127360,133120,-1994240,41
4182,256,23,7,0.0576836413,0.942316359,1261.799049,1546.907481,2205.968436,2440.550781,4438,109.0685672,8876,-2141184,131072,-2010112,41
4159,247,22,8,0.0560599183,0.943940082,1254.36862,1513.274143,2187.847319,2467.060729,4406,77.85827885,8812,-2129408,126464,-2002944,41
4169,252,22,8,0.0570006786,0.942999321,1257.601343,1549.466165,2205.452627,2302.77381,4421,106.4275397,8842,-2134528,129024,-2005504,41
4147,249,22,8,0.0566424022,0.943357598,1249.730723,1552.538141,2192.963106,2290.714859,4396,114.7181628,8792,-2123264,127488,-1995776,41
4146,241,22,8,0.0549350353,0.945064965,1248.193029,1539.398482,2185.530632,2339.701245,4387,97.55392484,8774,-2122752,123392,-1999360,41
4164,253,22,8,0.0572786959,0.942721304,1254.949425,1559.101516,2198.252402,2385.889328,4417,113.6059671,8834,-2131968,129536,-2002432,41
4179,257,22,8,0.0579350766,0.942064923,1260.228786,1559.403417,2205.394592,2431.603113,4436,109.7476497,8872,-2139648,131584,-2008064,41
4148,245,22,8,0.055770544,0.944229456,1249.230128,1547.61629,2188.993491,2332.555102,4393,106.9376826,8786,-2123776,125440,-1998336,41
4159,259,22,8,0.0586238117,0.941376188,1252.763205,1580.16241,2196.363308,2420.447876,4418,102.4345003,8836,-2129408,132608,-1996800,41
4177,242,22,8,0.0547635212,0.945236479,1257.126665,1551.722777,2200.330859,2376.892562,4419,81.29139073,8838,-2138624,123904,-2014720,41
4156,242,22,8,0.0550250114,0.944974989,1252.036363,1538.581867,2195.522377,2267.809917,4398,88.47314424,8796,-2127872,123904,-2003968,41
4223,263,22,8,0.0586268391,0.941373161,1272.651539,1607.44452,2236.249112,2359.927757,4486,107.2692492,8972,-2162176,134656,-2027520,41
2169,123,22,8,0.0536649215,0.946335079,652.6204538,733.5140296,1164.699862,825.5609756,2292,90.0589391,4584,-1110528,62976,-1047552,41
4156,248,22,8,0.0563124432,0.943687557,1252.369736,1532.63037,2187.274783,2457.645161,4404,94.06236651,8808,-2127872,126976,-2000896,41
2608,163,22,8,0.0588235294,0.941176471,787.2214742,956.9293666,1372.91181,1595.411043,2771,75.23757806,5542,-1335296,83456,-1251840,41
2591,169,22,8,0.0612318841,0.938768116,786.884354,913.1619362,1367.812814,1575.011834,2760,74.29340511,5520,-1326592,86528,-1240064,41
2589,156,22,8,0.0568306011,0.943169399,780.122177,927.3252433,1355.566242,1662.333333,2745,64.61864407,5490,-1325568,79872,-1245696,41
2630,172,22,8,0.0613847252,0.938615275,802.0685023,893.7778388,1391.910266,1548.133721,2802,73.85345282,5604,-1346560,88064,-1258496,41
2603,166,22,8,0.0599494402,0.94005056,787.6100271,933.1813062,1369.848252,1622.590361,2769,71.90340171,5538,-1332736,84992,-1247744,41
2653,170,22,8,0.0602196245,0.939780375,803.8859396,923.5834495,1393.353185,1703,2823,49.76203067,5646,-1358336,87040,-1271296,41
2603,170,22,8,0.0613054454,0.938694555,787.3801052,968.2987686,1377.597003,1530.976471,2773,58.70025402,5546,-1332736,87040,-1245696,41
2620,171,22,8,0.0612683626,0.938731637,795.9649485,931.2749103,1386.929389,1534.976608,2791,70.81958894,5582,-1341440,87552,-1253888,41
2615,161,21,9,0.0579971182,0.942002882,789.301072,937.9194568,1372.234034,1652.695652,2776,72.82266527,5552,-1338880,82432,-1256448,41
2597,168,22,8,0.0607594937,0.939240506,785.6470799,951.6187634,1370.692722,1573.25,2765,63.60708535,5530,-1329664,86016,-1243648,41
2663,162,22,8,0.0573451327,0.942654867,805.4532093,941.7479014,1400.324071,1621.37037,2825,73.64442127,5650,-1363456,82944,-1280512,41
2584,163,22,8,0.059337459,0.940662541,783.8780328,902.5674955,1361.462074,1572.760736,2747,70.61696658,5494,-1323008,83456,-1239552,41
2591,170,22,8,0.0615718942,0.938428106,782.1115278,965.8016461,1365.225782,1621.417647,2761,48.46410391,5522,-1326592,87040,-1239552,41
2587,166,22,8,0.0602978569,0.939702143,783.6741836,941.6010486,1368.951295,1502.433735,2753,58.42529711,5506,-1324544,84992,-1239552,41
2591,168,21,9,0.0608916274,0.939108373,783.2113053,948.809833,1365.03242,1610.839286,2759,73.61259338,5518,-1326592,86016,-1240576,41
2594,161,22,8,0.0584392015,0.941560799,783.3914551,935.3096574,1363.174634,1616.863354,2755,69.95937024,5510,-1328128,82432,-1245696,41
2671,167,21,9,0.0588442565,0.941155743,807.4862307,973.4976168,1409.025459,1587.02994,2838,57.74160732,5676,-1367552,85504,-1282048,41
2654,171,22,8,0.0605309735,0.939469027,805.3534303,950.8751835,1405.021477,1536.830409,2825,66.67453387,5650,-1358848,87552,-1271296,41
2587,158,22,8,0.0575591985,0.942440801,781.7107373,930.6052761,1361.482412,1561.582278,2745,66.67476318,5490,-1324544,80896,-1243648,41
2591,164,21,9,0.0595281307,0.940471869,784.9746904,919.5341246,1365.015824,1583.134146,2755,71.04177411,5510,-1326592,83968,-1242624,41
1586,82,23,7,0.0491606715,0.950839329,476.7165503,520.3150123,845.7692308,616.5365854,1668,65.61762392,3336,-812032,41984,-770048,41
1830,125,23,7,0.0639386189,0.936061381,552.2305535,666.3894474,960.1808743,1238.872,1955,49.54384187,3910,-936960,64000,-872960,41
1759,134,22,8,0.0707871104,0.92921289,532.6224902,681.1823285,934.1444002,1115.753731,1893,48.25388733,3786,-900608,68608,-832000,41
1616,90,23,7,0.0527549824,0.947245018,485.6776151,601.3969176,852.5222772,871.0555556,1706,50.54814815,3412,-827392,46080,-781312,41
1762,137,23,7,0.0721432333,0.927856767,533.2292503,698.0184309,939.0374574,1090.992701,1899,54.04097894,3798,-902144,70144,-832000,41
1760,131,24,6,0.0692755156,0.930724484,532.1390479,686.4606587,934.45625,1101.091603,1891,50.38635758,3782,-901120,67072,-834048,41
1755,133,23,7,0.0704449153,0.929555085,531.0713548,667.9131009,928.3293447,1157.879699,1888,47.83379782,3776,-898560,68096,-830464,41
1758,126,23,7,0.0668789809,0.933121019,531.8443572,641.1654302,924.8361775,1188.952381,1884,48.03671596,3768,-900096,64512,-835584,41
1910,133,22,8,0.0651003426,0.934899657,577.7081474,711.4035314,1007.902618,1224.451128,2043,52.15726321,4086,-977920,68096,-909824,41
1790,135,23,7,0.0701298701,0.92987013,541.5439837,697.8215889,950.8759777,1123.755556,1925,51.97084233,3850,-916480,69120,-847360,41
1590,91,23,7,0.0541344438,0.945865556,480.0096973,523.3445871,853.4698113,623.1208791,1681,41.66047088,3362,-814080,46592,-767488,41
1797,133,23,7,0.0689119171,0.931088083,543.9775594,687.0215382,952.277685,1144.150376,1930,49.75509152,3860,-920064,68096,-851968,41
1903,121,23,7,0.0597826087,0.940217391,573.3385196,706.1147121,999.8712559,1211.115702,2024,51.00806452,4048,-974336,61952,-912384,41
1800,138,23,7,0.0712074303,0.92879257,544.774892,716.5255357,961.7588889,1070.471014,1938,46.63137632,3876,-921600,70656,-850944,41
1772,136,23,7,0.071278826,0.928721174,536.7651096,685.147699,941.1230248,1128.794118,1908,45.11704895,3816,-907264,69632,-837632,41
1754,122,23,7,0.0650319829,0.934968017,529.9011337,642.7507112,922.0718358,1174.688525,1876,44.28706327,3752,-898048,62464,-835584,41
1753,130,23,7,0.0690387679,0.930961232,529.7607809,671.2979636,926.8590987,1146.169231,1883,51.2659951,3766,-897536,66560,-830976,41
1763,125,23,7,0.0662076271,0.933792373,532.7862381,656.7338005,928.9222915,1164.208,1888,50.15940489,3776,-902656,64000,-838656,41
1907,132,23,7,0.0647376165,0.935262384,575.6474467,712.7282604,1004.090718,1249.840909,2039,53.67201895,4078,-976384,67584,-908800,41
1028,71,23,7,0.0646041856,0.935395814,311.7064801,381.6661465,554.9533074,478.2816901,1099,17.49164412,2198,-526336,36352,-489984,41
1542,82,23,7,0.0504926108,0.949507389,463.5909728,545.2466262,818.6238651,697.3414634,1624,62.89697909,3248,-789504,41984,-747520,41
1665,128,23,7,0.071388734,0.928611266,504.439133,640.8633703,883.7291291,1069.625,1793,49.64008859,3586,-852480,65536,-786944,41
1678,124,23,7,0.0688124306,0.931187569,507.8361657,634.3771545,887.227056,1094.645161,1802,46.59943108,3604,-859136,63488,-795648,41
1705,120,23,7,0.0657534247,0.934246575,514.8134933,616.3947436,894.3096774,1178.558333,1825,45.05060479,3650,-872960,61440,-811520,41
1667,124,23,7,0.0692350642,0.930764936,504.4452201,636.4085112,882.5878824,1076.306452,1791,51.01110795,3582,-853504,63488,-790016,41
1556,87,23,7,0.0529519172,0.947048083,468.204545,572.269827,822.529563,812.5287356,1643,67.253377,3286,-796672,44544,-752128,41
1688,120,22,8,0.0663716814,0.933628319,509.9665332,615.3796023,886.681872,1155.141667,1808,49.10374796,3616,-864256,61440,-802816,41
1672,121,23,7,0.0674846626,0.932515337,505.2521869,623.7907392,880.8761962,1119.801653,1793,48.19892473,3586,-856064,61952,-794112,41
1825,127,23,7,0.0650614754,0.934938525,551.983499,671.6295053,961.3128767,1194.740157,1952,42.42555966,3904,-934400,65024,-869376,41
1807,133,23,7,0.068556701,0.931443299,547.5666672,684.4483681,957.6524626,1145.052632,1940,51.45888594,3880,-925184,68096,-857088,41
1666,121,23,7,0.0677112479,0.932288752,504.4567364,613.918325,878.4057623,1108.710744,1787,46.45178061,3574,-852992,61952,-791040,41
1718,132,23,7,0.0713513514,0.928648649,520.1023134,657.2649833,909.87078,1128.916667,1850,47.54561809,3700,-879616,67584,-812032,41
1664,117,23,7,0.0656934307,0.934306569,503.0811971,628.1641463,879.3094952,1057.264957,1781,42.53642226,3562,-851968,59904,-792064,41
1800,133,23,7,0.0688049664,0.931195034,546.0330128,665.4115028,951.4527778,1177.413534,1933,51.23244103,3866,-921600,68096,-853504,41
1668,115,23,7,0.064498037,0.935501963,503.6445755,603.6674051,875.1408873,1136.530435,1783,46.29966243,3566,-854016,58880,-795136,41
1666,127,22,8,0.0708310095,0.929168991,504.620918,652.8913578,887.8205282,1017.417323,1793,31.84159119,3586,-852992,65024,-787968,41
1672,118,24,6,0.0659217877,0.934078212,505.1544526,610.0600822,878.4587321,1136.966102,1790,44.47204969,3580,-856064,60416,-795648,41
851,52,23,7,0.057585825,0.942414175,258.1014994,274.520229,459.1245593,335.4038462,903,22.71126761,1806,-435712,26624,-409088,41
916,60,23,7,0.0614754098,0.93852459,277.046361,345.2608853,489.5524017,472.4333333,976,15.46016157,1952,-468992,30720,-438272,41
850,53,23,7,0.0586932447,0.941306755,257.7890125,279.3347511,459.1341176,337.5849057,903,34.69074145,1806,-435200,27136,-408064,41
1648,125,23,7,0.0705019741,0.929498026,499.5042878,616.1438078,871.2226942,1095.008,1773,48.16625917,3546,-843776,64000,-779776,41
1680,120,23,7,0.0666666667,0.933333333,508.9980468,609.6185483,884.8767857,1119.225,1800,44.97751124,3600,-860160,61440,-798720,41
1664,126,23,7,0.0703910615,0.929608939,504.0440023,634.799811,881.8353365,1075.960317,1790,47.96355841,3580,-851968,64512,-787456,41
1658,124,22,8,0.0695847363,0.930415264,501.5543177,628.3065004,876.2617612,1095.25,1782,48.24038982,3564,-848896,63488,-785408,41
1644,128,22,8,0.072234763,0.927765237,496.8717013,620.6089491,867.1770073,1134.679688,1772,32.57352941,3544,-841728,65536,-776192,41
1653,132,22,8,0.0739495798,0.92605042,500.778119,639.578458,877.4319419,1087.954545,1785,48.23020805,3570,-846336,67584,-778752,41
1657,126,22,8,0.0706674145,0.929332586,501.9848122,630.0904941,877.7066989,1079.968254,1783,47.42021277,3566,-848384,64512,-783872,41
1643,129,22,8,0.0727990971,0.927200903,497.4309908,633.4642815,871.0803408,1082.891473,1772,47.60881247,3544,-841216,66048,-775168,41
1654,127,23,7,0.0713082538,0.928691746,501.7756338,625.2614563,876.7974607,1075.968504,1781,43.87780241,3562,-846848,65024,-781824,41
1654,122,23,7,0.0686936937,0.931306306,501.1033892,623.4726083,875.503023,1064.704918,1776,40.29952349,3552,-846848,62464,-784384,41
1646,122,22,8,0.0690045249,0.930995475,498.6084668,617.3701968,870.2770352,1076.393443,1768,47.69355274,3536,-842752,62464,-780288,41
1615,116,23,7,0.0670132871,0.932986713,488.2604792,628.6938286,858.4823529,970.6637931,1731,40.50070192,3462,-826880,59392,-767488,41
1653,129,23,7,0.0723905724,0.927609428,500.5352696,608.7418645,870.9673321,1154.604651,1782,31.07778165,3564,-846336,66048,-780288,41
1657,124,23,7,0.0696238069,0.930376193,501.8594101,620.8958318,875.6173808,1096.556452,1781,48.07017544,3562,-848384,63488,-784896,41
1659,123,22,8,0.069023569,0.930976431,501.924463,627.443663,876.801085,1089.756098,1782,49.98597475,3564,-849408,62976,-786432,41
1645,122,23,7,0.0690435767,0.930956423,498.0853016,612.3405682,868.256535,1096.278689,1767,44.72285497,3534,-842240,62464,-779776,41
1779,130,23,7,0.0680984809,0.931901519,538.8105339,665.5284702,940.2417088,1156.961538,1909,49.32816537,3818,-910848,66560,-844288,41
1778,128,22,8,0.0671563484,0.932843652,538.4893756,661.1476851,939.091676,1153.640625,1906,50.69148936,3812,-910336,65536,-844800,41
1645,121,23,7,0.0685164213,0.931483579,498.0213941,599.2049002,865.7896657,1124.272727,1766,46.15786722,3532,-842240,61952,-780288,41
1662,128,23,7,0.0715083799,0.92849162,503.6115616,638.0215475,881.8736462,1072.429688,1790,46.08650875,3580,-850944,65536,-785408,41
9436,522,22,8,0.0524201647,0.947579835,2860.317343,3092.49637,5002.561891,4562.618774,9958,702.2566996,19916,-4831232,267264,-4563968,42
8980,594,23,7,0.0620430332,0.937956967,2737.999809,3127.409133,4784.874388,4827.193603,9574,217.4920491,19148,-4597760,304128,-4293632,42
9521,449,22,8,0.0450351053,0.954964895,2862.751027,3114.41422,5016.457095,4329.057906,9970,1303.267974,19940,-4874752,229888,-4644864,42
9414,542,21,9,0.0544395339,0.945560466,2860.930765,3036.156909,5011.559167,4404.295203,9956,237.047619,19912,-4819968,277504,-4542464,42
9419,535,22,8,0.0537472373,0.946252763,2866.065054,2975.349968,4999.085359,4597.476636,9954,980.6896552,19908,-4822528,273920,-4548608,42
9431,527,21,9,0.0529222735,0.947077726,2871.924938,2886.403962,5004.421906,4533.506641,9958,1293.246753,19916,-4828672,269824,-4558848,42
9504,463,22,8,0.0464532959,0.953546704,2862.758192,3004.396724,5030.527041,4028.939525,9967,1623.289902,19934,-4866048,237056,-4628992,42
7150,868,21,9,0.108256423,0.891743577,2256.678753,2452.456456,3867.989231,5175.170507,8018,164.5392982,16036,-3660800,444416,-3216384,42
9380,570,22,8,0.0572864322,0.942713568,2851.278364,3156.986432,5005.889552,4475.405263,9950,770.7203718,19900,-4802560,291840,-4510720,42
9424,533,22,8,0.0535301798,0.94646982,2873.989653,2838.705058,5005.900042,4503.378987,9957,619.2164179,19914,-4825088,272896,-4552192,42
9384,568,22,8,0.057073955,0.942926045,2875.973097,2609.707739,5039.546355,3934.903169,9952,176.7673179,19904,-4804608,290816,-4513792,42
7830,554,21,9,0.0660782443,0.933921756,2395.301006,2725.036968,4167.846232,4540.945848,8384,201.1033821,16768,-4008960,283648,-3725312,42
9393,561,22,8,0.0563592526,0.943640747,2856.520185,3105.417124,5005.898861,4502.008913,9954,835.0671141,19908,-4809216,287232,-4521984,42
9395,560,22,8,0.0562531391,0.943746861,2868.050947,2889.794135,5017.172113,4320.817857,9955,392.7021696,19910,-4810240,286720,-4523520,42
9404,551,21,9,0.0553490708,0.944650929,2869.454116,2892.441961,5009.93322,4432.990926,9955,622.5766104,19910,-4814848,282112,-4532736,42
9376,573,22,8,0.057593728,0.942406272,2859.453612,3056.179388,4992.567513,4687.542757,9949,757.1537291,19898,-4800512,293376,-4507136,42
4649,247,22,8,0.0504493464,0.949550654,1397.448561,1565.196699,2480.797161,1840.607287,4896,77.66497462,9792,-2380288,126464,-2253824,42
9583,405,22,8,0.0405486584,0.959451342,2866.058875,3116.384137,5034.747052,4042.185185,9988,1269.123253,19976,-4906496,207360,-4699136,42
7229,828,22,8,0.10276778,0.89723222,2271.211311,2524.317271,3908.645317,5079.777778,8057,198.791019,16114,-3701248,423936,-3277312,42
9413,542,21,9,0.0544450025,0.945554997,2869.427725,2900.190917,5007.606395,4463.821033,9955,1061.30064,19910,-4819456,277504,-4541952,42
3381,358,22,8,0.0957475261,0.904252474,1065.261844,1111.379063,1823.278024,2311.248603,3739,68.20503466,7478,-1731072,183296,-1547776,42
5356,817,22,8,0.132350559,0.867649441,1783.92136,1621.497168,2986.416169,3746.396573,6173,110.0356506,12346,-2742272,418304,-2323968,42
5657,849,22,8,0.130494928,0.869505072,1889.698065,1665.490006,3158.294502,3887.866902,6506,115.3341606,13012,-2896384,434688,-2461696,42
3662,355,22,8,0.0883744088,0.911625591,1158.264327,1138.434165,1982.692245,2280.377465,4017,126.7992424,8034,-1874944,181760,-1693184,42
3639,346,22,8,0.086825596,0.913174404,1152.207241,1103.449279,1970.51003,2229.534682,3985,123.1078159,7970,-1863168,177152,-1686016,42
5421,831,22,8,0.132917466,0.867082534,1799.75961,1666.028167,3015.924184,3847.837545,6252,111.9627507,12504,-2775552,425472,-2350080,42
3595,365,22,8,0.0921717172,0.907828283,1136.537274,1162.157837,1949.191377,2288.868493,3960,90.53497942,7920,-1840640,186880,-1653760,42
3264,311,22,8,0.086993007,0.913006993,1026.434433,1070.594397,1769.926164,1977.688103,3575,74.10862355,7150,-1671168,159232,-1511936,42
3597,370,22,8,0.0932694732,0.906730527,1139.109686,1138.842284,1946.173756,2351.732432,3967,116.1980082,7934,-1841664,189440,-1652224,42
3643,374,22,8,0.0931043067,0.906895693,1153.456267,1157.877781,1972.07933,2368.631016,4017,118.2513983,8034,-1865216,191488,-1673728,42
3659,382,22,8,0.0945310567,0.905468943,1157.340614,1180.104782,1979.698278,2416.609948,4041,109.6905537,8082,-1873408,195584,-1677824,42
3538,357,22,8,0.0916559692,0.908344031,1125.374454,1073.900743,1919.304975,2232.378151,3895,128.6327609,7790,-1811456,182784,-1628672,42
3650,338,22,8,0.0847542628,0.915245737,1152.403239,1111.094249,1972.47863,2232.304734,3988,123.0484418,7976,-1868800,173056,-1695744,42
3716,346,22,8,0.0851797144,0.914820286,1172.888395,1149.329025,2012.249731,2238.245665,4062,105.3150117,8124,-1902592,177152,-1725440,42
3596,343,22,8,0.0870779386,0.912922061,1137.521428,1094.888141,1943.595662,2246.822157,3939,139.5818568,7878,-1841152,175616,-1665536,42
3609,374,22,8,0.0938990711,0.906100929,1143.091236,1166.287601,1959.271543,2307.820856,3983,84.2962963,7966,-1847808,191488,-1656320,42
3581,341,22,8,0.086945436,0.913054564,1136.425561,1057.841662,1938.887741,2198.961877,3922,131.8762609,7844,-1833472,174592,-1658880,42
1539,89,22,8,0.0546683047,0.945331695,467.8732309,479.4944559,823.3619233,661.258427,1628,28.88061025,3256,-787968,45568,-742400,42
4547,612,22,8,0.118627641,0.881372359,1480.841196,1391.043979,2493.460523,3222.965686,5159,106.4369713,10318,-2328064,313344,-2014720,42
971,42,23,7,0.0414610069,0.958538993,289.8465983,328.6348429,511.6889804,398.5952381,1013,37.6860119,2026,-497152,21504,-475648,42
9462,495,22,8,0.0497137692,0.950286231,2861.451758,3082.910936,5000.049567,4576.634343,9957,1531.846154,19914,-4844544,253440,-4591104,42
9389,562,22,8,0.056476736,0.943523264,2864.954055,2885.262608,5023.257322,4186.5,9951,524.288725,19902,-4807168,287744,-4519424,42
9493,468,22,8,0.0469832346,0.953016765,2863.226609,3037.223754,5014.050774,4310.59188,9961,1410.906516,19922,-4860416,239616,-4620800,42
9478,481,22,8,0.0482980219,0.951701978,2866.641735,2955.586292,5013.786664,4314.241164,9959,829.2256453,19918,-4852736,246272,-4606464,42
9419,536,22,8,0.0538422903,0.94615771,2863.804234,3004.941506,5004.702516,4508.76306,9955,954.4582934,19910,-4822528,274432,-4548096,42
9463,494,22,8,0.0496133374,0.950386663,2862.669455,2945.942156,5026.349149,4071.98583,9957,725.2002913,19914,-4845056,252928,-4592128,42
9438,517,22,8,0.0519337017,0.948066298,2870.205341,2870.573679,5011.357809,4369.042553,9955,948.9990467,19910,-4832256,264704,-4567552,42
9424,531,22,8,0.0533400301,0.94665997,2868.754726,2898.199103,5011.309104,4386.841808,9955,1082.065217,19910,-4825088,271872,-4553216,42
4951,772,23,7,0.134894286,0.865105714,1650.635545,1593.734358,2793.949303,3298.423575,5723,109.2592593,11446,-2534912,395264,-2139648,42
9411,543,23,7,0.0545509343,0.945449066,2857.99055,3053.984212,5015.87589,4312.388582,9954,989.4632207,19908,-4818432,278016,-4540416,42
9423,529,22,8,0.0531551447,0.946844855,2867.921835,2892.468021,5010.862995,4364.396975,9952,1006.268959,19904,-4824576,270848,-4553728,42
9425,527,22,8,0.0529541801,0.94704582,2858.668631,3066.992443,5006.568382,4438.749526,9952,1096.035242,19904,-4825600,269824,-4555776,42
9415,535,22,8,0.0537688442,0.946231156,2868.072042,2862.891994,5013.913117,4299.500935,9950,872.0420684,19900,-4820480,273920,-4546560,42
9423,531,22,8,0.0533453888,0.946654611,2865.701074,2942.645246,5011.702536,4370.549906,9954,1512.765957,19908,-4824576,271872,-4552704,42
9522,440,22,8,0.0441678378,0.955832162,2859.310573,2985.999903,5034.91945,3825.454545,9962,870.0436681,19924,-4875264,225280,-4649984,42
9426,528,22,8,0.0530440024,0.946955998,2861.48734,3026.055238,5008.664651,4421.140152,9954,1133.712984,19908,-4826112,270336,-4555776,42
9431,523,22,8,0.0525416918,0.947458308,2857.632457,3124.550248,4997.038066,4625.179732,9954,1474.666667,19908,-4828672,267776,-4560896,42
9435,518,22,8,0.0520446097,0.94795539,2863.110089,2966.924216,5014.988235,4285.071429,9953,938.9622642,19906,-4830720,265216,-4565504,42
5772,885,22,8,0.132942767,0.867057233,1950.953106,1689.417749,3283.798683,3623.80452,6657,117.4281178,13314,-2955264,453120,-2502144,42
9403,549,22,8,0.055164791,0.944835209,2845.474378,2838.897753,5072.808465,3326.976321,9952,215.0853685,19904,-4814336,281088,-4533248,42
9404,547,22,8,0.0549693498,0.94503065,2869.638616,2846.14509,5013.690451,4328.027422,9951,954.0747843,19902,-4814848,280064,-4534784,42
7545,502,22,8,0.062383497,0.937616503,2300.692533,2633.976403,4018.846786,4101.452191,8047,143.5938615,16094,-3863040,257024,-3606016,42
9398,551,22,8,0.0553824505,0.94461755,2875.467216,2777.408535,5000.323154,4543.08167,9949,584.5475911,19898,-4811776,282112,-4529664,42
8222,581,22,8,0.0660002272,0.933999773,2523.525734,2777.101471,4409.705668,4292.953528,8803,318.9492754,17606,-4209664,297472,-3912192,42
9365,579,22,8,0.058226066,0.941773934,2862.739181,2979.990056,4990.251789,4685.374784,9944,1119.81982,19888,-4794880,296448,-4498432,42
9404,547,22,8,0.0549693498,0.94503065,2871.804586,2788.355791,5018.167482,4251.058501,9951,526.7866596,19902,-4814848,280064,-4534784,42
9427,528,22,8,0.053038674,0.946961326,2866.46597,2916.726503,5016.495598,4290.693182,9955,1386.490251,19910,-4826624,270336,-4556288,42
7961,562,22,8,0.0659392233,0.934060777,2438.911184,2744.217255,4254.354604,4370.300712,8523,254.6459516,17046,-4076032,287744,-3788288,42
9342,599,22,8,0.0602555075,0.939744493,2867.138754,2626.453497,5048.831621,3757.138564,9941,610.2516882,19882,-4783104,306688,-4476416,42
8867,585,22,8,0.0618916631,0.938108337,2713.741651,2943.496764,4730.002932,4673.405128,9452,318.4636119,18904,-4539904,299520,-4240384,42
7931,568,22,8,0.0668313919,0.933168608,2435.631266,2685.877637,4260.237045,4107.059859,8499,265.676774,16998,-4060672,290816,-3769856,42
5467,196,22,8,0.0346106304,0.96538937,1627.910316,1771.473111,2846.018109,2440.994898,5663,165.5847953,11326,-2799104,100352,-2698752,42
8163,559,22,8,0.0640908049,0.935909195,2505.367519,2680.810406,4378.577974,4112.112701,8722,293.4724092,17444,-4179456,286208,-3893248,42
8043,641,22,8,0.0738139106,0.926186089,2463.068788,2903.922867,4283.983464,5076.74103,8684,152.3508772,17368,-4118016,328192,-3789824,42
7995,604,22,8,0.0702407257,0.929759274,2460.040835,2759.361899,4305.241151,4230.624172,8599,178.7362295,17198,-4093440,309248,-3784192,42
7966,550,22,8,0.0645843119,0.935415688,2445.751379,2632.64271,4264.514687,4171.385455,8516,245.0647482,17032,-4078592,281600,-3796992,42
9403,549,22,8,0.055164791,0.944835209,2869.373816,2801.728791,5025.653728,4134.619308,9952,1028.099174,19904,-4814336,281088,-4533248,42
7952,536,22,8,0.0631479736,0.936852026,2427.411701,2754.733018,4227.269869,4500.123134,8488,271.00894,16976,-4071424,274432,-3796992,42
9387,560,22,8,0.0562983814,0.943701619,2862.635928,3005.540548,4988.112176,4737.444643,9947,671.6407833,19894,-4806144,286720,-4519424,42
7960,553,22,8,0.0649594737,0.935040526,2421.421783,2792.822205,4197.955528,5106.898734,8513,282.5423166,17026,-4075520,283136,-3792384,42
9352,590,22,8,0.0593441963,0.940655804,2863.566472,2923.310427,5003.682421,4461.381356,9942,299.5480566,19884,-4788224,302080,-4486144,42
7691,528,23,7,0.0642413919,0.935758608,2360.433651,2540.197172,4118.64738,3984.039773,8219,269.9178982,16438,-3937792,270336,-3667456,42
6413,505,22,8,0.0729979763,0.927002024,1966.028671,2325.581355,3430.995634,3821.477228,6918,213.0582076,13836,-3283456,258560,-3024896,42
3627,239,23,7,0.0618210036,0.938178996,1108.070906,1127.494255,1964.929418,1456.535565,3866,67.69392401,7732,-1857024,122368,-1734656,42
9370,577,22,8,0.0580074394,0.941992561,2864.094495,2921.177794,5011.667022,4362.318891,9947,257.761078,19894,-4797440,295424,-4502016,42
6482,539,22,8,0.0767696909,0.923230309,1986.561615,2351.422348,3453.374267,4204.005566,7021,194.379845,14042,-3318784,275968,-3042816,42
9370,577,22,8,0.0580074394,0.941992561,2864.499197,2948.819214,5000.546852,4542.901213,9947,325.0653595,19894,-4797440,295424,-4502016,42
6460,509,22,8,0.0730377386,0.926962261,1981.451772,2235.532329,3426.901858,4222.355599,6969,190.2538903,13938,-3307520,260608,-3046912,42
6076,491,22,8,0.0747677783,0.925232222,1883.286632,1911.222523,3340.208361,2588.435845,6567,118.4310189,13134,-3110912,251392,-2859520,42
6033,491,23,7,0.0752605763,0.924739424,1842.725418,2268.294232,3222.586773,3752.92057,6524,120.4356655,13048,-3088896,251392,-2837504,42
6436,505,22,8,0.072756087,0.927243913,1974.310229,2321.712244,3445.473275,3796.326733,6941,209.8881161,13882,-3295232,258560,-3036672,42
6477,500,22,8,0.071664039,0.928335961,1986.495429,2341.265497,3483.803458,3556.316,6977,241.5858726,13954,-3316224,256000,-3060224,42
7411,543,22,8,0.0682675383,0.931732462,2284.718427,2441.753968,3988.218999,3831.20442,7954,175.4687845,15908,-3794432,278016,-3516416,42
6425,538,22,8,0.0772655465,0.922734454,1978.220597,2338.847701,3458.43284,3763.447955,6963,186.7256637,13926,-3289600,275456,-3014144,42
9385,562,22,8,0.0564994471,0.943500553,2876.543927,2756.940787,4996.952371,4590.711744,9947,697.545582,19894,-4805120,287744,-4517376,42
6016,497,22,8,0.0763089206,0.923691079,1866.812302,1898.243609,3315.136636,2553.277666,6513,118.4612586,13026,-3080192,254464,-2825728,42
6351,485,22,8,0.0709479228,0.929052077,1961.775905,2112.655875,3431.046449,3254.206186,6836,145.1380042,13672,-3251712,248320,-3003392,42
9390,561,22,8,0.0563762436,0.943623756,2871.378553,2787.182659,5021.011076,4222.606061,9951,687.6986869,19902,-4807680,287232,-4520448,42
6450,547,23,7,0.0781763613,0.921823639,1982.902304,2362.912068,3459.04093,3970.180987,6997,198.4964539,13994,-3302400,280064,-3022336,42
6158,483,22,8,0.0727300105,0.927269989,1889.589502,2237.160396,3315.597759,3389.875776,6641,126.1109001,13282,-3152896,247296,-2905600,42
9455,501,22,8,0.0503214142,0.949678586,2867.927267,2833.231923,5027.389529,4055.844311,9956,759.4202899,19912,-4840960,256512,-4584448,42
9444,510,23,7,0.0512356841,0.948764316,2865.751052,2826.765218,5032.337039,3962.047059,9954,938.1715363,19908,-4835328,261120,-4574208,42
9445,510,22,8,0.0512305374,0.948769463,2864.600314,2840.783743,5034.695183,3928.027451,9955,1195.078031,19910,-4835840,261120,-4574720,42
9412,536,22,8,0.0538801769,0.946119823,2869.858315,2701.603137,5033.590948,3936.880597,9948,584.1456254,19896,-4818944,274432,-4544512,42
5502,779,22,8,0.124024837,0.875975163,1830.928076,1572.303548,3061.674119,3701.27086,6281,112.5223934,12562,-2817024,398848,-2418176,42
9465,492,22,8,0.0494124736,0.950587526,2866.319012,2792.661528,5037.852509,3846.806911,9957,974.2661448,19914,-4846080,251904,-4594176,42
2924,258,22,8,0.0810810811,0.918918919,916.5879943,939.7303859,1587.94186,1631.825581,3182,86.98742482,6364,-1497088,132096,-1364992,42
5466,838,22,8,0.132931472,0.867068528,1837.465922,1625.341001,3081.301683,3616.903341,6304,115.9676233,12608,-2798592,429056,-2369536,42
9462,496,22,8,0.0498091986,0.950190801,2858.3062,2832.412959,5052.22881,3592.080645,9958,180.2026782,19916,-4844544,253952,-4590592,42
9451,504,22,8,0.0506278252,0.949372175,2865.651917,2816.559932,5034.877579,3911.43254,9955,1002.517623,19910,-4838912,258048,-4580864,42
9448,507,22,8,0.0509291813,0.949070819,2865.854981,2833.471589,5032.21666,3967.666667,9955,1263.324873,19910,-4837376,259584,-4577792,42
9455,502,22,8,0.0504167922,0.949583208,2866.184071,2814.073517,5036.250555,3900.705179,9957,1118.764045,19914,-4840960,257024,-4583936,42
9440,514,23,7,0.0516375327,0.948362467,2867.275862,2803.356028,5031.868962,3978.972763,9954,1034.719335,19908,-4833280,263168,-4570112,42
9472,488,22,8,0.0489959839,0.951004016,2866.545678,2906.740679,5024.947635,4117.778689,9960,817.0631665,19920,-4849664,249856,-4599808,42
9448,506,23,7,0.0508338356,0.949166164,2863.319208,2843.420757,5036.054191,3884.179842,9954,1199.277108,19908,-4837376,259072,-4578304,42
9434,521,22,8,0.0523355098,0.94766449,2865.235337,2799.289332,5039.496184,3864.458733,9955,1255.359395,19910,-4830208,266752,-4563456,42
3670,519,22,8,0.123895918,0.876104082,1198.589582,1175.001291,2027.070572,2575.348748,4189,116.2965019,8378,-1879040,265728,-1613312,42
9665,327,22,8,0.0327261809,0.967273819,2877.028394,3060.765967,5011.899017,4541.357798,9992,679.7278912,19984,-4948480,167424,-4781056,42
5240,885,22,8,0.144489796,0.855510204,1761.288422,1656.739928,2949.854771,3732.922034,6125,108.7535511,12250,-2682880,453120,-2229760,42
1073,83,22,8,0.071799308,0.928200692,332.086869,353.9991836,578.6076421,577.1084337,1156,17.83675359,2312,-549376,42496,-506880,42
9483,477,22,8,0.0478915663,0.952108434,2864.610058,2859.350183,5036.457661,3868.033543,9960,946.7680608,19920,-4855296,244224,-4611072,42
9469,489,22,8,0.0491062462,0.950893754,2862.564121,2846.927993,5041.147323,3785.760736,9958,1035.135135,19916,-4848128,250368,-4597760,42
9460,498,22,8,0.0500100422,0.949989958,2863.150259,2829.167181,5042.554228,3781.722892,9958,847.4893617,19916,-4843520,254976,-4588544,42
9478,481,22,8,0.0482980219,0.951701978,2865.380442,2839.920029,5035.98027,3876.920998,9959,1045.01574,19918,-4852736,246272,-4606464,42
9462,495,22,8,0.0497137692,0.950286231,2866.304471,2804.53927,5036.651131,3876.989899,9957,564.4557823,19914,-4844544,253440,-4591104,42
9466,491,22,8,0.0493120418,0.950687958,2863.918274,2817.993542,5040.39119,3795.437882,9957,1105.105438,19914,-4846592,251392,-4595200,42
9458,500,22,8,0.0502108857,0.949789114,2862.481732,2837.791101,5043.195919,3774.628,9958,1153.881808,19916,-4842496,256000,-4586496,42
9444,510,22,8,0.0512356841,0.948764316,2860.274081,2907.381687,5035.248518,3908.133333,9954,1274.519846,19908,-4835328,261120,-4574208,42
7731,265,22,8,0.0331415708,0.966858429,2301.028669,2471.176445,4013.262709,3567.818868,7996,139.3031359,15992,-3958272,135680,-3822592,42
8768,475,22,8,0.0513902413,0.948609759,2651.56843,2611.161763,4695.431341,3266.534737,9243,160.0242382,18486,-4489216,243200,-4246016,42
9469,490,22,8,0.0492017271,0.950798273,2862.752456,2832.828797,5043.602915,3750.906122,9959,1333.199465,19918,-4848128,250880,-4597248,42
9464,493,22,8,0.0495129055,0.950487095,2863.673102,2836.181754,5038.933643,3828.46856,9957,1134.05467,19914,-4845568,252416,-4593152,42
9464,493,22,8,0.0495129055,0.950487095,2865.015127,2869.506211,5031.162933,3977.640974,9957,681.9863014,19914,-4845568,252416,-4593152,42
9463,495,22,8,0.0497087769,0.950291223,2866.764675,2777.849237,5040.049878,3821.957576,9958,671.9298246,19916,-4845056,253440,-4591616,42
9450,507,22,8,0.0509189515,0.949081049,2861.313748,2869.932594,5041.233439,3819.027613,9957,1095.379538,19914,-4838400,259584,-4578816,42
5023,809,22,8,0.138717421,0.861282579,1693.609514,1545.429202,2844.019709,3366.522868,5832,102.9842839,11664,-2571776,414208,-2157568,42
9458,500,23,7,0.0502108857,0.949789114,2862.619642,2841.509107,5042.440262,3788.922,9958,1036.212279,19916,-4842496,256000,-4586496,42
9461,496,22,8,0.0498142011,0.950185799,2865.397647,2823.114424,5036.606278,3880.183468,9957,469.2271442,19914,-4844032,253952,-4590080,42
9474,486,22,8,0.0487951807,0.951204819,2862.906004,2827.324273,5044.740764,3728.201646,9960,874.451273,19920,-4850688,248832,-4601856,42
4722,665,22,8,0.123445331,0.876554669,1549.681561,1419.660253,2598.721516,3370.548872,5387,95.63287769,10774,-2417664,340480,-2077184,42
3189,357,22,8,0.100676819,0.899323181,1016.641443,1062.787177,1750.75196,1976.703081,3546,115.9202354,7092,-1632768,182784,-1449984,42
2976,356,22,8,0.106842737,0.893157263,948.6562228,1005.989497,1626.668011,1999.477528,3332,123.2248521,6664,-1523712,182272,-1341440,42
3286,363,22,8,0.0994793094,0.900520691,1056.167108,1014.196484,1807.553865,1982.928375,3649,99.45489234,7298,-1682432,185856,-1496576,42
3225,336,23,7,0.0943555181,0.905644482,1031.748352,980.4744872,1766.72062,1918.056548,3561,99.16457811,7122,-1651200,172032,-1479168,42
3229,343,22,8,0.0960246361,0.903975364,1034.651147,994.5969108,1778.738309,1859.568513,3572,93.77789446,7144,-1653248,175616,-1477632,42
3237,335,22,8,0.0937849944,0.906215006,1033.078302,1008.06051,1777.380599,1874.61791,3572,94.72288518,7144,-1657344,171520,-1485824,42
3252,342,22,8,0.0951585977,0.904841402,1038.824732,1017.696866,1785.449877,1912.081871,3594,95.63597658,7188,-1665024,175104,-1489920,42
3154,346,22,8,0.0988571429,0.901142857,1009.32172,997.5979977,1728.457831,1951.427746,3500,128.8659794,7000,-1614848,177152,-1437696,42
3321,360,22,8,0.097799511,0.902200489,1065.031083,1005.045319,1813.45408,2095.111111,3681,98.4487831,7362,-1700352,184320,-1516032,42
3240,326,22,8,0.0914189568,0.908581043,1030.66172,1010.336412,1772.397531,1893.843558,3566,85.80365736,7132,-1658880,166912,-1491968,42
3068,333,22,8,0.0979123787,0.902087621,978.7226446,992.5833637,1681.998044,1876.069069,3401,116.1543716,6802,-1570816,170496,-1400320,42
2995,329,22,8,0.098977136,0.901022864,953.9978582,995.6661672,1645.615693,1816.203647,3324,127.1614384,6648,-1533440,168448,-1364992,42
3054,317,22,8,0.0940373776,0.905962622,961.0461339,1075.613901,1673.867714,1802.883281,3371,79.82476912,6742,-1563648,162304,-1401344,42
3147,341,22,8,0.0977637615,0.902236239,999.826366,1045.120666,1720.906578,1962.237537,3488,116.53859,6976,-1611264,174592,-1436672,42
3259,341,22,8,0.0947222222,0.905277778,1039.290841,1033.861935,1790.579626,1895.31085,3600,93.65244537,7200,-1668608,174592,-1494016,42
2889,332,22,8,0.10307358,0.89692642,919.4576054,988.3702988,1585.595016,1832.069277,3221,98.71284094,6442,-1479168,169984,-1309184,42
3240,337,22,8,0.0942130277,0.905786972,1033.809385,1015.091751,1778.326543,1891.617211,3577,96.18176929,7154,-1658880,172544,-1486336,42
1310,82,23,7,0.058908046,0.941091954,397.423989,465.4156415,698.5961832,663.0121951,1392,45.13618677,2784,-670720,41984,-628736,42
3173,354,22,8,0.100368585,0.899631415,1010.085804,1044.713785,1731.911755,2051.615819,3527,109.9781727,7054,-1624576,181248,-1443328,42
945,58,22,8,0.0578265204,0.94217348,285.0803958,326.6337829,510.1915344,368.5344828,1003,15.57211613,2006,-483840,29696,-454144,42
9375,572,22,8,0.0575047753,0.942495225,2875.911081,2642.766056,5028.3184,4083.729021,9947,480.7636539,19894,-4800000,292864,-4507136,42
4789,451,22,8,0.0860687023,0.913931298,1495.90863,1641.346996,2588.140113,2964.117517,5240,188.8288288,10480,-2451968,230912,-2221056,42
4079,565,22,8,0.12166236,0.87833764,1327.307254,1364.733588,2265.780829,2731.982301,4644,104.7361299,9288,-2088448,289280,-1799168,42
8316,559,22,8,0.0629859155,0.937014085,2556.934607,2613.560687,4460.372415,4105.175313,8875,267.8032589,17750,-4257792,286208,-3971584,42
9380,568,22,8,0.0570969039,0.942903096,2878.383005,2588.368714,5030.790405,4044.915493,9948,945.6273764,19896,-4802560,290816,-4511744,42
4817,476,21,9,0.0899300964,0.910069904,1507.809618,1698.627582,2622.366411,2896.285714,5293,94.55162558,10586,-2466304,243712,-2222592,42
9377,572,22,8,0.0574932154,0.942506785,2868.196644,2665.616196,5047.618855,3784.533217,9949,548.15427,19898,-4801024,292864,-4508160,42
4105,574,22,8,0.122675785,0.877324215,1342.032157,1335.245511,2280.171498,2767.867596,4679,114.1497926,9358,-2101760,293888,-1807872,42
9351,591,22,8,0.0594447797,0.94055522,2878.837145,2590.892737,5023.551171,4147.928934,9942,999.1959799,19884,-4787712,302592,-4485120,42
4750,474,22,8,0.0907350689,0.909264931,1491.995473,1658.838464,2605.935579,2678.2827,5224,104.6893788,10448,-2432000,242688,-2189312,42
9398,552,22,8,0.0554773869,0.944522613,2881.670106,2570.917526,5024.08406,4148.338768,9950,926.443203,19900,-4811776,282624,-4529152,42
9364,580,22,8,0.0583266291,0.941673371,2878.084887,2625.732377,5020.950128,4190.281034,9944,1096.361632,19888,-4794368,296960,-4497408,42
9343,598,22,8,0.060154914,0.939845086,2875.968041,2610.640569,5028.506797,4072.528428,9941,783.9905363,19882,-4783616,306176,-4477440,42
9376,570,22,8,0.0573094711,0.942690529,2871.767841,2698.769937,5029.59215,4050.833333,9946,826.0797342,19892,-4800512,291840,-4508672,42
4138,578,22,8,0.122561493,0.877438507,1349.358068,1367.587399,2297.60174,2794.480969,4716,124.993374,9432,-2118656,295936,-1822720,42
9428,525,22,8,0.0527479152,0.947252085,2879.967042,2612.302899,5023.312686,4145.312381,9953,640.4761905,19906,-4827136,268800,-4558336,42
9379,570,22,8,0.0572921902,0.94270781,2874.926841,2642.457287,5033.768952,4007.992982,9949,724.6176256,19898,-4802048,291840,-4510208,42
9393,557,22,8,0.0559798995,0.944020101,2878.380976,2596.54257,5030.768019,4043.48474,9950,895.589559,19900,-4809216,285184,-4524032,42
9387,563,23,7,0.0565829146,0.943417085,2876.142395,2619.909832,5034.32577,3994.687389,9950,829.1666667,19900,-4806144,288256,-4517888,42
4834,471,22,8,0.0887841659,0.911215834,1516.040574,1638.681803,2618.069715,3011.498938,5305,159.8373004,10610,-2475008,241152,-2233856,42
9436,518,23,7,0.0520393812,0.947960619,2862.1119,3031.187405,5004.526494,4485.179537,9954,1106,19908,-4831232,265216,-4566016,42
9536,432,22,8,0.0433386838,0.956661316,2869.102659,3021.72993,5005.102139,4529.726852,9968,1014.038657,19936,-4882432,221184,-4661248,42
9447,508,22,8,0.0510296334,0.948970367,2861.73549,3060.633719,4999.82947,4572.049213,9955,2127.136752,19910,-4836864,260096,-4576768,42
9445,510,22,8,0.0512305374,0.948769463,2864.593306,2983.62533,5008.247962,4417.819608,9955,724.5269287,19910,-4835840,261120,-4574720,42
9442,511,22,8,0.0513413041,0.948658696,2863.447219,2973.023889,5012.295806,4324.821918,9953,286.9953864,19906,-4834304,261632,-4572672,42
8731,298,22,8,0.0330047624,0.966995238,2598.497444,2798.621212,4528.988203,4105.16443,9029,249.9031276,18058,-4470272,152576,-4317696,42
9433,520,22,8,0.0522455541,0.947754446,2867.263142,2881.690897,5017.430404,4243.576923,9953,565.1902328,19906,-4829696,266240,-4563456,42
9499,462,22,8,0.0463808855,0.953619115,2865.616676,3036.593616,5002.938941,4529.922078,9961,1480.089153,19922,-4863488,236544,-4626944,42
6285,920,22,8,0.127689105,0.872310895,2100.056147,1864.751724,3531.533174,4091.227174,7205,126.6701828,14410,-3217920,471040,-2746880,42
9479,478,22,8,0.0480064276,0.951993572,2860.056598,3102.797173,5004.017196,4482.895397,9957,1167.291911,19914,-4853248,244736,-4608512,42
9416,537,23,7,0.0539535818,0.946046418,2862.532902,3012.399454,5004.835174,4488.925512,9953,1442.463768,19906,-4820992,274944,-4546048,42
6085,1071,22,8,0.149664617,0.850335383,2048.452737,1996.820288,3444.208874,4341.489262,7156,122.9975937,14312,-3115520,548352,-2567168,42
3734,386,22,8,0.0936893204,0.90631068,1172.807052,1334.711468,2070.773701,1961.11658,4120,74.6647336,8240,-1911808,197632,-1714176,42
9416,538,22,8,0.0540486237,0.945951376,2872.715867,2691.629658,5035.466015,3962.986989,9954,797.5961538,19908,-4820992,275456,-4545536,42
6580,1015,22,8,0.133640553,0.866359447,2201.472579,2058.023631,3717.339514,4320.902463,7595,131.8347509,15190,-3368960,519680,-2849280,42
9425,530,22,8,0.0532395781,0.946760422,2862.820809,2991.175716,5013.771671,4341.871698,9955,1209.599028,19910,-4825600,271360,-4554240,42
5453,764,22,8,0.122888853,0.877111147,1803.153172,1656.546639,3042.153127,3586.115183,6217,127.1890344,12434,-2791936,391168,-2400768,42
3926,374,22,8,0.0869767442,0.913023256,1234.138666,1304.411279,2165.039735,1997.871658,4300,77.51937984,8600,-2010112,191488,-1818624,42
9456,500,22,8,0.0502209723,0.949779028,2862.72403,3031.115418,5006.784158,4443.59,9956,1719.516408,19912,-4841472,256000,-4585472,42
9482,474,22,8,0.0476094817,0.952390518,2865.292841,3022.960406,4995.902447,4630.377637,9956,1284.645161,19912,-4854784,242688,-4612096,42
2139,248,21,9,0.103896104,0.896103896,674.2418034,804.1915378,1199.397382,1147.447581,2387,154.2986425,4774,-1095168,126976,-968192,43
2151,251,21,9,0.104496253,0.895503747,676.617348,823.1624636,1203.119014,1187.625498,2402,162.8474576,4804,-1101312,128512,-972800,43
2179,244,22,8,0.10070161,0.89929839,685.3687435,813.7710989,1215.805415,1178.016393,2423,50.31146179,4846,-1115648,124928,-990720,43
2253,260,21,9,0.103461998,0.896538002,709.0097984,854.6923564,1256.936085,1257.553846,2513,127.8229908,5026,-1153536,133120,-1020416,43
2184,255,21,9,0.104551046,0.895448954,688.4924895,825.4668288,1218.338828,1234.227451,2439,45.17503241,4878,-1118208,130560,-987648,43
2153,248,21,9,0.103290296,0.896709704,676.3225504,824.5664518,1201.828611,1193.806452,2401,152.6382708,4802,-1102336,126976,-975360,43
2273,276,21,9,0.108277756,0.891722244,717.6661838,870.1284268,1270.152662,1314.92029,2549,96.18867925,5098,-1163776,141312,-1022464,43
2154,237,22,8,0.0991217064,0.900878294,676.8489304,799.6678,1201.812442,1143.172996,2391,166.0416667,4782,-1102848,121344,-981504,43
2185,252,21,9,0.103405827,0.896594173,688.2142978,823.5367101,1222.735011,1186.615079,2437,78.23434992,4874,-1118720,129024,-989696,43
1700,194,21,9,0.102428722,0.897571278,533.1092052,654.0453098,949.1941176,932.6546392,1894,77.30612245,3788,-870400,99328,-771072,43
2221,247,21,9,0.100081037,0.899918963,697.2531029,835.8727471,1238.638451,1197.287449,2468,185.9834213,4936,-1137152,126464,-1010688,43
2246,259,21,9,0.103393214,0.896606786,707.0413722,849.361721,1256.541407,1222.289575,2505,163.5117493,5010,-1149952,132608,-1017344,43
2135,239,21,9,0.100673968,0.899326032,670.5893085,801.575784,1195.367213,1117.221757,2374,53.14528767,4748,-1093120,122368,-970752,43
2140,247,21,9,0.103477168,0.896522832,673.516443,809.0194311,1200.814019,1134.963563,2387,59.8245614,4774,-1095680,126464,-969216,43
2163,250,21,9,0.10360547,0.89639453,683.1619433,802.6274656,1210.62552,1175.632,2413,51.4389256,4826,-1107456,128000,-979456,43
2198,256,21,9,0.104319478,0.895680522,695.7169753,809.1381835,1228.83485,1216.039063,2454,46.41573671,4908,-1125376,131072,-994304,43
2166,241,21,9,0.100124636,0.899875364,680.9336433,807.362526,1209.715143,1152.634855,2407,148.7639061,4814,-1108992,123392,-985600,43
2191,262,21,9,0.10680799,0.89319201,691.8852873,830.1830084,1221.578275,1272.339695,2453,171.899089,4906,-1121792,134144,-987648,43
2162,238,21,9,0.0991666667,0.900833333,679.8150257,799.9806079,1205.39408,1156.042017,2400,150.3759398,4800,-1106944,121856,-985088,43
2170,246,22,8,0.101821192,0.898178808,683.1227563,810.8751757,1214.623502,1154.48374,2416,49.30612245,4832,-1111040,125952,-985088,43
519,50,20,10,0.0878734622,0.912126538,158.7686622,145.2277329,299.3391137,136.16,569,59.02489627,1138,-265728,25600,-240128,43
522,50,20,10,0.0874125874,0.912587413,160.1335935,147.3377467,300.2241379,143.22,572,56.80238332,1144,-267264,25600,-241664,43
518,51,20,10,0.0896309315,0.910369069,159.4529937,134.8044078,299.7335907,135.3529412,569,54.44976077,1138,-265216,26112,-239104,43
517,50,20,10,0.0881834215,0.911816578,158.3852536,152.5888187,297.4255319,145.18,567,61.76470588,1134,-264704,25600,-239104,43
524,50,20,10,0.0871080139,0.912891986,160.743655,148.0183354,301.1755725,144.18,574,62.45919478,1148,-268288,25600,-242688,43
524,53,20,10,0.0918544194,0.908145581,160.7052719,175.0527297,301.2156489,168.2264151,577,66.01830664,1154,-268288,27136,-241152,43
519,49,20,10,0.0862676056,0.913732394,159.1923642,143.199863,298.1040462,140.4081633,568,55.3067186,1136,-265728,25088,-240640,43
520,51,20,10,0.0893169877,0.910683012,159.7872771,141.9263825,300.4173077,139,571,55.76171875,1142,-266240,26112,-240128,43
526,51,20,10,0.0883882149,0.911611785,160.6934025,164.8283508,302.2205323,152.6470588,577,73.13054499,1154,-269312,26112,-243200,43
529,53,20,10,0.0910652921,0.908934708,162.6457525,158.8703312,305.2381853,154.3773585,582,61.26315789,1164,-270848,27136,-243712,43
527,53,20,10,0.0913793103,0.90862069,161.4919597,175.6750414,302.8500949,167.6981132,580,63.66630077,1160,-269824,27136,-242688,43
523,49,20,10,0.0856643357,0.914335664,160.404075,145.1389574,299.9655832,142.7755102,572,54.115421,1144,-267776,25088,-242688,43
522,53,20,10,0.092173913,0.907826087,160.0504141,169.4373177,300.9463602,160.490566,575,59.1563786,1150,-267264,27136,-240128,43
525,53,20,10,0.0916955017,0.908304498,161.1670946,175.5539369,301.4780952,170.8490566,578,67.68149883,1156,-268800,27136,-241664,43
531,51,24,6,0.087628866,0.912371134,163.4076639,143.21454,305.5913371,144.7843137,582,51.96428571,1164,-271872,26112,-245760,43
527,50,20,10,0.0866551127,0.913344887,161.10902,147.5441846,303.28463,138.44,577,62.5813449,1154,-269824,25600,-244224,43
527,51,23,7,0.0882352941,0.911764706,163.0089202,147.1437898,302.3358634,156.8627451,578,46.76375405,1156,-269824,26112,-243712,43
533,54,23,7,0.0919931857,0.908006814,164.7054718,148.0298243,308.467167,151.2037037,587,52.88288288,1174,-272896,27648,-245248,43
521,52,20,10,0.0907504363,0.909249564,159.619197,168.5105039,299.706334,159.6923077,573,62.41830065,1146,-266752,26624,-240128,43
527,52,23,7,0.0898100173,0.910189983,161.7764135,154.5340044,303.9449715,148.6730769,579,43.53383459,1158,-269824,26624,-243200,43
919,165,22,8,0.152214022,0.847785978,305.6231322,350.3317494,539.4504897,559.4848485,1084,31.59428738,2168,-470528,84480,-386048,43
947,188,20,10,0.165638767,0.834361233,314.4618731,387.1818864,569.6821542,559.5265957,1135,31.60679476,2270,-484864,96256,-388608,43
848,160,21,9,0.158730159,0.841269841,281.1768035,336.2170409,510.9080189,470.5375,1008,20.36363636,2016,-434176,81920,-352256,43
908,175,22,8,0.161588181,0.838411819,303.2027577,357.5939254,541.5539648,544.3142857,1083,28.71917263,2166,-464896,89600,-375296,43
930,184,22,8,0.165170557,0.834829443,310.8648556,370.9981806,556.3354839,563.3858696,1114,32.9390893,2228,-476160,94208,-381952,43
928,190,22,8,0.169946333,0.830053667,312.9282164,366.7451407,557.481681,569.3578947,1118,31.69832719,2236,-475136,97280,-377856,43
930,186,21,9,0.166666667,0.833333333,311.1366266,372.3817122,557.5107527,563.4462366,1116,32.48908297,2232,-476160,95232,-380928,43
916,184,21,9,0.167272727,0.832727273,307.5540304,362.9404538,553.0305677,537.9021739,1100,31.064671,2200,-468992,94208,-374784,43
943,181,21,9,0.161032028,0.838967972,315.6065986,366.3497942,558.0911983,585.4696133,1124,30.71877562,2248,-482816,92672,-390144,43
922,175,21,9,0.15952598,0.84047402,307.1051647,362.054721,544.5433839,572.48,1097,32.86399041,2194,-472064,89600,-382464,43
929,184,21,9,0.165318958,0.834681042,313.0621431,359.1864467,552.6232508,579.0978261,1113,30.01618123,2226,-475648,94208,-381440,43
919,172,22,8,0.157653529,0.842346471,306.7556025,354.5996392,541.6191513,569.4069767,1091,32.12603062,2182,-470528,88064,-382464,43
930,181,22,8,0.162916292,0.837083708,311.438414,363.8612235,551.6172043,578.519337,1111,32.63807286,2222,-476160,92672,-383488,43
938,176,22,8,0.157989228,0.842010772,312.9315246,362.3170128,551.0522388,591.8636364,1114,30.57080132,2228,-480256,90112,-390144,43
935,180,22,8,0.161434978,0.838565022,312.9446678,364.5309645,555.7743316,569.5611111,1115,27.95186764,2230,-478720,92160,-386560,43
938,183,22,8,0.163247101,0.836752899,313.3649349,371.5987697,559.5479744,568.442623,1121,31.69352559,2242,-480256,93696,-386560,43
907,165,22,8,0.15391791,0.84608209,302.0615165,346.2763168,531.9889746,561.2969697,1072,28.5030577,2144,-464384,84480,-379904,43
908,168,22,8,0.156133829,0.843866171,302.7750595,349.9201548,537.6332599,543.1845238,1076,29.78134514,2152,-464896,86016,-378880,43
938,183,22,8,0.163247101,0.836752899,312.8463547,373.8928451,560.1918977,565.1420765,1121,29.40713536,2242,-480256,93696,-386560,43
946,198,22,8,0.173076923,0.826923077,318.8146849,379.7656236,569.2980973,587.7979798,1144,30.77750874,2288,-484352,101376,-382976,43
793,188,21,9,0.191641182,0.808358818,275.9971282,310.7402164,496.2358134,468.9148936,981,27.53297783,1962,-406016,96256,-309760,43
807,177,21,9,0.179878049,0.820121951,278.4225477,308.3041649,494.3209418,484.1977401,984,26.62337662,1968,-413184,90624,-322560,43
816,169,22,8,0.171573604,0.828426396,278.1078837,312.7023274,492.4901961,495.4615385,985,28.34532374,1970,-417792,86528,-331264,43
820,192,22,8,0.18972332,0.81027668,284.2423428,323.6489965,505.245122,511.859375,1012,17.86092481,2024,-419840,98304,-321536,43
809,193,22,8,0.19261477,0.80738523,282.8835637,314.1488628,504.8974042,487.2590674,1002,29.16181607,2004,-414208,98816,-315392,43
833,194,21,9,0.188899708,0.811100292,286.7943194,334.7339048,515.8439376,506.0824742,1027,26.93417257,2054,-426496,99328,-327168,43
802,174,21,9,0.178278689,0.821721311,275.8259396,307.2860098,491.0860349,476.5804598,976,27.11111111,1952,-410624,89088,-321536,43
829,186,21,9,0.183251232,0.816748768,285.5635217,320.8023902,517.3522316,466.3172043,1015,29.83539095,2030,-424448,95232,-329216,43
825,185,20,10,0.183168317,0.816831683,284.1998848,322.3248324,506.3393939,501.7567568,1010,28.66061294,2020,-422400,94720,-327680,43
815,184,21,9,0.184184184,0.815815816,281.9231191,315.3395119,498.4969325,506.6576087,999,26.76848875,1998,-417280,94208,-323072,43
819,180,21,9,0.18018018,0.81981982,284.1583658,306.6141553,497.4163614,511.7555556,999,27.33242134,1998,-419328,92160,-327168,43
794,184,22,8,0.188139059,0.811860941,274.403182,313.0408253,495.186398,464.9619565,978,28.07118255,1956,-406528,94208,-312320,43
797,166,21,9,0.172377985,0.827622015,271.9810975,305.1119099,483.5244668,474.6807229,963,26.50701899,1926,-408064,84992,-323072,43
832,189,21,9,0.185112635,0.814887365,287.9873587,322.6638086,509.25,518.7037037,1021,29.92379836,2042,-425984,96768,-329216,43
816,181,22,8,0.181544634,0.818455366,281.9166425,312.6655602,501.8982843,485.9337017,997,28.99098575,1994,-417792,92672,-325120,43
825,179,22,8,0.178286853,0.821713147,285.9052346,307.1896767,503.8824242,496.1284916,1004,27.58999725,2008,-422400,91648,-330752,43
802,194,22,8,0.194779116,0.805220884,280.538462,313.9660815,503.3004988,478.6546392,996,27.38520759,1992,-410624,99328,-311296,43
821,182,22,8,0.181455633,0.818544367,283.2435814,316.2336396,504.0231425,492.8736264,1003,28.51862383,2006,-420352,93184,-327168,43
809,173,21,9,0.176171079,0.823828921,276.5036072,312.5591334,497.4276885,463.7803468,982,28.83147387,1964,-414208,88576,-325632,43
547,118,21,9,0.177443609,0.822556391,187.0147358,203.0225278,345.8848263,273.2711864,665,9.539520872,1330,-280064,60416,-219648,43
1066,190,22,8,0.151273885,0.848726115,351.8338002,417.5762263,626.5037523,639.7,1256,31.80552038,2512,-545792,97280,-448512,43
1048,180,21,9,0.146579805,0.853420195,344.7338841,404.8584348,608.3864504,650.0944444,1228,35.15602634,2456,-536576,92160,-444416,43
1065,188,21,9,0.150039904,0.849960096,348.1793283,429.2526221,632.1164319,598.0159574,1253,33.64661654,2506,-545280,96256,-449024,43
1089,200,22,8,0.155159038,0.844840962,359.1452757,435.0977993,640.40955,669.995,1289,33.90320884,2578,-557568,102400,-455168,43
60,22,23,7,0.268292683,0.731707317,21.67653621,27.90157583,39.83333333,46.04545455,82,6.2215478,164,-30720,11264,-19456,43
1083,194,21,9,0.151918559,0.848081441,358.3271749,420.6578951,634.3776547,664.8041237,1277,35.11135551,2554,-554496,99328,-455168,43
1072,196,20,10,0.154574132,0.845425868,355.84017,417.2351094,632.2994403,646.5357143,1268,36.39494834,2536,-548864,100352,-448512,43
1064,196,22,8,0.155555556,0.844444444,352.4472102,419.1711399,626.8571429,650.2755102,1260,36.56413233,2520,-544768,100352,-444416,43
1069,197,22,8,0.155608215,0.844391785,352.5268675,428.8073111,635.0710945,624.9746193,1266,25.18901711,2532,-547328,100864,-446464,43
857,122,21,9,0.124616956,0.875383044,271.9655319,344.992722,496.4270712,444.852459,979,27.50772689,1958,-438784,62464,-376320,43
1092,202,21,9,0.1561051,0.8438949,361.2413126,432.2821027,640.8241758,683.5891089,1294,38.07002059,2588,-559104,103424,-455680,43
879,146,22,8,0.142439024,0.857560976,281.8391571,368.873509,515.9317406,495.3493151,1025,27.42108079,2050,-450048,74752,-375296,43
1049,174,22,8,0.142273099,0.857726901,341.471207,415.643696,609.0695901,629.6666667,1223,33.12567714,2446,-537088,89088,-448000,43
1080,201,22,8,0.156908665,0.843091335,357.6998525,426.5509121,633.2231481,682.7860697,1281,34.8476605,2562,-552960,102912,-450048,43
931,162,21,9,0.148215919,0.851784081,301.8095069,384.9602232,547.4360902,544.4938272,1093,26.53556689,2186,-476672,82944,-393728,43
1071,184,21,9,0.146613546,0.853386454,353.183949,407.6145221,619.2885154,678.7065217,1255,35.64328316,2510,-548352,94208,-454144,43
1102,205,22,8,0.156847743,0.843152257,366.2243552,431.2689571,649.738657,676.9073171,1307,34.57671958,2614,-564224,104960,-459264,43
1097,196,21,9,0.15158546,0.84841454,362.7054279,423.4991728,637.3591613,700.9591837,1293,34.13410771,2586,-561664,100352,-461312,43
1070,195,22,8,0.154150198,0.845849802,356.2291443,408.8948452,626.3700935,669.3794872,1265,35.00276702,2530,-547840,99840,-448000,43
1104,205,21,9,0.156608098,0.843391902,367.2549505,429.0686208,648.8306159,688.2243902,1309,35.20710059,2618,-565248,104960,-460288,43
1608,204,21,9,0.112582781,0.887417219,513.9598723,587.8591157,912.568408,858.6666667,1812,89.83639068,3624,-823296,104448,-718848,43
1609,209,22,8,0.114961496,0.885038504,514.8141712,595.4588015,913.1025482,881.7655502,1818,70.87719298,3636,-823808,107008,-716800,43
1606,208,22,8,0.114663727,0.885336273,515.1307672,585.1691199,909.117061,895.0144231,1814,38.53016143,3628,-822272,106496,-715776,43
1627,210,22,8,0.114316821,0.885683179,520.5063071,600.4452574,921.3700061,900.6380952,1837,38.96902843,3674,-833024,107520,-725504,43
1601,208,22,8,0.114980652,0.885019348,515.6366249,566.8937171,912.6083698,846.4375,1809,118.7787262,3618,-819712,106496,-713216,43
1658,209,22,8,0.111944296,0.888055704,529.581995,606.483902,939.4638118,890.6555024,1867,134.0272793,3734,-848896,107008,-741888,43
1582,205,22,8,0.114717403,0.885282597,506.2546012,584.3063482,896.682048,873.302439,1787,52.12952159,3574,-809984,104960,-705024,43
1608,203,22,8,0.112092766,0.887907234,512.6014964,596.2921915,910.3084577,871.8719212,1811,46.75961787,3622,-823296,103936,-719360,43
1606,215,21,9,0.118066996,0.881933004,514.8589276,599.953366,913.752802,890.4372093,1821,129.9785867,3642,-822272,110080,-712192,43
1662,238,21,9,0.125263158,0.874736842,530.8060217,654.2226073,940.0800241,1023.264706,1900,33.34503335,3800,-850944,121856,-729088,43
1588,200,22,8,0.111856823,0.888143177,504.7079958,598.9380244,896.9848866,874.77,1788,38.47643641,3576,-813056,102400,-710656,43
1608,211,21,9,0.115997801,0.884002199,516.338721,587.2784006,912.3706468,891.9336493,1819,41.64377289,3638,-823296,108032,-715264,43
1595,196,21,9,0.109436069,0.890563931,507.6900783,584.7289975,902.5341693,842.8265306,1791,41.17241379,3582,-816640,100352,-716288,43
1594,206,21,9,0.114444444,0.885555556,508.9032594,595.4663047,903.6499373,876.1262136,1800,126.9393512,3600,-816128,105472,-710656,43
1562,202,21,9,0.114512472,0.885487528,499.9253867,575.4594053,885.734315,857.490099,1764,36.50662252,3528,-799744,103424,-696320,43
1583,202,21,9,0.113165266,0.886834734,505.2101495,587.3715531,896.9576753,861.9851485,1785,110.9384711,3570,-810496,103424,-707072,43
1621,221,21,9,0.119978284,0.880021716,521.7377803,599.9768694,920.5175817,928.7058824,1842,105.0770108,3684,-829952,113152,-716800,43
1653,221,21,9,0.117929562,0.882070438,528.2266901,628.1787946,938.0048397,933.7239819,1874,33.60229514,3748,-846336,113152,-733184,43
1657,203,22,8,0.109139785,0.890860215,526.6723411,614.2783862,931.4381412,922.8423645,1860,41.88245891,3720,-848384,103936,-744448,43
560,76,21,9,0.119496855,0.880503145,179.2535685,175.6499841,333.8178571,205.6315789,636,10.46224708,1272,-286720,38912,-247808,43
1966,169,21,9,0.0791569087,0.920843091,611.1198677,649.9315251,1053.310275,1238.887574,2135,39.23911046,4270,-1006592,86528,-920064,43
1882,169,22,8,0.0823988298,0.91760117,589.4878627,618.0108165,1030.40542,976.9408284,2051,37.58475353,4102,-963584,86528,-877056,43
1939,175,22,8,0.082781457,0.917218543,608.3693695,630.8192412,1057.531717,1057.148571,2114,38.23476216,4228,-992768,89600,-903168,43
1972,185,21,9,0.0857672694,0.914232731,617.7672068,672.1820822,1076.54716,1105.145946,2157,39.53445748,4314,-1009664,94720,-914944,43
1918,177,22,8,0.0844868735,0.915513126,603.9634477,613.3889829,1047.004692,1058.785311,2095,38.98399702,4190,-982016,90624,-891392,43
1905,178,21,9,0.0854536726,0.914546327,600.1855556,613.1249855,1042.952756,1031.803371,2083,38.86919201,4166,-975360,91136,-884224,43
1947,178,22,8,0.0837647059,0.916235294,611.7077623,623.0900254,1053.738059,1164.308989,2125,38.39205059,4250,-996864,91136,-905728,43
1850,169,22,8,0.0837048044,0.916295196,580.0836119,612.086402,1009.253514,1018.171598,2019,36.73580786,4038,-947200,86528,-860672,43
1944,168,22,8,0.0795454545,0.920454545,607.4473118,634.8972358,1055.722222,1065.5,2112,39.16913947,4224,-995328,86016,-909312,43
1881,170,22,8,0.0828863969,0.917113603,588.9357902,625.7093088,1025.53748,1031.117647,2051,59.41483198,4102,-963072,87040,-876032,43
2116,171,21,9,0.0747704416,0.925229558,656.6259176,700.5552789,1139.517958,1199.461988,2287,62.07926167,4574,-1083392,87552,-995840,43
1866,175,21,9,0.0857422832,0.914257717,584.5305829,636.4657813,1022.586817,1004.08,2041,36.25222025,4082,-955392,89600,-865792,43
1944,184,21,9,0.0864661654,0.913533835,613.2391089,625.3663342,1063.865741,1071.201087,2128,37.88499199,4256,-995328,94208,-901120,43
1954,188,21,9,0.0877684407,0.912231559,613.6983919,658.36503,1063.094678,1158.861702,2142,37.22627737,4284,-1000448,96256,-904192,43
1881,168,21,9,0.0819912152,0.918008785,587.8288852,630.4372982,1027.461457,997.4404762,2049,36.59582068,4098,-963072,86016,-877056,43
1869,176,21,9,0.0860635697,0.91393643,589.6178575,595.1111002,1028.249866,967.25,2045,38.26721557,4090,-956928,90112,-866816,43
1888,165,21,9,0.08037019,0.91962981,588.3290462,637.6623641,1031.598517,974.3818182,2053,59.33526012,4106,-966656,84480,-882176,43
1935,167,22,8,0.0794481446,0.920551855,604.7510388,629.9647813,1052.01447,1045.538922,2102,38.88991674,4204,-990720,85504,-905216,43
1899,174,22,8,0.0839363242,0.916063676,596.4244863,617.0208566,1031.838863,1093.327586,2073,38.81295638,4146,-972288,89088,-883200,43
1943,184,21,9,0.0865068171,0.913493183,611.4510696,640.3788305,1063.270715,1071.701087,2127,38.40736728,4254,-994816,94208,-900608,43
844,177,21,9,0.173359452,0.826640548,285.4101043,335.2487263,514.1919431,495.779661,1021,29.20480549,2042,-432128,90624,-341504,43
60,23,22,8,0.277108434,0.722891566,25.12698859,19.6323486,44.03333333,36.69565217,83,4.017424976,166,-30720,11776,-18944,43
850,175,22,8,0.170731707,0.829268293,288.4929029,329.1776065,510.3776471,525.7371429,1025,28.72757848,2050,-435200,89600,-345600,43
853,172,21,9,0.167804878,0.832195122,289.3275868,326.4984636,513.2696366,511.6627907,1025,29.02860379,2050,-436736,88064,-348672,43
853,179,21,9,0.173449612,0.826550388,289.2688828,335.595014,513.1184056,532.6145251,1032,29.30985515,2064,-436736,91648,-345088,43
854,162,22,8,0.159448819,0.840551181,286.3485232,327.2557616,510.6100703,497.3765432,1016,29.14515204,2032,-437248,82944,-354304,43
854,170,22,8,0.166015625,0.833984375,289.32264,325.2511482,511.2447307,518.8058824,1024,28.95927602,2048,-437248,87040,-350208,43
589,90,22,8,0.132547865,0.867452135,189.1952353,203.4684521,356.959253,229.0111111,679,26.32803412,1358,-301568,46080,-255488,43
871,180,22,8,0.171265461,0.828734539,294.1106015,344.4507134,522.9988519,540.5222222,1051,28.88949973,2102,-445952,92160,-353792,43
854,195,21,9,0.185891325,0.814108675,292.3762072,344.1684665,529.4742389,505.4051282,1049,31.73018754,2098,-437248,99840,-337408,43
619,114,21,9,0.155525239,0.844474761,201.5453571,254.9962287,375.1227787,322.8947368,733,18.8383449,1466,-316928,58368,-258560,43
848,178,21,9,0.173489279,0.826510721,286.9285455,336.5227748,516.0389151,501.4044944,1026,31.01571947,2052,-434176,91136,-343040,43
859,176,21,9,0.170048309,0.829951691,289.2919978,341.2564147,519.1967404,512.1590909,1035,29.40340909,2070,-439808,90112,-349696,43
876,182,22,8,0.172022684,0.827977316,295.9085386,347.3415685,531.8744292,518.0714286,1058,27.87878788,2116,-448512,93184,-355328,43
896,186,21,9,0.171903882,0.828096118,306.0499711,341.0448298,541.9330357,539.4139785,1082,27.11099975,2164,-458752,95232,-363520,43
880,188,21,9,0.176029963,0.823970037,297.8723748,353.001739,535.775,528.5319149,1068,26.39644093,2136,-450560,96256,-354304,43
861,177,21,9,0.170520231,0.829479769,292.6325186,331.6457522,519.3670151,520.1468927,1038,29.66561875,2076,-440832,90624,-350208,43
839,171,22,8,0.169306931,0.830693069,283.318946,328.7451924,508.0238379,493.1169591,1010,26.49527807,2020,-429568,87552,-342016,43
880,180,22,8,0.169811321,0.830188679,297.6862699,343.6668357,531.8136364,524.0777778,1060,30.644695,2120,-450560,92160,-358400,43
583,112,21,9,0.161151079,0.838848921,193.6960513,214.8990145,364.0308748,264.5535714,695,10.76851565,1390,-298496,57344,-241152,43
1042,180,22,8,0.147299509,0.852700491,344.8391396,394.8656944,607.890595,632.3944444,1222,36.5430622,2444,-533504,92160,-441344,43
1052,196,22,8,0.157051282,0.842948718,348.0226386,419.2669986,620.4752852,646.1020408,1248,35.41430193,2496,-538624,100352,-438272,43
1031,204,21,9,0.165182186,0.834817814,344.1899127,410.1222653,608.8816683,664.0833333,1235,21.51942847,2470,-527872,104448,-423424,43
39,24,21,9,0.380952381,0.619047619,14.05918737,21.05746107,27.07692308,40,63,1.640197865,126,-19968,12288,-7680,43
1038,176,22,8,0.144975288,0.855024712,340.942022,400.9394723,602.955684,634.3011364,1214,34.41043084,2428,-531456,90112,-441344,43
1043,180,22,8,0.147179068,0.852820932,342.1300173,410.6385491,612.3873442,609.7555556,1223,32.13347346,2446,-534016,92160,-441856,43
1069,213,21,9,0.166146646,0.833853354,356.6751735,430.1896967,636.3685688,667.2535211,1282,37.99644339,2564,-547328,109056,-438272,43
1041,192,21,9,0.155717762,0.844282238,345.2597113,408.5856544,613.8808838,633.9114583,1233,34.67379078,2466,-532992,98304,-434688,43
1113,202,22,8,0.153612167,0.846387833,366.3828747,442.3843395,666.7663971,609.6980198,1315,33.63171355,2630,-569856,103424,-466432,43
1053,193,21,9,0.154895666,0.845104334,344.8384997,431.7689484,622.4938272,628.9896373,1246,35.8767636,2492,-539136,98816,-440320,43
1052,205,22,8,0.163086714,0.836913286,348.8199616,427.2683393,625.4106464,647.4195122,1257,33.71781116,2514,-538624,104960,-433664,43
1051,196,21,9,0.157177225,0.842822775,348.6786435,415.328156,623.1769743,628.4132653,1247,34.09898824,2494,-538112,100352,-437760,43
1029,194,24,6,0.158626329,0.841373671,344.3366839,394.349715,605.6190476,645.8453608,1223,33.11670728,2446,-526848,99328,-427520,43
1054,200,21,9,0.159489633,0.840510367,349.9194506,419.9016978,626.3491461,633.565,1254,33.8096522,2508,-539648,102400,-437248,43
952,155,22,8,0.140018067,0.859981933,309.8879128,373.2680778,551.8813025,567.0129032,1107,28.13929842,2214,-487424,79360,-408064,43
1053,198,21,9,0.158273381,0.841726619,350.1622958,411.3814341,617.0693257,673.4949495,1251,31.55903128,2502,-539136,101376,-437760,43
1083,190,21,9,0.149253731,0.850746269,359.5044768,408.792483,631.8938135,666.1052632,1273,35.67825112,2546,-554496,97280,-457216,43
1088,208,21,9,0.160493827,0.839506173,364.5781264,417.9949644,640.4181985,690.7740385,1296,30.03476246,2592,-557056,106496,-450560,43
1065,219,21,9,0.170560748,0.829439252,357.1088826,426.8850567,632.0525822,693.3059361,1284,22.8591775,2568,-545280,112128,-433152,43
1059,206,22,8,0.16284585,0.83715415,352.6779191,422.3368674,627.1029273,663.315534,1265,33.59001593,2530,-542208,105472,-436736,43
541,116,20,10,0.176560122,0.823439878,178.4227613,233.5386368,334.219963,304.6551724,657,25.69417286,1314,-276992,59392,-217600,43
568,137,20,10,0.194326241,0.805673759,190.398832,247.7522945,361.2711268,318.7080292,705,24.90286118,1410,-290816,70144,-220672,43
548,111,21,9,0.168437026,0.831562974,180.248386,231.6445754,335.2244526,304.2072072,659,24.1038771,1318,-280576,56832,-223744,43
549,127,20,10,0.187869822,0.812130178,182.1588393,243.2126186,336.3315118,347.8740157,676,12.23529412,1352,-281088,65024,-216064,43
559,105,20,10,0.15813253,0.84186747,182.0564067,233.2853957,339.1019678,297.352381,664,27.00284669,1328,-286208,53760,-232448,43
572,137,21,9,0.193229901,0.806770099,192.2757298,246.4830323,363.8129371,318.2043796,709,25.44867193,1418,-292864,70144,-222720,43
526,126,21,9,0.193251534,0.806748466,176.9165597,227.8826776,332.2661597,302.4285714,652,23.17810167,1304,-269312,64512,-204800,43
553,109,21,9,0.164652568,0.835347432,181.7743788,230.9703923,336.6582278,305.3302752,662,26.17635429,1324,-283136,55808,-227328,43
551,121,20,10,0.180059524,0.819940476,182.7640898,236.8921849,342.0272232,311.3305785,672,28.49872774,1344,-282112,61952,-220160,43
554,122,20,10,0.180473373,0.819526627,184.9659851,231.7352272,347.299639,298.5409836,676,25.48058801,1352,-283648,62464,-221184,43
552,108,21,9,0.163636364,0.836363636,180.9108996,231.1422181,336.5036232,299.8148148,660,23.08499475,1320,-282624,55296,-227328,43
534,132,21,9,0.198198198,0.801801802,180.0005656,232.4727374,341.7153558,300.2651515,666,26.04614783,1332,-273408,67584,-205824,43
547,124,21,9,0.184798808,0.815201192,183.2318297,227.8353189,347.2449726,286.3951613,671,24.17146974,1342,-280064,63488,-216576,43
547,130,21,9,0.192023634,0.807976366,183.6249489,234.638512,348.4862888,299.0846154,677,26.97211155,1354,-280064,66560,-213504,43
556,128,21,9,0.187134503,0.812865497,184.5575767,237.0924793,355.9100719,284.25,684,21.72808132,1368,-284672,65536,-219136,43
574,115,21,9,0.166908563,0.833091437,188.4476224,244.2903011,346.6811847,336.6086957,689,21.90779014,1378,-293888,58880,-235008,43
527,113,20,10,0.1765625,0.8234375,174.1711749,221.3577557,330.8785579,272.0973451,640,24.51168135,1280,-269824,57856,-211968,43
546,108,20,10,0.165137615,0.834862385,179.6056081,226.7452448,334.1190476,294.037037,654,24.22222222,1308,-279552,55296,-224256,43
526,121,20,10,0.187017002,0.812982998,176.0053183,218.8746575,337.0494297,267.2727273,647,26.13085622,1294,-269312,61952,-207360,43
386,100,20,10,0.205761317,0.794238683,132.7470687,155.9038406,256.8290155,192.05,486,7.725321888,972,-197632,51200,-146432,43
1984,100,22,8,0.0479846449,0.952015355,594.2233538,667.6773769,1057.344758,747.98,2084,306.4705882,4168,-1015808,51200,-964608,44
1947,93,22,8,0.0455882353,0.954411765,583.2213267,656.5624705,1031.444273,791.3763441,2040,263.9068564,4080,-996864,47616,-949248,44
1942,101,22,8,0.0494371023,0.950562898,581.7838218,660.4121773,1037.331617,727.2079208,2043,64.65189873,4086,-994304,51712,-942592,44
1917,99,22,8,0.0491071429,0.950892857,574.4656927,659.0219609,1022.050078,746.1212121,2016,44.84983315,4032,-981504,50688,-930816,44
1919,98,21,9,0.0485870104,0.95141299,574.7720241,652.1762509,1023.375717,727.5,2017,186.4140481,4034,-982528,50176,-932352,44
1925,94,21,9,0.0465577018,0.953442298,576.5300856,658.5136005,1021.258182,779.4468085,2019,123.637477,4038,-985600,48128,-937472,44
1922,93,22,8,0.0461538462,0.953846154,575.1132825,657.406677,1019.877211,762.5376344,2015,49.96280684,4030,-984064,47616,-936448,44
1899,98,22,8,0.0490736104,0.95092639,569.2527178,640.4616945,1013.471301,718.5816327,1997,277.3611111,3994,-972288,50176,-922112,44
1917,97,22,8,0.04816286,0.95183714,574.1357683,657.8533692,1020.648931,747.6391753,2014,260.880829,4028,-981504,49664,-931840,44
1913,97,22,8,0.0482587065,0.951741294,573.3156209,656.4734424,1017.933612,760.2886598,2010,291.7271408,4020,-979456,49664,-929792,44
1918,103,21,9,0.0509648689,0.949035131,575.1474533,660.8857848,1025.972367,732.1941748,2021,178.061674,4042,-982016,52736,-929280,44
1911,97,22,8,0.0483067729,0.951693227,573.8270568,657.4368208,1013.937729,818.5670103,2008,247.9012346,4016,-978432,49664,-928768,44
1897,90,22,8,0.0452944137,0.954705586,568.5450233,627.8207242,1005.017396,761.7777778,1987,161.6761595,3974,-971264,46080,-925184,44
1923,91,21,9,0.045183714,0.954816286,575.4141389,653.1385537,1018.592824,773.0879121,2014,237.5,4028,-984576,46592,-937984,44
1921,97,22,8,0.0480673935,0.951932607,575.3711232,654.6816686,1023.01822,741.7835052,2018,170.4391892,4036,-983552,49664,-933888,44
1891,92,21,9,0.046394352,0.953605648,566.2694782,636.6205665,1004.287678,739.4347826,1983,386.5497076,3966,-968192,47104,-921088,44
1922,98,22,8,0.0485148515,0.951485149,576.0408912,658.6031627,1023.402185,757.4591837,2020,388.4615385,4040,-984064,50176,-933888,44
242,49,21,9,0.16838488,0.83161512,81.47665048,87.76050292,152.9586777,111.6326531,291,4.487278335,582,-123904,25088,-98816,44
1927,91,22,8,0.0450941526,0.954905847,577.2716955,654.1988846,1018.836015,811.8021978,2018,288.6981402,4036,-986624,46592,-940032,44
1920,101,22,8,0.0499752598,0.95002474,575.5278979,659.6786287,1025.402083,737.2178218,2021,204.7619048,4042,-983040,51712,-931328,44
1783,86,22,8,0.0460139112,0.953986089,533.7503537,608.4322157,945.4918676,717.4767442,1869,228.4841076,3738,-912896,44032,-868864,44
1756,96,21,9,0.0518358531,0.948164147,526.9074508,598.2487373,941.3485194,654.8958333,1852,232.0802005,3704,-899072,49152,-849920,44
1794,89,22,8,0.0472650027,0.952734997,537.2825929,609.0132878,954.025641,699.5955056,1883,47.1339174,3766,-918528,45568,-872960,44
1762,84,22,8,0.045503792,0.954496208,527.5803466,597.5774975,933.3893303,716.0595238,1846,300.6514658,3692,-902144,43008,-859136,44
1759,95,21,9,0.0512405609,0.948759439,527.3492282,593.9323477,943.1245026,638.2,1854,177.0773639,3708,-900608,48640,-851968,44
1765,92,21,9,0.0495422725,0.950457728,528.3597977,639.2547471,938.6640227,743.5978261,1857,32.41403386,3714,-903680,47104,-856576,44
1765,89,22,8,0.048004315,0.951995685,528.6334429,602.2410936,939.7864023,683.8426966,1854,183.5643564,3708,-903680,45568,-858112,44
1762,86,22,8,0.0465367965,0.953463203,527.8331872,598.4354178,935.0573212,708.1976744,1848,225.9168704,3696,-902144,44032,-858112,44
1898,91,21,9,0.045751634,0.954248366,567.954528,647.3621639,1006.354584,758.1758242,1989,198.3050847,3978,-971776,46592,-925184,44
1765,85,21,9,0.0459459459,0.954054054,528.7674973,604.4710045,934.4719547,739.2,1850,201.9650655,3700,-903680,43520,-860160,44
1757,96,21,9,0.0518078791,0.948192121,527.0828691,598.0585687,942.1132612,650.3958333,1853,310.9060403,3706,-899584,49152,-850432,44
1761,89,22,8,0.0481081081,0.951891892,527.743905,597.9341919,937.592845,686.2247191,1850,207.3991031,3700,-901632,45568,-856064,44
1759,86,22,8,0.0466124661,0.953387534,527.1082759,597.3447734,933.238772,713.5813953,1845,174.3856333,3690,-900608,44032,-856576,44
1782,87,22,8,0.0465489567,0.953451043,534.0626963,606.6496128,944.9292929,731.6206897,1869,317.8571429,3738,-912384,44544,-867840,44
1755,85,21,9,0.0461956522,0.953804348,525.7324977,593.5220479,930.9008547,705.7529412,1840,280.9160305,3680,-898560,43520,-855040,44
1771,87,21,9,0.0468245425,0.953175457,530.2604965,602.5525466,940.9514399,696.3908046,1858,46.51977967,3716,-906752,44544,-862208,44
1767,94,22,8,0.0505104782,0.949489522,529.8457683,599.6110566,945.3916242,660.4680851,1861,122.4342105,3722,-904704,48128,-856576,44
1768,94,22,8,0.0504833512,0.949516649,530.2576423,605.3524876,945.0277149,677.0638298,1862,197.4549311,3724,-905216,48128,-857088,44
1758,95,22,8,0.0512682137,0.948731786,527.4782389,597.9914253,941.3902162,660.7052632,1853,214.9651972,3706,-900096,48640,-851456,44
1760,92,22,8,0.0496760259,0.950323974,527.7386611,600.1226421,939.5573864,676.7065217,1852,215.0987224,3704,-901120,47104,-854016,44
1563,89,21,9,0.053874092,0.946125908,469.555158,537.3026311,840.1420345,586.9213483,1652,270.8196721,3304,-800256,45568,-754688,44
1570,83,22,8,0.0502117362,0.949788264,471.1109267,513.4174385,840.9171975,563.746988,1653,37.55964554,3306,-803840,42496,-761344,44
1566,84,22,8,0.0509090909,0.949090909,470.4051016,535.0217051,836.5747126,619.0357143,1650,31.31524008,3300,-801792,43008,-758784,44
1566,87,20,10,0.0526315789,0.947368421,469.7145733,536.188672,841.0427842,574.2298851,1653,187.6276958,3306,-801792,44544,-757248,44
1559,84,21,9,0.051125989,0.948874011,467.6596024,526.0475598,835.2982681,575.1904762,1643,310.5860113,3286,-798208,43008,-755200,44
1566,80,22,8,0.0486026731,0.951397327,469.9364531,535.2863947,832.9367816,638.775,1646,186.8331442,3292,-801792,40960,-760832,44
1684,94,21,9,0.0528683915,0.947131609,505.736401,568.8938196,904.5961995,619.0531915,1778,153.673293,3556,-862208,48128,-814080,44
1565,91,22,8,0.0549516908,0.945048309,470.2606854,534.1051227,843.4798722,570.8791209,1656,203.6900369,3312,-801280,46592,-754688,44
1562,85,21,9,0.051608986,0.948391014,468.9480978,537.9735088,835.7829706,607.4705882,1647,143.9685315,3294,-799744,43520,-756224,44
1563,88,22,8,0.0533010297,0.94669897,469.5981343,536.2345221,839.1151631,593.0568182,1651,114.1770401,3302,-800256,45056,-755200,44
1571,89,21,9,0.0536144578,0.946385542,471.7002862,534.2711816,845.0897518,572.9662921,1660,46.09830603,3320,-804352,45568,-758784,44
1613,83,22,8,0.0489386792,0.951061321,483.8421148,547.9956476,859.516429,634.4096386,1696,250.1474926,3392,-825856,42496,-783360,44
1590,89,22,8,0.0530077427,0.946992257,476.9695492,563.0698573,852.2327044,621.4606742,1679,41.95402299,3358,-814080,45568,-768512,44
1576,85,22,8,0.0511739916,0.948826008,473.1017318,539.2512127,842.9727157,609.0117647,1661,230.3744799,3322,-806912,43520,-763392,44
1562,80,22,8,0.0487210719,0.951278928,468.4417662,535.466781,831.5300896,625.6625,1642,161.4552606,3284,-799744,40960,-758784,44
1746,96,21,9,0.0521172638,0.947882736,522.531717,587.8847358,939.5498282,593.21875,1842,115.4858934,3684,-893952,49152,-844800,44
1564,83,21,9,0.050394657,0.949605343,469.3988309,527.306819,836.2046036,594.0240964,1647,173.5511064,3294,-800768,42496,-758272,44
1567,83,21,9,0.0503030303,0.94969697,470.3938109,537.624037,836.2839821,621.9036145,1650,179.7385621,3300,-802304,42496,-759808,44
1571,88,21,9,0.0530440024,0.946955998,471.7854462,560.8137236,840.3131763,645.8863636,1659,82.29166667,3318,-804352,45056,-759296,44
1567,78,22,8,0.0474164134,0.952583587,469.9123371,531.5757277,832.3497128,635.1666667,1645,195.8333333,3290,-802304,39936,-762368,44
1551,90,22,8,0.0548446069,0.945155393,466.082644,527.8572291,835.8613798,564.8888889,1641,31.25119025,3282,-794112,46080,-748032,44
1543,83,22,8,0.0510455105,0.94895449,463.0095883,527.7995021,825.4802333,590.7831325,1626,305.6390977,3252,-790016,42496,-747520,44
1540,84,22,8,0.0517241379,0.948275862,461.9738127,563.4647554,819.8051948,678.5714286,1624,28.53127196,3248,-788480,43008,-745472,44
1535,79,21,9,0.0489467162,0.951053284,460.3875018,526.942524,817.4143322,614.8607595,1614,249.0740741,3228,-785920,40448,-745472,44
1570,84,22,8,0.0507859734,0.949214027,470.9294918,537.3819044,839.7369427,598.7857143,1654,161.6813294,3308,-803840,43008,-760832,44
1552,89,22,8,0.0542352224,0.945764778,465.5989743,507.1296152,838.6514175,513.1910112,1641,40.61881188,3282,-794624,45568,-749056,44
1553,90,22,8,0.0547778454,0.945222155,466.3041223,547.4572247,835.2028332,594.1777778,1643,92.61555806,3286,-795136,46080,-749056,44
1541,84,22,8,0.0516923077,0.948307692,462.4898495,526.4515712,825.541207,582.9285714,1625,248.0916031,3250,-788992,43008,-745984,44
1549,86,22,8,0.0525993884,0.947400612,464.5051471,530.5322934,832.0348612,565.2093023,1635,255.46875,3270,-793088,44032,-749056,44
1544,84,22,8,0.0515970516,0.948402948,463.119294,528.4286984,827.3698187,577.9404762,1628,249.6932515,3256,-790528,43008,-747520,44
289,39,21,9,0.118902439,0.881097561,92.1085972,87.0519429,173.4152249,98.43589744,328,9.20056101,656,-147968,19968,-128000,44
1558,79,21,9,0.0482590104,0.95174099,467.2131046,527.4056383,829.4088575,613.721519,1637,199.3909866,3274,-797696,40448,-757248,44
1543,86,22,8,0.0527931246,0.947206875,463.2691225,528.8822167,828.1056384,579.8604651,1629,195.0898204,3258,-790016,44032,-745984,44
1536,86,21,9,0.0530209618,0.946979038,460.5112365,528.1245988,825.7473958,557.0348837,1622,254.2319749,3244,-786432,44032,-742400,44
1572,85,21,9,0.0512975256,0.948702474,471.2343166,540.4520732,842.0508906,587.6352941,1657,317.4329502,3314,-804864,43520,-761344,44
1561,83,22,8,0.050486618,0.949513382,468.1439977,529.5723768,835.0768738,585.9638554,1644,44.42042691,3288,-799232,42496,-756736,44
1554,83,22,8,0.0507025046,0.949297495,466.7855757,533.9067493,829.3861004,624.5421687,1637,91.55480984,3274,-795648,42496,-753152,44
1543,80,22,8,0.0492914356,0.950708564,462.4312247,527.1349921,823.4121841,591.8875,1623,167.4922601,3246,-790016,40960,-749056,44
1553,86,22,8,0.0524710189,0.947528981,466.6199408,529.5586594,832.5318738,593.6976744,1639,203.6024845,3278,-795136,44032,-751104,44
368,54,21,9,0.127962085,0.872037915,117.658955,127.809568,221.4728261,143.537037,422,6.704798221,844,-188416,27648,-160768,44
1374,75,22,8,0.0517598344,0.948240166,412.8731792,468.5171547,735.3537118,535.32,1449,129.2595897,2898,-703488,38400,-665088,44
1360,72,22,8,0.0502793296,0.94972067,408.3321021,461.8727946,726.2823529,531.7222222,1432,159.1111111,2864,-696320,36864,-659456,44
1374,75,21,9,0.0517598344,0.948240166,412.3428495,467.667239,736.4934498,514.44,1449,108.0536913,2898,-703488,38400,-665088,44
1390,81,22,8,0.0550645819,0.944935418,417.7196576,469.3892123,749.8805755,497.8024691,1471,239.5765472,2942,-711680,41472,-670208,44
1371,77,22,8,0.0531767956,0.946823204,412.3850567,468.7137666,735.1633844,534.6363636,1448,192.8095872,2896,-701952,39424,-662528,44
1368,77,21,9,0.0532871972,0.946712803,411.2114991,465.4342488,734.5599415,517.6233766,1445,170.2002356,2890,-700416,39424,-660992,44
1365,82,21,9,0.0566689703,0.94333103,410.3577822,466.1561264,738.1201465,488.9512195,1447,141.1707317,2894,-698880,41984,-656896,44
1393,82,22,8,0.0555932203,0.94440678,418.8338633,494.6136886,748.936827,552.2073171,1475,27.9886148,2950,-713216,41984,-671232,44
1411,84,21,9,0.056187291,0.943812709,424.237775,476.6980527,762.6775337,501.452381,1495,264.1342756,2990,-722432,43008,-679424,44
1385,81,22,8,0.0552523874,0.944747613,416.3998634,467.0895853,747.2505415,498.382716,1466,190.8854167,2932,-709120,41472,-667648,44
1412,83,22,8,0.0555183946,0.944481605,424.0895231,501.2744568,759.9631728,544.4819277,1495,83.84744812,2990,-722944,42496,-680448,44
1366,76,21,9,0.052704577,0.947295423,410.3776298,465.998672,732.8155198,518.1184211,1442,119.4697597,2884,-699392,38912,-660480,44
1378,74,22,8,0.0509641873,0.949035813,413.606621,465.922126,737.5566038,520.6081081,1452,125.388601,2904,-705536,37888,-667648,44
1364,73,22,8,0.0508002784,0.949199722,409.6712685,465.3264973,728.75,536.8219178,1437,174.8175182,2874,-698368,37376,-660992,44
1399,78,22,8,0.0528097495,0.947190251,420.1353973,467.1417425,752.0993567,504.0512821,1477,196.4095745,2954,-716288,39936,-676352,44
1406,82,22,8,0.0551075269,0.944892473,422.5350446,464.5198515,759.6273115,485.1219512,1488,180.1452785,2976,-719872,41984,-677888,44
1372,81,22,8,0.0557467309,0.944253269,412.7307411,465.1750081,740.3542274,500.8024691,1453,162.7099664,2906,-702464,41472,-660992,44
1372,79,22,8,0.0544452102,0.94555479,412.1209813,464.8753133,739.3330904,494.443038,1451,85.65525384,2902,-702464,40448,-662016,44
1372,72,22,8,0.0498614958,0.950138504,411.6536623,466.6109439,732.4744898,532.4305556,1444,31.12068966,2888,-702464,36864,-665600,44
1400,76,21,9,0.0514905149,0.948509485,420.442213,471.2070202,750.0221429,526.25,1476,164.7321429,2952,-716800,38912,-677888,44
1748,90,22,8,0.0489662677,0.951033732,523.4831826,600.7616643,932.3987414,668.9777778,1838,273.5119048,3676,-894976,46080,-848896,44
1753,83,22,8,0.0452069717,0.954793028,524.3525912,598.7479327,928.6714204,703.6746988,1836,183.4165834,3672,-897536,42496,-855040,44
1764,88,22,8,0.0475161987,0.952483801,527.8704487,614.934435,937.5561224,704.875,1852,290.2821317,3704,-903168,45056,-858112,44
1779,89,22,8,0.0476445396,0.95235546,532.6162079,608.6585035,946.6902754,690.8314607,1868,199.5726496,3736,-910848,45568,-865280,44
476,46,21,9,0.0881226054,0.911877395,147.0357364,146.1957233,271.8529412,154.3695652,522,10.05780347,1044,-243712,23552,-220160,44
1748,83,21,9,0.0453304205,0.954669579,523.1756973,596.2210264,925.6487414,712.7951807,1831,187.4104401,3662,-894976,42496,-852480,44
1750,89,21,9,0.0483958673,0.951604133,523.9436274,601.4990561,932.5268571,673.6853933,1839,264.9855908,3678,-896000,45568,-850432,44
1754,86,22,8,0.0467391304,0.95326087,524.9803271,601.6266225,931.5558723,695.0116279,1840,263.6103152,3680,-898048,44032,-854016,44
1876,93,21,9,0.0472320975,0.952767902,561.2558398,641.171885,998.2345416,718.0322581,1969,45.27477581,3938,-960512,47616,-912896,44
1751,82,22,8,0.0447354064,0.955264594,523.6033784,595.658346,927.2015991,699.1585366,1833,285.0699844,3666,-896512,41984,-854528,44
1771,90,21,9,0.0483610962,0.951638904,530.0224284,609.4726172,943.9655562,675.8666667,1861,210.2824859,3722,-906752,46080,-860672,44
1751,85,21,9,0.0462962963,0.953703704,524.036573,602.178129,928.8794974,704.6823529,1836,282.0276498,3672,-896512,43520,-852992,44
1741,83,22,8,0.045504386,0.954495614,520.659181,601.5621311,922.3388857,706.1204819,1824,31.96635121,3648,-891392,42496,-848896,44
1781,94,22,8,0.0501333333,0.949866667,533.0018413,636.5428103,950.1712521,707.393617,1875,41.5190434,3750,-911872,48128,-863744,44
1747,86,21,9,0.0469176214,0.953082379,522.4155315,599.7504835,929.1545507,670.0930233,1833,330.2702703,3666,-894464,44032,-850432,44
1742,86,22,8,0.0470459519,0.952954048,521.6077158,596.594136,925.4885189,691.9186047,1828,234.6598203,3656,-891904,44032,-847872,44
1750,86,22,8,0.0468409586,0.953159041,523.6067851,597.1656784,930.4011429,676.3255814,1836,206.7567568,3672,-896000,44032,-851968,44
1768,91,21,9,0.048951049,0.951048951,529.3988534,598.1460915,944.22681,653.5934066,1859,134.2238267,3718,-905216,46592,-858624,44
1746,89,21,9,0.0485013624,0.951498638,522.6570745,597.8421098,931.058992,661.8089888,1835,221.3510253,3670,-893952,45568,-848384,44
1750,85,22,8,0.0463215259,0.953678474,523.8514446,599.4035104,928.4554286,702.7411765,1835,122.7424749,3670,-896000,43520,-852480,44
1366,82,21,9,0.0566298343,0.943370166,410.9222153,467.0542665,738.0915081,498.0853659,1448,50.87842586,2896,-699392,41984,-657408,44
1370,78,22,8,0.0538674033,0.946132597,411.2361775,472.5052978,736.8832117,507,1448,202.5174825,2896,-701440,39936,-661504,44
1400,78,22,8,0.0527740189,0.947225981,419.0350562,460.7974538,755.3528571,454.9615385,1478,123.0641132,2956,-716800,39936,-676864,44
937,59,21,9,0.0592369478,0.940763052,281.9952294,328.8615726,508.0576307,346.7118644,996,23.90782525,1992,-479744,30208,-449536,44
1362,85,21,9,0.0587422253,0.941257775,410.3464133,457.9862989,739.133627,481.5058824,1447,67.36499069,2894,-697344,43520,-653824,44
1369,82,22,8,0.0565127498,0.94348725,411.6234067,466.2946865,740.0672023,491.1463415,1451,251.4731369,2902,-700928,41984,-658944,44
1370,80,22,8,0.0551724138,0.944827586,411.9790969,465.1990911,738.5262774,502.425,1450,242.881072,2900,-701440,40960,-660480,44
1285,69,22,8,0.0509601182,0.949039882,384.8100074,439.2165822,688.8824903,465.5217391,1354,87.12998713,2708,-657920,35328,-622592,44
1375,76,22,8,0.0523776706,0.947622329,413.2828779,487.5802718,733.9432727,582.2894737,1451,33.30273124,2902,-704000,38912,-665088,44
1378,74,22,8,0.0509641873,0.949035813,414.0956051,466.5575345,736.5,540.2837838,1452,156.4655172,2904,-705536,37888,-667648,44
1389,80,22,8,0.0544588155,0.945541184,416.86315,463.6076136,749.8207343,477.675,1469,144.4444444,2938,-711168,40960,-670208,44
1367,83,22,8,0.0572413793,0.942758621,411.1373001,468.7570962,739.5954645,493.3493976,1450,213.2352941,2900,-699904,42496,-657408,44
1361,75,22,8,0.0522284123,0.947771588,408.723358,466.4577201,729.3783982,521.0933333,1436,188.2044561,2872,-696832,38400,-658432,44
1368,80,21,9,0.0552486188,0.944751381,411.2054609,467.3885696,737.5409357,501.5,1448,144.6553447,2896,-700416,40960,-659456,44
1362,83,21,9,0.0574394464,0.942560554,409.6007429,466.5802213,737.3127753,488.1325301,1445,274.7148289,2890,-697344,42496,-654848,44
855,65,22,8,0.0706521739,0.929347826,258.4543089,283.348521,475.0421053,269.2153846,920,19.93067591,1840,-437760,33280,-404480,44
1390,79,22,8,0.0537780803,0.94622192,417.3229384,462.6475159,749.157554,485.8987342,1469,61.28493951,2938,-711680,40448,-671232,44
1373,71,22,8,0.0491689751,0.950831025,412.2241791,465.6596165,731.3831027,550.7183099,1444,146.8972533,2888,-702976,36352,-666624,44
1375,84,22,8,0.0575736806,0.942426319,413.7988208,467.2022041,744.5214545,492.297619,1459,138.0321665,2918,-704000,43008,-660992,44
372,53,21,9,0.124705882,0.875294118,118.2122671,129.3281706,223.2311828,141.1886792,425,6.716182048,850,-190464,27136,-163328,44
1384,77,21,9,0.0527036277,0.947296372,415.5736629,459.0010724,744.2875723,492.1688312,1461,187.5481386,2922,-708608,39424,-669184,44
1352,80,21,9,0.0558659218,0.944134078,406.416613,454.3917347,730.691568,476.6625,1432,228.3891547,2864,-692224,40960,-651264,44
1348,81,22,8,0.0566829951,0.943317005,405.7572307,438.6592304,730.4183976,458.4074074,1429,47.80863165,2858,-690176,41472,-648704,44
1365,76,21,9,0.052741152,0.947258848,410.1672829,465.1807537,732.2249084,519.3947368,1441,34.86571498,2882,-698880,38912,-659968,44
1479,84,21,9,0.0537428023,0.946257198,443.7166184,495.3003275,797.2467884,513.547619,1563,188.5404101,3126,-757248,43008,-714240,44
1351,76,21,9,0.0532585844,0.946741416,405.4820413,454.6889539,727.0429312,482.1447368,1427,160.5174353,2854,-691712,38912,-652800,44
1358,78,21,9,0.0543175487,0.945682451,407.9416026,456.0368245,731.9889543,483.6538462,1436,170.1421801,2872,-695296,39936,-655360,44
1362,77,22,8,0.0535093815,0.946490618,409.262549,463.6997665,731.9390602,508.8181818,1439,273.0550285,2878,-697344,39424,-657920,44
1356,73,21,9,0.0510846746,0.948915325,406.6527965,455.709143,726.9269912,493.4520548,1429,185.1036269,2858,-694272,37376,-656896,44
1377,78,22,8,0.0536082474,0.946391753,413.7496964,468.5514874,740.2236747,512.2051282,1455,222.8177642,2910,-705024,39936,-665088,44
1424,83,22,8,0.0550763106,0.944923689,428.0834558,487.0810887,767.2780899,526.1927711,1507,34.27336821,3014,-729088,42496,-686592,44
1352,81,22,8,0.0565247732,0.943475227,406.5684925,455.1492671,731.3971893,476.691358,1433,261.4963504,2866,-692224,41472,-650752,44
1359,74,21,9,0.0516399163,0.948360084,407.8555126,473.4379215,726.8815305,535.527027,1433,72.19143577,2866,-695808,37888,-657920,44
1346,79,22,8,0.0554385965,0.944561404,404.2699173,435.2317422,728.9665676,440.9620253,1425,49.39341421,2850,-689152,40448,-648704,44
1359,71,22,8,0.0496503497,0.95034965,407.5519873,455.3798252,726.3671818,507.4929577,1430,153.7634409,2860,-695808,36352,-659456,44
1351,78,21,9,0.0545836249,0.945416375,406.166064,456.5925846,727.7698001,493.8205128,1429,181.5756036,2858,-691712,39936,-651776,44
1355,74,21,9,0.0517844647,0.948215535,406.4854107,454.7433715,727.3380074,489.0810811,1429,176.6378245,2858,-693760,37888,-655872,44
1364,73,22,8,0.0508002784,0.949199722,409.8035237,455.6302084,729.6693548,519.6438356,1437,54.95219885,2874,-698368,37376,-660992,44
232,41,21,9,0.15018315,0.84981685,75.79096675,88.86193664,142.0301724,108.5365854,273,3.88004548,546,-118784,20992,-97792,44
241,49,21,9,0.168965517,0.831034483,80.94914071,87.5196414,152.8879668,109.1632653,290,4.549019608,580,-123392,25088,-98304,44
1365,78,21,9,0.0540540541,0.945945946,410.3596336,466.1995692,733.9040293,513.6794872,1443,175.1213592,2886,-698880,39936,-658944,44
1365,79,21,9,0.0547091413,0.945290859,410.4176347,467.8279669,734.6725275,512.1772152,1444,183.248731,2888,-698880,40448,-658432,44
1365,77,22,8,0.0533980583,0.946601942,410.0718616,468.814307,733.0490842,516.7662338,1442,166.1290323,2884,-698880,39424,-659456,44
1391,76,22,8,0.0518064076,0.948193592,418.4703851,469.1851402,744.1646298,547.9605263,1467,273.1843575,2934,-712192,38912,-673280,44
1368,76,22,8,0.0526315789,0.947368421,410.6341589,468.4094129,734.2090643,511.7368421,1444,236.7213115,2888,-700416,38912,-661504,44
1373,74,22,8,0.0511402903,0.94885971,412.4344773,467.5233646,734.1267298,536.1081081,1447,148.8683128,2894,-702976,37888,-665088,44
1385,80,21,9,0.0546075085,0.945392491,415.5590488,482.6649951,745.8779783,510.05,1465,38.78739741,2930,-709120,40960,-668160,44
1379,71,22,8,0.0489655172,0.951034483,414.0625455,466.6148183,734.271211,555.1408451,1450,110.3500761,2900,-706048,36352,-669696,44
1382,77,22,8,0.0527758739,0.947224126,415.3240861,466.111516,741.8806078,516.7662338,1459,166.1731207,2918,-707584,39424,-668160,44
1373,77,21,9,0.0531034483,0.946896552,412.934109,465.7160914,736.6853605,526.0519481,1450,195.6815115,2900,-702976,39424,-663552,44
1365,73,22,8,0.0507649513,0.949235049,409.6642871,469.4228702,729.389011,534.5890411,1438,121.7612193,2876,-698880,37376,-661504,44
1367,79,22,8,0.0546334716,0.945366528,411.1446824,466.9092568,735.5866862,514.3544304,1446,28.39748625,2892,-699904,40448,-659456,44
1369,83,22,8,0.0571625344,0.942837466,412.0538135,466.1056815,740.4075968,497.1084337,1452,300,2904,-700928,42496,-658432,44
1365,74,22,8,0.0514246004,0.9485754,410.2800968,457.8446663,730.6871795,522.8648649,1439,66.68211307,2878,-698880,37888,-660992,44
1360,69,21,9,0.0482855143,0.951714486,407.7794633,464.4497179,723.7213235,543.1014493,1429,149.0093848,2858,-696320,35328,-660992,44
645,57,21,9,0.0811965812,0.918803419,197.5498515,188.6521077,365.8186047,189.4736842,702,13.1092437,1404,-330240,29184,-301056,44
1355,70,22,8,0.049122807,0.950877193,406.9672221,457.0265979,721.7195572,544.2142857,1425,211.1111111,2850,-693760,35840,-657920,44
1343,76,20,10,0.0535588443,0.946441156,403.4963433,449.0309162,722.8287416,483.3026316,1419,132.122905,2838,-687616,38912,-648704,44
1369,79,22,8,0.054558011,0.945441989,411.5623046,470.8992339,736.4747991,516.9873418,1448,180.5486284,2896,-700928,40448,-660480,44
1402,84,22,8,0.0565275908,0.943472409,421.8108837,470.3342566,758.2774608,496.8571429,1486,233.6477987,2972,-717824,43008,-674816,44
1758,85,22,8,0.0461204558,0.953879544,526.4331777,597.7587471,932.3697383,707.5294118,1843,317.211704,3686,-900096,43520,-856576,44
1755,94,22,8,0.050838291,0.949161709,526.2606876,595.6059326,939.6273504,651.9042553,1849,190.4222451,3698,-898560,48128,-850432,44
1772,86,22,8,0.0462863294,0.953713671,530.3658908,605.4382033,940.3944695,705.0232558,1858,89.32692308,3716,-907264,44032,-863232,44
1748,87,22,8,0.0474114441,0.952588556,523.62786,596.8125727,929.2173913,692.6206897,1835,192.1465969,3670,-894976,44544,-850432,44
1757,95,21,9,0.0512958963,0.948704104,526.6355401,595.7193911,942.1035857,637.9157895,1852,97.11588883,3704,-899584,48640,-850944,44
1760,84,22,8,0.0455531453,0.954446855,526.7669785,594.6452594,933.2255682,697.7738095,1844,225.7037944,3688,-901120,43008,-858112,44
1775,87,22,8,0.0467239527,0.953276047,531.5505383,604.6084108,942.5605634,705.8390805,1862,171.7712177,3724,-908800,44544,-864256,44
1750,93,22,8,0.0504612046,0.949538795,524.6776243,599.6303511,935.6674286,664.8172043,1843,246.7202142,3686,-896000,47616,-848384,44
1740,93,21,9,0.0507364975,0.949263502,521.7704322,590.2332774,931.4074713,647.4408602,1833,192.7444795,3666,-890880,47616,-843264,44
1772,88,21,9,0.047311828,0.952688172,530.8513821,605.0835378,941.6585779,705.8068182,1860,72.42990654,3720,-907264,45056,-862208,44
1770,99,22,8,0.0529695024,0.947030498,530.6325884,653.3289155,945.119774,754.0707071,1869,96.5392562,3738,-906240,50688,-855552,44
1813,98,21,9,0.0512820513,0.948717949,542.6752952,626.4553545,972.1196911,657.7857143,1911,157.1546053,3822,-928256,50176,-878080,44
1749,89,22,8,0.048422198,0.951577802,523.8704919,599.7304171,931.7575758,678.6179775,1838,170.8178439,3676,-895488,45568,-849920,44
1757,89,22,8,0.048212351,0.951787649,526.3515642,596.1684657,936.1354582,674.0561798,1846,44.13100645,3692,-899584,45568,-854016,44
1749,85,21,9,0.046346783,0.953653217,523.4727965,598.0222127,928.294454,695.3882353,1834,207.4660633,3668,-895488,43520,-851968,44
1830,91,22,8,0.0473711609,0.952628839,548.2173125,621.9600042,972.9879781,719.9230769,1921,328.3760684,3842,-936960,46592,-890368,44
1685,84,22,8,0.0474844545,0.952515546,504.9734322,550.5522937,898.2041543,620.1309524,1769,59.78371071,3538,-862720,43008,-819712,44
1779,98,21,9,0.052210975,0.947789025,533.2678326,636.0030419,951.742552,707.6836735,1877,32.84339458,3754,-910848,50176,-860672,44
1748,95,21,9,0.0515463918,0.948453608,524.3776928,593.7100586,936.9021739,647.8,1843,158.8793103,3686,-894976,48640,-846336,44
247,48,21,9,0.162711864,0.837288136,82.53025286,91.00930727,154.2550607,115.8125,295,4.697452229,590,-126464,24576,-101888,44
9332,604,21,9,0.0607890499,0.93921095,2870.680371,2749.102006,5010.869374,4313.879139,9936,258.3463339,19872,-4777984,309248,-4468736,45
4545,294,22,8,0.0607563546,0.939243645,1403.76927,1247.209685,2439.658966,2116.088435,4839,182.9489603,9678,-2327040,150528,-2176512,45
9063,632,22,8,0.0651882414,0.934811759,2802.748729,2693.920998,4881.762551,4363.838608,9695,212.7029399,19390,-4640256,323584,-4316672,45
2838,215,21,9,0.0704225352,0.929577465,877.8331091,895.4975251,1544.270261,1299.032558,3053,303.1777557,6106,-1453056,110080,-1342976,45
9122,635,21,9,0.06508148,0.93491852,2824.039287,2640.479397,4919.305635,4299.995276,9757,233.3652236,19514,-4670464,325120,-4345344,45
4961,317,21,9,0.060060629,0.939939371,1525.631755,1454.897973,2659.958476,2319.328076,5278,206.2524424,10556,-2540032,162304,-2377728,45
4862,359,21,9,0.0687607738,0.931239226,1511.964137,1384.042216,2639.509461,2224.891365,5221,176.8631436,10442,-2489344,183808,-2305536,45
5326,336,21,9,0.0593429883,0.940657012,1633.22605,1614.417061,2853.565715,2481.732143,5662,197.6955307,11324,-2726912,172032,-2554880,45
7143,374,21,9,0.0497538912,0.950246109,2172.290934,2090.647372,3778.473331,3387.080214,7517,835.2222222,15034,-3657216,191488,-3465728,45
8964,603,22,8,0.0630291627,0.936970837,2764.65946,2664.399259,4819.0444,4263.041459,9567,237.2767857,19134,-4589568,308736,-4280832,45
3591,289,21,9,0.0744845361,0.925515464,1113.274026,1193.47871,1951.014202,1809.854671,3880,409.7148891,7760,-1838592,147968,-1690624,45
5135,363,22,8,0.0660240087,0.933975991,1586.689961,1560.039553,2771.668744,2435.900826,5498,220.9807074,10996,-2629120,185856,-2443264,45
2993,230,21,9,0.071362085,0.928637915,926.3274348,959.8791158,1627.297695,1412.930435,3223,246.2184874,6446,-1532416,117760,-1414656,45
8366,495,21,9,0.0558627694,0.944137231,2555.491849,2507.365451,4470.35967,3765.781818,8861,292.3457605,17722,-4283392,253440,-4029952,45
2961,228,21,9,0.0714957667,0.928504233,918.0000878,922.6867715,1612.845323,1363.245614,3189,266.1936561,6378,-1516032,116736,-1399296,45
2926,214,21,9,0.0681528662,0.931847134,904.6936874,899.9040836,1587.064593,1344.014019,3140,215.2159013,6280,-1498112,109568,-1388544,45
6260,547,21,9,0.0803584545,0.919641545,1944.183041,2172.421015,3381.254153,3664.308958,6807,1031.363636,13614,-3205120,280064,-2925056,45
5063,380,21,9,0.0698144406,0.930185559,1575.577803,1440.595031,2755.365001,2277.455263,5443,197.6397967,10886,-2592256,194560,-2397696,45
9320,589,21,9,0.0594409123,0.940559088,2861.117378,2804.828526,4986.117167,4462.619694,9909,222.7242077,19818,-4771840,301568,-4470272,45
4973,342,21,9,0.06434619,0.93565381,1532.686451,1451.199193,2695.657149,2110.429825,5315,133.8116818,10630,-2546176,175104,-2371072,45
9185,745,23,7,0.0750251762,0.924974824,2841.15523,3124.842083,4927.360697,5435.714094,9930,625.3148615,19860,-4702720,381440,-4321280,45
8744,652,23,7,0.0693912303,0.93060877,2678.691318,3116.588408,4678.094579,4972.157975,9396,227.5611528,18792,-4476928,333824,-4143104,45
8517,595,23,7,0.0652985075,0.934701493,2616.658968,2818.955838,4551.638253,4626.092437,9112,218.1469955,18224,-4360704,304640,-4056064,45
9231,702,23,7,0.0706735125,0.929326487,2841.242205,3183.38604,4983.785289,4746.280627,9933,250.1385042,19866,-4726272,359424,-4366848,45
9131,782,22,8,0.0788863109,0.921113689,2812.116618,3301.18409,4894.845362,5682.746803,9913,842.2259983,19826,-4675072,400384,-4274688,45
8085,569,23,7,0.0657499422,0.934250058,2494.297586,2551.073058,4334.113667,4233.525483,8654,354.3816544,17308,-4139520,291328,-3848192,45
8439,598,23,7,0.0661724023,0.933827598,2586.081075,2908.250749,4525.872023,4422.021739,9037,354.9489395,18074,-4320768,306176,-4014592,45
8197,606,23,7,0.0688401681,0.931159832,2520.830901,2801.90101,4405.401366,4355.991749,8803,351.8385292,17606,-4196864,310272,-3886592,45
8404,581,23,7,0.0646633278,0.935336672,2578.47345,2802.705743,4501.182056,4374.648881,8985,205.3244973,17970,-4302848,297472,-4005376,45
7404,519,23,7,0.0655054903,0.93449451,2271.3814,2499.106252,3954.396542,4070.470135,7923,891.2260967,15846,-3790848,265728,-3525120,45
9226,707,22,8,0.0711768851,0.928823115,2834.24592,3256.922099,4945.846412,5243.043847,9933,408.4292763,19866,-4723712,361984,-4361728,45
6881,532,23,7,0.0717658168,0.928234183,2137.038468,2174.724735,3714.794071,3606.18985,7413,195.1302974,14826,-3523072,272384,-3250688,45
3457,286,23,7,0.0764092974,0.923590703,1077.512426,1057.312753,1900.424356,1528.423077,3743,98.16417519,7486,-1769984,146432,-1623552,45
8845,667,23,7,0.0701219512,0.929878049,2711.215448,3025.879087,4687.810514,5667.382309,9512,173.6400146,19024,-4528640,341504,-4187136,45
9095,808,22,8,0.0815914369,0.918408563,2852.41644,2923.320277,4936.347883,5128.183168,9903,566.8574699,19806,-4656640,413696,-4242944,45
6672,495,23,7,0.069066555,0.930933445,2073.660322,1961.11837,3613.569694,3185.436364,7167,126.1573667,14334,-3416064,253440,-3162624,45
9144,771,22,8,0.0777609682,0.922239032,2832.180663,3134.571603,4907.107393,5561.582361,9915,1106.584821,19830,-4681728,394752,-4286976,45
9281,659,23,7,0.0662977867,0.933702213,2853.680415,3047.626605,4938.678375,5418.658574,9940,803.5569927,19880,-4751872,337408,-4414464,45
2397,121,23,7,0.0480540111,0.951945989,726.0165448,728.07643,1267.006675,1110.793388,2518,73.45390898,5036,-1227264,61952,-1165312,45
1084,75,23,7,0.0647109577,0.935289042,331.0355398,372.3408322,585.7352399,497.1066667,1159,18.65443425,2318,-555008,38400,-516608,45
8303,695,24,6,0.0772393865,0.922760613,2561.593573,2970.694709,4469.959292,4852.415827,8998,161.8636445,17996,-4251136,355840,-3895296,45
9171,753,23,7,0.0758766626,0.924123337,2824.991136,3258.073463,4915.697525,5532.520584,9924,611.4602588,19848,-4695552,385536,-4310016,45
1497,62,23,7,0.0397690827,0.960230917,447.8328243,489.1359679,784.3012692,676.1451613,1559,161.3871636,3118,-766464,31744,-734720,45
9102,808,23,7,0.0815338042,0.918466196,2819.670258,3157.01125,4877.190068,5837.649752,9910,762.3076923,19820,-4660224,413696,-4246528,45
4970,307,24,6,0.0581769945,0.941823005,1518.482116,1551.158661,2662.495976,2258.625407,5277,140.3457447,10554,-2544640,157184,-2387456,45
8003,557,24,6,0.0650700935,0.934929907,2446.608534,2798.853686,4281.361364,4268.123878,8560,353.4269199,17120,-4097536,285184,-3812352,45
8298,601,22,8,0.0675356782,0.932464322,2544.426418,2885.315355,4445.83261,4507.539101,8899,187.584317,17798,-4248576,307712,-3940864,45
8453,618,24,6,0.068129203,0.931870797,2589.510846,2971.696672,4514.11558,4835.334951,9071,201.5329927,18142,-4327936,316416,-4011520,45
8307,573,23,7,0.064527027,0.935472973,2545.718874,2807.511386,4438.080655,4475.574171,8880,289.4393742,17760,-4253184,293376,-3959808,45
8205,586,24,6,0.0666590832,0.933340917,2513.0152,2857.298781,4406.848629,4244.100683,8791,355.766896,17582,-4200960,300032,-3900928,45
9113,800,23,7,0.0807021083,0.919297892,2817.250249,3254.38534,4899.340503,5613.81375,9913,781.1662727,19826,-4665856,409600,-4256256,45
9121,788,21,9,0.0795236654,0.920476335,2817.165852,3249.936131,4898.361693,5610.581218,9909,736.7286245,19818,-4669952,403456,-4266496,45
5863,429,24,6,0.0681818182,0.931818182,1824.500239,1699.978312,3150.579226,3090.750583,6292,225.6814921,12584,-3001856,219648,-2782208,45
8416,605,24,6,0.0670657355,0.932934264,2577.834056,2945.243202,4507.054895,4565.879339,9021,230.3038039,18042,-4308992,309760,-3999232,45
8867,1027,23,7,0.103800283,0.896199717,2812.295764,3049.646607,4837.655802,5895.882181,9894,708.739255,19788,-4539904,525824,-4014080,45
8369,594,23,7,0.0662724534,0.933727547,2577.817978,2716.477697,4474.382722,4589.321549,8963,325.690407,17926,-4284928,304128,-3980800,45
8094,575,23,7,0.0663282962,0.933671704,2488.986578,2685.57192,4337.716333,4296.763478,8669,200.9969859,17338,-4144128,294400,-3849728,45
8141,664,23,7,0.0754116979,0.924588302,2497.511931,2976.812424,4357.633092,4959.222892,8805,808.5399449,17610,-4168192,339968,-3828224,45
4753,313,24,6,0.0617844453,0.938215555,1463.972689,1377.653595,2559.964233,2131.632588,5066,177.6920379,10132,-2433536,160256,-2273280,45
8233,598,23,7,0.0677160005,0.932284,2539.849468,2674.339602,4409.631605,4503.677258,8831,328.9013035,17662,-4215296,306176,-3909120,45
9039,859,23,7,0.0867852091,0.913214791,2822.436711,3071.294124,4867.494856,5812.4156,9898,636.1182519,19796,-4627968,439808,-4188160,45
7684,665,23,7,0.0796502575,0.920349742,2377.892902,2705.553411,4131.591359,4676.581955,8349,156.759294,16698,-3934208,340480,-3593728,45
9053,845,23,7,0.085370782,0.914629218,2831.872243,2979.514187,4867.834751,5824.429586,9898,528.7393162,19796,-4635136,432640,-4202496,45
9071,838,22,8,0.0845695832,0.915430417,2822.776423,3171.134858,4895.979826,5593.868735,9909,634.785394,19818,-4644352,429056,-4215296,45
9102,807,23,7,0.0814411141,0.918558886,2831.019658,3079.079334,4889.568996,5692.983891,9909,589.8214286,19818,-4660224,413184,-4247040,45
1742,123,23,7,0.0659517426,0.934048257,535.2080615,504.9903541,952.6659013,654.4796748,1865,32.46301131,3730,-891904,62976,-828928,45
9100,809,23,7,0.0816429509,0.918357049,2826.656615,3096.204223,4880.742088,5790.286774,9909,551.7260579,19818,-4659200,414208,-4244992,45
7748,642,21,9,0.0765196663,0.923480334,2384.894687,2821.459614,4176.486061,4424.970405,8390,152.1581429,16780,-3966976,328704,-3638272,45
9077,832,23,7,0.0839640731,0.916035927,2838.155632,2972.097921,4879.684587,5776.680288,9909,581.855549,19818,-4647424,425984,-4221440,45
9224,705,23,7,0.0710041293,0.928995871,2824.787692,3341.107387,4937.426279,5325.765957,9929,1000.907258,19858,-4722688,360960,-4361728,45
7030,493,23,7,0.0655323674,0.934467633,2160.049761,2315.99882,3780.222617,3502.15213,7523,304.821718,15046,-3599360,252416,-3346944,45
9085,817,23,7,0.0825085841,0.917491416,2823.995263,3148.626235,4894.700275,5583.110159,9902,1029.313929,19804,-4651520,418304,-4233216,45
7169,499,23,7,0.065075639,0.934924361,2199.158457,2364.758249,3866.127354,3380.118236,7668,206.2399139,15336,-3670528,255488,-3415040,45
4937,317,23,7,0.0603349829,0.939665017,1505.510514,1626.314864,2654.060968,2213.835962,5254,91.77292576,10508,-2527744,162304,-2365440,45
872,86,23,7,0.0897703549,0.910229645,277.7090552,230.5846392,491.6961009,355.8372093,958,24.16750757,1916,-446464,44032,-402432,45
9121,790,23,7,0.0797094138,0.920290586,2836.952101,3040.38687,4895.644666,5652.836709,9911,589.9404762,19822,-4669952,404480,-4265472,45
7020,481,23,7,0.0641247834,0.935875217,2149.64751,2348.301074,3777.781481,3360.135135,7501,294.6190102,15002,-3594240,246272,-3347968,45
2301,145,23,7,0.0592804579,0.940719542,702.4502318,749.7060121,1231.718818,1093.075862,2446,258.8359788,4892,-1178112,74240,-1103872,45
8995,901,23,7,0.0910468876,0.908953112,2818.864941,3042.788808,4850.747304,5924.399556,9896,330.1968635,19792,-4605440,461312,-4144128,45
9392,557,23,7,0.0559855262,0.944014474,2851.114233,3186.904052,4994.154813,4652.016158,9949,992.9141717,19898,-4808704,285184,-4523520,45
9144,770,23,7,0.0776679443,0.922332056,2814.576627,3341.402664,4919.789808,5405.320779,9914,534.7357066,19828,-4681728,394240,-4287488,45
2907,248,23,7,0.0786053883,0.921394612,906.4816862,818.6450697,1618.999656,1097.41129,3155,56.36948365,6310,-1488384,126976,-1361408,45
9089,824,23,7,0.0831231716,0.916876828,2811.808206,3285.229952,4894.733414,5643.821602,9913,743.1034483,19826,-4653568,421888,-4231680,45
8362,634,23,7,0.070475767,0.929524233,2580.059382,2796.316006,4518.648409,4232.757098,8996,200.2671416,17992,-4281344,324608,-3956736,45
9130,785,22,8,0.0791729702,0.92082703,2817.776819,3285.033378,4910.145564,5514.574522,9915,488.9053254,19830,-4674560,401920,-4272640,45
9047,860,23,7,0.086807308,0.913192692,2814.488903,3137.820037,4861.176854,5930.477907,9907,447.875226,19814,-4632064,440320,-4191744,45
9093,817,23,7,0.0824419778,0.917558022,2812.690307,3262.301618,4890.102057,5683.362301,9910,804.3831169,19820,-4655616,418304,-4237312,45
8881,991,23,7,0.100384927,0.899615073,2789.335736,3081.343079,4799.222497,6166.733602,9872,622.0541903,19744,-4547072,507392,-4039680,45
8415,648,23,7,0.0714995035,0.928500497,2584.450025,2998.295804,4527.554961,4589.723765,9063,224.1652238,18126,-4308480,331776,-3976704,45
4533,392,23,7,0.0795939086,0.920406091,1408.211782,1505.476052,2499.829032,2037.117347,4925,89.04357259,9850,-2320896,200704,-2120192,45
9122,789,23,7,0.0796085158,0.920391484,2808.131632,3354.32582,4903.305744,5565.223067,9911,810.3843009,19822,-4670464,403968,-4266496,45
8999,897,24,6,0.0906426839,0.909357316,2807.811209,3218.231345,4875.871764,5677.130435,9896,310.2194357,19792,-4607488,459264,-4148224,45
8428,653,23,7,0.0719083801,0.92809162,2588.627334,3008.787259,4528.738609,4699.25268,9081,227.9939744,18162,-4315136,334336,-3980800,45
9146,768,23,7,0.0774662094,0.922533791,2814.884086,3328.828751,4914.089329,5474.471354,9914,635.9204618,19828,-4682752,393216,-4289536,45
6710,431,23,7,0.0603556925,0.939644308,2043.52346,2321.735858,3567.400298,3627.041763,7141,300.800337,14282,-3435520,220672,-3214848,45
9172,752,23,7,0.0757758968,0.924224103,2832.761347,3201.854064,4928.822939,5373.25266,9924,792.6517572,19848,-4696064,385024,-4311040,45
9207,718,23,7,0.0723425693,0.927657431,2837.707163,3177.932342,4937.776257,5286.447075,9925,532.7428878,19850,-4713984,367616,-4346368,45
8426,594,22,8,0.0658536585,0.934146341,2586.942666,2832.636967,4508.234512,4542.636364,9020,334.4456804,18040,-4314112,304128,-4009984,45
4389,329,23,7,0.0697329377,0.930267062,1362.584641,1308.018498,2384.719982,2023.054711,4718,153.0327603,9436,-2247168,168448,-2078720,45
8874,686,23,7,0.0717573222,0.928242678,2752.209527,2840.98647,4759.243182,5055.475219,9560,187.4877427,19120,-4543488,351232,-4192256,45
9262,666,23,7,0.0670829976,0.932917002,2871.799294,2717.105571,5006.500108,4380.408408,9928,1098.230088,19856,-4742144,340992,-4401152,45
6817,685,22,8,0.0913089843,0.908691016,2142.99065,2318.51127,3700.299545,4261.037956,7502,137.701909,15004,-3490304,350720,-3139584,45
6964,668,23,7,0.0875262055,0.912473795,2161.005653,2567.496642,3777.603102,4222.005988,7632,140.3199117,15264,-3565568,342016,-3223552,45
2564,203,23,7,0.0733646549,0.926635345,797.4527255,813.2154378,1379.727769,1437.960591,2767,121.7869718,5534,-1312768,103936,-1208832,45
2857,280,23,7,0.0892572522,0.910742748,903.8649741,917.4821442,1578.278264,1474.328571,3137,810.5943152,6274,-1462784,143360,-1319424,45
6919,694,23,7,0.0911598581,0.908840142,2163.968575,2464.974751,3762.1691,4253.95245,7613,134.9822695,15226,-3542528,355328,-3187200,45
6377,611,23,7,0.0874356039,0.912564396,1986.555651,2313.537075,3495.038576,3488.878887,6988,142.2928121,13976,-3265024,312832,-2952192,45
6954,703,23,7,0.0918114144,0.908188586,2175.724994,2487.401788,3785.652286,4257.790896,7657,135.8105711,15314,-3560448,359936,-3200512,45
6969,677,23,7,0.088543029,0.911456971,2175.407616,2486.398465,3790.795667,4160.156573,7646,138.3891403,15292,-3568128,346624,-3221504,45
5132,341,22,8,0.0623058652,0.937694135,1572.746356,1677.39605,2727.282931,2883.240469,5473,167.9349494,10946,-2627584,174592,-2452992,45
2938,269,23,7,0.0838790147,0.916120985,916.3089147,997.7096263,1624.025868,1385.27881,3207,468.8596491,6414,-1504256,137728,-1366528,45
6894,684,23,7,0.0902612827,0.909738717,2150.342504,2476.44015,3739.349434,4294.964912,7578,136.663661,15156,-3529728,350208,-3179520,45
3642,316,23,7,0.0798383022,0.920161698,1139.444309,1177.754807,1981.77073,1953.329114,3958,132.9079919,7916,-1864704,161792,-1702912,45
2196,197,23,7,0.0823234434,0.917676557,690.8768912,682.7283371,1205.54827,1101.71066,2393,78.82081686,4786,-1124352,100864,-1023488,45
3128,254,23,7,0.0751034891,0.924896511,976.2935624,929.3514327,1714.876279,1403.622047,3382,61.19051927,6764,-1601536,130048,-1471488,45
8873,1000,23,7,0.101286336,0.898713664,2824.326514,2994.377477,4865.021639,5575.664,9873,665.7451113,19746,-4542976,512000,-4030976,45
7203,710,23,7,0.0897257677,0.910274232,2248.219636,2556.238872,3901.998612,4514.992958,7913,144.0036397,15826,-3687936,363520,-3324416,45
7163,704,23,7,0.0894877336,0.910512266,2234.259028,2586.309979,3897.316069,4307.24858,7867,140.6076854,15734,-3667456,360448,-3307008,45
8966,925,23,7,0.093519361,0.906480639,2834.647619,3002.889232,4894.62592,5443.967568,9891,676.5389877,19782,-4590592,473600,-4116992,45
9062,831,22,8,0.083998787,0.916001213,2841.665095,3002.013778,4932.846723,5101.340554,9893,942.1904762,19786,-4639744,425472,-4214272,45
7833,792,23,7,0.091826087,0.908173913,2468.713387,2649.303077,4268.254564,4755.539141,8625,153.6611438,17250,-4010496,405504,-3604992,45
8084,811,23,7,0.0911748173,0.908825183,2536.099363,2820.286514,4400.141514,4925.050555,8895,167.9252407,17790,-4139008,415232,-3723776,45
7831,773,23,7,0.089841934,0.910158066,2455.05438,2701.56828,4250.331886,4830.997413,8604,160.9728718,17208,-4009472,395776,-3613696,45
7892,808,23,7,0.0928735632,0.907126437,2489.723729,2693.485282,4317.419919,4673.60396,8700,160.5462262,17400,-4040704,413696,-3627008,45
2506,320,23,7,0.113234253,0.886765747,816.0835963,783.4339731,1439.865922,1207.021875,2826,49.29356358,5652,-1283072,163840,-1119232,45
7794,772,23,7,0.090123745,0.909876255,2452.963938,2628.342957,4242.044906,4702.024611,8566,156.3709383,17132,-3990528,395264,-3595264,45
7819,776,22,8,0.0902850494,0.909714951,2451.814722,2719.674092,4253.774651,4743.615979,8595,150.2622378,17190,-4003328,397312,-3606016,45
7757,798,23,7,0.0932787843,0.906721216,2443.128224,2680.813995,4236.770917,4678.769424,8555,175.8478931,17110,-3971584,408576,-3563008,45
7891,813,23,7,0.0934053309,0.906594669,2486.750242,2697.625107,4299.505386,4866.867159,8704,154.7377778,17408,-4040192,416256,-3623936,45
7903,799,23,7,0.0918179729,0.908182027,2483.638247,2728.365531,4301.401114,4847.033792,8702,156.3139932,17404,-4046336,409088,-3637248,45
8841,1024,23,7,0.103801318,0.896198682,2817.240313,3003.555564,4849.334238,5655.352539,9865,926.2910798,19730,-4526592,524288,-4002304,45
8000,812,23,7,0.0921470722,0.907852928,2518.250517,2703.019345,4342.414375,5037.885468,8812,169.951784,17624,-4096000,415744,-3680256,45
7759,776,23,7,0.0909197422,0.909080258,2435.042721,2681.721917,4216.687073,4781.063144,8535,152.73801,17070,-3972608,397312,-3575296,45
8140,802,23,7,0.0896891076,0.910310892,2555.396934,2796.315879,4429.872236,4894.006234,8942,159.0537175,17884,-4167680,410624,-3757056,45
8894,995,22,8,0.100616847,0.899383153,2816.868868,3069.659661,4859.800315,5706.573869,9889,719.2,19778,-4553728,509440,-4044288,45
7569,716,23,7,0.0864212432,0.913578757,2364.776648,2623.585719,4103.659664,4558.875698,8285,197.7326969,16570,-3875328,366592,-3508736,45
8870,1002,22,8,0.10149919,0.89850081,2827.485573,2981.219438,4872.682638,5501.43014,9872,232.8851144,19744,-4541440,513024,-4028416,45
7856,782,23,7,0.0905302153,0.909469785,2464.582641,2734.104357,4278.478106,4731.607417,8638,154.8861395,17276,-4022272,400384,-3621888,45
7662,745,23,7,0.088616629,0.911383371,2396.252553,2692.373521,4166.782172,4586.769128,8407,151.2594458,16814,-3922944,381440,-3541504,45
7777,769,23,7,0.0899836181,0.910016382,2432.159403,2764.82528,4234.721486,4665.672302,8546,153.4015437,17092,-3981824,393728,-3588096,45
9104,809,23,7,0.0816100071,0.918389993,2828.532377,3114.759558,4890.651252,5703.648949,9913,831.6275168,19826,-4661248,414208,-4247040,45
6905,478,22,8,0.0647433293,0.935256671,2126.015748,2181.815938,3713.831282,3376.633891,7383,298.6650485,14766,-3535360,244736,-3290624,45
9037,859,23,7,0.0868027486,0.913197251,2816.631118,3114.089004,4864.428461,5832.963912,9896,182.9881657,19792,-4626944,439808,-4187136,45
9104,803,23,7,0.0810538003,0.9189462,2821.924202,3097.560573,4868.155866,5927.256538,9907,868.2734443,19814,-4661248,411136,-4250112,45
9008,889,23,7,0.0898251996,0.9101748,2826.409122,2976.796207,4851.882882,5933.061867,9897,337.5511596,19794,-4612096,455168,-4156928,45
7597,641,23,7,0.0778101481,0.922189852,2341.214028,2655.498682,4053.31802,4903.875195,8238,166.0887097,16476,-3889664,328192,-3561472,45
9024,868,23,7,0.0877476749,0.912252325,2812.809224,3157.47963,4869.372562,5748.341014,9892,730.5760709,19784,-4620288,444416,-4175872,45
8834,1043,23,7,0.105598866,0.894401134,2784.77035,3091.900378,4791.587503,6187.554171,9877,197.1850669,19754,-4523008,534016,-3988992,45
9150,764,23,7,0.0770627396,0.92293726,2834.497423,3066.206512,4892.322732,5738.091623,9914,457.2878229,19828,-4684800,391168,-4293632,45
7671,611,23,7,0.0737744506,0.926225549,2360.361108,2702.341524,4104.781906,4602.489362,8282,146.1701377,16564,-3927552,312832,-3614720,45
6822,494,23,7,0.0675232367,0.932476763,2108.518369,2134.899408,3680.873204,3349.532389,7316,138.8235294,14632,-3492864,252928,-3239936,45
9102,805,23,7,0.0812556778,0.918744322,2824.757357,3092.008433,4874.582729,5851.957764,9907,864.4851658,19814,-4660224,412160,-4248064,45
7448,541,23,7,0.0677181124,0.932281888,2287.854197,2535.155679,4011.237782,3771.452865,7989,144.8857454,15978,-3813376,276992,-3536384,45
6708,500,23,7,0.0693673696,0.93063263,2055.602756,2384.636524,3618.836911,3412.156,7208,180.3803804,14416,-3434496,256000,-3178496,45
6991,492,23,7,0.0657490311,0.934250969,2144.596943,2321.770446,3774.435703,3281.109756,7483,268.8825009,14966,-3579392,251904,-3327488,45
9094,815,23,7,0.082248461,0.917751539,2823.35755,3171.807523,4895.73587,5616.28589,9909,723.8130022,19818,-4656128,417280,-4238848,45
8928,965,22,8,0.0975437178,0.902456282,2812.428052,3050.652442,4837.980399,5955.629016,9893,260.3421053,19786,-4571136,494080,-4077056,45
2087,195,23,7,0.0854513585,0.914548642,655.249301,654.9312361,1162.331097,918.5538462,2282,41.08010801,4564,-1068544,99840,-968704,45
9060,848,23,7,0.0855874041,0.914412596,2824.148333,3091.468458,4873.818874,5816.494104,9908,603.410475,19816,-4638720,434176,-4204544,45
9072,836,23,7,0.0843762616,0.915623738,2824.741978,3106.812901,4879.915344,5763.868421,9908,1011.020408,19816,-4644864,428032,-4216832,45
7645,389,21,9,0.0484192183,0.951580782,2303.553848,2586.367308,4034.140353,3690.467866,8034,425.7551669,16068,-3914240,199168,-3715072,45
7543,370,22,8,0.0467584987,0.953241501,2270.114132,2529.093435,3974.759512,3594.945946,7913,433.5890411,15826,-3862016,189440,-3672576,45
7504,356,22,8,0.0452926209,0.954707379,2252.694649,2582.905294,3938.488006,3762.123596,7860,478.6845311,15720,-3842048,182272,-3659776,45
7399,374,20,10,0.0481152708,0.951884729,2220.480309,2662.209629,3892.738748,3773.467914,7773,1030.901857,15546,-3788288,191488,-3596800,45
805,60,20,10,0.0693641618,0.930635838,244.4377247,291.0268501,441.0608696,324.85,865,43.59879032,1730,-412160,30720,-381440,45
7544,377,22,8,0.0475950006,0.952404999,2268.478483,2614.237778,3971.42166,3752.456233,7921,439.32335,15842,-3862528,193024,-3669504,45
7508,370,20,10,0.0469662351,0.953033765,2256.298671,2581.929007,3958.111881,3561.82973,7878,619.8269079,15756,-3844096,189440,-3654656,45
7662,404,20,10,0.050086784,0.949913216,2305.968595,2688.964482,4054.529366,3634.670792,8066,272.6842461,16132,-3922944,206848,-3716096,45
7409,375,22,8,0.0481757451,0.951824255,2229.343269,2565.939105,3901.18626,3720.882667,7784,510.7611549,15568,-3793408,192000,-3601408,45
7390,358,22,8,0.0462054724,0.953794528,2221.225917,2531.59114,3879.991746,3761.136872,7748,606.7345341,15496,-3783680,183296,-3600384,45
8320,389,21,9,0.044666437,0.955333563,2493.60415,2916.206626,4359.207452,4265.010283,8709,997.5945017,17418,-4259840,199168,-4060672,45
7432,362,21,9,0.0464459841,0.953554016,2228.344628,2654.189552,3899.841227,3849.433702,7794,879.6839729,15588,-3805184,185344,-3619840,45
7406,360,22,8,0.0463559104,0.95364409,2220.283793,2645.074283,3888.070213,3789.480556,7766,680.6310254,15532,-3791872,184320,-3607552,45
7431,369,21,9,0.0473076923,0.952692308,2229.310148,2656.663053,3908.826134,3732.826558,7800,1023.622047,15600,-3804672,188928,-3615744,45
8380,394,22,8,0.0449054023,0.955094598,2514.604583,2893.383777,4388.770167,4360.484772,8774,763.6205396,17548,-4290560,201728,-4088832,45
7416,344,23,7,0.0443298969,0.955670103,2226.1938,2505.958489,3893.253641,3605.555233,7760,636.0655738,15520,-3796992,176128,-3620864,45
7378,363,21,9,0.0468931663,0.953106834,2211.233539,2663.703436,3876.438059,3760.471074,7741,722.7824463,15482,-3777536,185856,-3591680,45
7726,380,20,10,0.0468788552,0.953121145,2318.156895,2738.803038,4063.49534,3850.278947,8106,786.9902913,16212,-3955712,194560,-3761152,45
7418,364,22,8,0.0467746081,0.953225392,2226.474829,2615.328549,3899.704233,3724.304945,7782,617.1292625,15564,-3798016,186368,-3611648,45
2095,146,21,9,0.0651494868,0.934850513,646.3703308,617.102698,1135.748449,909.369863,2241,40.4075009,4482,-1072640,74752,-997888,45
7718,660,23,7,0.0787777513,0.921222249,2387.771683,2752.121358,4184.802021,4244.437879,8378,175.7499476,16756,-3951616,337920,-3613696,45
7737,643,22,8,0.0767303103,0.92326969,2382.556871,2810.857985,4170.566111,4430.357698,8380,208.9775561,16760,-3961344,329216,-3632128,45
7898,661,22,8,0.0772286482,0.922771352,2440.889399,2787.619091,4256.215371,4564.192133,8559,191.4336837,17118,-4043776,338432,-3705344,45
7524,607,21,9,0.0746525643,0.925347436,2310.250741,2720.67463,4027.863238,4538.719934,8131,185.0477924,16262,-3852288,310784,-3541504,45
2067,171,23,7,0.0764075067,0.923592493,643.6964153,662.3582205,1129.378326,1000.093567,2238,162.173913,4476,-1058304,87552,-970752,45
7633,643,23,7,0.0776945384,0.922305462,2362.047394,2678.051468,4118.665924,4373.948678,8276,178.1317262,16552,-3908096,329216,-3578880,45
7801,635,22,8,0.0752726411,0.924727359,2398.247202,2833.589923,4193.83438,4521.51811,8436,186.1429832,16872,-3994112,325120,-3668992,45
9384,565,22,8,0.0567896271,0.943210373,2857.889447,3047.683778,5007.335145,4437.950442,9949,756.0030395,19898,-4804608,289280,-4515328,45
9048,856,23,7,0.0864297254,0.913570275,2820.959559,3152.846982,4887.302719,5641.641355,9904,810.4746318,19808,-4632576,438272,-4194304,45
8842,917,22,8,0.0939645455,0.906035454,2773.741861,3058.89557,4785.240896,5793.696838,9759,241.2011864,19518,-4527104,469504,-4057600,45
3051,261,21,9,0.0788043478,0.921195652,956.357673,910.7735155,1679.528351,1387.306513,3312,63.25439267,6624,-1562112,133632,-1428480,45
7526,612,22,8,0.0752027525,0.924797247,2311.566992,2759.008293,4049.417885,4316.457516,8138,202.4881811,16276,-3853312,313344,-3539968,45
7507,602,22,8,0.0742385004,0.9257615,2303.827731,2736.888909,4026.715332,4407.712625,8109,198.3125459,16218,-3843584,308224,-3535360,45
8578,907,23,7,0.0956246705,0.904375329,2685.403557,3011.835397,4636.202145,5753.046307,9485,233.8510848,18970,-4391936,464384,-3927552,45
7694,621,21,9,0.0746843055,0.925315695,2354.915927,2873.380946,4124.957629,4567.384863,8315,196.572104,16630,-3939328,317952,-3621376,45
9046,854,22,8,0.0862626263,0.913737374,2819.859882,3165.232557,4890.938426,5581.406323,9900,701.1331445,19800,-4631552,437248,-4194304,45
6584,505,23,7,0.0712371279,0.928762872,2044.092598,1995.365165,3587.486179,2991.081188,7089,126.0042659,14178,-3371008,258560,-3112448,45
9061,844,23,7,0.0852094902,0.91479051,2822.318496,3149.438318,4889.11544,5638.850711,9905,645.6975228,19810,-4639232,432128,-4207104,45
140,10,23,7,0.0666666667,0.933333333,42.24479197,40.89315346,78.14285714,38.5,150,4.474940334,300,-71680,5120,-66560,45
7618,631,21,9,0.0764941205,0.92350588,2345.808589,2766.496396,4108.802704,4320.548336,8249,188.3333333,16498,-3900416,323072,-3577344,45
8736,986,20,10,0.101419461,0.898580539,2770.379369,3082.415394,4818.716346,5240.564909,9722,177.4411389,19444,-4472832,504832,-3968000,46
6072,611,20,10,0.0914260063,0.908573994,1905.013603,2153.524314,3334.322299,3418.299509,6683,123.0528448,13366,-3108864,312832,-2796032,46
1231,122,19,11,0.0901699926,0.909830007,381.9564364,460.1927731,668.5588952,762.1721311,1353,77.35849057,2706,-630272,62464,-567808,46
6052,519,21,9,0.078983412,0.921016588,1878.623961,2097.129995,3291.295935,3224.244701,6571,210.2047345,13142,-3098624,265728,-2832896,46
5961,524,21,9,0.0808018504,0.91919815,1855.174117,2052.443868,3250.526925,3157.374046,6485,225.6437022,12970,-3052032,268288,-2783744,46
1218,124,20,10,0.0923994039,0.907600596,377.6904607,461.3673945,661.7027915,767.733871,1342,73.89867841,2684,-623616,63488,-560128,46
6097,614,20,10,0.091491581,0.908508419,1917.307181,2123.812644,3347.550763,3439.900651,6711,139.376947,13422,-3121664,314368,-2807296,46
1215,123,19,11,0.0919282511,0.908071749,377.7159161,455.5157727,661.981893,743.7642276,1338,139.6659708,2676,-622080,62976,-559104,46
1253,121,21,9,0.0880640466,0.911935953,388.466632,462.0128813,678.1348763,784.4793388,1374,118.8581315,2748,-641536,61952,-579584,46
5896,531,20,10,0.082620196,0.917379804,1837.195664,2043.183081,3222.836499,3115.883239,6427,188.8627681,12854,-3018752,271872,-2746880,46
1213,123,21,9,0.0920658683,0.907934132,377.0305272,453.3062366,659.7312448,754.9756098,1336,81.56288156,2672,-621056,62976,-558080,46
1225,121,21,9,0.0898959881,0.910104012,381.2642908,444.9230339,664.1461224,768.1983471,1346,118.4859155,2692,-627200,61952,-565248,46
1193,124,19,11,0.0941533789,0.905846621,370.7042221,454.8731915,651.2590109,733.4758065,1317,49.75443899,2634,-610816,63488,-547328,46
1222,122,20,10,0.0907738095,0.90922619,378.3170548,467.595034,665.0981997,746.6393443,1344,126.7924528,2688,-625664,62464,-563200,46
6632,669,21,9,0.0916312834,0.908368717,2085.529965,2310.444036,3636.734469,3792.418535,7301,143.325481,14602,-3395584,342528,-3053056,46
6367,576,20,10,0.0829612559,0.917038744,1988.31256,2133.286404,3507.773206,3076.569444,6943,144.2551423,13886,-3259904,294912,-2964992,46
5881,547,21,9,0.085096453,0.914903547,1837.640046,2034.276854,3226.526951,3085.193784,6428,189.8405198,12856,-3011072,280064,-2731008,46
1225,121,20,10,0.0898959881,0.910104012,379.8253811,455.1119379,663.2767347,777,1346,114.2614601,2692,-627200,61952,-565248,46
5892,504,20,10,0.0787992495,0.92120075,1827.531169,2053.29038,3194.809063,3241.64881,6396,213.9846102,12792,-3016704,258048,-2758656,46
2035,200,20,10,0.0894854586,0.910514541,632.5105204,704.9980776,1145.191646,841.325,2235,26.90178142,4470,-1041920,102400,-939520,46
9425,539,20,10,0.0540947411,0.945905259,2851.495376,3233.316596,5013.43756,4441.523191,9964,937.3471308,19928,-4825600,275968,-4549632,46
909,75,20,10,0.0762195122,0.923780488,280.8551739,318.6566124,495.0847085,461.1733333,984,28.27586207,1968,-465408,38400,-427008,46
9267,528,20,10,0.0539050536,0.946094946,2798.776882,3209.559725,4938.62933,4184.909091,9795,201.8339172,19590,-4744704,270336,-4474368,46
9181,562,20,10,0.0576824387,0.942317561,2787.125721,3061.370294,4927.276985,3968.978648,9743,317.3615635,19486,-4700672,287744,-4412928,46
1237,119,20,10,0.0877581121,0.912241888,384.1000544,451.8817544,670.1641067,765.1512605,1356,40.14209591,2712,-633344,60928,-572416,46
9409,554,20,10,0.0556057412,0.944394259,2843.606276,3288.641015,5026.698268,4222.855596,9963,240.7684872,19926,-4817408,283648,-4533760,46
9146,559,20,10,0.0575991757,0.942400824,2777.579114,3009.447696,4911.860376,3889.964222,9705,265.1639344,19410,-4682752,286208,-4396544,46
9350,591,20,10,0.0594507595,0.940549241,2837.479448,3338.15047,4974.383102,4917.477157,9941,960.4830918,19882,-4787200,302592,-4484608,46
9440,524,20,10,0.0525893216,0.947410678,2848.762827,3228.885378,5027.509958,4171.633588,9964,564.2129105,19928,-4833280,268288,-4564992,46
1508,183,20,10,0.108219988,0.891780012,472.290678,601.5152649,851.1041114,803.9398907,1691,52.61356565,3382,-772096,93696,-678400,46
1225,121,20,10,0.0898959881,0.910104012,380.3115577,453.2974633,664.2302041,767.3471074,1346,144.4206009,2692,-627200,61952,-565248,46
9207,717,20,10,0.0722490931,0.927750907,2837.8859,3190.41898,4963.35712,4951.493724,9924,789.4988067,19848,-4713984,367104,-4346880,46
9310,628,20,10,0.0631917891,0.936808211,2830.230444,3381.944086,4984.944146,4740.542994,9938,1170.553592,19876,-4766720,321536,-4445184,46
9187,535,20,10,0.0550298293,0.944970171,2788.733197,2995.320701,4905.768259,4101.327103,9722,265.1936716,19444,-4703744,273920,-4429824,46
9261,580,20,10,0.0589370999,0.9410629,2799.380715,3412.566871,4945.278048,4533.346552,9841,173.4708267,19682,-4741632,296960,-4444672,46
1231,122,21,9,0.0901699926,0.909830007,382.5987257,451.9153827,667.2818846,775.057377,1353,131.4868805,2706,-630272,62464,-567808,46
1449,176,20,10,0.108307692,0.891692308,452.2469075,588.7381118,817.0614217,779.5625,1625,51.21336275,3250,-741888,90112,-651776,46
9409,554,21,9,0.0556057412,0.944394259,2847.563014,3251.002645,5021.391115,4312.990975,9963,615.3798641,19926,-4817408,283648,-4533760,46
9385,548,20,10,0.0551696366,0.944830363,2846.600909,3080.286589,5016.811401,4113.934307,9933,295.625,19866,-4805120,280576,-4524544,46
9365,574,20,10,0.057752289,0.942247711,2831.015241,3394.498801,5000.05307,4479.674216,9939,878.7798408,19878,-4794880,293888,-4500992,46
4216,413,20,10,0.0892201339,0.910779866,1314.175927,1518.33021,2341.158444,2047.968523,4629,130.0646249,9258,-2158592,211456,-1947136,46
4268,429,20,10,0.0913348946,0.908665105,1334.582389,1540.840725,2366.948454,2170.435897,4697,112.7731092,9394,-2185216,219648,-1965568,46
4505,438,21,9,0.0886101558,0.911389844,1398.701449,1688.811416,2466.014206,2533.56621,4943,151.7654283,9886,-2306560,224256,-2082304,46
1234,121,21,9,0.089298893,0.910701107,383.0790414,453.407326,668.102107,778.9421488,1355,93.8365651,2710,-631808,61952,-569856,46
7778,965,20,10,0.110374013,0.889625987,2481.163861,2791.583874,4307.845847,4889.089119,8743,187.4169346,17486,-3982336,494080,-3488256,46
4259,400,20,10,0.0858553338,0.914144666,1317.39637,1609.082295,2331.845738,2310.3475,4659,152.9044962,9318,-2180608,204800,-1975808,46
1491,177,20,10,0.106115108,0.893884892,466.4514846,591.5904959,839.6686787,790.960452,1668,46.42360145,3336,-763392,90624,-672768,46
8435,1353,20,10,0.138230486,0.861769514,2790.103162,2823.467727,4727.830943,5933.563932,9788,191.9592077,19576,-4318720,692736,-3625984,46
4236,418,20,10,0.0898152127,0.910184787,1316.351839,1588.69976,2338.076723,2220.315789,4654,144.0866873,9308,-2168832,214016,-1954816,46
4258,428,20,10,0.0913358942,0.908664106,1328.007225,1577.698612,2344.635275,2332.205607,4686,159.2252803,9372,-2180096,219136,-1960960,46
1189,120,20,10,0.0916730328,0.908326967,370.1750698,437.4673377,646.137931,742.8083333,1309,61.13965437,2618,-608768,61440,-547328,46
4394,401,20,10,0.08362878,0.91637122,1358.684189,1637.879964,2396.906919,2409.977556,4795,158.7748344,9590,-2249728,205312,-2044416,46
1198,123,20,10,0.0931112793,0.906888721,372.6986864,442.0777283,649.6611018,771.4390244,1321,48.12386157,2642,-613376,62976,-550400,46
1216,123,21,9,0.0918595967,0.908140403,378.9060076,443.3190477,660.0682566,768.1869919,1339,106.4387917,2678,-622592,62976,-559616,46
4414,398,20,10,0.0827098919,0.917290108,1362.443471,1653.673386,2414.493883,2317.844221,4812,156.0311284,9624,-2259968,203776,-2056192,46
4315,425,21,9,0.0896624473,0.910337553,1333.559286,1679.827465,2364.527462,2431.138824,4740,125.5629139,9480,-2209280,217600,-1991680,46
4278,429,20,10,0.091140854,0.908859146,1328.260815,1632.038685,2351.109397,2382.825175,4707,83.96361042,9414,-2190336,219648,-1970688,46
1229,122,20,10,0.0903034789,0.909696521,382.1751439,449.4559619,666.0895037,775.8360656,1351,93.36558397,2702,-629248,62464,-566784,46
4232,409,19,11,0.0881275587,0.911872441,1312.275515,1596.284307,2319.002363,2341.669927,4641,151.2711864,9282,-2166784,209408,-1957376,46
2839,252,20,10,0.0815270139,0.918472986,876.318215,975.61816,1580.312434,1159.440476,3091,45.88776722,6182,-1453568,129024,-1324544,46
4641,440,19,11,0.0865971265,0.913402873,1434.428128,1767.683473,2552.464555,2420.075,5081,162.2286079,10162,-2376192,225280,-2150912,46
1213,120,20,10,0.0900225056,0.909977494,375.2476588,462.8538459,658.9596043,748.275,1333,112.4894515,2666,-621056,61440,-559616,46
4644,424,20,10,0.0836621942,0.916337806,1432.659084,1742.522822,2557.031008,2287.721698,5068,169.0460307,10136,-2377728,217088,-2160640,46
4563,412,20,10,0.0828140704,0.91718593,1409.023139,1708.043918,2486.744247,2501.907767,4975,164.1914191,9950,-2336256,210944,-2125312,46
4837,445,21,9,0.0842483908,0.915751609,1497.940167,1777.269315,2660.826339,2431.429213,5282,127.9554264,10564,-2476544,227840,-2248704,46
1209,120,21,9,0.0902934537,0.909706546,375.2154346,450.3781429,656.1058726,754.6083333,1329,101.2185834,2658,-619008,61440,-557568,46
4593,420,20,10,0.0837821664,0.916217834,1416.252612,1743.936375,2519.280427,2372.704762,5013,157.0980884,10026,-2351616,215040,-2136576,46
4572,387,19,11,0.0780399274,0.921960073,1405.136718,1712.93317,2479.889764,2481.302326,4959,123.4503361,9918,-2340864,198144,-2142720,46
1231,124,21,9,0.0915129151,0.908487085,384.0264359,444.882496,668.4289196,773.016129,1355,46.02581522,2710,-630272,63488,-566784,46
5471,509,20,10,0.0851170569,0.914882943,1698.20829,1963.625786,2955.19777,3369.946955,5980,111.4216508,11960,-2801152,260608,-2540544,46
4585,434,20,10,0.0864714086,0.913528591,1414.483362,1770.384512,2516.292475,2443.523041,5019,187.1364653,10038,-2347520,222208,-2125312,46
8117,1302,21,9,0.138231235,0.861768765,2659.333643,2783.833788,4519.013921,5900.655914,9419,184.3248532,18838,-4155904,666624,-3489280,46
4572,420,20,10,0.0841346154,0.915865385,1408.354759,1758.081133,2498.399606,2475.821429,4992,155.1756295,9984,-2340864,215040,-2125824,46
1240,125,20,10,0.0915750916,0.908424908,385.3087753,460.404612,673.0104839,782.096,1365,94.33310297,2730,-634880,64000,-570880,46
4800,424,20,10,0.0811638591,0.918836141,1480.066818,1794.366768,2610.329583,2637.070755,5224,167.75851,10448,-2457600,217088,-2240512,46
4720,415,20,10,0.0808179163,0.919182084,1457.885285,1734.647595,2574.722458,2491.542169,5135,148.23903,10270,-2416640,212480,-2204160,46
8274,1323,20,10,0.13785558,0.86214442,2698.625167,2877.754221,4597.105632,6061.640967,9597,187.2220055,19194,-4236288,677376,-3558912,46
8870,1020,20,10,0.103134479,0.896865521,2870.743876,2713.299977,4937.834611,5012.158824,9890,586.2477771,19780,-4541440,522240,-4019200,46
4497,394,21,9,0.0805561235,0.919443877,1390.884834,1584.776094,2479.03002,2069.005076,4891,91.26702743,9782,-2302464,201728,-2100736,46
4796,425,21,9,0.0814020303,0.91859797,1475.925186,1823.018409,2611.740409,2602.644706,5221,159.9571078,10442,-2455552,217600,-2237952,46
1221,119,21,9,0.0888059701,0.91119403,378.6768389,454.109744,662.4897625,752.6890756,1340,130.3501946,2680,-625152,60928,-564224,46
3936,374,20,10,0.086774942,0.913225058,1221.058193,1465.281162,2152.494411,2187.131016,4310,136.3061354,8620,-2015232,191488,-1823744,46
1215,120,20,10,0.0898876404,0.91011236,377.7884796,443.7118302,658.4337449,764.8583333,1335,104.1341654,2670,-622080,61440,-560640,46
1212,122,20,10,0.0914542729,0.908545727,377.7866764,441.2535243,658.4174917,757.7295082,1334,99.47800149,2668,-620544,62464,-558080,46
1233,122,20,10,0.0900369004,0.9099631,382.5252255,459.305379,668.7923763,771.057377,1355,79.42555686,2710,-631296,62464,-568832,46
2347,228,20,10,0.0885436893,0.911456311,731.5420706,797.2338413,1316.745633,992.0964912,2575,45.63175616,5150,-1201664,116736,-1084928,46
3929,406,19,11,0.093656286,0.906343714,1229.973732,1437.048068,2180.280988,2049.152709,4335,89.32618999,8670,-2011648,207872,-1803776,46
1206,118,20,10,0.0891238671,0.910876133,374.5275834,443.2644474,653.6500829,752.9491525,1324,101.1459129,2648,-617472,60416,-557056,46
1181,121,20,10,0.0929339478,0.907066052,366.8346872,442.8925769,641.5012701,749.0909091,1302,167.5675676,2604,-604672,61952,-542720,46
3919,377,20,10,0.0877560521,0.912243948,1217.018915,1455.99067,2157.143404,2058.649867,4296,96.69142471,8592,-2006528,193024,-1813504,46
7149,789,21,9,0.0993953137,0.900604686,2259.887102,2548.48776,3943.839278,4202.007605,7938,159.9113618,15876,-3660288,403968,-3256320,46
7218,1274,20,10,0.150023552,0.849976448,2409.260073,2510.065377,4094.687725,5106.610675,8492,178.7789474,16984,-3695616,652288,-3043328,46
8504,1253,20,10,0.128420621,0.871579379,2813.513359,2799.325211,4815.202611,5311.987231,9757,175.8018018,19514,-4354048,641536,-3712512,46
3768,382,19,11,0.0920481928,0.907951807,1177.145529,1384.74542,2083.174628,1999.798429,4150,111.2898901,8300,-1929216,195584,-1733632,46
1214,120,20,10,0.0899550225,0.910044978,377.7842508,442.2294528,658.4884679,758.6666667,1334,124.7895229,2668,-621568,61440,-560128,46
3826,374,21,9,0.089047619,0.910952381,1186.612572,1446.86399,2091.015159,2197.529412,4200,120.6203331,8400,-1958912,191488,-1767424,46
6806,1089,20,10,0.137935402,0.862064598,2260.968953,2285.459278,3844.52777,4594.677686,7895,150.9848919,15790,-3484672,557568,-2927104,46
6097,798,20,10,0.115736041,0.884263959,1954.31096,2149.820845,3367.465147,4063.314536,6895,125.7752645,13790,-3121664,408576,-2713088,46
1224,123,21,9,0.0913140312,0.908685969,381.2781615,445.7897964,664.2009804,771.5121951,1347,92.38683128,2694,-626688,62976,-563712,46
3736,379,20,10,0.0921020656,0.907897934,1163.014353,1409.298123,2054.083244,2096.609499,4115,146.9118172,8230,-1912832,194048,-1718784,46
4150,410,21,9,0.0899122807,0.910087719,1292.863719,1533.038849,2275.251566,2333.62439,4560,150.5944518,9120,-2124800,209920,-1914880,46
4355,538,21,9,0.109952994,0.890047006,1385.473536,1613.283935,2454.616303,2385.347584,4893,92.53025719,9786,-2229760,275456,-1954304,46
4176,416,21,9,0.0905923345,0.909407666,1296.763933,1586.143982,2298.267241,2278.759615,4592,163.0681818,9184,-2138112,212992,-1925120,46
4180,415,20,10,0.0903155604,0.90968444,1298.017464,1584.578887,2300.190191,2275.939759,4595,152.5564409,9190,-2140160,212480,-1927680,46
7837,781,20,10,0.0906242748,0.909375725,2463.14611,2715.371338,4290.291693,4502.247119,8618,159.0330319,17236,-4012544,399872,-3612672,46
1491,182,20,10,0.108786611,0.891213389,469.2406991,578.3008541,845.7612341,765.2252747,1673,33.50690967,3346,-763392,93184,-670208,46
1212,120,20,10,0.0900900901,0.90990991,375.8237032,453.8608267,657.7376238,755,1332,64.31675519,2664,-620544,61440,-559104,46
3549,304,20,10,0.0788995588,0.921100441,1098.703661,1222.803357,1951.926176,1636.003289,3853,77.77553492,7706,-1817088,155648,-1661440,46
7618,1294,20,10,0.145197487,0.854802513,2525.227716,2656.622468,4300.641769,5374.064142,8912,175.9178839,17824,-3900416,662528,-3237888,46
1230,122,20,10,0.0902366864,0.909763314,381.2515469,463.1631784,667.9845528,762.352459,1352,130.2504817,2704,-629760,62464,-567296,46
1210,118,20,10,0.0888554217,0.911144578,375.3381509,446.9301244,655.3644628,758.1779661,1328,68.27763496,2656,-619520,60416,-559104,46
1220,121,20,10,0.0902311708,0.909768829,376.1164413,480.9289445,665.6581967,724.8595041,1341,128.3253589,2682,-624640,61952,-562688,46
4147,403,21,9,0.0885714286,0.911428571,1286.338106,1563.471001,2267.921871,2353.48139,4550,161.6915423,9100,-2123264,206336,-1916928,46
7697,1308,21,9,0.145252637,0.854747363,2548.399511,2633.532869,4319.066779,5585.365443,9005,184.3020876,18010,-3940864,669696,-3271168,46
4183,406,21,9,0.0884724341,0.911527566,1298.183684,1568.58884,2284.923261,2398.820197,4589,149.0903184,9178,-2141696,207872,-1933824,46
7647,1197,20,10,0.135345997,0.864654003,2521.645015,2623.794246,4305.003138,5173.125313,8844,191.1389669,17688,-3915264,612864,-3302400,46
2375,203,21,9,0.0787432118,0.921256788,726.0864582,919.0605128,1301.339789,1150.980296,2578,59.96743429,5156,-1216000,103936,-1112064,46
4331,428,20,10,0.0899348603,0.91006514,1346.673677,1615.046747,2395.160009,2226.593458,4759,116.9574834,9518,-2217472,219136,-1998336,46
1239,125,20,10,0.0916422287,0.908357771,385.2863619,459.9939211,673.4681195,772.024,1364,120.4946996,2728,-634368,64000,-570368,46
1506,184,20,10,0.10887574,0.89112426,471.9041161,600.2670691,851.8545817,793.4891304,1690,39.29318763,3380,-771072,94208,-676864,46
4731,447,20,10,0.0863267671,0.913673233,1458.948731,1820.095327,2571.195942,2783.228188,5178,155.4021609,10356,-2422272,228864,-2193408,46
4678,412,20,10,0.0809430255,0.919056974,1440.347436,1715.132083,2510.106456,2947.371359,5090,182.6992103,10180,-2395136,210944,-2184192,46
4732,430,21,9,0.0833010461,0.916698954,1463.95688,1725.921072,2554.977177,2873.374419,5162,171.6090426,10324,-2422784,220160,-2202624,46
1231,121,20,10,0.0894970414,0.910502959,382.5000927,450.5310129,666.8521527,774.6528926,1352,104.4015444,2704,-630272,61952,-568320,46
4766,417,20,10,0.0804553347,0.919544665,1468.062865,1753.01563,2563.064834,2922.707434,5183,175.9334691,10366,-2440192,213504,-2226688,46
4720,425,20,10,0.0826044704,0.91739553,1457.565948,1713.182634,2536.904661,2973.870588,5145,176.1383088,10290,-2416640,217600,-2199040,46
4748,427,20,10,0.0825120773,0.917487923,1468.670915,1699.969229,2552.199874,2986.077283,5175,170.0624384,10350,-2430976,218624,-2212352,46
8843,1040,19,11,0.105231205,0.894768795,2901.243473,2398.539832,4924.448264,5091.240385,9883,306.9254658,19766,-4527616,532480,-3995136,46
1211,121,20,10,0.0908408408,0.909159159,376.9906948,441.4345477,656.8150289,763.4297521,1332,139.6226415,2664,-620032,61952,-558080,46
1265,122,20,10,0.0879596251,0.912040375,392.0965972,466.2481003,684.2988142,794.5901639,1387,128.9033457,2774,-647680,62464,-585216,46
1223,124,20,10,0.0920564217,0.907943578,380.8933768,447.2918036,663.6394113,776.1854839,1347,106.5664557,2694,-626176,63488,-562688,46
3800,283,21,9,0.0693117806,0.930688219,1160.099598,1380.776239,2060.399211,1794.943463,4083,228.6114222,8166,-1945600,144896,-1800704,46
8780,1109,20,10,0.112144807,0.887855193,2908.693266,2366.922577,4910.555695,5217.697024,9889,298.4907938,19778,-4495360,567808,-3927552,46
1501,178,21,9,0.106015485,0.893984515,469.2766158,597.574027,844.7301799,800.1123596,1679,53.40330789,3358,-768512,91136,-677376,46
4759,429,20,10,0.082690825,0.917309175,1476.284298,1683.559742,2565.435596,2916.918415,5188,163.556116,10376,-2436608,219648,-2216960,46
44,21,20,10,0.323076923,0.676923077,18.84137515,18.58912466,33.15909091,32.66666667,65,2.632644795,130,-22528,10752,-11776,46
4744,443,21,9,0.0854058222,0.914594178,1472.4985,1709.325694,2564.259486,2912.485327,5187,141.2966494,10374,-2428928,226816,-2202112,46
1211,119,20,10,0.0894736842,0.910526316,375.3968164,451.7751485,656.4541701,757.5546218,1330,136.9721936,2660,-620032,60928,-559104,46
4742,445,20,10,0.0857914016,0.914208598,1470.508438,1741.758563,2572.483973,2823.278652,5187,163.5761589,10374,-2427904,227840,-2200064,46
4706,411,21,9,0.0803205003,0.9196795,1454.030603,1670.606993,2524.772206,2950.912409,5117,145.9498003,10234,-2409472,210432,-2199040,46
9443,536,20,10,0.0537127969,0.946287203,2850.627845,3057.376608,5067.816796,3619.059701,9979,755.4125662,19958,-4834816,274432,-4560384,46
9454,525,20,10,0.052610482,0.947389518,2856.382843,2950.637557,5068.38809,3578.417143,9979,446.687556,19958,-4840448,268800,-4571648,46
9489,494,20,10,0.049484123,0.950515877,2864.6347,2995.822286,5048.282748,3910.892713,9983,836.7979883,19966,-4858368,252928,-4605440,46
9465,513,21,9,0.0514131088,0.948586891,2856.955412,3011.61893,5058.502166,3716.389864,9978,898.9189189,19956,-4846080,262656,-4583424,46
1223,123,20,10,0.0913818722,0.908618128,380.1777832,450.8465087,663.1046607,776.8617886,1346,153.4777651,2692,-626176,62976,-563200,46
1220,119,20,10,0.0888722928,0.911127707,378.0428294,455.5289137,661.4278689,757.8823529,1339,106.185567,2678,-624640,60928,-563712,46
9469,510,20,10,0.0511073254,0.948892675,2856.061739,2995.803123,5063.201394,3630.894118,9979,1077.645788,19958,-4848128,261120,-4587008,46
9479,500,20,10,0.050105221,0.949894779,2856.783618,3014.011192,5059.247494,3677.206,9979,1133.977273,19958,-4853248,256000,-4597248,46
1240,123,20,10,0.090242113,0.909757887,385.4045952,454.4715031,671.8306452,784.5203252,1363,85.02807236,2726,-634880,62976,-571904,46
2675,236,19,11,0.0810717966,0.918928203,825.4132384,886.6216855,1493.988411,1025.411017,2911,51.90798859,5822,-1369600,120832,-1248768,46
9487,492,20,10,0.0493035374,0.950696463,2858.445051,3016.024504,5055.220301,3732.388211,9979,1024.537988,19958,-4857344,251904,-4605440,46
9451,528,20,10,0.0529111133,0.947088887,2856.287497,2954.017127,5068.373505,3587.143939,9979,1100.220507,19958,-4838912,270336,-4568576,46
1220,120,20,10,0.0895522388,0.910447761,378.0929516,458.6559822,662.552459,751.3,1340,81.6575259,2680,-624640,61440,-563200,46
9489,490,20,10,0.0491031165,0.950896883,2867.25384,2946.096433,5043.156813,3960.602041,9979,839.2767031,19958,-4858368,250880,-4607488,46
9431,548,20,10,0.0549153222,0.945084678,2853.8042,2943.054974,5075.483512,3518.841241,9979,659.9867725,19958,-4828672,280576,-4548096,46
9473,506,21,9,0.0507064836,0.949293516,2853.961241,3069.101271,5058.817165,3701.650198,9979,593.9880952,19958,-4850176,259072,-4591104,46
1225,119,21,9,0.0885416667,0.911458333,379.7615716,456.0358211,664.4653061,755.210084,1344,136.8635438,2688,-627200,60928,-566272,46
9490,488,20,10,0.0489075967,0.951092403,2855.428124,3066.852679,5054.435406,3726.719262,9978,800.1603849,19956,-4858880,249856,-4609024,46
1227,126,20,10,0.0931263858,0.906873614,380.6186352,464.8359161,666.6193969,778.0873016,1353,117.5499566,2706,-628224,64512,-563712,46
843,60,20,10,0.0664451827,0.933554817,255.7127339,319.4565698,454.9893238,410,903,13.68596544,1806,-431616,30720,-400896,46
8052,1249,21,9,0.134286636,0.865713364,2672.577691,2614.083977,4521.625186,5485.048038,9301,167.7064551,18602,-4122624,639488,-3483136,46
4350,439,20,10,0.0916684068,0.908331593,1351.602945,1648.321477,2411.757011,2228.95672,4789,117.4350172,9578,-2227200,224768,-2002432,46
1233,130,21,9,0.095377843,0.904622157,382.8532488,462.5037211,668.1654501,813.2153846,1363,23.86204482,2726,-631296,66560,-564736,46
4257,439,21,9,0.093483816,0.906516184,1325.783999,1605.353458,2367.203195,2167.134396,4696,120.502951,9392,-2179584,224768,-1954816,46
40,30,19,11,0.428571429,0.571428571,16.85014837,22.16977422,30.35,42.36666667,70,1.816766156,140,-20480,15360,-5120,46
3012,270,20,10,0.0822669104,0.91773309,935.4610635,960.6215476,1682.34927,1185.803704,3282,57.27748691,6564,-1542144,138240,-1403904,46
4177,417,20,10,0.0907705703,0.90922943,1298.037451,1579.669142,2302.689011,2245.522782,4594,135.7565012,9188,-2138624,213504,-1925120,46
4324,403,20,10,0.0852549186,0.914745081,1333.344798,1659.506066,2354.27914,2468.300248,4727,121.2984347,9454,-2213888,206336,-2007552,46
4195,402,20,10,0.0874483359,0.912551664,1299.85807,1583.02725,2300.200954,2286.467662,4597,144.6962543,9194,-2147840,205824,-1942016,46
4203,423,20,10,0.0914396887,0.908560311,1305.260638,1601.663439,2322.646681,2222.617021,4626,164.3339254,9252,-2151936,216576,-1935360,46
4117,407,20,10,0.0899646331,0.910035367,1279.061782,1552.11448,2262.778965,2259.678133,4524,151.0517529,9048,-2107904,208384,-1899520,46
4196,425,20,10,0.0919714348,0.908028565,1305.67398,1585.131694,2317.249523,2249.298824,4621,149.6437824,9242,-2148352,217600,-1930752,46
4378,402,20,10,0.0841004184,0.915899582,1349.722446,1672.94743,2393.767245,2354.91791,4780,149.7493734,9560,-2241536,205824,-2035712,46
1224,119,20,10,0.0886075949,0.911392405,379.4213252,452.7998747,662.4787582,769.9327731,1343,105.3333333,2686,-626688,60928,-565760,46
1236,122,21,9,0.0898379971,0.910162003,383.5844935,459.0375581,670.4409385,771.2786885,1358,139.5683453,2716,-632832,62464,-570368,46
5360,614,20,10,0.102778708,0.897221292,1691.840692,1968.530731,2957.919963,3245.723127,5974,148.1279445,11948,-2744320,314368,-2429952,46
4201,425,20,10,0.0918720277,0.908127972,1302.998921,1620.340783,2318.890502,2260.216471,4626,135.0262697,9252,-2150912,217600,-1933312,46
1224,123,19,11,0.0913140312,0.908685969,383.8469697,430.7740615,667.8905229,734.796748,1347,159.0318772,2694,-626688,62976,-563712,46
1233,125,20,10,0.0920471281,0.907952872,384.5966538,447.5601009,669.7234388,775.936,1358,43.12480152,2716,-631296,64000,-567296,46
1239,126,20,10,0.0923076923,0.907692308,385.6883894,456.1031859,672.7078289,784.2063492,1365,105.2428682,2730,-634368,64512,-569856,46
8781,624,23,7,0.0663476874,0.933652313,2665.468549,3254.743691,4653.140189,5404.633013,9405,204.6344648,18810,-4495872,319488,-4176384,46
8922,550,23,7,0.0580658784,0.941934122,2699.131158,3252.271681,4739.05111,4695.116364,9472,298.4247007,18944,-4568064,281600,-4286464,46
1199,117,22,8,0.0889057751,0.911094225,373.636009,410.5746268,644.0425354,806.6581197,1316,33.70038412,2632,-613888,59904,-553984,46
8371,529,23,7,0.0594382022,0.940561798,2531.016576,3111.757766,4451.289332,4438.009452,8900,219.9159872,17800,-4285952,270848,-4015104,46
1208,116,22,8,0.0876132931,0.912386707,376.1706934,412.8989456,648.5115894,808.1724138,1324,125.1417769,2648,-618496,59392,-559104,46
8291,520,23,7,0.0590171377,0.940982862,2511.24982,3010.820051,4401.715475,4474.313462,8811,259.1470588,17622,-4244992,266240,-3978752,46
9309,630,23,7,0.0633866586,0.936613341,2820.562426,3480.246446,4940.413041,5407.18254,9939,644.9707982,19878,-4766208,322560,-4443648,46
9175,751,22,8,0.0756598831,0.924340117,2800.108266,3377.639973,4873.069428,6068.294274,9926,540.0435256,19852,-4697600,384512,-4313088,46
8958,541,23,7,0.0569533635,0.943046636,2698.745722,3374.727238,4738.48292,4940.702403,9499,273.8253099,18998,-4586496,276992,-4309504,46
1199,113,22,8,0.0861280488,0.913871951,372.3905098,414.4771929,643.0542118,799.1681416,1312,102.7407987,2624,-613888,57856,-556032,46
8687,549,23,7,0.0594413166,0.940558683,2625.8027,3218.462407,4596.131921,4972.437158,9236,215.9457564,18472,-4447744,281088,-4166656,46
9156,765,23,7,0.0771091624,0.922890838,2789.501886,3374.901974,4851.844037,6267.447059,9921,479.5070082,19842,-4687872,391680,-4296192,46
8892,538,23,7,0.0570519618,0.942948038,2684.089226,3287.395627,4709.805893,4809.611524,9430,284.6362813,18860,-4552704,275456,-4277248,46
8948,547,23,7,0.057609268,0.942390732,2699.530872,3345.22314,4741.944569,4847.056673,9495,293.5992579,18990,-4581376,280064,-4301312,46
8655,540,23,7,0.0587275693,0.941272431,2612.487427,3213.481381,4567.457886,5087.522222,9195,232.2556201,18390,-4431360,276480,-4154880,46
8653,553,23,7,0.0600695199,0.93993048,2618.751356,3197.024228,4590.46793,4807.417722,9206,256.077886,18412,-4430336,283136,-4147200,46
8664,535,23,7,0.0581584955,0.941841505,2613.826511,3224.602779,4572.418975,5046.657944,9199,212.6444753,18398,-4435968,273920,-4162048,46
8645,533,23,7,0.0580736544,0.941926346,2609.696022,3209.824964,4569.780914,4909.333959,9178,250.7650273,18356,-4426240,272896,-4153344,46
1217,113,22,8,0.084962406,0.915037594,377.1975057,429.0892655,653.4050945,795.7610619,1330,132.3383085,2660,-623104,57856,-565248,46
8656,541,23,7,0.0588235294,0.941176471,2610.301691,3230.654362,4561.990873,5191.146026,9197,224.3170732,18394,-4431872,276992,-4154880,46
5475,543,24,6,0.0902293121,0.909770688,1719.810554,1856.389775,2969.407306,3413.74954,6018,284.6736045,12036,-2803200,278016,-2525184,47
4096,278,22,8,0.0635573845,0.936442615,1247.872288,1436.9575,2169.315674,2455.42446,4374,371.9387755,8748,-2097152,142336,-1954816,47
5458,530,23,7,0.088510354,0.911489646,1713.661868,1795.153127,2944.18908,3512.607547,5988,151.4415781,11976,-2794496,271360,-2523136,47
5380,588,24,6,0.0985254692,0.901474531,1687.566535,1863.285952,2904.383086,3717.542517,5968,104.4086774,11936,-2754560,301056,-2453504,47
4182,333,24,6,0.0737541528,0.926245847,1280.286523,1564.222542,2260.308226,2229.012012,4515,289.6087235,9030,-2141184,170496,-1970688,47
4099,280,24,6,0.0639415392,0.936058461,1251.066195,1417.456024,2172.638936,2444.153571,4379,377.1748493,8758,-2098688,143360,-1955328,47
4145,317,24,6,0.0710443747,0.928955625,1268.134592,1521.491438,2223.962847,2330.053628,4462,460.9504132,8924,-2122240,162304,-1959936,47
4129,311,23,7,0.070045045,0.929954955,1262.150157,1516.497346,2215.963914,2280.723473,4440,363.0417007,8880,-2114048,159232,-1954816,47
4202,327,22,8,0.072201369,0.927798631,1286.476826,1547.017469,2256.198715,2378.097859,4529,262.5507246,9058,-2151424,167424,-1984000,47
4127,317,23,7,0.0713321332,0.928667867,1263.510445,1509.263667,2215.190453,2317.662461,4444,451.1675127,8888,-2113024,162304,-1950720,47
4101,275,24,6,0.0628427788,0.937157221,1252.165577,1385.912818,2168.967569,2479.781818,4376,334.3009931,8752,-2099712,140800,-1958912,47
3917,299,22,8,0.0709203036,0.929079696,1194.501396,1480.68043,2105.843758,2143.297659,4216,252.15311,8432,-2005504,153088,-1852416,47
3850,305,24,6,0.0734055355,0.926594465,1175.533974,1461.804043,2067.58961,2209.409836,4155,243.4094903,8310,-1971200,156160,-1815040,47
3848,306,23,7,0.0736639384,0.926336062,1174.84835,1463.678151,2066.328482,2217.98366,4154,207.2854291,8308,-1970176,156672,-1813504,47
3368,184,22,8,0.0518018018,0.948198198,1011.372927,1115.926366,1806.970903,1218.75,3552,65.7899611,7104,-1724416,94208,-1630208,47
4320,336,23,7,0.0721649485,0.927835052,1326.182711,1550.996857,2319.297454,2446.818452,4656,174.6436609,9312,-2211840,172032,-2039808,47
4261,339,24,6,0.0736956522,0.926304348,1306.275654,1568.5205,2289.878667,2434.00295,4600,169.1176471,9200,-2181632,173568,-2008064,47
3953,290,24,6,0.0683478671,0.931652133,1204.256942,1469.812095,2111.564129,2264.251724,4243,236.906756,8486,-2023936,148480,-1875456,47
4254,320,23,7,0.0699606471,0.930039353,1301.501994,1541.313324,2275.690879,2444.4875,4574,414.3115942,9148,-2178048,163840,-2014208,47
4138,326,22,8,0.0730286738,0.926971326,1267.552457,1521.671465,2219.466167,2397.941718,4464,79.52966328,8928,-2118656,166912,-1951744,47
3332,238,24,6,0.0666666667,0.933333333,1012.31423,1257.83175,1782.366747,1829.365546,3570,232.2706571,7140,-1705984,121856,-1584128,47
3382,229,23,7,0.0634173359,0.936582664,1025.989869,1256.821456,1799.968066,1895.082969,3611,347.8805395,7222,-1731584,117248,-1614336,47
2514,153,24,6,0.057367829,0.942632171,761.2706821,845.97595,1352.124105,1036.196078,2667,113.7313433,5334,-1287168,78336,-1208832,47
3181,223,23,7,0.0655111633,0.934488837,961.5621503,1244.637808,1700.03961,1737.596413,3404,223.2131148,6808,-1628672,114176,-1514496,47
2970,196,22,8,0.0619077701,0.93809223,899.2297472,1087.822778,1598.659933,1353.780612,3166,55.47573156,6332,-1520640,100352,-1420288,47
3065,205,23,7,0.0626911315,0.937308869,925.7925361,1182.164194,1638.131485,1596.156098,3270,273.8693467,6540,-1569280,104960,-1464320,47
3205,219,24,6,0.0639602804,0.93603972,966.6070641,1264.320035,1709.080187,1762.547945,3424,215.6171285,6848,-1640960,112128,-1528832,47
3356,234,23,7,0.0651810585,0.934818942,1019.216279,1256.110387,1797.757449,1763.123932,3590,247.0750172,7180,-1718272,119808,-1598464,47
2842,159,24,6,0.0529823392,0.947017661,858.1695264,909.2205708,1523.766714,1094.062893,3001,86.06251792,6002,-1455104,81408,-1373696,47
3331,239,22,8,0.0669467787,0.933053221,1012.615676,1254.286271,1784.740018,1796.09205,3570,325.136612,7140,-1705472,122368,-1583104,47
3466,244,24,6,0.0657681941,0.934231806,1055.981842,1263.354866,1859.925563,1792.635246,3710,330.3650935,7420,-1774592,124928,-1649664,47
3341,253,23,7,0.0703951029,0.929604897,1017.658798,1270.12887,1794.569291,1836.201581,3594,330.9392265,7188,-1710592,129536,-1581056,47
2807,150,23,7,0.0507270883,0.949272912,844.1525942,942.8472625,1498.497328,1114.14,2957,375.2538071,5914,-1437184,76800,-1360384,47
3325,225,24,6,0.0633802817,0.936619718,1009.24057,1229.809025,1770.69985,1846.435556,3550,299.5780591,7100,-1702400,115200,-1587200,47
3446,234,24,6,0.0635869565,0.936413043,1047.119496,1265.21592,1841.156123,1830.837607,3680,87.55650726,7360,-1764352,119808,-1644544,47
4625,453,22,8,0.0892083497,0.91079165,1446.715423,1588.020856,2497.980757,2963.399558,5078,225.1884701,10156,-2368000,231936,-2136064,47
3156,210,23,7,0.0623885918,0.937611408,952.8378748,1220.126198,1684.843156,1663.314286,3366,306.8368277,6732,-1615872,107520,-1508352,47
3435,212,22,8,0.0581299698,0.94187003,1038.145004,1256.442714,1814.309753,1981.009434,3647,166.9107551,7294,-1758720,108544,-1650176,47
4752,429,23,7,0.0828025478,0.917197452,1480.560305,1533.34961,2537.534722,3183.230769,5181,205.1068884,10362,-2433024,219648,-2213376,47
2796,152,23,7,0.0515603799,0.94843962,842.3419264,910.1654183,1496.067954,1077.763158,2948,44.25097568,5896,-1431552,77824,-1353728,47
1510,212,24,6,0.12311266,0.87688734,476.343135,620.3454472,851.1602649,935.1462264,1722,158.1267218,3444,-773120,108544,-664576,47
1506,209,24,6,0.121865889,0.878134111,472.3897819,634.9389152,856.5763612,868.2583732,1715,165.22158,3430,-771072,107008,-664064,47
1469,211,24,6,0.125595238,0.874404762,463.9772971,611.4799596,840.0422056,843.6872038,1680,77.59815242,3360,-752128,108032,-644096,47
974,101,23,7,0.0939534884,0.906046512,301.5906605,326.3554693,558.0687885,344.4653465,1075,89.80785297,2150,-498688,51712,-446976,47
36,26,24,6,0.419354839,0.580645161,12.22332697,18.7046493,23.58333333,42.46153846,62,3.679525223,124,-18432,13312,-5120,47
1489,200,23,7,0.118413262,0.881586738,465.1127322,629.5303468,841.6218939,870.15,1689,134.5816733,3378,-762368,102400,-659968,47
1510,214,24,6,0.12412993,0.87587007,477.2430926,621.0814684,855.8708609,909.2757009,1724,164.1904762,3448,-773120,109568,-663552,47
1557,219,24,6,0.123310811,0.876689189,491.6061495,633.2456847,873.8542068,992.6255708,1776,125.3352152,3552,-797184,112128,-685056,47
1521,208,24,6,0.120300752,0.879699248,480.1002591,619.7560689,860.5410914,897.6057692,1729,58.92978868,3458,-778752,106496,-672256,47
1503,212,24,6,0.12361516,0.87638484,474.7802325,618.5983948,852.091151,899.8915094,1715,132.7399381,3430,-769536,108544,-660992,47
1510,202,23,7,0.117990654,0.882009346,475.599448,615.4615221,854.0390728,874.8960396,1712,211.6192831,3424,-773120,103424,-669696,47
1518,213,23,7,0.12305026,0.87694974,477.9367318,632.8500985,862.2694335,892.5868545,1731,139.5967742,3462,-777216,109056,-668160,47
1488,210,23,7,0.123674912,0.876325088,471.1681644,605.5922332,842.3084677,900.4571429,1698,148.8168273,3396,-761856,107520,-654336,47
1224,135,23,7,0.0993377483,0.900662252,379.3227999,442.4641156,703.1674837,469.9481481,1359,42.42897284,2718,-626688,69120,-557568,47
1506,213,24,6,0.12390925,0.87609075,478.0296868,608.3505017,854.7961487,896.7934272,1719,131.1212815,3438,-771072,109056,-662016,47
1504,213,24,6,0.124053582,0.875946418,474.8570439,619.066643,849.668883,924.8873239,1717,145.6318914,3434,-770048,109056,-660992,47
1492,218,23,7,0.12748538,0.87251462,471.5579461,623.1429186,850.7707775,887.8669725,1710,114.3812709,3420,-763904,111616,-652288,47
1524,208,23,7,0.120092379,0.879907621,478.4972272,635.6402415,866.5360892,866.2355769,1732,116.2416107,3464,-780288,106496,-673792,47
1543,238,22,8,0.133632791,0.866367209,493.6013561,631.1507062,889.5560596,900.3613445,1781,79.33184855,3562,-790016,121856,-668160,47
1513,205,23,7,0.119324796,0.880675204,476.0706762,623.2460364,858.2723067,868.5609756,1718,100.8807986,3436,-774656,104960,-669696,47
3013,209,23,7,0.0648665425,0.935133457,910.7511641,1173.563871,1614.216064,1572.344498,3222,275.6201882,6444,-1542656,107008,-1435648,47
3471,207,24,6,0.0562805873,0.943719413,1049.185143,1238.516132,1828.201671,2028.951691,3678,181.6296296,7356,-1777152,105984,-1671168,47
4664,472,23,7,0.0919003115,0.908099688,1462.499959,1618.021121,2529.184605,2956.989407,5136,169.0029615,10272,-2387968,241664,-2146304,47
3301,247,23,7,0.0696166855,0.930383315,1003.505838,1268.967127,1773.902757,1782.481781,3548,287.0550162,7096,-1690112,126464,-1563648,47
3025,215,23,7,0.0663580247,0.933641975,916.3341822,1169.515666,1623.000992,1585.311628,3240,158.6679726,6480,-1548800,110080,-1438720,47
3048,208,23,7,0.0638820639,0.936117936,921.6764203,1175.289388,1628.379593,1630.264423,3256,271.7863105,6512,-1560576,106496,-1454080,47
3438,248,23,7,0.0672816061,0.932718394,1047.705327,1266.616679,1837.848168,1921.850806,3686,196.0638298,7372,-1760256,126976,-1633280,47
3285,240,23,7,0.0680851064,0.931914894,998.2118374,1252.937382,1762.924505,1764.033333,3525,379.4402583,7050,-1681920,122880,-1559040,47
3020,210,22,8,0.0650154799,0.93498452,913.4360236,1170.430795,1611.550662,1672.295238,3230,185.206422,6460,-1546240,107520,-1438720,47
3418,252,24,6,0.0686648501,0.93133515,1041.227755,1280.693649,1833.165594,1867.162698,3670,289.4321767,7340,-1750016,129024,-1620992,47
4686,438,23,7,0.0854800937,0.914519906,1464.944558,1475.551133,2501.953905,3210.260274,5124,92.15827338,10248,-2399232,224256,-2174976,47
3300,255,24,6,0.0717299578,0.928270042,1002.499975,1284.86759,1766.096667,1932.043137,3555,62.1177704,7110,-1689600,130560,-1559040,47
3363,203,23,7,0.0569265283,0.943073472,1015.622832,1222.963367,1773.12251,1955.418719,3566,137.3651772,7132,-1721856,103936,-1617920,47
3289,236,23,7,0.0669503546,0.933049645,999.6585117,1240.662153,1762.511402,1769.809322,3525,344.5747801,7050,-1683968,120832,-1563136,47
3285,241,24,6,0.0683494044,0.931650596,996.8932471,1265.252705,1755.996956,1865.771784,3526,62.5177305,7052,-1681920,123392,-1558528,47
2997,207,23,7,0.0646067416,0.935393258,905.7192056,1168.008018,1602.452786,1603.183575,3204,281.5465729,6408,-1534464,105984,-1428480,47
3136,219,22,8,0.0652757079,0.934724292,947.0289126,1235.582089,1676.610651,1697.894977,3355,234.6153846,6710,-1605632,112128,-1493504,47
3363,205,23,7,0.057455157,0.942544843,1014.281176,1239.119936,1770.956289,2006.682927,3568,232.7462492,7136,-1721856,104960,-1616896,47
3003,215,22,8,0.0668116843,0.933188316,908.7279148,1172.58641,1615.378621,1527.390698,3218,307.9425837,6436,-1537536,110080,-1427456,47
4584,467,23,7,0.0924569392,0.907543061,1438.897309,1563.4596,2479.694154,2980.531049,5051,91.47048171,10102,-2347008,239104,-2107904,47
9594,386,20,10,0.0386773547,0.961322645,2869.918981,3095.792877,5011.991974,4456.318653,9980,1077.75378,19960,-4912128,197632,-4714496,47
9597,384,19,11,0.0384730989,0.961526901,2868.917429,3128.021744,5012.196416,4461.255208,9981,1392.050209,19962,-4913664,196608,-4717056,47
9599,381,20,10,0.0381763527,0.961823647,2871.592014,3074.939556,5008.128243,4546.370079,9980,1122.609674,19960,-4914688,195072,-4719616,47
9604,377,20,10,0.0377717664,0.962228234,2873.476344,3018.086706,5013.283424,4423.334218,9981,229.712313,19962,-4917248,193024,-4724224,47
9600,380,19,11,0.0380761523,0.961923848,2873.952229,3016.157564,5008.884896,4526.039474,9980,844.3316413,19960,-4915200,194560,-4720640,47
9577,403,20,10,0.0403807615,0.959619238,2868.175555,3012.652704,5031.162577,4024.183623,9980,531.9829424,19960,-4903424,206336,-4697088,47
9603,377,20,10,0.0377755511,0.962224449,2872.36521,3050.095486,5010.103405,4491.159151,9980,989.0981169,19960,-4916736,193024,-4723712,47
9617,364,20,10,0.0364692917,0.963530708,2871.285687,3106.787037,5006.160029,4590.467033,9981,954.206501,19962,-4923904,186368,-4737536,47
9585,395,19,11,0.0395791583,0.960420842,2870.095731,3058.314238,5018.051539,4321.939241,9980,768.2832948,19960,-4907520,202240,-4705280,47
9590,390,20,10,0.0390781563,0.960921844,2870.022717,3038.902109,5021.745777,4222.174359,9980,985.1924975,19960,-4910080,199680,-4710400,47
9597,383,20,10,0.0383767535,0.961623246,2871.610646,3054.323043,5012.685735,4434.582245,9980,946.8690702,19960,-4913664,196096,-4717568,47
9596,384,20,10,0.0384769539,0.961523046,2867.932324,3149.861348,5010.219883,4497.708333,9980,1309.711286,19960,-4913152,196608,-4716544,47
9609,372,20,10,0.0372708145,0.962729185,2871.884003,3039.990787,5016.607451,4329.543011,9981,683.1622177,19962,-4919808,190464,-4729344,47
9600,381,20,10,0.0381725278,0.961827472,2869.955166,3088.832395,5015.615833,4370.75853,9981,1542.658423,19962,-4915200,195072,-4720128,47
9605,376,20,10,0.037671576,0.962328424,2870.896179,3098.790554,5009.13493,4527.739362,9981,1457.080292,19962,-4917760,192512,-4725248,47
9603,378,20,10,0.0378719567,0.962128043,2869.456398,3126.41757,5010.405811,4498,9981,1775.978648,19962,-4916736,193536,-4723200,47
9591,389,19,11,0.0389779559,0.961022044,2870.073822,3070.911801,5016.134605,4358.465296,9980,873.9054291,19960,-4910592,199168,-4711424,47
6840,291,20,10,0.0408077408,0.959192259,2048.049074,2183.138341,3594.998977,2884.37457,7131,125.6342495,14262,-3502080,148992,-3353088,47
9588,392,20,10,0.0392785571,0.960721443,2870.127107,3082.603975,5013.307676,4432.642857,9980,1021.494371,19960,-4909056,200704,-4708352,47
9599,381,20,10,0.0381763527,0.961823647,2870.701107,3093.387374,5008.765601,4530.312336,9980,1185.273159,19960,-4914688,195072,-4719616,47
3785,295,24,6,0.0723039216,0.927696078,1158.496,1377.033372,2020.714399,2294.359322,4080,347.826087,8160,-1937920,151040,-1786880,47
3624,281,24,6,0.0719590269,0.928040973,1104.335991,1381.829393,1942.037528,2094.380783,3905,371.1977186,7810,-1855488,143872,-1711616,47
3537,277,23,7,0.0726271631,0.927372837,1080.744567,1322.195839,1894.768731,2070.064982,3814,196.6993296,7628,-1810944,141824,-1669120,47
3866,307,24,6,0.0735681764,0.926431824,1183.993031,1427.727564,2072.93792,2264.081433,4173,309.1111111,8346,-1979392,157184,-1822208,47
3815,309,23,7,0.0749272551,0.925072745,1166.961287,1442.917712,2051.407864,2199.446602,4124,281.8865345,8248,-1953280,158208,-1795072,47
2823,175,22,8,0.0583722482,0.941627752,850.6038158,976.8485135,1526.781792,1059.405714,2998,237.3713381,5996,-1445376,89600,-1355776,47
3819,316,23,7,0.0764207981,0.923579202,1171.788082,1420.792423,2053.819586,2239.376582,4135,208.4173387,8270,-1955328,161792,-1793536,47
2543,145,24,6,0.0539434524,0.946056548,764.8967944,867.669297,1365.849784,970.0689655,2688,143.4364995,5376,-1302016,74240,-1227776,47
3333,206,24,6,0.0582085335,0.941791467,1006.947478,1228.425504,1777.656766,1646.116505,3539,287.4898457,7078,-1706496,105472,-1601024,47
5118,543,23,7,0.0959194489,0.904080551,1618.286801,1702.145474,2779.482024,3316.578269,5661,108.907272,11322,-2620416,278016,-2342400,47
3855,331,23,7,0.0790731008,0.920926899,1183.765131,1460.433589,2083.918807,2205.087613,4186,328.8295365,8372,-1973760,169472,-1804288,47
232,67,24,6,0.224080268,0.775919732,87.58709261,65.62509544,162.4008621,107.0597015,299,14.51456311,598,-118784,34304,-84480,47
3492,264,24,6,0.0702875399,0.92971246,1064.540084,1305.96714,1865.731672,2047.390152,3756,274.5614035,7512,-1787904,135168,-1652736,47
3537,285,24,6,0.0745682889,0.925431711,1081.125777,1332.277181,1895.253039,2113.133333,3822,157.1546053,7644,-1810944,145920,-1665024,47
5067,485,24,6,0.0873559078,0.912644092,1594.942646,1518.089541,2710.301756,3468.101031,5552,197.509783,11104,-2594304,248320,-2345984,47
3506,289,23,7,0.0761528327,0.923847167,1071.646267,1343.927913,1886.3166,2039.737024,3795,327.7202073,7590,-1795072,147968,-1647104,47
2666,157,24,6,0.0556145944,0.944385406,802.4218706,930.3090977,1433.577269,1045.598726,2823,149.0496304,5646,-1364992,80384,-1284608,47
3844,324,23,7,0.0777351248,0.922264875,1182.632269,1422.42397,2077.960978,2162.080247,4168,203.4163006,8336,-1968128,165888,-1802240,47
3749,263,25,5,0.06555334,0.93444666,1142.89945,1304.727976,1981.14964,2367.863118,4012,264.993395,8024,-1919488,134656,-1784832,47
2673,159,23,7,0.0561440678,0.943855932,802.8437504,940.5051464,1441.276094,999.9811321,2832,38.9385398,5664,-1368576,81408,-1287168,47
3560,280,22,8,0.0729166667,0.927083333,1084.450054,1374.41008,1912.664888,2020.117857,3840,239.8500937,7680,-1822720,143360,-1679360,47
3581,300,24,6,0.077299665,0.922700335,1098.448744,1342.245685,1926.257191,2116.98,3881,369.9714013,7762,-1833472,153600,-1679872,47
3617,262,24,6,0.0675431812,0.932456819,1104.098365,1249.536878,1910.847387,2342.461832,3879,273.3615222,7758,-1851904,134144,-1717760,47
4913,518,23,7,0.0953783834,0.904621617,1551.005455,1643.043848,2665.359047,3196.30695,5431,102.5103813,10862,-2515456,265216,-2250240,47
3322,276,23,7,0.0767092829,0.923290717,1012.957328,1301.589759,1788.441902,1932.597826,3598,360.8826479,7196,-1700864,141312,-1559552,47
4810,487,23,7,0.0919388333,0.908061167,1519.012221,1497.956772,2588.104158,3250.455852,5297,212.3046092,10594,-2462720,249344,-2213376,47
3308,274,24,6,0.076493579,0.923506421,1009.058956,1286.261327,1777.529021,1960.171533,3582,264.9408284,7164,-1693696,140288,-1553408,47
3564,258,24,6,0.0675039246,0.932496075,1087.852041,1243.217877,1885.362795,2272.55814,3822,306.9879518,7644,-1824768,132096,-1692672,47
4050,313,24,6,0.0717396287,0.928260371,1232.984225,1530.741846,2158.694568,2483.555911,4363,114.6649146,8726,-2073600,160256,-1913344,47
3691,290,23,7,0.0728460186,0.927153981,1123.49259,1425.955731,1977.590897,2161.665517,3981,290.1603499,7962,-1889792,148480,-1741312,47
3560,257,24,6,0.0673303642,0.932669636,1083.233218,1268.760145,1880.375843,2305.505837,3817,292.2664625,7634,-1822720,131584,-1691136,47
3583,314,23,7,0.0805748011,0.919425199,1099.038886,1365.404919,1928.551493,2182.334395,3897,79.70955206,7794,-1834496,160768,-1673728,47
3709,281,23,7,0.0704260652,0.929573935,1129.227592,1413.863791,1989.094095,2080.053381,3990,190.6354515,7980,-1899008,143872,-1755136,47
3579,302,23,7,0.0778149961,0.922185004,1096.915301,1351.280042,1923.817826,2144.625828,3881,338.3609416,7762,-1832448,154624,-1677824,47
3639,329,22,8,0.0829133065,0.917086694,1119.834044,1388.780106,1970.665842,2137.516717,3968,259.1770085,7936,-1863168,168448,-1694720,47
3844,318,23,7,0.0764055742,0.923594426,1176.468054,1450.878329,2062.514828,2310.993711,4162,406.4453125,8324,-1968128,162816,-1805312,47
3840,323,23,7,0.0775882777,0.922411722,1181.663982,1412.671122,2071.207292,2210.309598,4163,297.1448965,8326,-1966080,165376,-1800704,47
3566,295,23,7,0.0764050764,0.923594924,1090.506923,1365.585308,1920.045149,2063.423729,3861,98.89856557,7722,-1825792,151040,-1674752,47
3704,319,23,7,0.0792940592,0.920705941,1133.050714,1429.158431,1991.780238,2246.777429,4023,98.84520885,8046,-1896448,163328,-1733120,47
2810,156,22,8,0.052596089,0.947403911,843.0380915,964.9946416,1507.969751,1042.730769,2966,45.98449612,5932,-1438720,79872,-1358848,47
3327,245,24,6,0.0685890258,0.931410974,1011.951296,1263.099223,1785.018034,1806.62449,3572,98.61954721,7144,-1703424,125440,-1577984,47
3467,245,23,7,0.0660021552,0.933997845,1051.562361,1322.397192,1857.847707,1837.428571,3712,308.8186356,7424,-1775104,125440,-1649664,47
3315,240,23,7,0.0675105485,0.932489451,1009.372175,1234.299365,1773.608145,1838.6625,3555,228.9117836,7110,-1697280,122880,-1574400,47
3349,233,23,7,0.0650474595,0.93495254,1016.697123,1256.962341,1790.330248,1808.313305,3582,263.3823529,7164,-1714688,119296,-1595392,47
3437,235,24,6,0.0639978214,0.936002179,1043.940069,1271.93741,1837.915624,1815.795745,3672,326.1101243,7344,-1759744,120320,-1639424,47
3306,239,22,8,0.0674188999,0.9325811,1005.019269,1248.466396,1776.820932,1720.146444,3545,339.559387,7090,-1692672,122368,-1570304,47
3031,209,23,7,0.0645061728,0.935493827,916.4727313,1174.788694,1619.037611,1641.708134,3240,214.1440846,6480,-1551872,107008,-1444864,47
3437,209,22,8,0.0573230938,0.942676906,1037.788535,1254.156129,1811.559791,2019.856459,3646,292.6163724,7292,-1759744,107008,-1652736,47
3367,241,24,6,0.0667960089,0.933203991,1022.114054,1282.346777,1803.015147,1825.244813,3608,265.6848306,7216,-1723904,123392,-1600512,47
4633,465,23,7,0.0912122401,0.90878776,1455.939666,1535.301769,2500.026333,3042.427957,5098,91.47676296,10196,-2372096,238080,-2134016,47
3302,236,23,7,0.0667043527,0.933295647,1002.83656,1250.900528,1772.737129,1724.207627,3538,323.992674,7076,-1690624,120832,-1569792,47
3325,243,22,8,0.0681053812,0.931894619,1010.663034,1264.651986,1781.977744,1819.012346,3568,213.0149254,7136,-1702400,124416,-1577984,47
3343,240,23,7,0.0669829752,0.933017025,1014.71481,1276.078453,1789.708645,1823.916667,3583,205.3295129,7166,-1711616,122880,-1588736,47
3446,246,23,7,0.0666305525,0.933369447,1047.863541,1290.222586,1849.553685,1803.723577,3692,274.702381,7384,-1764352,125952,-1638400,47
3338,230,22,8,0.0644618834,0.935538117,1012.328939,1256.334054,1779.306171,1859.878261,3568,210.3773585,7136,-1709056,117760,-1591296,47
3454,213,23,7,0.0580856286,0.941914371,1044.05126,1256.873175,1822.654893,2017.971831,3667,322.7992958,7334,-1768448,109056,-1659392,47
4630,466,24,6,0.09144427,0.90855573,1450.108733,1590.02878,2501.031317,3020.130901,5096,100.8509796,10192,-2370560,238592,-2131968,47
3419,203,24,6,0.0560463832,0.943953617,1031.61374,1237.388154,1798.502779,2030.403941,3622,263.4181818,7244,-1750528,103936,-1646592,47
3473,245,22,8,0.0658956428,0.934104357,1057.638836,1274.21035,1857.091276,1893.644898,3718,313.2266217,7436,-1778176,125440,-1652736,47
4790,457,23,7,0.087097389,0.912902611,1497.870946,1585.88025,2573.250313,3155.92779,5247,94.3705036,10494,-2452480,233984,-2218496,47
5448,315,21,9,0.0546590318,0.945340968,1653.868573,1676.935805,2922.379405,2183.628571,5763,114.527027,11526,-2789376,161280,-2628096,47
9497,468,20,10,0.0469643753,0.953035625,2849.110554,3184.975844,5038.493103,3856.893162,9965,510.7637109,19930,-4862464,239616,-4622848,47
7642,404,20,10,0.0502112851,0.949788715,2296.1674,2748.046519,4044.075242,3634.30198,8046,211.4030478,16092,-3912704,206848,-3705856,47
9532,441,21,9,0.0442193924,0.955780608,2854.68059,3065.883243,5049.30256,3640.360544,9973,638.0678183,19946,-4880384,225792,-4654592,47
3226,280,19,11,0.0798630918,0.920136908,997.7679537,1138.521494,1773.871358,1518.792857,3506,98.70495495,7012,-1651712,143360,-1508352,47
7170,420,21,9,0.0553359684,0.944664032,2164.417873,2538.021396,3828.643933,3229.685714,7590,206.9811835,15180,-3671040,215040,-3456000,47
3727,306,21,9,0.0758740392,0.924125961,1149.567853,1301.715278,2038.480816,1755.369281,4033,93.72530792,8066,-1908224,156672,-1751552,47
7185,427,20,10,0.0560956385,0.943904362,2170.441365,2545.852427,3839.576618,3249.929742,7612,197.406639,15224,-3678720,218624,-3460096,47
7623,447,20,10,0.0553903346,0.944609665,2300.649696,2703.116044,4071.853863,3415.532438,8070,215.3148346,16140,-3902976,228864,-3674112,47
8837,456,21,9,0.0490691919,0.950930808,2659.811255,3031.453201,4677.70533,4051.949561,9293,177.8905054,18586,-4524544,233472,-4291072,47
3651,291,21,9,0.0738203957,0.926179604,1124.782793,1286.917743,1980.179951,1862.597938,3942,106.425486,7884,-1869312,148992,-1720320,47
2872,284,19,11,0.0899873257,0.910012674,896.5272843,1037.52737,1591.568245,1446.34507,3156,85.48212351,6312,-1470464,145408,-1325056,47
9533,434,20,10,0.0435436942,0.956456306,2852.341094,3145.652281,5038.802371,3780.241935,9967,867.4499565,19934,-4880896,222208,-4658688,47
7876,456,21,9,0.0547287566,0.945271243,2371.968489,2877.36314,4194.721432,3679.061404,8332,148.4940296,16664,-4032512,233472,-3799040,47
6308,406,21,9,0.0604706583,0.939529342,1913.666384,2234.944493,3387.26506,2895.041872,6714,170.4926359,13428,-3229696,207872,-3021824,47
8231,457,20,10,0.0526012891,0.947398711,2481.496012,2833.416264,4387.885919,3563.078775,8688,229.719725,17376,-4214272,233984,-3980288,47
3867,333,19,11,0.0792857143,0.920714286,1191.668337,1418.034299,2116.808637,1911.114114,4200,74.60035524,8400,-1979904,170496,-1809408,47
9519,449,20,10,0.0450441413,0.954955859,2853.862501,3076.585506,5044.396155,3714.674833,9968,703.4580099,19936,-4873728,229888,-4643840,47
7240,430,21,9,0.0560625815,0.943937419,2192.861684,2448.049201,3875.818923,3156.64186,7670,143.8484621,15340,-3706880,220160,-3486720,47
4959,338,21,9,0.0638097036,0.936190296,1508.125989,1756.918766,2677.486993,2231.050296,5297,131.5044687,10594,-2539008,173056,-2365952,47
2930,165,23,7,0.0533117932,0.946688207,877.8396245,1132.817282,1543.767577,1623.157576,3095,66.74574078,6190,-1500160,84480,-1415680,47
3287,236,24,6,0.0669883622,0.933011638,998.3140333,1246.826555,1757.458777,1825.25,3523,334.5679012,7046,-1682944,120832,-1562112,47
2996,205,22,8,0.0640424867,0.935957513,904.0336957,1178.294288,1602.014686,1586.170732,3201,319.1425723,6402,-1533952,104960,-1428992,47
3292,241,22,8,0.0682139825,0.931786018,1000.85106,1251.262742,1766.668894,1771.522822,3533,197.3743017,7066,-1685504,123392,-1562112,47
2997,215,22,8,0.0669364882,0.933063512,906.2232663,1176.820372,1613.955622,1502.572093,3212,276.6580534,6424,-1534464,110080,-1424384,47
2981,209,24,6,0.0655172414,0.934482759,900.9631296,1166.908453,1599.628313,1536.617225,3190,280.8098592,6380,-1526272,107008,-1419264,47
3276,237,23,7,0.0674637062,0.932536294,994.1292957,1256.406598,1752.217338,1823.109705,3513,193.8741722,7026,-1677312,121344,-1555968,47
3303,234,24,6,0.0661577608,0.933842239,1002.553332,1253.159046,1767.843778,1785.320513,3537,321.8380346,7074,-1691136,119808,-1571328,47
3299,241,22,8,0.068079096,0.931920904,1000.944195,1274.696143,1770.534101,1770.033195,3540,229.2746114,7080,-1689088,123392,-1565696,47
4853,563,23,7,0.103951256,0.896048744,1541.126396,1626.378657,2639.29796,3305.01421,5416,100.0554221,10832,-2484736,288256,-2196480,47
3337,201,24,6,0.0568117581,0.943188242,1007.100756,1220.288398,1758.82709,1946.691542,3538,236.4973262,7076,-1708544,102912,-1605632,47
3404,245,24,6,0.0671416827,0.932858317,1036.835184,1260.479898,1822.652174,1857.620408,3649,296.4256702,7298,-1742848,125440,-1617408,47
3349,211,22,8,0.0592696629,0.940730337,1010.232713,1227.692018,1759.925052,2107.066351,3560,62.81983413,7120,-1714688,108032,-1606656,47
3287,238,24,6,0.0675177305,0.93248227,997.3530916,1263.077098,1759.185884,1815.676471,3525,240.7786885,7050,-1682944,121856,-1561088,47
3187,189,22,8,0.0559834123,0.944016588,960.1459648,1191.076051,1686.197051,1727.333333,3376,259.8922248,6752,-1631744,96768,-1534976,47
4668,435,23,7,0.0852439741,0.914756026,1452.466223,1502.960406,2485.348757,3267.236782,5103,264.5412131,10206,-2390016,222720,-2167296,47
3261,230,24,6,0.0658837009,0.934116299,988.223195,1251.699916,1748.939282,1704.326087,3491,266.8960245,6982,-1669632,117760,-1551872,47
3305,234,22,8,0.066120373,0.933879627,1003.400837,1250.934573,1770.008775,1769.876068,3539,285.6335755,7078,-1692160,119808,-1572352,47
3371,210,23,7,0.0586428372,0.941357163,1018.085946,1249.492043,1781.797983,1938.714286,3581,326.1384335,7162,-1725952,107520,-1618432,47
2798,166,23,7,0.0560053981,0.943994602,842.3704557,982.1612202,1504.60436,1109.921687,2964,47.10743802,5928,-1432576,84992,-1347584,47
9447,517,20,10,0.0518867925,0.948113208,2862.952339,3109.069376,4976.394728,5094.059961,9964,781.4901961,19928,-4836864,264704,-4572160,48
9429,532,19,11,0.0534082923,0.946591708,2858.495484,3150.304116,4966.325909,5241.078947,9961,396.2211615,19922,-4827648,272384,-4555264,48
9284,581,19,11,0.0588950836,0.941104916,2822.172957,3179.773117,4898.712839,5480.886403,9865,338.8869804,19730,-4753408,297472,-4455936,48
9440,522,19,11,0.0523991166,0.947600883,2853.370037,3254.162551,4978.774576,5030.787356,9962,359.3795094,19924,-4833280,267264,-4566016,48
9492,474,19,11,0.0475617098,0.95243829,2869.818529,2998.680616,4999.201643,4669.06962,9966,1026.364573,19932,-4859904,242688,-4617216,48
1214,86,20,10,0.0661538462,0.933846154,367.4216962,370.1096926,670.6004942,366.755814,1300,28.67225408,2600,-621568,44032,-577536,48
9401,558,20,10,0.0560297219,0.943970278,2857.2573,3153.516948,4970.736305,5136.071685,9959,736.067997,19918,-4813312,285696,-4527616,48
9255,549,20,10,0.055997552,0.944002448,2814.046686,3076.568971,4886.319503,5175.269581,9804,273.3965421,19608,-4738560,281088,-4457472,48
9472,493,19,11,0.049473156,0.950526844,2875.754125,2892.524498,4987.294658,4900.486815,9965,653.8713911,19930,-4849664,252416,-4597248,48
9289,673,20,10,0.0675567155,0.932443284,2813.247753,3400.231571,4892.485736,6210.10847,9962,924.9767874,19924,-4755968,344576,-4411392,48
9430,532,20,10,0.0534029311,0.946597069,2853.539362,3241.72428,4973.704242,5119.684211,9962,689.4117647,19924,-4828160,272384,-4555776,48
1480,112,19,11,0.0703517588,0.929648241,447.8567756,451.0343511,824.5925676,425.2767857,1592,27.74002439,3184,-757760,57344,-700416,48
9440,523,19,11,0.0524942286,0.947505771,2865.043688,3064.249516,4990.492479,4828.713193,9963,793.2324841,19926,-4833280,267776,-4565504,48
9473,492,20,10,0.0493728048,0.950627195,2870.365624,2975.351505,5000.359443,4648.760163,9965,332.9435349,19930,-4850176,251904,-4598272,48
9080,888,19,11,0.0890850722,0.910914928,2747.489376,3420.822716,4796.503304,6906.808559,9968,969.6498054,19936,-4648960,454656,-4194304,48
9459,505,19,11,0.0506824568,0.949317543,2869.274338,2991.674829,4997.734644,4697.144554,9964,509.146653,19928,-4843008,258560,-4584448,48
9484,482,19,11,0.0483644391,0.951635561,2868.860812,3003.238149,5003.960671,4580.908714,9966,592.1568627,19932,-4855808,246784,-4609024,48
9469,494,19,11,0.0495834588,0.950416541,2872.996493,2932.944504,4986.647798,4892.910931,9963,655.0295858,19926,-4848128,252928,-4595200,48
9408,552,20,10,0.0554216867,0.944578313,2855.012865,3190.648327,4966.705463,5215.606884,9960,680.7928913,19920,-4816896,282624,-4534272,48
9376,576,19,11,0.0578778135,0.942122186,2853.49284,3133.158231,4946.962884,5457.298611,9952,310.0311526,19904,-4800512,294912,-4505600,48
1136,89,18,12,0.0726530612,0.927346939,345.0801192,350.9606022,634.084507,343.8764045,1225,21.73913043,2450,-581632,45568,-536064,48
5767,314,20,10,0.051636244,0.948363756,1734.187678,2089.051123,3026.089128,3314.856688,6081,182.9422383,12162,-2952704,160768,-2791936,48
5744,342,19,11,0.0561945449,0.943805455,1731.216093,2141.568648,3040.029248,3101.792398,6086,166.922655,12172,-2940928,175104,-2765824,48
5728,340,20,10,0.0560316414,0.943968359,1722.780491,2176.404823,3025.696054,3182.820588,6068,207.6659822,12136,-2932736,174080,-2758656,48
6167,962,20,10,0.134941787,0.865058213,1865.104078,2072.637091,3247.474947,5600.527027,7129,202.6435475,14258,-3157504,492544,-2664960,48
5731,951,19,11,0.142322658,0.857677342,1734.100561,1933.387954,3023.439539,5258.223975,6682,207.3867163,13364,-2934272,486912,-2447360,48
5721,339,20,10,0.0559405941,0.944059406,1725.5391,2106.270248,3022.054886,3173.020649,6060,149.5926932,12120,-2929152,173568,-2755584,48
5737,335,20,10,0.055171278,0.944828722,1727.414595,2131.634745,3024.64023,3239.602985,6072,209.813407,12144,-2937344,171520,-2765824,48
5767,951,19,11,0.141559988,0.858440012,1747.413491,1889.206648,3036.029305,5321.072555,6718,233.0211585,13436,-2952704,486912,-2465792,48
5740,331,19,11,0.0545214956,0.945478504,1730.32912,2078.008389,3018.699652,3336.012085,6071,190.9720038,12142,-2938880,169472,-2769408,48
5724,329,19,11,0.0543532133,0.945646787,1724.79173,2086.398736,3012.978686,3270.945289,6053,204.2861964,12106,-2930688,168448,-2762240,48
5736,325,20,10,0.0536215146,0.946378485,1726.415276,2095.568538,3013.924861,3332.363077,6061,195.516129,12122,-2936832,166400,-2770432,48
5759,334,20,10,0.0548170031,0.945182997,1734.378509,2127.572595,3035.171558,3250.952096,6093,197.6321765,12186,-2948608,171008,-2777600,48
5415,305,19,11,0.0533216783,0.946678322,1626.966673,2031.98837,2855.234164,2953.990164,5720,103.2304638,11440,-2772480,156160,-2616320,48
5751,336,19,11,0.0551996057,0.944800394,1731.545647,2130.872509,3028.256651,3313.464286,6087,214.1801548,12174,-2944512,172032,-2772480,48
861,81,20,10,0.0859872611,0.914012739,264.9061612,272.5666576,489.4308943,280.9012346,942,32.74244004,1884,-440832,41472,-399360,48
5785,353,19,11,0.0575105898,0.94248941,1741.498552,2209.306088,3064.100951,3157.98017,6138,207.0850202,12276,-2961920,180736,-2781184,48
5731,332,19,11,0.0547583704,0.94524163,1725.578187,2115.645547,3017.43064,3283.496988,6063,162.0256547,12126,-2934272,169984,-2764288,48
5750,336,20,10,0.0552086756,0.944791324,1731.990093,2127.388111,3031.224696,3253.568452,6086,215.509915,12172,-2944000,172032,-2771968,48
4985,249,19,11,0.0475735575,0.952426442,1495.212281,1742.413266,2638.891675,2189.236948,5234,385.4197349,10468,-2552320,127488,-2424832,48
9572,401,19,11,0.0402085631,0.959791437,2865.14609,3135.775882,5011.245508,4408.25187,9973,291.0974898,19946,-4900864,205312,-4695552,48
9581,397,19,11,0.0397875326,0.960212467,2864.979996,3106.615153,5025.447135,4121.969773,9978,707.1580439,19956,-4905472,203264,-4702208,48
9558,415,19,11,0.0416123534,0.958387647,2860.264859,3190.309424,5019.402281,4240.73253,9973,886.4888889,19946,-4893696,212480,-4681216,48
9608,373,20,10,0.0373710049,0.962628995,2866.11065,3112.936704,5026.221378,4083.742627,9981,1313.289474,19962,-4919296,190976,-4728320,48
9586,393,19,11,0.0393827037,0.960617296,2862.212583,3192.088927,5023.54976,4171.659033,9979,682.5581395,19958,-4908032,201216,-4706816,48
9601,378,20,10,0.037879547,0.962120453,2864.250273,3169.28679,5021.200083,4197.534392,9979,1357.687075,19958,-4915712,193536,-4722176,48
9584,394,19,11,0.0394868711,0.960513129,2865.417498,3126.662104,5021.091507,4221.040609,9978,964.057971,19956,-4907008,201728,-4705280,48
9574,402,19,11,0.0402967121,0.959703288,2862.730263,3139.249049,5024.739712,4125.41791,9976,613.1530424,19952,-4901888,205824,-4696064,48
9600,379,19,11,0.0379797575,0.962020243,2864.562832,3179.992953,5018.265,4274.05277,9979,1348.513514,19958,-4915200,194048,-4721152,48
9590,388,19,11,0.0388855482,0.961114452,2867.407644,3085.59968,5020.772471,4216.554124,9978,1004.833837,19956,-4910080,198656,-4711424,48
9605,374,19,11,0.0374787053,0.962521295,2865.678712,3165.984023,5016.744092,4303.163102,9979,795.7735247,19958,-4917760,191488,-4726272,48
9544,429,20,10,0.0430161436,0.956983856,2856.662586,3285.619333,5012.560666,4418.34965,9973,521.0553814,19946,-4886528,219648,-4666880,48
9575,398,19,11,0.0399077509,0.960092249,2862.840817,3169.225034,5014.940888,4314.80402,9973,522.4201152,19946,-4902400,203776,-4698624,48
9611,368,20,10,0.0368774426,0.963122557,2867.983949,3105.983021,5018.088857,4256.407609,9979,1576.461295,19958,-4920832,188416,-4732416,48
9610,371,20,10,0.0371706242,0.962829376,2865.226904,3183.644224,5019.185848,4260.902965,9981,1109,19962,-4920320,189952,-4730368,48
9598,381,20,10,0.0381801784,0.961819822,2865.107455,3155.607044,5020.052303,4232.934383,9979,1274.457216,19958,-4914176,195072,-4719104,48
9587,391,20,10,0.0391862097,0.96081379,2862.065754,3189.666803,5023.049338,4166.897698,9978,1083.387622,19956,-4908544,200192,-4708352,48
9593,386,20,10,0.0386812306,0.961318769,2862.253472,3222.963378,5019.047847,4268.093264,9979,988.9990089,19958,-4911616,197632,-4713984,48
9597,382,20,10,0.0382803888,0.961719611,2862.085534,3189.190546,5025.163593,4106.58377,9979,642.9768041,19958,-4913664,195584,-4718080,48
9618,363,19,11,0.0363691013,0.963630899,2868.198737,3110.090264,5020.166355,4218.212121,9981,593.753718,19962,-4924416,185856,-4738560,48
5756,333,19,11,0.0546887831,0.945311217,1733.430611,2111.245087,3027.26164,3351.612613,6089,176.6976204,12178,-2947072,170496,-2776576,48
5847,328,20,10,0.0531174089,0.946882591,1759.306141,2119.773895,3066.656405,3468.47561,6175,180.502777,12350,-2993664,167936,-2825728,48
5730,336,19,11,0.0553907023,0.944609298,1725.019229,2142.937764,3025.34904,3172.502976,6066,190.2760351,12132,-2933760,172032,-2761728,48
5729,344,20,10,0.0566441627,0.943355837,1724.777734,2168.131569,3029.976436,3153.97093,6073,204.8229342,12146,-2933248,176128,-2757120,48
5773,1102,20,10,0.160290909,0.839709091,1754.726847,1871.308095,3049.182228,5474.88294,6875,226.1513158,13750,-2955776,564224,-2391552,48
5728,337,19,11,0.0555647156,0.944435284,1727.281004,2102.450331,3022.10632,3218.160237,6065,159.1863517,12130,-2932736,172544,-2760192,48
5746,353,19,11,0.0578783407,0.942121659,1731.742899,2152.688356,3030.413853,3368.815864,6099,106.6818261,12198,-2941952,180736,-2761216,48
6193,351,19,11,0.0536369193,0.946363081,1863.624758,2275.164086,3257.061037,3544.903134,6544,184.3380282,13088,-3170816,179712,-2991104,48
1482,94,20,10,0.0596446701,0.94035533,446.5458111,494.8536363,806.0674764,511.5319149,1576,45.78733295,3152,-758784,48128,-710656,48
5715,342,19,11,0.0564635958,0.943536404,1720.069953,2165.331289,3021.472266,3154.792398,6057,176.3318777,12114,-2926080,175104,-2750976,48
5745,330,20,10,0.0543209877,0.945679012,1730.11987,2115.543245,3028.297476,3206.912121,6075,159.1981132,12150,-2941440,168960,-2772480,48
5720,326,19,11,0.0539199471,0.946080053,1723.129063,2079.290502,3008.438986,3287.760736,6046,200,12092,-2928640,166912,-2761728,48
5796,331,20,10,0.0540231761,0.945976824,1745.190955,2134.356873,3056.113872,3202.090634,6127,157.02204,12254,-2967552,169472,-2798080,48
5731,334,19,11,0.0550700742,0.944929926,1723.883412,2155.099432,3023.764962,3191.461078,6065,151.2468828,12130,-2934272,171008,-2763264,48
9575,403,20,10,0.0403888555,0.959611145,2866.868769,3149.355537,5009.102141,4523.766749,9978,866.8983493,19956,-4902400,206336,-4696064,48
5704,342,20,10,0.0565663248,0.943433675,1718.696342,2134.312887,3013.477735,3190.654971,6046,122.4382341,12092,-2920448,175104,-2745344,48
4669,243,19,11,0.049470684,0.950529316,1404.537958,1567.721587,2483.41979,1939.263374,4912,87.1230933,9824,-2390528,124416,-2266112,48
5739,327,20,10,0.0539070227,0.946092977,1728.928134,2095.225692,3023.778533,3204.116208,6066,149.041769,12132,-2938368,167424,-2770944,48
5753,337,20,10,0.0553366174,0.944663383,1734.141318,2123.640841,3041.451764,3114.608309,6090,158.7591241,12180,-2945536,172544,-2772992,48
5708,346,19,11,0.057152296,0.942847704,1720.446808,2140.393789,3017.523651,3192.080925,6054,183.1215971,12108,-2922496,177152,-2745344,48
5749,317,20,10,0.0522584899,0.94774151,1730.653855,2073.474113,3020.535571,3268.618297,6066,197.4609375,12132,-2943488,162304,-2781184,48
5878,923,20,10,0.135715336,0.864284664,1780.393527,2020.663015,3104.271691,5290.673889,6801,159.6853722,13602,-3009536,472576,-2536960,48
5915,323,20,10,0.0517794165,0.948220584,1779.656582,2148.229252,3113.867117,3222.653251,6238,184.0660962,12476,-3028480,165376,-2863104,48
5828,330,20,10,0.0535888275,0.946411172,1755.589581,2119.550646,3067.833391,3285.539394,6158,207.2005384,12316,-2983936,168960,-2814976,48
6453,356,19,11,0.0522837421,0.947716258,1942.023778,2350.880642,3400.824113,3480.69382,6809,153.1144592,13618,-3303936,182272,-3121664,48
3966,197,19,11,0.047321643,0.952678357,1194.721882,1259.123333,2103.579929,1647.553299,4163,73.81205674,8326,-2030592,100864,-1929728,48
5699,315,20,10,0.0523777852,0.947622215,1712.632062,2110.84849,2999.49728,3152.285714,6014,163.423913,12028,-2917888,161280,-2756608,48
6069,937,19,11,0.133742506,0.866257494,1841.449945,2114.342405,3210.770473,5399.52508,7006,210.8335841,14012,-3107328,479744,-2627584,48
5847,333,19,11,0.0538834951,0.946116505,1761.306718,2122.676215,3073.845562,3382.927928,6180,209.0663058,12360,-2993664,170496,-2823168,48
5842,325,20,10,0.0526998541,0.947300146,1759.052464,2113.306875,3071.598083,3306.929231,6167,224.0101707,12334,-2991104,166400,-2824704,48
5856,349,20,10,0.0562449637,0.943755036,1764.695041,2180.418333,3091.793033,3291.045845,6205,220.035461,12410,-2998272,178688,-2819584,48
5752,932,20,10,0.139437463,0.860562537,1742.414287,2021.064255,3046.495654,5169.342275,6684,122.4624405,13368,-2945024,477184,-2467840,48
5827,337,19,11,0.0546722907,0.945327709,1753.188042,2180.175132,3075.909216,3196.459941,6164,166.4146868,12328,-2983424,172544,-2810880,48
5847,331,19,11,0.0535772095,0.946422791,1760.369442,2139.053125,3077.309731,3304.836858,6178,174.7171946,12356,-2993664,169472,-2824192,48
5893,331,20,10,0.0531812339,0.946818766,1774.727738,2134.332446,3097.957916,3371.401813,6224,206.0244952,12448,-3017216,169472,-2847744,48
6049,330,20,10,0.0517322464,0.948267754,1820.706095,2180.276742,3180.729211,3359.936364,6379,205.5752498,12758,-3097088,168960,-2928128,48
5900,335,19,11,0.0537289495,0.946271051,1778.722026,2121.883285,3103.249831,3377.779104,6235,189.1113133,12470,-3020800,171520,-2849280,48
6108,347,20,10,0.0537567777,0.946243222,1838.699009,2243.764671,3215.982318,3439.538905,6455,217.3400673,12910,-3127296,177664,-2949632,48
6010,342,20,10,0.0538413098,0.94615869,1809.735873,2210.254366,3171.206156,3269.52924,6352,189.4422905,12704,-3077120,175104,-2902016,48
5958,341,19,11,0.0541355771,0.945864423,1794.189471,2193.611733,3142.043471,3289.017595,6299,167.3485654,12598,-3050496,174592,-2875904,48
9483,485,23,7,0.0486556982,0.951344302,2861.265011,3172.079181,4994.629548,4786.441237,9968,664.0906063,19936,-4855296,248320,-4606976,48
9466,504,23,7,0.050551655,0.949448345,2863.58668,3135.880021,4979.405345,5099.968254,9970,715.2080344,19940,-4846592,258048,-4588544,48
9448,521,22,8,0.0522620122,0.947737988,2861.203635,3155.07029,4997.562976,4757.178503,9969,890.0892857,19938,-4837376,266752,-4570624,48
9446,524,23,7,0.052557673,0.947442327,2857.638293,3218.388886,4996.316007,4790.522901,9970,586.815774,19940,-4836352,268288,-4568064,48
9450,518,23,7,0.0519662921,0.948033708,2860.388341,3160.106277,5000.193757,4698.194981,9968,1289.521345,19936,-4838400,265216,-4573184,48
9453,516,23,7,0.0517604574,0.948239543,2863.195472,3128.833397,4993.959907,4820.856589,9969,949.4285714,19938,-4839936,264192,-4575744,48
6047,331,23,7,0.0518971464,0.948102854,1830.803598,1916.068582,3223.793617,2562.993958,6378,111.2312522,12756,-3096064,169472,-2926592,48
9473,496,22,8,0.0497542381,0.950245762,2865.54724,3091.734473,4998.231711,4732.290323,9969,1101.546961,19938,-4850176,253952,-4596224,48
9469,499,23,7,0.0500601926,0.949939807,2865.621091,3090.406163,4992.710212,4828.703407,9968,879.788173,19936,-4848128,255488,-4592640,48
9463,505,23,7,0.0506621188,0.949337881,2862.953511,3131.35084,4995.021558,4787.340594,9968,202.3548518,19936,-4845056,258560,-4586496,48
9439,528,23,7,0.0529748169,0.947025183,2862.803042,3122.42139,4989.108592,4892.674242,9967,941.170916,19934,-4832768,270336,-4562432,48
9460,508,23,7,0.0509630819,0.949036918,2859.047723,3187.702457,5000.306765,4690.145669,9968,829.9750208,19936,-4843520,260096,-4583424,48
9464,505,23,7,0.0506570368,0.949342963,2865.264778,3084.482231,5002.792899,4651.550495,9969,988.0079286,19938,-4845568,258560,-4587008,48
9466,502,23,7,0.0503611557,0.949638844,2861.655882,3156.307844,4994.023452,4804.920319,9968,1374.896552,19936,-4846592,257024,-4589568,48
9444,524,22,8,0.0525682183,0.947431782,2864.360216,3099.148676,4994.826027,4798.395038,9968,277.5055679,19936,-4835328,268288,-4567040,48
9472,497,22,8,0.0498545491,0.950145451,2862.114439,3155.32469,4995.460726,4785.635815,9969,775.1944012,19938,-4849664,254464,-4595200,48
9447,521,23,7,0.0522672552,0.947732745,2865.040344,3093.192799,4990.144596,4882.149712,9968,686.5013774,19936,-4836864,266752,-4570112,48
9465,503,22,8,0.0504614767,0.949538523,2860.647088,3161.379712,5001.435182,4665.829026,9968,939.4910462,19936,-4846080,257536,-4588544,48
9448,520,22,8,0.0521669342,0.947833066,2864.204511,3105.326508,4993.05398,4829.080769,9968,660.1324503,19936,-4837376,266240,-4571136,48
9508,460,23,7,0.0461476726,0.953852327,2868.807242,3043.374982,4995.280816,4761.665217,9968,415.6797331,19936,-4868096,235520,-4632576,48
9455,513,22,8,0.051464687,0.948535313,2867.067389,3061.234396,4990.962877,4865.384016,9968,1078.787879,19936,-4840960,262656,-4578304,48
9491,482,22,8,0.0483304923,0.951669508,2846.366282,3438.583299,5005.452007,4623.6639,9973,670.2284946,19946,-4859392,246784,-4612608,48
9515,456,23,7,0.0457326246,0.954267375,2853.020531,3358.214062,4995.391908,4790.026316,9971,481.4582327,19942,-4871680,233472,-4638208,48
9488,483,23,7,0.0484404774,0.951559523,2866.107779,3075.471971,5008.82989,4537.532091,9971,788.8449367,19942,-4857856,247296,-4610560,48
4850,302,22,8,0.0586180124,0.941381988,1475.64813,1600.06429,2603.785773,2138.301325,5152,90.14873141,10304,-2483200,154624,-2328576,48
3043,170,23,7,0.0529100529,0.947089947,916.6648154,999.8022916,1632.430496,1151.794118,3213,56.93779904,6426,-1558016,87040,-1470976,48
9506,465,23,7,0.0466352422,0.953364758,2860.186297,3223.65794,4978.088365,5147.737634,9971,294.825547,19942,-4867072,238080,-4628992,48
9447,522,23,7,0.0523623232,0.947637677,2868.175067,3045.965198,4988.795702,4916.306513,9969,725.0181818,19938,-4836864,267264,-4569600,48
9439,529,23,7,0.0530698234,0.946930177,2863.162351,3121.678016,4988.449306,4914.032136,9968,533.0481283,19936,-4832768,270848,-4561920,48
9539,434,23,7,0.0435174972,0.956482503,2854.750726,3335.642426,5007.508754,4536.232719,9973,817.4590164,19946,-4883968,222208,-4661760,48
9433,536,23,7,0.0537666767,0.946233323,2863.602821,3106.794105,4999.019718,4738.268657,9969,1224.692875,19938,-4829696,274432,-4555264,48
9248,504,22,8,0.0516817063,0.948318294,2793.327971,3183.717555,4886.544334,4692.194444,9752,314.9870801,19504,-4734976,258048,-4476928,48
9507,464,23,7,0.0465349514,0.953465049,2847.865388,3424.717238,5003.608604,4625.213362,9971,772.3470178,19942,-4867584,237568,-4630016,48
9452,516,23,7,0.0517656501,0.94823435,2862.593836,3125.040624,4999.813161,4703.996124,9968,1373.002755,19936,-4839424,264192,-4575232,48
9465,505,23,7,0.0506519559,0.949348044,2861.251314,3155.768782,5004.670365,4626.19802,9970,768.1047766,19940,-4846080,258560,-4587520,48
9488,480,23,7,0.0481540931,0.951845907,2842.219281,3502.814681,4985.866568,4957.4875,9968,701.4778325,19936,-4857856,245760,-4612096,48
9468,500,22,8,0.0501605136,0.949839486,2838.291216,3534.252345,4974.957752,5165.192,9968,907.8324226,19936,-4847616,256000,-4591616,48
9460,509,23,7,0.0510582807,0.948941719,2864.635415,3089.647214,5004.687315,4619.102161,9969,999.8996991,19938,-4843520,260608,-4582912,48
8601,401,23,7,0.0445456565,0.955454343,2571.487338,3057.168544,4531.008952,3868.566085,9002,134.8412223,18004,-4403712,205312,-4198400,48
9426,542,23,7,0.0543739968,0.945626003,2864.912031,3088.152189,4986.936877,4942.119926,9968,1179.64497,19936,-4826112,277504,-4548608,48
8696,483,23,7,0.0526201111,0.947379889,2631.858506,2953.050562,4592.349126,4547.706004,9179,247.9470556,18358,-4452352,247296,-4205056,48
8891,482,23,7,0.0514243039,0.948575696,2686.284492,3041.726973,4683.168148,4757.682573,9373,313.1640494,18746,-4552192,246784,-4305408,48
6437,345,23,7,0.0508699499,0.94913005,1939.946524,2240.695753,3408.836414,3068.037681,6782,118.5871656,13564,-3295744,176640,-3119104,48
8275,445,23,7,0.0510321101,0.94896789,2499.035474,2828.190012,4350.468882,4547.033708,8720,262.0979862,17440,-4236800,227840,-4008960,48
8349,449,24,6,0.051034326,0.948965674,2522.183779,2842.32345,4391.000479,4557.545657,8798,288.7430259,17596,-4274688,229888,-4044800,48
8864,494,22,8,0.0527890575,0.947210943,2681.820728,3031.618041,4680.458935,4662.293522,9358,300.4173355,18716,-4538368,252928,-4285440,48
9140,495,24,6,0.0513751946,0.948624805,2765.978512,3051.609717,4815.725821,4859.991919,9635,303.1780994,19270,-4679680,253440,-4426240,48
8908,498,23,7,0.0529449288,0.947055071,2695.397492,3049.030404,4702.575438,4720.038153,9406,302.0552344,18812,-4560896,254976,-4305920,48
9024,484,23,7,0.0509045015,0.949095499,2727.242501,3052.283615,4753.336769,4776.188017,9508,247.1536262,19016,-4620288,247808,-4372480,48
8281,441,23,7,0.0505617978,0.949438202,2500.778501,2813.656456,4352.63857,4527.897959,8722,258.8898783,17444,-4239872,225792,-4014080,48
8710,483,22,8,0.0525399761,0.947460024,2635.324068,2965.052899,4590.994259,4705.302277,9193,258.0853453,18386,-4459520,247296,-4212224,48
8615,487,22,8,0.0535047242,0.946495276,2607.608439,2957.590282,4550.134068,4575.663244,9102,281.0126582,18204,-4410880,249344,-4161536,48
9212,484,22,8,0.0499174917,0.950082508,2793.00067,2910.342561,4846.114199,4893.909091,9696,174.9864645,19392,-4716544,247808,-4468736,48
8250,433,23,7,0.0498675573,0.950132443,2490.587752,2791.17016,4336.040242,4455.551963,8683,277.9449424,17366,-4224000,221696,-4002304,48
9195,475,24,6,0.0491209928,0.950879007,2777.657835,3045.71125,4839.743665,4753.351579,9670,281.9241983,19340,-4707840,243200,-4464640,48
9572,406,23,7,0.0406895169,0.959310483,2867.689612,3125.416624,5010.314981,4498.758621,9978,1178.040142,19956,-4900864,207872,-4692992,48
8409,459,23,7,0.051759134,0.948240866,2538.242197,2927.200938,4440.88655,4317.496732,8868,275.3182242,17736,-4305408,235008,-4070400,48
8907,488,22,8,0.0519425226,0.948057477,2697.334725,2959.916339,4685.776131,4921.110656,9395,304.5380875,18790,-4560384,249856,-4310528,48
8988,493,24,6,0.0519987343,0.948001266,2725.558677,2931.141471,4731.516911,4913.888438,9481,268.507505,18962,-4601856,252416,-4349440,48
5886,306,22,8,0.0494186047,0.950581395,1768.491319,2062.465626,3121.325688,2618.970588,6192,94.92564771,12384,-3013632,156672,-2856960,48
9549,426,23,7,0.0427067669,0.957293233,2862.283986,3232.568645,4998.908053,4743.49061,9975,1141.304348,19950,-4889088,218112,-4670976,48
9408,563,23,7,0.0564637449,0.943536255,2855.499467,3149.245744,4942.515412,5712.648313,9971,375.5555556,19942,-4816896,288256,-4528640,48
9544,431,23,7,0.0432080201,0.95679198,2861.854407,3218.501082,5006.779862,4572.141531,9975,1347.972973,19950,-4886528,220672,-4665856,48
9523,451,22,8,0.0452175657,0.954782434,2856.990424,3309.355525,4996.013126,4807.742794,9974,1331.64219,19948,-4875776,230912,-4644864,48
9604,377,23,7,0.0377717664,0.962228234,2865.422432,3211.737408,5012.298521,4448.424403,9981,199.9799639,19962,-4917248,193024,-4724224,48
9546,429,23,7,0.0430075188,0.956992481,2861.787865,3245.789604,4994.778651,4837.16317,9975,1219.437653,19950,-4887552,219648,-4667904,48
9597,381,23,7,0.0381840048,0.961815995,2866.914656,3176.270155,5005.090549,4596.790026,9978,1126.185102,19956,-4913664,195072,-4718592,48
9553,425,23,7,0.0425937062,0.957406294,2859.486206,3251.710434,5017.759133,4354.301176,9978,1971.936759,19956,-4891136,217600,-4673536,48
9387,587,23,7,0.0588530178,0.941146982,2825.303903,3436.028413,4915.602855,6137.241908,9974,537.1028541,19948,-4806144,300544,-4505600,48
9559,416,23,7,0.0417042607,0.958295739,2868.813233,3091.939076,5004.376713,4611.689904,9975,1128.393665,19950,-4894208,212992,-4681216,48
9569,407,23,7,0.040797915,0.959202085,2863.039655,3201.782145,5011.6218,4444.882064,9976,1925.868726,19952,-4899328,208384,-4690944,48
9579,399,23,7,0.0399879735,0.960012026,2861.662825,3262.098414,5009.429481,4511.042607,9978,1581.299525,19956,-4904448,204288,-4700160,48
9556,419,23,7,0.0420050125,0.957994987,2861.832683,3235.395482,5004.162411,4619.389021,9975,831.25,19950,-4892672,214528,-4678144,48
7378,348,23,7,0.0450427129,0.954957287,2219.506145,2333.81177,3897.567091,3141.238506,7726,135.734364,15452,-3777536,178176,-3599360,48
9532,443,22,8,0.0444110276,0.955588972,2859.029256,3263.117255,5007.042698,4578.259594,9975,557.5740637,19950,-4880384,226816,-4653568,48
9456,519,23,7,0.0520300752,0.947969925,2842.770144,3436.560295,4958.01893,5534.244701,9975,1169.40211,19950,-4841472,265728,-4575744,48
9552,423,22,8,0.042406015,0.957593985,2861.59849,3232.291007,5005.830507,4585.359338,9975,1214.98173,19950,-4890624,216576,-4674048,48
9366,605,23,7,0.0606759603,0.93932404,2831.568629,3444.09553,4939.101537,5712.034711,9971,332.8104139,19942,-4795392,309760,-4485632,48
9386,589,22,8,0.059047619,0.940952381,2824.613487,3517.512798,4929.898253,5913.879457,9975,245.8713335,19950,-4805632,301568,-4504064,48
9556,420,23,7,0.0421010425,0.957898957,2865.287046,3175.060113,5002.925387,4660.288095,9976,780.5946792,19952,-4892672,215040,-4677632,48
9462,505,23,7,0.0506672018,0.949332798,2849.471517,3352.404222,4990.925597,4854.237624,9967,348.4965035,19934,-4844544,258560,-4585984,48
9482,486,23,7,0.0487560193,0.951243981,2858.272438,3221.834563,4996.0193,4759.755144,9968,887.6224399,19936,-4854784,248832,-4605952,48
9500,469,23,7,0.0470458421,0.952954158,2861.838844,3181.081218,4991.539789,4852.530917,9969,796.882494,19938,-4864000,240128,-4623872,48
9504,467,23,7,0.0468358239,0.953164176,2853.648587,3330.928964,4999.134364,4718.700214,9971,1069.849785,19942,-4866048,239104,-4626944,48
4258,277,23,7,0.0610804851,0.938919515,1298.166514,1327.519577,2307.437529,1661.772563,4535,79.35258093,9070,-2180096,141824,-2038272,48
9464,505,22,8,0.0506570368,0.949342963,2861.573322,3164.408298,4978.880178,5099.689109,9969,530.5481639,19938,-4845568,258560,-4587008,48
9481,487,23,7,0.0488563403,0.95114366,2855.986577,3260.932764,4995.620715,4768,9968,424.3507876,19936,-4854272,249344,-4604928,48
9457,512,24,6,0.0513592136,0.948640786,2854.213669,3261.821206,5004.709845,4620.945313,9969,600.9041591,19938,-4841984,262144,-4579840,48
9469,500,22,8,0.050155482,0.949844518,2848.07824,3386.214299,4995.09642,4793.794,9969,570.6353749,19938,-4848128,256000,-4592128,48
9461,507,24,6,0.0508627608,0.949137239,2853.29115,3284.284263,4999.626889,4702.220907,9968,756.8716781,19936,-4844032,259584,-4584448,48
9463,506,23,7,0.0507573478,0.949242652,2858.869328,3211.337067,4985.891155,4968.333992,9969,634.9681529,19938,-4845056,259072,-4585984,48
9484,484,23,7,0.0485553772,0.951444623,2858.62216,3185.833965,5009.585618,4492.946281,9968,742.7719821,19936,-4855808,247808,-4608000,48
2452,164,23,7,0.0626911315,0.937308869,746.4048337,721.6702546,1340.639886,827.9695122,2616,46.22724863,5232,-1255424,83968,-1171456,48
9482,486,24,6,0.0487560193,0.951243981,2859.118182,3205.14345,4997.345708,4733.876543,9968,834.840871,19936,-4854784,248832,-4605952,48
5325,254,24,6,0.0455278724,0.954472128,1599.798961,1756.810539,2812.292958,2322.637795,5579,533.8755981,11158,-2726400,130048,-2596352,48
9517,455,24,6,0.0456277577,0.954372242,2857.76674,3283.013073,4980.506357,5111.865934,9972,861.8841832,19944,-4872704,232960,-4639744,48
9474,493,23,7,0.0494632287,0.950536771,2850.876038,3342.138393,4988.80209,4891.718053,9967,943.844697,19934,-4850688,252416,-4598272,48
9467,502,24,6,0.0503561039,0.949643896,2853.493565,3282.97645,5003.717756,4632.00996,9969,597.3037747,19938,-4847104,257024,-4590080,48
9476,493,22,8,0.0494533052,0.950546695,2848.787883,3386.332684,4989.583263,4896.904665,9969,702.0422535,19938,-4851712,252416,-4599296,48
8376,406,23,7,0.0462309269,0.953769073,2510.156319,2917.570449,4425.49618,3690.140394,8782,122.6193801,17564,-4288512,207872,-4080640,48
7930,332,21,9,0.0401839748,0.959816025,2373.555942,2525.629394,4163.644767,3363.704819,8262,900.9814613,16524,-4060160,169984,-3890176,49
7936,331,21,9,0.0400387081,0.959961292,2374.086516,2546.847713,4166.257813,3360.592145,8267,847.8974359,16534,-4063232,169472,-3893760,49
7948,329,20,10,0.0397487012,0.960251299,2378.848655,2527.161257,4168.635883,3423.054711,8277,1011.858191,16554,-4069376,168448,-3900928,49
7943,332,20,10,0.0401208459,0.959879154,2376.501795,2567.906916,4167.323052,3436.454819,8275,773.364486,16550,-4066816,169984,-3896832,49
7924,340,20,10,0.041142304,0.958857696,2371.926073,2545.221441,4168.407749,3295.638235,8264,693.2885906,16528,-4057088,174080,-3883008,49
7915,324,21,9,0.0393251608,0.960674839,2368.735007,2509.779996,4147.737713,3442.395062,8239,1211.617647,16478,-4052480,165888,-3886592,49
7932,320,21,9,0.0387784779,0.961221522,2373.91313,2497.52844,4151.755043,3500.490625,8252,691.1222781,16504,-4061184,163840,-3897344,49
7926,322,21,9,0.0390397672,0.960960233,2371.927402,2511.571792,4150.36109,3487.931677,8248,1381.574539,16496,-4058112,164864,-3893248,49
7935,338,21,9,0.040855796,0.959144204,2376.188644,2542.519418,4168.870825,3388.789941,8273,1157.062937,16546,-4062720,173056,-3889664,49
7930,337,21,9,0.0407644853,0.959235515,2373.388899,2553.962829,4167.258764,3351.382789,8267,1339.87034,16534,-4060160,172544,-3887616,49
7939,334,21,9,0.0403722954,0.959627705,2376.315516,2526.898582,4170.615821,3337.97006,8273,199.7826612,16546,-4064768,171008,-3893760,49
950,90,20,10,0.0865384615,0.913461538,289.3131227,272.3625872,546.7168421,243.7666667,1040,20.0462606,2080,-486400,46080,-440320,49
7934,327,21,9,0.0395835855,0.960416414,2374.959219,2524.045286,4157.984875,3476.266055,8261,1055.0447,16522,-4062208,167424,-3894784,49
7916,326,21,9,0.0395535064,0.960446494,2369.087432,2509.256146,4151.088555,3403.02454,8242,429.4945284,16484,-4052992,166912,-3886080,49
2773,178,20,10,0.0603185361,0.939681464,843.5794395,870.0952816,1502.971511,1055.820225,2951,52.00916461,5902,-1419776,91136,-1328640,49
6275,287,21,9,0.0437366657,0.956263334,1881.330705,1998.626766,3317.925896,2485.080139,6562,121.5860663,13124,-3212800,146944,-3065856,49
7936,338,20,10,0.0408508581,0.959149142,2375.519688,2549.272732,4171.331149,3343.168639,8274,919.3333333,16548,-4063232,173056,-3890176,49
7941,329,21,9,0.0397823458,0.960217654,2375.904115,2537.004591,4166.369979,3390.398176,8270,1155.027933,16540,-4065792,168448,-3897344,49
7925,339,20,10,0.0410212972,0.958978703,2371.013552,2624.636206,4159.830158,3493.587021,8264,145.9039548,16528,-4057600,173568,-3884032,49
7964,329,19,11,0.0396720125,0.960327987,2381.636929,2578.675204,4175.876821,3447.987842,8293,972.2157093,16586,-4077568,168448,-3909120,49
613,111,24,6,0.153314917,0.846685083,203.5703599,221.6168351,376.3800979,285.8468468,724,80.89385475,1448,-313856,56832,-257024,49
603,96,24,6,0.137339056,0.862660944,194.5578812,230.4916507,361.0447761,280.625,699,137.0588235,1398,-308736,49152,-259584,49
610,97,23,7,0.137199434,0.862800566,198.6579525,220.7508954,366.0803279,278.0309278,707,105.6801196,1414,-312320,49664,-262656,49
614,100,24,6,0.140056022,0.859943978,200.334123,227.7943976,368.1970684,291.82,714,98.48275862,1428,-314368,51200,-263168,49
605,99,24,6,0.140625,0.859375,198.0890168,220.1580718,363.6809917,284.1717172,704,74.65535525,1408,-309760,50688,-259072,49
609,106,24,6,0.148251748,0.851748252,200.4009626,226.551994,369.6978654,290.7924528,715,83.52803738,1430,-311808,54272,-257536,49
602,92,24,6,0.132564841,0.867435159,195.0432704,224.4447791,355.8787375,292.673913,694,148.608137,1388,-308224,47104,-261120,49
616,107,23,7,0.147994467,0.852005533,200.2267528,230.3851249,378.3977273,267.5981308,723,102.991453,1446,-315392,54784,-260608,49
618,107,22,8,0.147586207,0.852413793,203.1544836,226.6097498,376.4352751,285.4018692,725,104.1666667,1450,-316416,54784,-261632,49
606,107,23,7,0.150070126,0.849929874,201.1381545,214.1220319,370.9257426,278.1308411,713,112.9952456,1426,-310272,54784,-255488,49
606,108,24,6,0.151260504,0.848739496,198.0892637,239.5078752,366.9587459,304.4259259,714,12.49781201,1428,-310272,55296,-254976,49
623,103,24,6,0.141873278,0.858126722,205.2064245,219.7274016,375.9518459,288.184466,726,90.75,1452,-318976,52736,-266240,49
608,99,23,7,0.140028289,0.859971711,197.4355424,232.8676467,363.3618421,296.5050505,707,50.71736011,1414,-311296,50688,-260608,49
600,98,24,6,0.140401146,0.859598854,196.1269486,222.0436646,359.505,288.244898,698,90.64935065,1396,-307200,50176,-257024,49
656,108,22,8,0.141361257,0.858638743,214.351069,236.4395116,397.0579268,294.0740741,764,92.2705314,1528,-335872,55296,-280576,49
604,100,23,7,0.142045455,0.857954545,197.2084508,225.7985704,363.205298,287.84,704,80.73394495,1408,-309248,51200,-258048,49
614,105,24,6,0.146036161,0.853963839,201.0447741,230.03948,371.9543974,290.0952381,719,100.27894,1438,-314368,53760,-260608,49
610,98,23,7,0.138418079,0.861581921,199.2654308,220.2551245,366.1606557,281.9183673,708,67.04545455,1416,-312320,50176,-262144,49
604,101,22,8,0.143262411,0.856737589,198.2000412,221.2026215,364.2235099,285.8811881,705,97.24137931,1410,-309248,51712,-257536,49
413,86,23,7,0.172344689,0.827655311,138.1817252,163.9358509,258.0968523,211.1162791,499,7.631136259,998,-211456,44032,-167424,49
6572,432,22,8,0.0616790405,0.938320959,2008.432505,2053.135821,3555.666007,2693.6875,7004,279.4892259,14008,-3364864,221184,-3143680,49
7672,429,23,7,0.0529564251,0.947043575,2325.328803,2458.787495,4090.486966,3344.83683,8101,272.9447439,16202,-3928064,219648,-3708416,49
6526,401,23,7,0.0578894182,0.942110582,1986.740578,2041.567864,3512.756359,2670.523691,6927,223.379555,13854,-3341312,205312,-3136000,49
7133,461,23,7,0.0607058204,0.93929418,2185.678006,2203.281279,3836.767139,3189.924078,7594,211.2378303,15188,-3652096,236032,-3416064,49
6559,426,22,8,0.0609878311,0.939012169,2002.682282,2074.212802,3542.239823,2734.868545,6985,273.2785603,13970,-3358208,218112,-3140096,49
1108,85,22,8,0.0712489522,0.928751048,338.2649444,361.8645437,612.1796029,399.1294118,1193,171.9020173,2386,-567296,43520,-523776,49
6515,397,22,8,0.0574363426,0.942563657,1978.748522,2147.937054,3496.123408,2806.256927,6912,262.9136554,13824,-3335680,203264,-3132416,49
6657,422,22,8,0.0596129397,0.94038706,2026.812075,2034.695849,3604.753342,2518.523697,7079,149.8835486,14158,-3408384,216064,-3192320,49
6671,417,23,7,0.0588318284,0.941168172,2035.668493,2117.738299,3582.12352,2942.613909,7088,254.3236455,14176,-3415552,213504,-3202048,49
6617,454,23,7,0.0642059115,0.935794089,2031.57413,2081.615447,3578.299229,2919.493392,7071,277.1854175,14142,-3387904,232448,-3155456,49
6698,443,23,7,0.0620361294,0.937963871,2048.369219,2131.078742,3617.169155,2872.939052,7141,267.6536732,14282,-3429376,226816,-3202560,49
6543,407,22,8,0.0585611511,0.941438849,1991.719967,2084.779784,3522.85068,2714.282555,6950,266.9996158,13900,-3350016,208384,-3141632,49
6597,435,23,7,0.0618600683,0.938139932,2019.929929,2007.447083,3570.207519,2701.997701,7032,241.1522634,14064,-3377664,222720,-3154944,49
6492,385,23,7,0.0559837138,0.944016286,1970.735382,2165.917198,3465.781885,2987.394805,6877,242.4039478,13754,-3323904,197120,-3126784,49
6614,447,23,7,0.0633054808,0.936694519,2024.664414,2076.045393,3584.408074,2740.751678,7061,272.7307841,14122,-3386368,228864,-3157504,49
6617,442,23,7,0.0626151013,0.937384899,2029.207834,1901.861516,3596.456854,2535.10181,7059,160.4682882,14118,-3387904,226304,-3161600,49
6629,435,23,7,0.0615798414,0.938420159,2029.867172,2049.343571,3579.096847,2822.406897,7064,228.6824215,14128,-3394048,222720,-3171328,49
6583,432,23,7,0.0615823236,0.938417676,2011.88227,2043.852747,3562.460732,2678.104167,7015,259.5264521,14030,-3370496,221184,-3149312,49
6660,426,23,7,0.0601185436,0.939881456,2033.08791,2063.800364,3596.11036,2721,7086,217.2953082,14172,-3409920,218112,-3191808,49
1149,141,22,8,0.109302326,0.890697674,354.9817662,491.7663384,644.8694517,650.6382979,1290,20.36627723,2580,-588288,72192,-516096,49
615,107,21,9,0.148199446,0.851800554,199.9812799,239.2374846,373.9609756,289.8785047,722,54.6969697,1444,-314880,54784,-260096,49
613,107,21,9,0.148611111,0.851388889,200.0928163,230.1397848,375.2218597,276.1588785,720,96,1440,-313856,54784,-259072,49
596,108,20,10,0.153409091,0.846590909,194.3535344,230.7234884,366.9748322,272.6203704,704,43.9176544,1408,-305152,55296,-249856,49
599,88,21,9,0.128093159,0.871906841,191.7813716,229.7138533,352.5926544,285.5113636,687,115.6565657,1374,-306688,45056,-261632,49
608,105,21,9,0.147265077,0.852734923,197.3619499,234.9773153,370.2549342,280.247619,713,138.7159533,1426,-311296,53760,-257536,49
617,108,22,8,0.148965517,0.851034483,199.3385435,238.4675805,379.280389,269.9907407,725,16.78629312,1450,-315904,55296,-260608,49
623,105,22,8,0.144230769,0.855769231,203.9284465,232.637658,375.8972713,296.8761905,728,85.74793875,1456,-318976,53760,-265216,49
594,98,22,8,0.141618497,0.858381503,193.3612261,221.2296859,358.5521886,273.4489796,692,106.1349693,1384,-304128,50176,-253952,49
621,103,20,10,0.142265193,0.857734807,203.9449548,231.4087146,370.5088567,314.2135922,724,75.81151832,1448,-317952,52736,-265216,49
38,27,20,10,0.415384615,0.584615385,17.89514318,19.15054788,30.02631579,37.18518519,65,2.848378615,130,-19456,13824,-5632,49
644,110,19,11,0.145888594,0.854111406,210.4209717,239.7168647,391.6692547,294.5454545,754,69.6857671,1508,-329728,56320,-273408,49
606,105,22,8,0.147679325,0.852320675,197.7226711,231.7001945,368.3316832,284.8285714,711,92.6988266,1422,-310272,53760,-256512,49
615,106,20,10,0.147018031,0.852981969,201.3273246,231.9008862,373.0325203,291.1886792,721,45.1754386,1442,-314880,54272,-260608,49
611,93,19,11,0.132102273,0.867897727,196.7762749,231.8068915,362.0327332,289.8709677,704,92.63157895,1408,-312832,47616,-265216,49
626,105,21,9,0.143638851,0.856361149,204.7921715,232.5227409,377.928115,294.8857143,731,67.74791474,1462,-320512,53760,-266752,49
602,105,20,10,0.148514851,0.851485149,196.4887674,229.5845397,366.8853821,280.1238095,707,161.4155251,1414,-308224,53760,-254464,49
610,101,21,9,0.142053446,0.857946554,199.4034267,221.138443,369.2885246,275.7425743,711,111.9685039,1422,-312320,51712,-260608,49
606,102,22,8,0.144067797,0.855932203,199.5815726,219.4178704,365.6732673,288.1176471,708,102.1645022,1416,-310272,52224,-258048,49
614,109,21,9,0.150760719,0.849239281,201.9294364,231.0762861,374.5162866,291.4954128,723,120.7011686,1446,-314368,55808,-258560,49
608,100,21,9,0.141242938,0.858757062,200.1789567,210.0488541,368.1233553,271.67,708,86.97788698,1416,-311296,51200,-260096,49
727,113,22,8,0.13452381,0.86547619,235.387015,278.6195106,428.4195323,369.5486726,840,124.0768095,1680,-372224,57856,-314368,49
731,102,23,7,0.12244898,0.87755102,239.420467,245.6725637,421.2667579,386.4215686,833,101.7094017,1666,-374272,52224,-322048,49
732,102,22,8,0.122302158,0.877697842,236.1583578,266.6672044,424.1352459,369.8823529,834,127.3282443,1668,-374784,52224,-322560,49
744,100,24,6,0.118483412,0.881516588,238.4814685,273.6071452,429.4233871,370.99,844,99.17743831,1688,-380928,51200,-329728,49
729,105,23,7,0.125899281,0.874100719,232.938622,281.7907372,426.2921811,356.4571429,834,130.3125,1668,-373248,53760,-319488,49
735,109,22,8,0.129146919,0.870853081,238.3757261,266.2230346,432.8585034,352.6513761,844,69.18032787,1688,-376320,55808,-320512,49
739,105,23,7,0.124407583,0.875592417,237.2054907,284.8557189,422.5074425,422.447619,844,86.12244898,1688,-378368,53760,-324608,49
734,98,23,7,0.117788462,0.882211538,235.0072825,271.3525628,422.7125341,369.9693878,832,149.9099099,1664,-375808,50176,-325632,49
739,97,23,7,0.116028708,0.883971292,237.2973479,267.5587334,423.0622463,383.742268,836,124.5901639,1672,-378368,49664,-328704,49
732,102,23,7,0.122302158,0.877697842,234.7372011,275.6686006,424.0327869,370.6176471,834,150.8137432,1668,-374784,52224,-322560,49
737,100,24,6,0.119474313,0.880525687,236.4411428,273.6813834,424.2944369,379.98,837,104.7559449,1674,-377344,51200,-326144,49
766,104,23,7,0.11954023,0.88045977,247.3357149,273.0716901,441.8707572,388.5769231,870,139.64687,1740,-392192,53248,-338944,49
747,119,23,7,0.137413395,0.862586605,241.8532209,292.9680421,439.7697456,394.1428571,866,133.8485317,1732,-382464,60928,-321536,49
739,109,24,6,0.128537736,0.871462264,236.6692896,285.7019895,434.067659,359.6330275,848,130.0613497,1696,-378368,55808,-322560,49
735,96,24,6,0.115523466,0.884476534,236.4396449,261.833519,420.8653061,378.75,831,137.1287129,1662,-376320,49152,-327168,49
741,109,22,8,0.128235294,0.871764706,240.6119993,269.6675356,433.2928475,372.5229358,850,55.05181347,1700,-379392,55808,-323584,49
733,104,23,7,0.124253286,0.875746714,237.8639199,264.1243816,423.8158254,385.0576923,837,100.239521,1674,-375296,53248,-322048,49
730,112,23,7,0.133016627,0.866983373,236.1541315,274.5684112,431.8767123,353.8660714,842,78.10760668,1684,-373760,57344,-316416,49
745,104,24,6,0.122497055,0.877502945,237.8859911,284.5115527,433.2979866,365.5576923,849,88.16199377,1698,-381440,53248,-328192,49
550,96,22,8,0.148606811,0.851393189,176.091643,217.2979063,338.9018182,235.2604167,646,10.04353234,1292,-281600,49152,-232448,49
620,107,23,7,0.147180193,0.852819807,202.340954,227.505583,380.1435484,270.4579439,727,100.6925208,1454,-317440,54784,-262656,49
596,102,23,7,0.146131805,0.853868195,194.7026985,225.7243754,361.0922819,281.7647059,698,125.0896057,1396,-305152,52224,-252928,49
633,96,24,6,0.131687243,0.868312757,204.0853061,237.782144,375.1184834,298.28125,729,123.9795918,1458,-324096,49152,-274944,49
599,98,24,6,0.140602582,0.859397418,196.1102878,217.4671932,360.3171953,279.8265306,697,82.97619048,1394,-306688,50176,-256512,49
603,97,22,8,0.138571429,0.861428571,194.3147843,232.4358352,361.9900498,279.0721649,700,94.33962264,1400,-308736,49664,-259072,49
607,97,23,7,0.137784091,0.862215909,196.2849195,233.1762733,362.214168,291.7113402,704,113.5483871,1408,-310784,49664,-261120,49
621,104,22,8,0.143448276,0.856551724,203.0315197,230.4447238,375.1095008,290.6923077,725,90.85213033,1450,-317952,53248,-264704,49
622,95,24,6,0.132496513,0.867503487,202.7022178,225.8327364,367.1897106,305.3789474,717,70.36310108,1434,-318464,48640,-269824,49
601,98,24,6,0.140200286,0.859799714,197.7704745,216.3330412,359.2595674,293.2142857,699,94.20485175,1398,-307712,50176,-257536,49
601,96,23,7,0.137733142,0.862266858,193.6692331,227.5498534,361.7054908,269.4583333,697,70.76142132,1394,-307712,49152,-258560,49
588,83,23,7,0.123695976,0.876304024,186.2610773,237.3686219,340.5816327,303.5421687,671,93.06518724,1342,-301056,42496,-258560,49
605,98,23,7,0.13940256,0.86059744,196.3714252,229.868204,362.1173554,289.5408163,703,99.57507082,1406,-309760,50176,-259584,49
614,103,24,6,0.143654114,0.856345886,202.1450128,224.18276,369.267101,297.7961165,717,116.7752443,1434,-314368,52736,-261632,49
604,100,24,6,0.142045455,0.857954545,198.8608843,218.8228105,362.2251656,293.76,704,92.14659686,1408,-309248,51200,-258048,49
606,102,23,7,0.144067797,0.855932203,198.483083,225.4147598,365.5973597,288.5686275,708,105.3571429,1416,-310272,52224,-258048,49
607,98,23,7,0.139007092,0.860992908,200.0265182,212.1669539,363.7248764,286.5714286,705,152.5974026,1410,-310784,50176,-260608,49
612,107,24,6,0.148817803,0.851182197,201.3294407,231.5314929,370.25,301.3738318,719,83.50754936,1438,-313344,54784,-258560,49
620,107,23,7,0.147180193,0.852819807,203.2704402,231.2882378,376.6903226,290.4672897,727,124.2735043,1454,-317440,54784,-262656,49
604,101,22,8,0.143262411,0.856737589,198.1812958,221.7469964,364.0115894,287.1485149,705,105.0670641,1410,-309248,51712,-257536,49
608,100,23,7,0.141242938,0.858757062,198.4616185,229.6672149,363.5493421,299.48,708,38.83708173,1416,-311296,51200,-260096,49
1575,122,24,6,0.0718915734,0.928108427,480.7311302,595.1604298,850.5434921,829.0737705,1697,324.4741874,3394,-806400,62464,-743936,49
1571,132,24,6,0.077510276,0.922489724,481.0378811,603.3788426,852.5327817,845.6590909,1703,238.8499299,3406,-804352,67584,-736768,49
1563,134,23,7,0.0789628757,0.921037124,477.04024,613.0220564,856.8131798,757.8656716,1697,201.3048636,3394,-800256,68608,-731648,49
1592,142,23,7,0.0818915802,0.91810842,486.3560536,636.0751529,872.3052764,813.6267606,1734,30.45845776,3468,-815104,72704,-742400,49
1582,133,24,6,0.0775510204,0.92244898,484.2407363,609.3523871,857.5619469,863.2105263,1715,178.6458333,3430,-809984,68096,-741888,49
1565,128,23,7,0.0756054341,0.924394566,478.8705961,595.4592634,849.3412141,818.375,1693,198.4759672,3386,-801280,65536,-735744,49
1570,128,24,6,0.0753828033,0.924617197,480.2313703,598.1780508,851.6452229,823.1875,1698,350.1030928,3396,-803840,65536,-738304,49
1578,124,24,6,0.0728554642,0.927144536,481.2379063,604.4535012,853.7452471,822.9274194,1702,253.6512668,3404,-807936,63488,-744448,49
1557,125,24,6,0.0743162901,0.92568371,475.6220894,594.2035694,844.551702,803.488,1682,252.5525526,3364,-797184,64000,-733184,49
1593,136,24,6,0.0786581839,0.921341816,487.6217131,617.7325109,866.6672944,845.4705882,1729,185.3161844,3458,-815616,69632,-745984,49
1572,126,23,7,0.074204947,0.925795053,482.7483082,566.9078263,842.1946565,940.6428571,1698,151.0676157,3396,-804864,64512,-740352,49
1584,124,24,6,0.0725995316,0.927400468,481.7396457,614.5202097,860.5296717,777.4758065,1708,172.5252525,3416,-811008,63488,-747520,49
1562,135,24,6,0.0795521509,0.920447849,476.792187,617.8847103,854.6267606,783.8962963,1697,253.2835821,3394,-799744,69120,-730624,49
1548,130,20,10,0.0774731824,0.922526818,472.616298,607.135253,840.8385013,823.5615385,1678,131.09375,3356,-792576,66560,-726016,49
1596,137,23,7,0.0790536642,0.920946336,486.1590406,623.8130985,879.5833333,720.4087591,1733,191.2803532,3466,-817152,70144,-747008,49
1600,148,24,6,0.0846681922,0.915331808,489.0885349,649.0153182,873.7,883.1486486,1748,30.86158192,3496,-819200,75776,-743424,49
1566,136,24,6,0.0799059929,0.920094007,480.7727568,597.9332113,855.2177522,808.6911765,1702,173.6734694,3404,-801792,69632,-732160,49
1608,133,23,7,0.0763928777,0.923607122,488.3934464,592.0532324,892.3401741,612.9924812,1741,288.2450331,3482,-823296,68096,-755200,49
1405,117,23,7,0.0768725361,0.923127464,425.9434084,571.0664074,767.8868327,684.8034188,1522,24.43802184,3044,-719360,59904,-659456,49
1562,132,23,7,0.0779220779,0.922077922,478.774196,596.4588028,849.5838668,822.8409091,1694,204.0963855,3388,-799744,67584,-732160,49
595,94,23,7,0.136429608,0.863570392,190.4450914,232.1866261,356.8168067,270.2021277,689,76.72605791,1378,-304640,48128,-256512,49
618,100,23,7,0.139275766,0.860724234,202.582279,225.5082704,368.9660194,301,718,86.81983071,1436,-316416,51200,-265216,49
584,83,23,7,0.124437781,0.875562219,185.0087905,229.5125294,342.8424658,271.7831325,667,68.34016393,1334,-299008,42496,-256512,49
594,102,21,9,0.146551724,0.853448276,194.662975,218.8611749,361.6548822,271.8921569,696,99.85652798,1392,-304128,52224,-251904,49
597,99,23,7,0.142241379,0.857758621,195.6946534,212.9074179,361.8274707,268.1313131,696,106.097561,1392,-305664,50688,-254976,49
596,103,23,7,0.147353362,0.852646638,196.2500704,217.2328034,362.6375839,276.8737864,699,89.04458599,1398,-305152,52736,-252416,49
607,105,23,7,0.14747191,0.85252809,198.3663957,225.6510548,370.8467875,273.5619048,712,113.015873,1424,-310784,53760,-257024,49
597,100,23,7,0.143472023,0.856527977,193.9106319,225.8387699,361.680067,273.3,697,110.6349206,1394,-305664,51200,-254464,49
598,95,23,7,0.137085137,0.862914863,194.6511952,221.3840813,356.819398,285.1894737,693,114.1680395,1386,-306176,48640,-257536,49
114,21,23,7,0.155555556,0.844444444,37.42928595,39.45777616,72.14912281,45.47619048,135,19.06779661,270,-58368,10752,-47616,49
596,95,23,7,0.13748191,0.86251809,190.9108557,233.4501355,357.716443,272.4947368,691,107.4650078,1382,-305152,48640,-256512,49
620,106,22,8,0.14600551,0.85399449,200.5263473,245.2329849,375.2129032,294.990566,726,98.24086604,1452,-317440,54272,-263168,49
624,101,23,7,0.139310345,0.860689655,203.143599,227.8121047,376.0592949,282.3168317,725,92.3566879,1450,-319488,51712,-267776,49
598,99,23,7,0.142037303,0.857962697,194.2264895,224.6159329,361.5551839,273.1616162,697,140.2414487,1394,-306176,50688,-255488,49
591,96,23,7,0.139737991,0.860262009,193.1470677,216.6599318,354.4974619,279.375,687,82.4729892,1374,-302592,49152,-253440,49
291,67,23,7,0.187150838,0.812849162,99.93533259,104.9708039,190.2302405,132.8955224,358,11.53722204,716,-148992,34304,-114688,49
596,105,23,7,0.14978602,0.85021398,195.4450104,225.8437945,363.114094,282.2380952,701,95.11533243,1402,-305152,53760,-251392,49
606,96,23,7,0.136752137,0.863247863,196.3930581,230.2263094,360.6006601,294.0520833,702,69.85074627,1404,-310272,49152,-261120,49
597,107,22,8,0.151988636,0.848011364,195.3331955,226.2648573,366.9447236,271.9065421,704,125.2669039,1408,-305664,54784,-250880,49
611,108,22,8,0.150208623,0.849791377,200.2534015,228.2046052,374.4402619,278.3055556,719,194.8509485,1438,-312832,55296,-257536,49
603,102,24,6,0.144680851,0.855319149,199.4058879,212.899003,364.9983416,282.0686275,705,145.9627329,1410,-308736,52224,-256512,49
611,99,23,7,0.13943662,0.86056338,201.5686764,216.2901794,364.6841244,298.8181818,710,143.7246964,1420,-312832,50688,-262144,49
610,105,21,9,0.146853147,0.853146853,201.3921,222.4325993,369.2377049,292.7142857,715,103.4732272,1430,-312320,53760,-258560,49
611,97,24,6,0.13700565,0.86299435,199.8585333,219.6350822,364.9803601,288.4845361,708,134.0909091,1416,-312832,49664,-263168,49
603,107,23,7,0.150704225,0.849295775,198.4876482,228.1465083,366.6766169,292.5140187,710,106.7669173,1420,-308736,54784,-253952,49
607,107,22,8,0.149859944,0.850140056,200.2960041,219.2496239,371.878089,275.9345794,714,41.90140845,1428,-310784,54784,-256000,49
605,105,23,7,0.147887324,0.852112676,200.0384424,217.0711878,368.2876033,281.8190476,710,70.2970297,1420,-309760,53760,-256000,49
612,96,22,8,0.13559322,0.86440678,200.3010203,219.7104155,363.754902,295.5,708,68.80466472,1416,-313344,49152,-264192,49
603,99,23,7,0.141025641,0.858974359,194.3734152,235.4007036,362.9552239,281.7272727,702,124.6891652,1404,-308736,50688,-258048,49
610,118,23,7,0.162087912,0.837912088,202.1799296,244.4359764,371.1639344,330.0508475,728,12.77417091,1456,-312320,60416,-251904,49
606,98,24,6,0.139204545,0.860795455,196.6195114,226.1168765,364.6056106,277.6428571,704,97.77777778,1408,-310272,50176,-260096,49
606,101,23,7,0.142857143,0.857142857,198.7263143,221.9288544,365.310231,286.1386139,707,80.34090909,1414,-310272,51712,-258560,49
614,100,24,6,0.140056022,0.859943978,201.9552779,218.60046,368.3029316,291.17,714,120.6081081,1428,-314368,51200,-263168,49
657,107,24,6,0.140052356,0.859947644,217.1083923,235.0694859,390.238965,334.9813084,764,31.46622735,1528,-336384,54784,-281600,49
630,102,24,6,0.139344262,0.860655738,205.0847568,241.7185873,373.6,322.6470588,732,71.484375,1464,-322560,52224,-270336,49
603,93,24,6,0.13362069,0.86637931,197.1629322,210.900295,359.2238806,278.9677419,696,62.81588448,1392,-308736,47616,-261120,49
305,56,22,8,0.155124654,0.844875346,101.3679866,115.5094734,185.4688525,156.6607143,361,19.76998905,722,-156160,28672,-127488,49
629,98,22,8,0.13480055,0.86519945,203.6127642,234.3420453,374.9650238,293.622449,727,126.6550523,1454,-322048,50176,-271872,49
608,90,24,6,0.128939828,0.871060172,197.9242772,217.5648588,356.9407895,299.2333333,698,101.7492711,1396,-311296,46080,-265216,49
608,102,23,7,0.143661972,0.856338028,198.2745995,234.9641766,363.8125,305.9509804,710,45.1653944,1420,-311296,52224,-259072,49
296,58,21,9,0.163841808,0.836158192,100.6878089,100.3021831,185.3885135,137.2413793,354,54.71406491,708,-151552,29696,-121856,49
284,50,21,9,0.149700599,0.850299401,93.81666564,96.10437035,176.1971831,118.1,334,44.12153236,668,-145408,25600,-119808,49
286,50,21,9,0.148809524,0.851190476,94.51658491,97.60660838,176.7167832,121.5,336,40.0476758,672,-146432,25600,-120832,49
286,54,21,9,0.158823529,0.841176471,96.45255902,89.71883379,180.4965035,117.5555556,340,43.81443299,680,-146432,27648,-118784,49
293,51,21,9,0.148255814,0.851744186,96.52848562,102.656866,180.443686,126.8627451,344,20.9500609,688,-150016,26112,-123904,49
287,54,21,9,0.158357771,0.841642229,96.82897139,93.98594589,179.6759582,124.8888889,341,45.52736983,682,-146944,27648,-119296,49
299,53,22,8,0.150568182,0.849431818,98.98016449,102.4964152,185.1438127,127.7358491,352,54.82866044,704,-153088,27136,-125952,49
285,53,21,9,0.156804734,0.843195266,95.59722537,96.22103944,177.7122807,125.3396226,338,49.41520468,676,-145920,27136,-118784,49
279,54,21,9,0.162162162,0.837837838,93.71886881,98.30693131,174.8028674,126.6851852,333,47.98270893,666,-142848,27648,-115200,49
285,55,21,9,0.161764706,0.838235294,95.57841693,100.6226467,178.5754386,128.6545455,340,26.17397998,680,-145920,28160,-117760,49
289,50,21,9,0.147492625,0.852507375,95.1127907,101.4666527,177.7370242,125.28,339,36.84782609,678,-147968,25600,-122368,49
288,52,21,9,0.152941176,0.847058824,95.37650774,100.4397487,178.8368056,124.3269231,340,53.79746835,680,-147456,26624,-120832,49
285,53,21,9,0.156804734,0.843195266,94.82541668,99.41780686,178,123.7924528,338,37.3480663,676,-145920,27136,-118784,49
290,49,21,9,0.144542773,0.855457227,95.07209105,102.4158862,177.4482759,125.9183673,339,46.05978261,678,-148480,25088,-123392,49
290,54,21,9,0.156976744,0.843023256,95.9774768,108.6191102,179.2344828,136.3333333,344,6.079886886,688,-148480,27648,-120832,49
290,50,21,9,0.147058824,0.852941176,96.321353,96.29080122,178.337931,125.04,340,52.30769231,680,-148480,25600,-122880,49
282,53,20,10,0.158208955,0.841791045,93.72153398,98.14360197,177.0319149,119.9433962,335,47.99426934,670,-144384,27136,-117248,49
286,53,21,9,0.156342183,0.843657817,95.53449942,99.35593229,177.8601399,127.5849057,339,53.55450237,678,-146432,27136,-119296,49
294,50,21,9,0.145348837,0.854651163,97.50171413,94.00072553,181.2687075,120.94,344,51.19047619,688,-150528,25600,-124928,49
286,51,21,9,0.151335312,0.848664688,94.65635803,98.77980281,177.2692308,122.627451,337,29.30434783,674,-146432,26112,-120320,49
8845,934,20,10,0.0955107884,0.904489212,2791.416202,2837.520269,4763.192651,6090.868308,9779,220.9444193,19558,-4528640,478208,-4050432,50
8870,1019,20,10,0.103043786,0.896956214,2844.264678,2662.209394,4808.234498,6135.490677,9889,569.3149108,19778,-4541440,521728,-4019712,50
6955,735,20,10,0.0955786736,0.904421326,2179.878923,2269.030643,3724.637527,4989.171429,7690,194.4865959,15380,-3560960,376320,-3184640,50
8764,969,20,10,0.099558204,0.900441796,2786.943552,2708.4987,4729.845048,6107.480908,9733,171.8093557,19466,-4487168,496128,-3991040,50
7598,723,20,10,0.0868885951,0.913111405,2363.058467,2571.039687,4065.070018,5169.127248,8321,156.6158479,16642,-3890176,370176,-3520000,50
7202,656,20,10,0.083481802,0.916518198,2228.304654,2446.492611,3836.385448,4951.772866,7858,151.6988417,15716,-3687424,335872,-3351552,50
8735,891,20,10,0.0925618118,0.907438188,2751.562981,2804.270812,4701.283572,5913.624018,9626,231.0055196,19252,-4472320,456192,-4016128,50
7057,699,20,10,0.0901237751,0.909876225,2182.320504,2435.209614,3758.57489,5089.246066,7756,198.515485,15512,-3613184,357888,-3255296,50
7523,763,20,10,0.0920830316,0.907916968,2350.384481,2447.549411,4018.423501,5376.724771,8286,204.2899408,16572,-3851776,390656,-3461120,50
7713,744,20,10,0.087974459,0.912025541,2389.146833,2659.326906,4116.138468,5399.028226,8457,201.0699001,16914,-3949056,380928,-3568128,50
7911,772,20,10,0.0889093631,0.911090637,2459.363442,2644.628778,4220.87865,5583.180052,8683,215.0854595,17366,-4050432,395264,-3655168,50
8799,1083,20,10,0.1095932,0.8904068,2822.788719,2748.822965,4778.88135,6262.720222,9882,503.6697248,19764,-4505088,554496,-3950592,50
8234,932,20,10,0.101680122,0.898319878,2619.583896,2583.305969,4449.655696,5765.982833,9166,214.7610122,18332,-4215808,477184,-3738624,50
8142,938,20,10,0.103303965,0.896696035,2598.050194,2543.255796,4409.144191,5680.690832,9080,189.7596656,18160,-4168704,480256,-3688448,50
6807,691,20,10,0.0921579088,0.907842091,2112.958058,2312.695025,3630.737035,4919.426918,7498,186.1007694,14996,-3485184,353792,-3131392,50
8810,1076,20,10,0.108840785,0.891159215,2822.107735,2765.425458,4781.60681,6269.038104,9886,590.9145248,19772,-4510720,550912,-3959808,50
6467,656,20,10,0.092096027,0.907903973,2009.680716,2178.422254,3449.759858,4668.489329,7123,185.8820459,14246,-3311104,335872,-2975232,50
6895,686,20,10,0.0904893813,0.909510619,2145.016769,2369.720226,3693.065845,4775.338192,7581,148.7053747,15162,-3530240,351232,-3179008,50
8510,928,20,10,0.0983259165,0.901674083,2700.933247,2665.356151,4593.011281,5879.434267,9438,225.5736138,18876,-4357120,475136,-3881984,50
2094,127,20,10,0.0571814498,0.94281855,634.1114933,747.3163711,1112.356256,1088.637795,2221,31.46338008,4442,-1072128,65024,-1007104,50
3924,441,23,7,0.101030928,0.898969072,1219.486024,1549.806111,2152.635066,2453.185941,4365,86.72759785,8730,-2009088,225792,-1783296,50
5222,743,24,6,0.124559933,0.875440067,1683.582359,1903.971319,2915.34661,3458.485868,5965,114.5573267,11930,-2673664,380416,-2293248,50
5163,701,24,6,0.119542974,0.880457026,1653.269605,1842.997409,2847.716057,3556.950071,5864,104.1563055,11728,-2643456,358912,-2284544,50
4735,681,24,6,0.125738552,0.874261448,1517.60433,1702.948307,2610.891869,3387.170338,5416,95.38569919,10832,-2424320,348672,-2075648,50
3597,335,24,6,0.0851983723,0.914801628,1107.981835,1393.094157,1965.658604,1975.534328,3932,82.76152389,7864,-1841664,171520,-1670144,50
5092,726,24,6,0.12478515,0.87521485,1628.801646,1853.39769,2809.475255,3611.050964,5818,103.009915,11636,-2607104,371712,-2235392,50
5192,751,23,7,0.126367155,0.873632845,1664.207338,1896.220939,2871.882704,3664.155792,5943,106.8884892,11886,-2658304,384512,-2273792,50
4779,752,24,6,0.135960947,0.864039053,1535.968602,1751.46121,2644.500942,3538.132979,5531,97.56570824,11062,-2446848,385024,-2061824,50
4783,711,23,7,0.129413906,0.870586094,1537.971501,1700.64585,2637.229354,3489.30661,5494,101.7030729,10988,-2448896,364032,-2084864,50
2522,285,24,6,0.101531885,0.898468115,799.3512367,891.9060558,1418.056305,1279.614035,2807,48.87689361,5614,-1291264,145920,-1145344,50
4580,711,24,6,0.134379134,0.865620866,1484.045697,1657.697195,2551.779694,3252.932489,5291,99.02676399,10582,-2344960,364032,-1980928,50
5095,726,24,6,0.124720838,0.875279162,1630.04884,1849.039609,2810.00157,3619.797521,5821,102.8626966,11642,-2608640,371712,-2236928,50
5042,720,24,6,0.124956612,0.875043388,1620.182682,1834.686289,2797.743752,3468.026389,5762,103.0769231,11524,-2581504,368640,-2212864,50
4700,666,23,7,0.124114797,0.875885203,1505.786623,1684.55401,2590.286809,3341.310811,5366,102.8757669,10732,-2406400,340992,-2065408,50
5082,719,24,6,0.123944148,0.876055852,1625.154847,1893.878397,2820.358717,3470.984701,5801,105.6648452,11602,-2601984,368128,-2233856,50
5049,696,24,6,0.121148825,0.878851175,1613.790796,1812.401545,2779.32343,3552.558908,5745,106.5072303,11490,-2585088,356352,-2228736,50
4856,725,23,7,0.129905035,0.870094965,1562.301318,1750.273777,2685.920717,3494.813793,5581,97.43365922,11162,-2486272,371200,-2115072,50
5039,725,24,6,0.125780708,0.874219292,1619.510029,1857.101618,2804.827148,3422.353103,5764,110.2735795,11528,-2579968,371200,-2208768,50
5092,681,24,6,0.117962931,0.882037069,1634.045192,1834.674105,2829.0652,3320.192364,5773,119.8463774,11546,-2607104,348672,-2258432,50
5059,741,23,7,0.127758621,0.872241379,1620.554722,1906.655645,2816.468274,3474.206478,5800,102.4553966,11600,-2590208,379392,-2210816,50
725,109,22,8,0.130695444,0.869304556,236.2337013,262.1070103,425.9186207,361.5045872,834,28.66964593,1668,-371200,55808,-315392,50
720,107,22,8,0.129383313,0.870616687,234.740877,256.6323175,422.6111111,356.0560748,827,30.92744951,1654,-368640,54784,-313856,50
714,109,22,8,0.132442284,0.867557716,232.9919818,254.7452552,422.7254902,341.7431193,823,30.87021755,1646,-365568,55808,-309760,50
737,109,22,8,0.128841608,0.871158392,240.4992256,258.4780571,433.2835821,357.3486239,846,30.18194791,1692,-377344,55808,-321536,50
724,109,22,8,0.130852341,0.869147659,236.3707583,257.9132891,426.1781768,356.0366972,833,25.58353808,1666,-370688,55808,-314880,50
726,109,22,8,0.130538922,0.869461078,236.2589157,265.9103874,425.1446281,370.412844,835,24.45811365,1670,-371712,55808,-315904,50
727,116,22,8,0.137603796,0.862396204,236.0309549,284.1347265,425.2682256,401.5172414,843,14.79466479,1686,-372224,59392,-312832,50
709,107,22,8,0.131127451,0.868872549,231.7353236,250.346792,418.0959097,344.9158879,816,27.5862069,1632,-363008,54784,-308224,50
730,122,22,8,0.143192488,0.856807512,237.4853008,291.3673297,427.9328767,417.9262295,852,14.93426819,1704,-373760,62464,-311296,50
738,108,22,8,0.127659574,0.872340426,239.9187126,262.2544642,433.2533875,356.8518519,846,23.32506203,1692,-377856,55296,-322560,50
714,108,22,8,0.131386861,0.868613139,232.8812783,254.9146129,421.5,345.3888889,822,24.70694319,1644,-365568,55296,-310272,50
713,108,22,8,0.131546894,0.868453106,232.5014579,257.9145396,419.4698457,355.0833333,821,30.26170291,1642,-365056,55296,-309760,50
719,107,22,8,0.129539952,0.870460048,233.6814291,260.6435809,422.3198887,354.2336449,826,27.59772803,1652,-368128,54784,-313344,50
716,103,22,8,0.125763126,0.874236874,232.4024704,253.731585,419.1480447,346.407767,819,30.07712082,1638,-366592,52736,-313856,50
707,104,22,8,0.128236745,0.871763255,230.8049467,244.7711615,416.0551627,337.6442308,811,26.4946096,1622,-361984,53248,-308736,50
723,107,22,8,0.128915663,0.871084337,236.0159669,253.9714074,424.6887967,353.411215,830,29.01083537,1660,-370176,54784,-315392,50
758,118,22,8,0.134703196,0.865296804,246.5265266,285.1277534,446.4709763,387.2966102,876,26.61804923,1752,-388096,60416,-327680,50
765,124,22,8,0.139482565,0.860517435,251.7262591,276.2364484,455.5673203,379.8064516,889,29.26267281,1778,-391680,63488,-328192,50
719,108,22,8,0.130592503,0.869407497,233.9227513,263.7154497,421.1251739,366.5648148,827,29.14023961,1654,-368128,55296,-312832,50
290,49,22,8,0.144542773,0.855457227,94.33696,112.7865373,174.5931034,142.8163265,339,5.055174471,678,-148480,25088,-123392,50
4025,470,24,6,0.104560623,0.895439377,1254.154738,1597.245786,2216.389317,2518.708511,4495,104.5348837,8990,-2060800,240640,-1820160,50
4745,700,23,7,0.12855831,0.87144169,1526.456636,1708.854337,2625.276291,3385.427143,5445,97.28425942,10890,-2429440,358400,-2071040,50
5112,721,24,6,0.123607063,0.876392937,1627.267127,1901.365884,2819.230634,3610.199723,5833,111.4231137,11666,-2617344,369152,-2248192,50
5124,711,23,7,0.1218509,0.8781491,1641.393574,1846.910901,2830.05445,3551.801688,5835,108.3766716,11670,-2623488,364032,-2259456,50
4975,684,24,6,0.120869412,0.879130588,1590.878297,1752.690057,2730.228141,3555.679825,5659,105.9936318,11318,-2547200,350208,-2196992,50
5111,720,24,6,0.123477963,0.876522037,1642.634103,1829.902215,2828.108589,3539.906944,5831,103.9393939,11662,-2616832,368640,-2248192,50
499,110,24,6,0.180623974,0.819376026,173.6555338,177.1487046,315.7995992,256.0090909,609,11.95054945,1218,-255488,56320,-199168,50
4204,510,23,7,0.108188375,0.891811625,1320.080786,1560.43741,2292.995243,2889.221569,4714,84.76892645,9428,-2152448,261120,-1891328,50
5060,714,23,7,0.123657776,0.876342224,1638.4822,1826.976429,2844.906917,3189.35014,5774,100.5923345,11548,-2590720,365568,-2225152,50
5136,723,24,6,0.123399898,0.876600102,1647.609755,1838.854763,2835.260903,3603.001383,5859,107.1899012,11718,-2629632,370176,-2259456,50
4879,3931,24,6,0.446197503,0.553802497,1734.608399,1823.600664,2770.511785,6434.781989,8810,171.3341112,17620,-2498048,2012672,-485376,50
4112,483,23,7,0.105114255,0.894885745,1285.104918,1572.264366,2247.444796,2728.399586,4595,94.76180656,9190,-2105344,247296,-1858048,50
5135,713,23,7,0.121922025,0.878077975,1642.996139,1819.473994,2821.7815,3664.274895,5848,102.975876,11696,-2629120,365056,-2264064,50
3388,279,24,6,0.0760839924,0.923916008,1035.322571,1307.643011,1837.355667,1793.250896,3667,103.8221971,7334,-1734656,142848,-1591808,50
5029,711,24,6,0.123867596,0.876132404,1609.46682,1824.226214,2775.446013,3542.829817,5740,106.4935065,11480,-2574848,364032,-2210816,50
5012,696,24,6,0.121934128,0.878065872,1592.476751,1843.596298,2753.190144,3584.047414,5708,105.0616602,11416,-2566144,356352,-2209792,50
5229,4241,24,6,0.447835269,0.552164731,1927.81837,1964.043406,3004.644674,6869.582174,9470,171.1548888,18940,-2677248,2171392,-505856,50
5050,705,24,6,0.122502172,0.877497828,1609.867627,1840.534619,2778.561188,3590.292199,5755,102.0028359,11510,-2585600,360960,-2224640,50
5011,689,24,6,0.120877193,0.879122807,1595.566875,1826.129232,2755.018559,3544.923077,5700,101.1176158,11400,-2565632,352768,-2212864,50
1207,152,24,6,0.111846946,0.888153054,387.1295229,421.1389903,691.011599,592.5592105,1359,19.5202528,2718,-617984,77824,-540160,50
6309,772,23,7,0.109024149,0.890975851,2005.387133,2156.650186,3437.133302,4389.82772,7081,140.6355511,14162,-3230208,395264,-2834944,50
3811,293,23,7,0.0713937622,0.928606238,1177.846311,1219.671298,2078.931514,1708.709898,4104,73.42995169,8208,-1951232,150016,-1801216,50
6349,756,23,7,0.106403941,0.893596059,2014.987944,2128.9785,3445.909435,4452.362434,7105,142.6993372,14210,-3250688,387072,-2863616,50
6392,810,23,7,0.112468759,0.887531241,2046.345416,2129.526447,3491.316489,4470.997531,7202,132.6335175,14404,-3272704,414720,-2857984,50
6447,805,23,7,0.111003861,0.888996139,2050.611323,2192.297869,3508.831705,4568.869565,7252,148.6674867,14504,-3300864,412160,-2888704,50
6311,778,23,7,0.109747496,0.890252504,2004.217538,2169.253492,3436.583426,4424.456298,7089,140.1542112,14178,-3231232,398336,-2832896,50
6567,811,23,7,0.109921388,0.890078612,2096.554997,2261.176343,3602.108269,4397.146732,7378,129.3478261,14756,-3362304,415232,-2947072,50
6358,788,23,7,0.110271481,0.889728519,2021.631356,2139.134805,3454.354829,4534.826142,7146,145.2143873,14292,-3255296,403456,-2851840,50
6539,847,23,7,0.114676415,0.885323585,2090.660114,2264.542171,3586.505276,4519.519481,7386,142.6694997,14772,-3347968,433664,-2914304,50
6518,817,23,7,0.111383776,0.888616224,2079.130388,2255.232243,3570.579165,4445.220318,7335,143.5139894,14670,-3337216,418304,-2918912,50
6119,762,23,7,0.110739718,0.889260282,1951.80758,2101.034257,3348.20134,4186.190289,6881,136.0688155,13762,-3132928,390144,-2742784,50
6321,789,23,7,0.110970464,0.889029536,2011.441146,2147.115202,3441.471128,4469.031686,7110,141.8878467,14220,-3236352,403968,-2832384,50
919,95,23,7,0.0936883629,0.906311637,289.793914,314.7887283,512.9434168,454.8421053,1014,19.46630831,2028,-470528,48640,-421888,50
6657,3250,23,7,0.328050873,0.671949127,2396.368128,2112.229473,3773.035301,7372.979077,9907,408.7046205,19814,-3408384,1664000,-1744384,50
6370,767,23,7,0.107468124,0.892531876,2016.463861,2242.625622,3473.915856,4358.681877,7137,142.9114938,14274,-3261440,392704,-2868736,50
6557,832,23,7,0.112599811,0.887400189,2096.217591,2262.283933,3598.00244,4459.438702,7389,135.1563929,14778,-3357184,425984,-2931200,50
6527,834,23,7,0.113299823,0.886700177,2087.781207,2247.569785,3581.140034,4462.517986,7361,137.0763501,14722,-3341824,427008,-2914816,50
6022,755,23,7,0.111406227,0.888593773,1925.285259,2033.505138,3293.425108,4151.32053,6777,120.802139,13554,-3083264,386560,-2696704,50
2785,210,23,7,0.0701168614,0.929883139,854.6696244,937.7416063,1520.310952,1202.114286,2995,39.35093943,5990,-1425920,107520,-1318400,50
1404,157,23,7,0.100576553,0.899423447,444.7753342,498.0289386,785.5505698,740.3057325,1561,23.35078534,3122,-718848,80384,-638464,50
4861,587,23,7,0.107745962,0.892254038,1527.622854,1792.330198,2650.725365,3335.434412,5448,104.4678811,10896,-2488832,300544,-2188288,50
4918,548,23,7,0.100256129,0.899743871,1540.4587,1794.458511,2673.949166,3267.936131,5466,104.4924489,10932,-2518016,280576,-2237440,50
4959,601,23,7,0.108093525,0.891906475,1557.440058,1812.570088,2696.966526,3469.755408,5560,113.5620915,11120,-2539008,307712,-2231296,50
4761,558,23,7,0.104906937,0.895093063,1492.817699,1726.441366,2583.2636,3314.734767,5319,104.787234,10638,-2437632,285696,-2151936,50
4812,576,23,7,0.106904232,0.893095768,1506.064333,1796.023837,2618.208645,3331.850694,5388,110.3646047,10776,-2463744,294912,-2168832,50
1662,164,23,7,0.0898138007,0.910186199,524.9097095,505.4954611,933.6696751,709.097561,1826,33.46774194,3652,-850944,83968,-766976,50
4949,627,23,7,0.112446198,0.887553802,1566.811296,1797.465754,2709.848858,3409.304625,5576,110.6568764,11152,-2533888,321024,-2212864,50
4865,601,23,7,0.109952433,0.890047567,1536.904968,1787.56648,2666.755807,3273.783694,5466,96.04638904,10932,-2490880,307712,-2183168,50
4944,637,23,7,0.114137251,0.885862749,1568.497711,1793.513256,2711.462985,3408.317111,5581,109.1317951,11162,-2531328,326144,-2205184,50
4850,613,23,7,0.112209409,0.887790591,1527.779931,1785.54502,2647.057938,3404.053834,5463,114.2409034,10926,-2483200,313856,-2169344,50
4796,553,23,7,0.10338381,0.89661619,1502.911201,1760.272275,2608.155546,3254.721519,5349,105.8369608,10698,-2455552,283136,-2172416,50
4835,580,23,7,0.10710988,0.89289012,1517.231363,1736.01017,2619.498656,3445.765517,5415,100.3521127,10830,-2475520,296960,-2178560,50
4919,604,23,7,0.109360855,0.890639145,1547.352662,1821.748698,2686.3889,3377.779801,5523,111.5532216,11046,-2518528,309248,-2209280,50
4831,581,23,7,0.107354028,0.892645972,1524.669699,1739.775716,2636.442765,3289.024096,5412,100.5574136,10824,-2473472,297472,-2176000,50
2640,267,23,7,0.0918472652,0.908152735,831.2851783,905.6162165,1465.5875,1339.426966,2907,51.08065366,5814,-1351680,136704,-1214976,50
4819,574,23,7,0.106434267,0.893565733,1511.310842,1781.753529,2623.905997,3310.658537,5393,107.5373878,10786,-2467328,293888,-2173440,50
4842,606,23,7,0.11123348,0.88876652,1527.009647,1776.414386,2645.40252,3356.4967,5448,104.4078191,10896,-2479104,310272,-2168832,50
4464,549,23,7,0.10951526,0.89048474,1404.500757,1611.896895,2426.229391,3163.757741,5013,97.83372365,10026,-2285568,281088,-2004480,50
1219,152,23,7,0.11086798,0.88913202,391.1224702,425.99052,693.90484,622.6052632,1371,19.26914968,2742,-624128,77824,-546304,50
2544,189,23,7,0.069154775,0.930845225,775.5016255,897.0416788,1389.772013,1060.481481,2733,38.66176263,5466,-1302528,96768,-1205760,50
5159,552,24,6,0.096655577,0.903344423,1596.700563,1808.942363,2753.26478,3816.164855,5711,110.1234092,11422,-2641408,282624,-2358784,50
4340,539,24,6,0.110473458,0.889526542,1359.685612,1572.461846,2349.428571,3169.276438,4879,96.11899133,9758,-2222080,275968,-1946112,50
4506,591,23,7,0.115950559,0.884049441,1424.589125,1653.340875,2464.952952,3189.805415,5097,91.32771905,10194,-2307072,302592,-2004480,50
4488,557,23,7,0.110406343,0.889593657,1407.329018,1590.94661,2423.578877,3324.08079,5045,102.3741883,10090,-2297856,285184,-2012672,50
4447,581,23,7,0.115552904,0.884447096,1402.944679,1628.29152,2426.297279,3189.607573,5028,100.0397931,10056,-2276864,297472,-1979392,50
4341,516,24,6,0.106238419,0.893761581,1365.337846,1618.529092,2378.492283,2853.910853,4857,85.63117066,9714,-2222592,264192,-1958400,50
4114,506,24,6,0.10952381,0.89047619,1292.697127,1480.068591,2231.507535,2952.743083,4620,85.11422255,9240,-2106368,259072,-1847296,50
4213,567,23,7,0.118619247,0.881380753,1327.395649,1560.704701,2299.060764,3069.924162,4780,89.39592295,9560,-2157056,290304,-1866752,50
4553,585,24,6,0.113857532,0.886142468,1436.456775,1656.558949,2482.432462,3247.138462,5138,105.7419222,10276,-2331136,299520,-2031616,50
4505,583,23,7,0.114583333,0.885416667,1422.541058,1627.96209,2455.007769,3236.030875,5088,99.375,10176,-2306560,298496,-2008064,50
4517,602,24,6,0.117601094,0.882398906,1427.855782,1646.948917,2466.437458,3262.0299,5119,89.88586479,10238,-2312704,308224,-2004480,50
4559,587,24,6,0.11406918,0.88593082,1437.930011,1641.624027,2480.219346,3297.974446,5146,95.34926811,10292,-2334208,300544,-2033664,50
4414,565,23,7,0.113476602,0.886523398,1388.817176,1658.875237,2415.24377,3074.024779,4979,89.22939068,9958,-2259968,289280,-1970688,50
4088,507,23,7,0.110337323,0.889662677,1282.016031,1434.011823,2204.568249,3051.351085,4595,87.10900474,9190,-2093056,259584,-1833472,50
4546,582,24,6,0.11349454,0.88650546,1431.710803,1665.356362,2477.263748,3245.902062,5128,91.29428521,10256,-2327552,297984,-2029568,50
4054,506,23,7,0.110964912,0.889035088,1269.894153,1447.693653,2189.358905,3010.709486,4560,91.2,9120,-2075648,259072,-1816576,50
4502,581,23,7,0.114302577,0.885697423,1421.358221,1653.490174,2460.690138,3172.046472,5083,91.02793696,10166,-2305024,297472,-2007552,50
4473,583,24,6,0.115308544,0.884691456,1413.258222,1678.991544,2457.927789,3069.957118,5056,89.66128746,10112,-2290176,298496,-1991680,50
4512,595,24,6,0.116506755,0.883493245,1424.7816,1679.581566,2471.754211,3177.685714,5107,106.5512205,10214,-2310144,304640,-2005504,50
4558,595,24,6,0.115466718,0.884533282,1437.150675,1706.061493,2496.384599,3194.554622,5153,102.3435948,10306,-2333696,304640,-2029056,50
6099,787,24,6,0.114289863,0.885710137,1951.41449,2018.133016,3322.678308,4379.829733,6886,125.4966284,13772,-3122688,402944,-2719744,50
632,64,24,6,0.091954023,0.908045977,199.0171266,211.7340516,353.8227848,295.9375,696,25.83518931,1392,-323584,32768,-290816,50
6072,700,23,7,0.103366804,0.896633196,1933.232646,1941.251683,3289.828063,4225.06,6772,133.7546909,13544,-3108864,358400,-2750464,50
6441,813,24,6,0.112076096,0.887923904,2057.168792,2220.18674,3530.235212,4398.081181,7254,132.8328145,14508,-3297792,416256,-2881536,50
5884,733,23,7,0.110775276,0.889224724,1876.519419,1961.684014,3202.417403,4164.568895,6617,129.4405321,13234,-3012608,375296,-2637312,50
6369,746,23,7,0.104848911,0.895151089,2028.660211,2028.094773,3447.959491,4497.474531,7115,141.5357072,14230,-3260928,381952,-2878976,50
6437,787,24,6,0.108942414,0.891057586,2044.754223,2188.079376,3500.972347,4524.702668,7224,146.5314402,14448,-3295744,402944,-2892800,50
6300,742,23,7,0.105367793,0.894632207,1997.03641,2095.374089,3411.936667,4451.754717,7042,124.3949832,14084,-3225600,379904,-2845696,50
5196,538,22,8,0.0938262993,0.906173701,1620.232395,1814.480069,2794.02194,3577.150558,5734,101.7749379,11468,-2660352,275456,-2384896,50
6430,811,24,6,0.112001105,0.887998895,2053.857701,2161.578544,3508.609331,4512.087546,7241,146.4011322,14482,-3292160,415232,-2876928,50
6317,766,23,7,0.108146266,0.891853734,2001.298136,2202.598281,3441.058097,4374.441253,7083,123.9803956,14166,-3234304,392192,-2842112,50
6328,773,24,6,0.108857907,0.891142093,2009.685219,2103.59975,3429.358091,4546.795602,7101,127.692861,14202,-3239936,395776,-2844160,50
6447,3253,23,7,0.335360825,0.664639175,2672.37258,1829.850842,3853.154335,6827.102367,9700,197.7170811,19400,-3300864,1665536,-1635328,50
6311,3227,24,6,0.338330887,0.661669113,2589.581419,1829.596129,3755.336872,6752.885033,9538,169.1434652,19076,-3231232,1652224,-1579008,50
6453,823,24,6,0.1131116,0.8868884,2064.815979,2177.988404,3529.064001,4496.568651,7276,132.7494983,14552,-3303936,421376,-2882560,50
6285,727,24,6,0.103679407,0.896320593,1981.6836,2143.135438,3398.290056,4441.98762,7012,129.7557365,14024,-3217920,372224,-2845696,50
5998,774,23,7,0.114294152,0.885705848,1914.637569,2003.406271,3264.111704,4334.930233,6772,128.5985568,13544,-3070976,396288,-2674688,50
6002,745,23,7,0.110419446,0.889580554,1912.763418,2023.699638,3270.31123,4209.355705,6747,131.5204678,13494,-3073024,381440,-2691584,50
6038,777,23,7,0.114013206,0.885986794,1935.199583,1974.421674,3290.180523,4323.564994,6815,140.6314486,13630,-3091456,397824,-2693632,50
5925,747,24,6,0.111960432,0.888039568,1888.265157,1988.356337,3223.855359,4229.966533,6672,119.548468,13344,-3033600,382464,-2651136,50
4347,572,24,6,0.116283798,0.883716202,1371.915941,1629.720147,2383.700483,3039.84965,4919,98.61668003,9838,-2225664,292864,-1932800,50
688,102,24,6,0.129113924,0.870886076,217.0404952,290.0905845,391.3081395,423.7745098,790,17.74084887,1580,-352256,52224,-300032,50
4278,555,23,7,0.114835506,0.885164494,1347.454625,1578.541831,2333.915381,3057.425225,4833,96.42857143,9666,-2190336,284160,-1906176,50
4383,586,24,6,0.117931173,0.882068827,1385.48845,1570.368049,2385.832535,3226.725256,4969,100.9343896,9938,-2244096,300032,-1944064,50
3981,534,24,6,0.118272425,0.881727575,1253.454071,1413.388832,2156.254459,3016.518727,4515,92.01141227,9030,-2038272,273408,-1764864,50
3978,535,24,6,0.118546421,0.881453579,1257.511799,1404.877006,2160.377577,2975.437383,4513,94.23679265,9026,-2036736,273920,-1762816,50
4303,565,23,7,0.116064092,0.883935908,1353.952719,1507.887134,2325.510806,3264.553982,4868,86.69634907,9736,-2203136,289280,-1913856,50
4317,572,23,7,0.116997341,0.883002659,1364.59648,1562.013721,2354.261524,3129.821678,4889,86.74591909,9778,-2210304,292864,-1917440,50
3896,497,24,6,0.113134532,0.886865468,1214.988874,1424.406876,2102.859856,2934.967807,4393,88.31926015,8786,-1994752,254464,-1740288,50
4431,571,23,7,0.114154338,0.885845662,1396.862339,1595.268636,2409.271948,3217.196147,5002,99.01029295,10004,-2268672,292352,-1976320,50
4055,517,24,6,0.113079615,0.886920385,1274.281069,1436.512474,2193.108015,3019.003868,4572,94.09343486,9144,-2076160,264704,-1811456,50
496,50,24,6,0.0915750916,0.908424908,155.4431389,166.7378409,279.4153226,214.82,546,17.7503251,1092,-253952,25600,-228352,50
4429,2284,23,7,0.340235364,0.659764636,1596.294479,1372.313849,2497.226462,5024.222855,6713,117.4217247,13426,-2267648,1169408,-1098240,50
3999,532,23,7,0.117413375,0.882586625,1261.245228,1404.845138,2166.020255,3017.539474,4531,89.47472354,9062,-2047488,272384,-1775104,50
4083,536,23,7,0.116042433,0.883957567,1284.102292,1442.590844,2208.250796,3085.078358,4619,93.93939394,9238,-2090496,274432,-1816064,50
4379,563,23,7,0.113921489,0.886078511,1378.865239,1573.879423,2377.715232,3200.955595,4942,97.14959701,9884,-2242048,288256,-1953792,50
4343,561,24,6,0.114396411,0.885603589,1363.943861,1615.257156,2365.862537,3123.206774,4904,94.00038336,9808,-2223616,287232,-1936384,50
4384,589,23,7,0.118439574,0.881560426,1383.956573,1625.26268,2397.550411,3152.78438,4973,90.54989075,9946,-2244608,301568,-1943040,50
4354,579,23,7,0.117372795,0.882627205,1372.05839,1617.972828,2378.403078,3133.236615,4933,108.7522046,9866,-2229248,296448,-1932800,50
4330,538,24,6,0.110517666,0.889482334,1359.008237,1555.925909,2345.01709,3154.687732,4868,97.16566866,9736,-2216960,275456,-1941504,50
7485,856,22,8,0.102625584,0.897374416,2346.650879,2570.019042,4028.238477,5419.329439,8341,148.7074345,16682,-3832320,438272,-3394048,50
7497,868,22,8,0.10376569,0.89623431,2351.457366,2608.203809,4042.863412,5393.373272,8365,152.5624658,16730,-3838464,444416,-3394048,50
7192,809,22,8,0.101112361,0.898887639,2260.514171,2458.226182,3879.883343,5077.725587,8001,148.1118104,16002,-3682304,414208,-3268096,50
7710,862,22,8,0.100559963,0.899440037,2406.664538,2873.306527,4189.899222,5150.527842,8572,156.3662897,17144,-3947520,441344,-3506176,50
7418,823,22,8,0.0998665211,0.900133479,2326.13365,2473.710768,3980.522648,5387.173755,8241,160.6745954,16482,-3798016,421376,-3376640,50
7574,851,22,8,0.101008902,0.898991098,2373.322554,2550.262614,4065.210061,5528.347826,8425,165.0989614,16850,-3877888,435712,-3442176,50
5395,353,22,8,0.0614126653,0.938587335,1642.108532,1873.906813,2895.468582,2554.031161,5748,150.1175242,11496,-2762240,180736,-2581504,50
7104,806,22,8,0.101896334,0.898103666,2225.972749,2411.643602,3816.084178,5184.296526,7910,147.9057592,15820,-3637248,412672,-3224576,50
7209,823,22,8,0.102465139,0.897534861,2254.969728,2442.944587,3865.127202,5342.437424,8032,163.8849214,16064,-3691008,421376,-3269632,50
7600,849,22,8,0.100485265,0.899514735,2377.410582,2603.460432,4081.794474,5506.93404,8449,160.5053191,16898,-3891200,434688,-3456512,50
7509,822,22,8,0.0986676269,0.901332373,2340.150926,2593.192485,4023.953522,5463.599757,8331,157.010931,16662,-3844608,420864,-3423744,50
7467,830,22,8,0.100036158,0.899963842,2335.511438,2558.728431,4010.414892,5395.76506,8297,151.4327432,16594,-3823104,424960,-3398144,50
7273,799,22,8,0.0989841427,0.901015857,2268.466721,2524.359614,3902.919566,5252.433041,8072,153.9576578,16144,-3723776,409088,-3314688,50
7504,837,22,8,0.10034768,0.89965232,2344.612017,2620.277741,4036.103278,5380.396655,8341,153.4400294,16682,-3842048,428544,-3413504,50
3080,291,22,8,0.0863245328,0.913675467,965.2266647,1022.824892,1708.63474,1446.429553,3371,58.83071553,6742,-1576960,148992,-1427968,50
46,23,22,8,0.333333333,0.666666667,19.52993195,20.18983629,33.19565217,38.60869565,69,2.268990464,138,-23552,11776,-11776,50
7435,843,22,8,0.101836192,0.898163808,2329.694469,2589.086494,4007.776194,5301.263345,8278,166.7606769,16556,-3806720,431616,-3375104,50
35,15,22,8,0.3,0.7,13.62261026,16.01110726,24.71428571,27.33333333,50,2.09117524,100,-17920,7680,-10240,50
7602,872,22,8,0.102902997,0.897097003,2387.004637,2610.482084,4097.307682,5459.681193,8474,153.4311063,16948,-3892224,446464,-3445760,50
7528,854,22,8,0.101884992,0.898115008,2359.941636,2566.240269,4047.826249,5457.982436,8382,156.1184578,16764,-3854336,437248,-3417088,50
9388,586,21,9,0.0587527572,0.941247243,2871.336048,2797.075165,5053.703877,3926.882253,9974,269.7863132,19948,-4806656,300032,-4506624,51
9381,590,21,9,0.0591715976,0.940828402,2876.159586,2754.477032,5043.907686,4065.267797,9971,870.8296943,19942,-4803072,302080,-4500992,51
9265,499,21,9,0.0511061041,0.948893896,2801.43438,3007.09864,4926.260011,4070.002004,9764,804.2833608,19528,-4743680,255488,-4488192,51
9348,622,21,9,0.0623871615,0.937612839,2866.705167,2812.735553,5060.497647,3858.364952,9970,543.0283224,19940,-4786176,318464,-4467712,51
7749,394,22,8,0.0483851161,0.951614884,2321.792994,2554.963561,4135.762679,2817.946701,8143,721.2577502,16286,-3967488,201728,-3765760,51
8255,488,21,9,0.0558160814,0.944183919,2489.654295,2983.251046,4407.102362,3778.209016,8743,860.5314961,17486,-4226560,249856,-3976704,51
8627,578,21,9,0.0627919609,0.937208039,2646.689688,2649.096716,4663.83343,3695.024221,9205,163.2381628,18410,-4417024,295936,-4121088,51
7733,438,21,9,0.05360421,0.94639579,2323.295512,2708.828351,4145.294582,3039.139269,8171,998.8997555,16342,-3959296,224256,-3735040,51
9436,535,21,9,0.0536556012,0.946344399,2869.445821,2953.175193,5023.793451,4319.42243,9971,769.367284,19942,-4831232,273920,-4557312,51
5562,443,21,9,0.0737718568,0.926228143,1731.369151,1729.540725,3027.972312,2689.465011,6005,105.4804145,12010,-2847744,226816,-2620928,51
9293,457,21,9,0.0468717949,0.953128205,2798.187793,3053.392045,4908.410094,4206.280088,9750,907.8212291,19500,-4758016,233984,-4524032,51
9426,546,21,9,0.0547533093,0.945246691,2857.040105,3154.323849,5025.460641,4313.893773,9972,650.065189,19944,-4826112,279552,-4546560,51
7779,427,22,8,0.0520350963,0.947964904,2348.197909,2566.259054,4151.365728,3231.491803,8206,764.0595903,16412,-3982848,218624,-3764224,51
9386,584,21,9,0.0585757272,0.941424273,2867.549488,2922.971639,5036.479757,4166.157534,9970,705.5909413,19940,-4805632,299008,-4506624,51
7704,439,21,9,0.0539113349,0.946088665,2325.754725,2586.252992,4124.072949,3158.173121,8143,542.8666667,16286,-3944448,224768,-3719680,51
8216,424,21,9,0.0490740741,0.950925926,2460.91477,2855.132055,4376.998905,3225.700472,8640,625.1808973,17280,-4206592,217088,-3989504,51
9447,526,22,8,0.0527424045,0.947257596,2854.913684,3136.460499,5039.175929,4049.91635,9973,724.2556282,19946,-4836864,269312,-4567552,51
9293,522,21,9,0.0531839022,0.946816098,2803.158348,3295.090998,4932.409663,4473.442529,9815,783.9456869,19630,-4758016,267264,-4490752,51
8994,538,21,9,0.0564414603,0.94355854,2747.88027,2659.432905,4819.934845,3873.204461,9532,586.9458128,19064,-4604928,275456,-4329472,51
6529,451,21,9,0.0646131805,0.935386819,2004.37114,2018.983403,3542.22423,2741.702882,6980,100.5763689,13960,-3342848,230912,-3111936,51
5467,401,21,9,0.0683367416,0.931663258,1685.938244,1763.041724,2960.037864,2586.331671,5868,495.1898734,11736,-2799104,205312,-2593792,51
7387,589,21,9,0.0738465396,0.92615346,2279.277586,2543.636363,3957.410586,4378.410866,7976,157.5350583,15952,-3782144,301568,-3480576,51
5621,414,21,9,0.0685998343,0.931400166,1733.906815,1803.206392,3047.547767,2616.821256,6035,622.1649485,12070,-2877952,211968,-2665984,51
5272,361,21,9,0.0640866323,0.935913368,1611.893174,1781.683311,2841.959598,2452.493075,5633,310.3581267,11266,-2699264,184832,-2514432,51
5508,405,21,9,0.0684931507,0.931506849,1697.312902,1801.095815,2981.088417,2629.397531,5913,242.8336756,11826,-2820096,207360,-2612736,51
6886,604,21,9,0.0806408545,0.919359146,2132.135429,2427.811833,3703.322393,4226.352649,7490,150.3714114,14980,-3525632,309248,-3216384,51
5577,349,21,9,0.0588930138,0.941106986,1702.939276,1807.011657,2981.084275,2682.504298,5926,433.8213763,11852,-2855424,178688,-2676736,51
5551,396,21,9,0.0665881957,0.933411804,1709.02301,1796.683677,2994.7078,2683.724747,5947,334.8536036,11894,-2842112,202752,-2639360,51
5273,401,22,8,0.0706732464,0.929326754,1624.509181,1747.110465,2870.835198,2399.154613,5674,473.2276897,11348,-2699776,205312,-2494464,51
5310,359,22,8,0.0633268654,0.936673135,1629.206621,1730.051171,2847.639548,2648.047354,5669,535.8223062,11338,-2718720,183808,-2534912,51
5489,419,22,8,0.0709207854,0.929079215,1696.173256,1773.57316,2985.58098,2547.331742,5908,579.7841021,11816,-2810368,214528,-2595840,51
5956,406,22,8,0.0638164099,0.93618359,1831.482822,1894.359376,3197.253694,2950.394089,6362,370.7459207,12724,-3049472,207872,-2841600,51
5543,377,21,9,0.0636824324,0.936317568,1701.221377,1790.971771,2981.395093,2653.281167,5920,260.9078889,11840,-2838016,193024,-2644992,51
5459,353,21,9,0.0607364074,0.939263593,1670.937167,1766.58822,2920.297307,2693.130312,5812,705.3398058,11624,-2795008,180736,-2614272,51
5431,397,21,9,0.0681194235,0.931880577,1675.132347,1756.1981,2934.457006,2641.486146,5828,480.8580858,11656,-2780672,203264,-2577408,51
5448,394,21,9,0.0674426566,0.932557343,1679.09681,1753.348897,2944.828744,2598.923858,5842,386.8874172,11684,-2789376,201728,-2587648,51
5280,363,22,8,0.0643274854,0.935672515,1620.99591,1726.67423,2836.914205,2605.066116,5643,272.7404543,11286,-2703360,185856,-2517504,51
2029,168,22,8,0.0764679108,0.923532089,637.9884022,532.1835949,1118.668802,861.452381,2197,42.37222758,4394,-1038848,86016,-952832,51
2644,198,21,9,0.069669247,0.930330753,814.1907409,844.6989449,1443.812027,1123.555556,2842,52.72727273,5684,-1353728,101376,-1252352,51
3294,218,21,9,0.0620728929,0.937927107,1005.909063,1068.361422,1779.439284,1409.885321,3512,53.80726214,7024,-1686528,111616,-1574912,51
226,31,22,8,0.120622568,0.879377432,73.88510362,65.81566982,133.9823009,92.67741935,257,6.020145233,514,-115712,15872,-99840,51
633,46,21,9,0.0677466863,0.932253314,192.353856,237.8165446,342.628752,303.826087,679,36.38799571,1358,-324096,23552,-300544,51
6099,471,21,9,0.0716894977,0.928310502,1889.544346,1967.931079,3305.189375,3030.541401,6570,553.9629005,13140,-3122688,241152,-2881536,51
5607,375,21,9,0.0626880642,0.937311936,1721.223607,1808.958134,2991.310326,2994.336,5982,292.0898438,11964,-2870784,192000,-2678784,51
5576,385,21,9,0.0645864788,0.935413521,1710.720232,1832.222331,3002.604555,2668.098701,5961,242.9095355,11922,-2854912,197120,-2657792,51
5609,414,22,8,0.06873651,0.93126349,1728.225583,1809.774158,3046.843466,2539.929952,6023,308.5553279,12046,-2871808,211968,-2659840,51
5484,378,21,9,0.0644831116,0.935516888,1681.425777,1821.852848,2949.444201,2671.166667,5862,724.5982695,11724,-2807808,193536,-2614272,51
5580,390,22,8,0.0653266332,0.934673367,1718.660204,1766.66846,3004.839427,2708.797436,5970,524.143986,11940,-2856960,199680,-2657280,51
5612,396,21,9,0.0659121172,0.934087883,1727.833071,1801.583724,3024.094975,2726.805556,6008,347.283237,12016,-2873344,202752,-2670592,51
5628,398,21,9,0.0660471291,0.933952871,1731.699804,1810.456426,3038.512793,2659.801508,6026,186.1600247,12052,-2881536,203776,-2677760,51
5609,396,22,8,0.0659450458,0.934054954,1726.272661,1807.579279,3023.645035,2710.580808,6005,115.3255233,12010,-2871808,202752,-2669056,51
5555,413,21,9,0.0692024129,0.930797587,1713.820417,1805.952735,3009.584698,2647.101695,5968,448.3846732,11936,-2844160,211456,-2632704,51
5574,393,21,9,0.0658622423,0.934137758,1717.267692,1784.763427,2997.314496,2795.157761,5967,587.8817734,11934,-2853888,201216,-2652672,51
8157,804,21,9,0.0897221292,0.910277871,2555.327551,2824.379157,4424.783989,5051.340796,8961,159.1651865,17922,-4176384,411648,-3764736,51
5545,385,21,9,0.0649241147,0.935075885,1702.163392,1791.384189,2995.324797,2535.945455,5930,399.5956873,11860,-2839040,197120,-2641920,51
5554,404,21,9,0.0678079893,0.932192011,1710.031084,1813.930764,3005.247209,2625.539604,5958,430.1805054,11916,-2843648,206848,-2636800,51
435,38,22,8,0.0803382664,0.919661734,135.0500125,130.3875775,243.6413793,160.9736842,473,16.66079605,946,-222720,19456,-203264,51
5522,383,21,9,0.0648602879,0.935139712,1695.92037,1788.952552,2977.391887,2601.32376,5905,607.5102881,11810,-2827264,196096,-2631168,51
5559,423,22,8,0.0707121364,0.929287864,1716.115346,1835.006142,3014.777298,2685.593381,5982,104.7635727,11964,-2846208,216576,-2629632,51
3304,244,21,9,0.0687711387,0.931228861,1016.841008,1068.154188,1798.349274,1451.557377,3548,55.35965049,7096,-1691648,124928,-1566720,51
2673,227,21,9,0.0782758621,0.921724138,830.8834733,847.0825694,1477.110363,1137.154185,2900,69.31166348,5800,-1368576,116224,-1252352,51
2752,204,22,8,0.0690121786,0.930987821,844.1522615,965.8838907,1483.681323,1408.602941,2956,242.0966421,5912,-1409024,104448,-1304576,51
2774,252,21,9,0.0832782551,0.916721745,863.8306111,939.1596822,1535.938356,1266.5,3026,254.2857143,6052,-1420288,129024,-1291264,51
2780,245,22,8,0.0809917355,0.919008264,868.6424058,921.9555708,1517.973741,1456.563265,3025,438.4057971,6050,-1423360,125440,-1297920,51
2744,219,21,9,0.0739115761,0.926088424,844.8218909,972.8592414,1489.412536,1389.123288,2963,235.5325914,5926,-1404928,112128,-1292800,51
2737,243,22,8,0.0815436242,0.918456376,854.9363162,901.1513417,1505.396054,1322.720165,2980,180.1692866,5960,-1401344,124416,-1276928,51
63,12,21,9,0.16,0.84,21.60846302,15.72396437,40.65079365,24.08333333,75,1.388888889,150,-32256,6144,-26112,51
2792,250,21,9,0.0821827745,0.917817226,867.851189,962.9518284,1539.633596,1318.984,3042,355.3738318,6084,-1429504,128000,-1301504,51
2859,239,22,8,0.0771465462,0.922853454,888.4481479,934.6435884,1567.701294,1331.769874,3098,292.8166352,6196,-1463808,122368,-1341440,51
2755,233,21,9,0.077978581,0.922021419,853.8659195,946.7266512,1507.131397,1345.145923,2988,314.5263158,5976,-1410560,119296,-1291264,51
2801,227,21,9,0.0749669749,0.925033025,867.0030922,934.5561642,1530.722599,1314.325991,3028,114.2210487,6056,-1434112,116224,-1317888,51
2778,250,21,9,0.0825627477,0.917437252,862.8957242,966.6773399,1532.991361,1309.024,3028,164.9237473,6056,-1422336,128000,-1294336,51
2760,249,21,9,0.0827517448,0.917248255,859.9681135,929.0494568,1525.667029,1275.919679,3009,273.5454545,6018,-1413120,127488,-1285632,51
2815,244,21,9,0.079764629,0.920235371,875.9285167,925.2683266,1551.735702,1279.237705,3059,352.8258362,6118,-1441280,124928,-1316352,51
2759,240,21,9,0.0800266756,0.919973324,855.9943979,957.4731469,1513.342153,1346.620833,2999,52.68798313,5998,-1412608,122880,-1289728,51
2699,197,21,9,0.0680248619,0.931975138,824.597034,962.8770263,1460.960356,1277.786802,2896,390.8232119,5792,-1381888,100864,-1281024,51
457,41,21,9,0.0823293173,0.917670683,142.2233164,131.1971057,257.3544858,161.9512195,498,17.93948127,996,-233984,20992,-212992,51
2748,243,21,9,0.0812437312,0.918756269,856.7790324,909.0982721,1514.642649,1285.176955,2991,281.1090226,5982,-1406976,124416,-1282560,51
2718,230,21,9,0.0780189959,0.921981004,844.7463832,903.7113599,1489.290655,1299.713043,2948,55.52834809,5896,-1391616,117760,-1273856,51
2776,236,22,8,0.0783532537,0.921646746,861.5950349,939.5398515,1521.554755,1329.415254,3012,162.2844828,6024,-1421312,120832,-1300480,51
3398,203,21,9,0.0563732297,0.94362677,1030.346184,1173.470295,1809.486463,1658.945813,3601,245.6343793,7202,-1739776,103936,-1635840,51
3413,225,21,9,0.0618471688,0.938152831,1039.196383,1190.31132,1831.416642,1638.737778,3638,367.8463094,7276,-1747456,115200,-1632256,51
3479,242,21,9,0.0650362806,0.934963719,1065.760186,1184.515486,1867.435757,1768.479339,3721,437.2502938,7442,-1781248,123904,-1657344,51
3410,247,21,9,0.0675417008,0.932458299,1045.941659,1152.662023,1847.311144,1576.202429,3657,450.9247842,7314,-1745920,126464,-1619456,51
3426,212,21,9,0.0582737768,0.941726223,1038.21308,1224.545438,1824.859311,1732.891509,3638,415.7714286,7276,-1754112,108544,-1645568,51
3415,221,21,9,0.0607810781,0.939218922,1039.89976,1177.699627,1829.119473,1654.402715,3636,435.971223,7272,-1748480,113152,-1635328,51
3436,216,21,9,0.0591456736,0.940854326,1044.475801,1190.541876,1835.13766,1689.097222,3652,331.3974592,7304,-1759232,110592,-1648640,51
3528,263,21,9,0.0693748351,0.930625165,1085.386355,1193.376805,1909.663549,1712.711027,3791,281.231454,7582,-1806336,134656,-1671680,51
3673,238,21,9,0.0608540015,0.939145998,1119.709305,1255.299459,1965.228696,1813.57563,3911,423.7269772,7822,-1880576,121856,-1758720,51
3379,203,21,9,0.0566722501,0.94332775,1024.799584,1169.680574,1799.229358,1662.842365,3582,377.4499473,7164,-1730048,103936,-1626112,51
3605,242,21,9,0.0629061606,0.937093839,1105.955121,1168.86378,1932.767268,1793.396694,3847,345.9532374,7694,-1845760,123904,-1721856,51
3394,218,21,9,0.0603543743,0.939645626,1031.402688,1199.149246,1813.835592,1692.293578,3612,302.5125628,7224,-1737728,111616,-1626112,51
3397,216,21,9,0.0597841129,0.940215887,1033.81474,1164.419551,1817.924934,1635.185185,3613,348.4088717,7226,-1739264,110592,-1628672,51
3478,270,21,9,0.0720384205,0.92796158,1075.507914,1137.077995,1892.328062,1644.848148,3748,319.7952218,7496,-1780736,138240,-1642496,51
3414,224,21,9,0.0615722925,0.938427708,1040.568363,1167.837751,1833.131517,1611.741071,3638,497.6744186,7276,-1747968,114688,-1633280,51
3394,206,21,9,0.0572222222,0.942777778,1028.917433,1195.420192,1803.37419,1753.145631,3600,272.9340409,7200,-1737728,105472,-1632256,51
3409,239,21,9,0.0655153509,0.934484649,1042.562681,1167.386143,1841.209152,1586.167364,3648,361.1881188,7296,-1745408,122368,-1623040,51
2545,187,21,9,0.0684480234,0.931551977,789.4384804,686.2651168,1392.490766,1012.775401,2732,118.6278767,5464,-1303040,95744,-1207296,51
3483,248,21,9,0.0664701153,0.933529885,1070.800534,1154.639869,1874.498134,1746.649194,3731,442.0616114,7462,-1783296,126976,-1656320,51
3655,264,21,9,0.0673641235,0.932635876,1123.816515,1210.893153,1975.253899,1748.814394,3919,274.0559441,7838,-1871360,135168,-1736192,51
7685,545,21,9,0.0662211422,0.933778858,2372.132148,2337.498205,4160.218998,3484.921101,8230,278.605281,16460,-3934720,279040,-3655680,51
3699,319,21,9,0.0793927327,0.920607267,1149.578953,1266.375553,2020.588808,1880.918495,4018,70.78928823,8036,-1893888,163328,-1730560,51
7854,605,22,8,0.0715214564,0.928478544,2439.048198,2411.419668,4272.563535,3677.447934,8459,149.2150291,16918,-4021248,309760,-3711488,51
7561,554,21,9,0.0682686383,0.931731362,2348.192531,2196.879071,4096.955165,3526.33935,8115,398.5756385,16230,-3871232,283648,-3587584,51
1171,137,21,9,0.104740061,0.895259939,379.0556986,352.5291835,664.882152,565.7591241,1308,25.2900232,2616,-599552,70144,-529408,51
7866,505,21,9,0.0603273205,0.939672679,2406.794158,2522.422282,4214.246758,3746.021782,8371,233.8268156,16742,-4027392,258560,-3768832,51
7859,565,21,9,0.0670702754,0.932929725,2427.071088,2429.787793,4252.349917,3658.19823,8424,254.8865356,16848,-4023808,289280,-3734528,51
7493,518,22,8,0.064661091,0.935338909,2307.749107,2325.417203,4040.292673,3509.947876,8011,394.4362383,16022,-3836416,265216,-3571200,51
7106,568,21,9,0.0740161585,0.925983842,2216.536755,2168.962525,3865.673515,3485.033451,7674,137.3299928,15348,-3638272,290816,-3347456,51
8403,593,21,9,0.0659181859,0.934081814,2604.859498,2431.095394,4532.510651,4016.558179,8996,369.9013158,17992,-4302336,303616,-3998720,51
7651,548,22,8,0.0668374192,0.933162581,2363.051028,2346.948062,4140.610508,3533.009124,8199,402.8992629,16398,-3917312,280576,-3636736,51
7921,573,21,9,0.0674593831,0.932540617,2449.885867,2444.627999,4277.1241,3837.984293,8494,148.9652753,16988,-4055552,293376,-3762176,51
7848,571,21,9,0.0678227818,0.932177218,2430.710327,2355.534456,4250.622452,3651.672504,8419,394.5173383,16838,-4018176,292352,-3725824,51
7790,520,21,9,0.0625752106,0.937424789,2403.79941,2272.74448,4186.904493,3685.036538,8310,364.3138974,16620,-3988480,266240,-3722240,51
7728,567,21,9,0.0683544304,0.93164557,2384.435675,2400.223647,4204.313018,3380.474427,8295,339.4026187,16590,-3956736,290304,-3666432,51
7817,561,21,9,0.0669610886,0.933038911,2419.771552,2343.043126,4225.854932,3682.928699,8378,302.4548736,16756,-4002304,287232,-3715072,51
7705,522,21,9,0.0634496171,0.936550383,2379.789309,2265.454174,4140.792732,3718.524904,8227,408.8966203,16454,-3944960,267264,-3677696,51
8460,630,21,9,0.0693069307,0.930693069,2625.047252,2491.506755,4601.529905,3793.098413,9090,227.3636818,18180,-4331520,322560,-4008960,51
7752,548,21,9,0.0660240964,0.933975904,2400.474021,2275.203714,4185.399639,3656.810219,8300,302.2578296,16600,-3969024,280576,-3688448,51
8850,648,22,8,0.0682248895,0.931775111,2741.400702,2742.258254,4761.806102,4581.430556,9498,420.2654867,18996,-4531200,331776,-4199424,51
9351,614,21,9,0.0616156548,0.938384345,2870.309216,2882.920395,5028.807293,4285.371336,9965,346.247394,19930,-4787712,314368,-4473344,51
9047,622,22,8,0.0643292998,0.9356707,2788.632397,2799.326615,4861.84481,4444.541801,9669,517.3354735,19338,-4632064,318464,-4313600,51
5784,479,21,9,0.0764809197,0.92351908,1800.480771,1894.73344,3126.273859,3201.14405,6263,109.3019197,12526,-2961408,245248,-2716160,51
9287,678,21,9,0.0680381335,0.931961867,2869.090583,2894.189145,5032.512437,4304.79646,9965,426.7665953,19930,-4754944,347136,-4407808,51
9249,709,22,8,0.071199036,0.928800964,2862.199203,3011.418492,5005.609688,4638.895628,9958,194.302439,19916,-4735488,363008,-4372480,51
8978,562,21,9,0.0589098532,0.941090147,2756.073482,2715.233335,4780.261528,4614.558719,9540,498.9539749,19080,-4596736,287744,-4308992,51
9138,581,21,9,0.0597798127,0.940220187,2803.222507,2803.976462,4889.047713,4403.135972,9719,338.8772664,19438,-4678656,297472,-4381184,51
8896,599,21,9,0.0630858346,0.936914165,2726.910062,2856.966167,4793.736174,4068.752922,9495,450.6407214,18990,-4554752,306688,-4248064,51
3938,476,21,9,0.107838695,0.892161305,1264.864943,1348.478047,2202.978669,2244.905462,4414,77.8620568,8828,-2016256,243712,-1772544,51
8911,563,22,8,0.0594257969,0.940574203,2725.130593,2829.267456,4772.159241,4188.923623,9474,491.9003115,18948,-4562432,288256,-4274176,51
3163,225,21,9,0.0664108619,0.933589138,967.7143863,896.1544846,1739.86595,1056.755556,3388,58.32329144,6776,-1619456,115200,-1504256,51
9027,636,21,9,0.0658180689,0.934181931,2767.109017,2984.657024,4886.320815,4061.003145,9663,169.3777388,19326,-4621824,325632,-4296192,51
9274,693,21,9,0.0695294472,0.930470553,2885.247675,2687.448717,5031.66983,4346.063492,9967,411.5194055,19934,-4748288,354816,-4393472,51
8887,577,21,9,0.0609678783,0.939032122,2731.236171,2709.996655,4759.629684,4314.646447,9464,407.0537634,18928,-4550144,295424,-4254720,51
8883,578,21,9,0.0610929077,0.938907092,2725.889564,2790.278452,4752.398401,4402.138408,9461,450.0951475,18922,-4548096,295936,-4252160,51
8862,578,21,9,0.0612288136,0.938771186,2720.191051,2735.049037,4758.147709,4143.278547,9440,396.8053804,18880,-4537344,295936,-4241408,51
8969,560,21,9,0.0587679715,0.941232029,2745.879814,2802.979257,4787.825176,4399.430357,9529,400.7148865,19058,-4592128,286720,-4305408,51
9290,667,21,9,0.0669880486,0.933011951,2874.112709,2876.839079,4983.206781,4920.407796,9957,527.104288,19914,-4756480,341504,-4414976,51
8991,618,21,9,0.064314705,0.935685295,2762.48111,2857.409546,4849.487599,4157.770227,9609,460.6423778,19218,-4603392,316416,-4286976,51
1066,130,21,9,0.108695652,0.891304348,351.7444295,257.9264993,612.8742964,480.6307692,1196,21.9248396,2392,-545792,66560,-479232,51
3082,227,21,9,0.0686007857,0.931399214,941.8635145,1022.678334,1687.63303,1211.938326,3309,260.7565012,6618,-1577984,116224,-1461760,51
3285,237,21,9,0.0672913118,0.932708688,1002.966204,1125.208475,1788.706545,1384.396624,3522,404.8275862,7044,-1681920,121344,-1560576,51
3307,237,21,9,0.0668735892,0.933126411,1008.015315,1176.586226,1793.131539,1484.616034,3544,61.84991274,7088,-1693184,121344,-1571840,51
3332,231,21,9,0.0648330059,0.935166994,1015.705346,1138.803027,1807.064826,1420.458874,3563,542.3135464,7126,-1705984,118272,-1587712,51
3542,228,21,9,0.0604774536,0.939522546,1073.085536,1265.863593,1904.531056,1589.850877,3770,343.9781022,7540,-1813504,116736,-1696768,51
3409,225,21,9,0.0619152449,0.938084755,1035.797233,1141.144718,1847.26254,1366.564444,3634,539.9702823,7268,-1745408,115200,-1630208,51
3515,221,21,9,0.0591541756,0.940845824,1062.147552,1278.712701,1886.22276,1586.61991,3736,299.8394864,7472,-1799680,113152,-1686528,51
3302,226,21,9,0.0640589569,0.935941043,1004.774147,1112.824457,1794.333131,1328.619469,3528,367.5,7056,-1690624,115712,-1574912,51
3412,216,21,9,0.059536935,0.940463065,1033.695003,1125.751549,1846.823857,1303.902778,3628,151.229679,7256,-1746944,110592,-1636352,51
3236,217,21,9,0.0628439039,0.937156096,982.7385584,1091.628999,1757.233004,1276.152074,3453,122.7515108,6906,-1656832,111104,-1545728,51
3748,259,21,9,0.0646368855,0.935363115,1137.217418,1406.778349,2009.35539,1926.501931,4007,292.2684172,8014,-1918976,132608,-1786368,51
3246,206,21,9,0.0596755504,0.94032445,987.7464339,1096.995163,1742.010474,1482.097087,3452,506.9016153,6904,-1661952,105472,-1556480,51
3062,203,21,9,0.0621745789,0.937825421,933.0497317,1023.736523,1654.133899,1314.221675,3265,309.478673,6530,-1567744,103936,-1463808,51
3316,217,21,9,0.0614208888,0.938579111,1010.039854,1110.465684,1788.270507,1441.963134,3533,610.1899827,7066,-1697792,111104,-1586688,51
3232,230,21,9,0.0664355864,0.933564414,984.4749782,1097.45797,1763.028775,1288.452174,3462,509.1176471,6924,-1654784,117760,-1537024,51
3253,222,21,9,0.0638848921,0.936115108,989.4002732,1105.71983,1766.401783,1321.824324,3475,386.5406007,6950,-1665536,113664,-1551872,51
3090,227,21,9,0.0684353331,0.931564667,943.4966765,1013.837245,1694.614563,1174.202643,3317,332.6980943,6634,-1582080,116224,-1465856,51
3261,217,21,9,0.0623921794,0.937607821,991.0749666,1112.775673,1765.08341,1355.041475,3478,285.3158326,6956,-1669632,111104,-1558528,51
3233,206,21,9,0.0599011341,0.940098866,980.1344914,1111.618362,1743.164862,1356.446602,3439,396.6551326,6878,-1655296,105472,-1549824,51
2319,178,21,9,0.0712855427,0.928714457,709.9878543,805.2272736,1269.005606,988.3651685,2497,34.40815764,4994,-1187328,91136,-1096192,51
2945,269,21,9,0.0836963286,0.916303671,919.8862985,964.7525517,1633.757895,1320.02974,3214,137.2331341,6428,-1507840,137728,-1370112,51
2840,260,21,9,0.0838709677,0.916129032,889.7208834,912.352055,1573.561972,1298.592308,3100,97.88443322,6200,-1454080,133120,-1320960,51
2833,263,21,9,0.0849483204,0.91505168,885.6291263,951.7512648,1568.029651,1338.129278,3096,354.2334096,6192,-1450496,134656,-1315840,51
2834,250,21,9,0.0810635538,0.918936446,882.5738576,943.622508,1562.674312,1313.804,3084,74.70930233,6168,-1451008,128000,-1323008,51
3044,263,21,9,0.0795282734,0.920471727,947.0332629,1015.8747,1671.964849,1446.072243,3307,290.8531223,6614,-1558528,134656,-1423872,51
3030,257,21,9,0.0781867965,0.921813204,940.740644,1009.192509,1664.459076,1402.789883,3287,241.1592076,6574,-1551360,131584,-1419776,51
3527,375,21,9,0.0961045618,0.903895438,1107.727474,1288.53105,1954.802665,1920.437333,3902,255.8688525,7804,-1805824,192000,-1613824,51
2864,254,21,9,0.0814624759,0.918537524,892.6336897,956.5229743,1577.715433,1354.110236,3118,328.9029536,6236,-1466368,130048,-1336320,51
2828,245,21,9,0.0797266515,0.920273349,878.7976147,961.2147249,1551.916549,1364.820408,3073,198.771022,6146,-1447936,125440,-1322496,51
2961,228,21,9,0.0714957667,0.928504233,919.2694477,877.3843765,1619.508274,1276.714912,3189,55.90813464,6378,-1516032,116736,-1399296,51
2891,260,21,9,0.0825134878,0.917486512,904.7806787,930.1938094,1597.043929,1342.007692,3151,340.2807775,6302,-1480192,133120,-1347072,51
3307,320,21,9,0.088227185,0.911772815,1025.517058,1245.472848,1807.013607,1886.2,3627,219.4192377,7254,-1693184,163840,-1529344,51
2851,259,21,9,0.0832797428,0.916720257,888.836733,978.9421131,1568.849877,1408.548263,3110,55.90508718,6220,-1459712,132608,-1327104,51
2727,225,21,9,0.0762195122,0.923780488,843.9065746,930.9176336,1490.104144,1311.617778,2952,373.6708861,5904,-1396224,115200,-1281024,51
2892,254,21,9,0.0807374444,0.919262556,902.8719444,945.6498427,1590.301521,1382.200787,3146,330.115425,6292,-1480704,130048,-1350656,51
2813,226,21,9,0.0743665679,0.925633432,865.2381379,983.8413888,1539.391753,1278.632743,3039,323.6421725,6078,-1440256,115712,-1324544,51
2871,266,21,9,0.0847943895,0.91520561,896.6587484,964.8048513,1591.182166,1329.582707,3137,387.2839506,6274,-1469952,136192,-1333760,51
2996,255,21,9,0.0784374039,0.921562596,934.2403013,958.7597308,1645.140521,1401.117647,3251,189.5626822,6502,-1533952,130560,-1403392,51
2854,275,21,9,0.087887504,0.912112496,894.9863329,954.8819001,1587.2726,1333.850909,3129,332.8723404,6258,-1461248,140800,-1320448,51
3438,339,21,9,0.0897537728,0.910246227,1064.325331,1317.474656,1875.294066,2028,3777,229.6048632,7554,-1760256,173568,-1586688,51
8878,749,21,9,0.0778020152,0.922197985,2783.001547,2703.080189,4846.181572,4432.547397,9627,451.1246485,19254,-4545536,383488,-4162048,51
145,26,22,8,0.152046784,0.847953216,48.83589253,51.83536752,87.02068966,80.30769231,171,3.624417126,342,-74240,13312,-60928,51
5257,470,22,8,0.0820674,0.9179326,1613.85699,2022.49876,2839.476317,3138.3,5727,431.5749812,11454,-2691584,240640,-2450944,51
8013,591,21,9,0.0686889819,0.931311018,2491.937878,2324.914851,4335.287533,3857.954315,8604,380.20327,17208,-4102656,302592,-3800064,51
7743,542,22,8,0.0654194327,0.934580567,2396.427976,2289.717494,4169.389255,3766.00369,8285,416.3316583,16570,-3964416,277504,-3686912,51
5191,437,21,9,0.0776474769,0.922352523,1582.658316,2055.000194,2804.001541,2939.208238,5628,448.8038278,11256,-2657792,223744,-2434048,51
8125,556,21,9,0.0640479207,0.935952079,2503.214066,2496.592597,4374.109538,3857.160072,8681,335.0443844,17362,-4160000,284672,-3875328,51
7996,593,22,8,0.0690417976,0.930958202,2476.068167,2439.024558,4341.562156,3667.15683,8589,375.2293578,17178,-4093952,303616,-3790336,51
8082,471,22,8,0.0550683971,0.944931603,2441.335938,2698.708664,4337.678916,3235.796178,8553,385.6176736,17106,-4137984,241152,-3896832,51
2991,107,22,8,0.0345384119,0.965461588,890.6102407,981.9408806,1554.528586,1408.934579,3098,105.6977141,6196,-1531392,54784,-1476608,51
8278,589,21,9,0.0664260742,0.933573926,2565.605865,2452.303005,4456.956511,4111.36163,8867,432.1150097,17734,-4238336,301568,-3936768,51
8109,617,21,9,0.0707082283,0.929291772,2519.531727,2455.82355,4402.145887,3855.591572,8726,295.596206,17452,-4151808,315904,-3835904,51
7820,595,22,8,0.0707070707,0.929292929,2434.841482,2297.180567,4245.644885,3713.238655,8415,196.9803371,16830,-4003840,304640,-3699200,51
7918,590,21,9,0.0693464974,0.930653503,2457.64774,2375.132887,4292.904016,3739.105085,8508,308.2608696,17016,-4054016,302080,-3751936,51
8072,563,21,9,0.0651997684,0.934800232,2488.282388,2504.702739,4352.136274,3828.571936,8635,291.3292848,17270,-4132864,288256,-3844608,51
8086,609,22,8,0.070040253,0.929959747,2519.146544,2351.49915,4377.229904,3959.899836,8695,340.9803922,17390,-4140032,311808,-3828224,51
4712,469,22,8,0.090523065,0.909476935,1457.210568,1826.810415,2572.177419,2780.108742,5181,377.6239067,10362,-2412544,240128,-2172416,51
7939,568,21,9,0.0667685436,0.933231456,2465.814239,2287.802468,4276.400806,3940.901408,8507,374.4278169,17014,-4064768,290816,-3773952,51
7789,554,21,9,0.0664029726,0.933597027,2411.363963,2324.513044,4202.532803,3742.722022,8343,428.2854209,16686,-3987968,283648,-3704320,51
7916,617,21,9,0.072307512,0.927692488,2452.286833,2504.42528,4319.436331,3594.251216,8533,382.4742268,17066,-4052992,315904,-3737088,51
4767,309,20,10,0.0608747045,0.939125296,1467.104196,1434.891754,2533.136564,2621.242718,5076,382.8054299,10152,-2440704,158208,-2282496,52
3785,215,20,10,0.05375,0.94625,1155.130982,1137.797778,2008.553765,1858.716279,4000,587.3715125,8000,-1937920,110080,-1827840,52
3748,221,20,10,0.0556815319,0.944318468,1144.133688,1155.21554,1996.609925,1788.104072,3969,408.3333333,7938,-1918976,113152,-1805824,52
4196,273,20,10,0.0610874916,0.938912508,1285.842024,1351.208479,2240.167064,2155.582418,4469,440.2955665,8938,-2148352,139776,-2008576,52
2546,173,20,10,0.0636263332,0.936373667,776.7939854,894.2293323,1363.547918,1307.786127,2719,255.065666,5438,-1303552,88576,-1214976,52
4266,269,20,10,0.0593164278,0.940683572,1303.311307,1395.664121,2273.306376,2183.847584,4535,624.6556474,9070,-2184192,137728,-2046464,52
4933,336,20,10,0.0637692162,0.936230784,1519.447597,1541.879021,2640.411717,2555.547619,5269,427.3317113,10538,-2525696,172032,-2353664,52
2566,176,20,10,0.064186725,0.935813275,784.7581923,883.7972165,1374.045986,1334.380682,2742,330.7599517,5484,-1313792,90112,-1223680,52
2567,176,20,10,0.0641633248,0.935836675,788.522732,838.6697277,1372.130892,1370.090909,2743,254.2168675,5486,-1314304,90112,-1224192,52
2548,184,20,10,0.0673499268,0.932650073,781.1536812,885.808754,1368.080063,1344.619565,2732,388.6201991,5464,-1304576,94208,-1210368,52
2845,211,20,10,0.0690445026,0.930955497,876.5551536,954.9412986,1528.471002,1528.890995,3056,215.5148096,6112,-1456640,108032,-1348608,52
3570,258,20,10,0.0673981191,0.932601881,1097.166631,1207.249081,1910.164986,1974.484496,3828,289.1238671,7656,-1827840,132096,-1695744,52
4835,306,20,10,0.0595214939,0.940478506,1480.746892,1535.717035,2570.242813,2582.964052,5141,412.9317269,10282,-2475520,156672,-2318848,52
4009,260,20,10,0.060904193,0.939095807,1225.066599,1338.423607,2138.693689,2078.046154,4269,340.1593625,8538,-2052608,133120,-1919488,52
3877,256,19,11,0.0619404791,0.938059521,1188.166867,1263.69495,2062.832087,2130.121094,4133,458.2039911,8266,-1985024,131072,-1853952,52
3035,212,19,11,0.0652910379,0.934708962,927.2778719,1070.469342,1621.90939,1653.929245,3247,396.4590965,6494,-1553920,108544,-1445376,52
2959,218,20,10,0.0686181933,0.931381807,904.8515291,1069.789524,1588.341332,1597.940367,3177,461.1030479,6354,-1515008,111616,-1403392,52
3506,221,20,10,0.0592970217,0.940702978,1072.738882,1119.862682,1857.606389,1965.429864,3727,353.6053131,7454,-1795072,113152,-1681920,52
4464,220,20,10,0.0469684031,0.953031597,1337.172394,1583.743657,2360.348342,1980.340909,4684,60.25987392,9368,-2285568,112640,-2172928,52
5841,259,19,11,0.0424590164,0.957540984,1742.824668,2099.875109,3065.596987,2710.030888,6100,89.52157323,12200,-2990592,132608,-2857984,52
2112,233,26,4,0.0993603412,0.900639659,671.7393988,681.8341906,1197.989583,946.4849785,2345,187.6,4690,-1081344,119296,-962048,52
2083,242,26,4,0.104086022,0.895913978,666.0356332,671.189633,1189.725396,932.9628099,2325,296.9348659,4650,-1066496,123904,-942592,52
2038,244,26,4,0.106923751,0.893076249,655.1294178,638.0451157,1170.712954,897.5,2282,78.66253016,4564,-1043456,124928,-918528,52
2052,231,26,4,0.101182654,0.898817346,656.1215538,647.9685491,1165.53655,932.9220779,2283,250.8791209,4566,-1050624,118272,-932352,52
2054,248,26,4,0.107732407,0.892267593,660.6698502,659.134947,1176.877313,941.3185484,2302,138.6746988,4604,-1051648,126976,-924672,52
2099,236,26,4,0.101070664,0.898929336,668.4390944,675.9797934,1195.068128,927.2542373,2335,105.4652213,4670,-1074688,120832,-953856,52
2039,231,26,4,0.101762115,0.898237885,652.5396996,634.434559,1161.509564,905.9177489,2270,123.4366504,4540,-1043968,118272,-925696,52
2063,228,26,4,0.0995198603,0.90048014,655.4313694,683.2708046,1167.262724,953.6096491,2291,130.6157355,4582,-1056256,116736,-939520,52
2050,234,26,4,0.102451839,0.897548161,654.4171892,661.602485,1167.534634,923.1794872,2284,257.4971815,4568,-1049600,119808,-929792,52
2035,234,26,4,0.103129132,0.896870868,649.5902125,655.6359928,1161.805405,901.8846154,2269,144.2466624,4538,-1041920,119808,-922112,52
2073,231,26,4,0.100260417,0.899739583,661.3293628,655.6274255,1177.844187,925.0606061,2304,160.1111883,4608,-1061376,118272,-943104,52
2055,218,26,4,0.095908491,0.904091509,653.2944312,655.910867,1156.052555,957.3990826,2273,84.46674099,4546,-1052160,111616,-940544,52
2044,229,26,4,0.10074791,0.89925209,653.0293044,636.0800803,1163.563112,899.9039301,2273,277.5335775,4546,-1046528,117248,-929280,52
2033,222,26,4,0.0984478936,0.901552106,648.3874818,639.4484579,1150.115593,925.472973,2255,180.1118211,4510,-1040896,113664,-927232,52
2077,230,26,4,0.0996965756,0.900303424,662.5415951,661.6168232,1176.768416,948.3913043,2307,214.2061281,4614,-1063424,117760,-945664,52
2055,233,26,4,0.101835664,0.898164336,656.0620384,659.5534897,1169.152311,927.0729614,2288,127.8212291,4576,-1052160,119296,-932864,52
2044,225,26,4,0.0991626267,0.900837373,651.7638718,646.3869562,1158.286204,923.4577778,2269,248.5213582,4538,-1046528,115200,-931328,52
2038,238,26,4,0.10456942,0.89543058,655.4854567,616.748494,1167.443572,890.6554622,2276,238.8247639,4552,-1043456,121856,-921600,52
2119,230,26,4,0.097914006,0.902085994,674.4995905,669.8304969,1199.392166,950.273913,2349,242.1649485,4698,-1084928,117760,-967168,52
2026,225,26,4,0.0999555753,0.900044425,647.0680813,637.7620803,1148.962981,919.2311111,2251,216.23439,4502,-1037312,115200,-922112,52
3947,259,23,7,0.0615786971,0.938421303,1199.251603,1387.253207,2083.567266,2407.262548,4206,209.9850225,8412,-2020864,132608,-1888256,52
3973,251,23,7,0.0594223485,0.940577652,1206.8031,1345.862566,2088.15555,2497.840637,4224,190.2702703,8448,-2034176,128512,-1905664,52
3953,259,22,8,0.0614909782,0.938509022,1202.110555,1381.473751,2088.678978,2378.494208,4212,207.2834646,8424,-2023936,132608,-1891328,52
3988,257,23,7,0.0605418139,0.939458186,1211.425926,1384.559138,2101.904965,2450.342412,4245,205.8680892,8490,-2041856,131584,-1910272,52
3990,248,23,7,0.0585181689,0.941481831,1210.630507,1375.192997,2099.880702,2435.149194,4238,205.0314465,8476,-2042880,126976,-1915904,52
4105,252,22,8,0.0578379619,0.942162038,1245.144382,1436.496619,2168.226797,2354.492063,4357,157.1789322,8714,-2101760,129024,-1972736,52
3994,250,23,7,0.0589066918,0.941093308,1211.400281,1397.845548,2105.141963,2399.812,4244,164.7515528,8488,-2044928,128000,-1916928,52
3947,254,23,7,0.0604617948,0.939538205,1198.578327,1376.806551,2080.772992,2415.314961,4201,203.7342386,8402,-2020864,130048,-1890816,52
3905,222,23,7,0.0537921008,0.946207899,1180.969234,1312.987024,2044.13009,2413.513514,4127,224.6597714,8254,-1999360,113664,-1885696,52
3526,204,23,7,0.054691689,0.945308311,1063.36646,1270.344765,1854.109756,2062.372549,3730,176.2759924,7460,-1805312,104448,-1700864,52
3892,259,23,7,0.0623946037,0.937605396,1187.881398,1342.63059,2070.812436,2153.953668,4151,102.140748,8302,-1992704,132608,-1860096,52
3940,255,22,8,0.0607866508,0.939213349,1197.044492,1375.828669,2078.919289,2392.815686,4195,201.006229,8390,-2017280,130560,-1886720,52
2923,143,23,7,0.046640574,0.953359426,879.1315835,985.0020335,1541.431064,1371.384615,3066,53.88400703,6132,-1496576,73216,-1423360,52
4019,258,22,8,0.0603226561,0.939677344,1220.723028,1392.223191,2117.504852,2473.841085,4277,150.8110014,8554,-2057728,132096,-1925632,52
3521,205,23,7,0.0550187869,0.944981213,1064.508666,1228.63503,1850.202499,2091.892683,3726,180.4358354,7452,-1802752,104960,-1697792,52
3910,258,22,8,0.0619001919,0.938099808,1189.111287,1370.877174,2066.525575,2356.903101,4168,220.5291005,8336,-2001920,132096,-1869824,52
3946,255,23,7,0.0606998334,0.939300167,1198.562169,1382.857189,2082.543588,2386.603922,4201,209.3173891,8402,-2020352,130560,-1889792,52
3951,251,23,7,0.0597334603,0.94026654,1200.478952,1362.251392,2082.830929,2395.370518,4202,246.3071512,8404,-2022912,128512,-1894400,52
1298,85,23,7,0.0614605929,0.938539407,391.6517181,498.7217785,695.0323575,645.6941176,1383,21.84489022,2766,-664576,43520,-621056,52
1306,86,23,7,0.0617816092,0.938218391,394.0119732,503.6237097,699.618683,649.1395349,1392,21.78403756,2784,-668672,44032,-624640,52
5514,289,23,7,0.0498018266,0.950198173,1652.387313,2062.368425,2901.603736,2909.560554,5803,182.5416798,11606,-2823168,147968,-2675200,52
5499,280,23,7,0.0484512892,0.951548711,1648.629628,2014.385851,2887.000182,2948.914286,5779,251.8082789,11558,-2815488,143360,-2672128,52
5488,276,23,7,0.0478834143,0.952116586,1646.029062,1985.685111,2879.630102,2939.565217,5764,184.5661223,11528,-2809856,141312,-2668544,52
5473,285,23,7,0.0494963529,0.950503647,1643.249271,1990.839947,2881.658871,2838.042105,5758,290.6612822,11516,-2802176,145920,-2656256,52
5484,281,23,7,0.0487424111,0.951257589,1647.11415,1968.295018,2883.940919,2864.637011,5765,232.0853462,11530,-2807808,143872,-2663936,52
5483,268,23,7,0.0466005912,0.953399409,1642.535131,1975.510774,2865.858289,3083.488806,5751,248.4233261,11502,-2807296,137216,-2670080,52
5474,288,23,7,0.0499826449,0.950017355,1642.103182,2024.159895,2884.789551,2818.975694,5762,289.2570281,11524,-2802688,147456,-2655232,52
5545,284,23,7,0.0487219077,0.951278092,1666.035381,1972.82299,2923.381966,2751.34507,5829,113.3605601,11658,-2839040,145408,-2693632,52
5482,279,23,7,0.0484290922,0.951570908,1646.751468,1955.514508,2883.306275,2835.684588,5761,275.7778842,11522,-2806784,142848,-2663936,52
5477,284,23,7,0.049296997,0.950703003,1642.021827,2026.430267,2880.420121,2892.183099,5761,263.9028859,11522,-2804224,145408,-2658816,52
5497,284,23,7,0.0491264487,0.950873551,1649.543256,2005.945719,2891.166273,2887.78169,5781,299.3785603,11562,-2814464,145408,-2669056,52
5361,288,22,8,0.0509824748,0.949017525,1612.470753,1935.456989,2831.482746,2704.326389,5649,165.5142104,11298,-2744832,147456,-2597376,52
5473,290,23,7,0.0503210134,0.949678987,1642.627775,2018.429198,2885.425726,2817.348276,5763,126.5480896,11526,-2802176,148480,-2653696,52
5476,286,23,7,0.0496355432,0.950364457,1644.576551,1981.881486,2889.96786,2719.367133,5762,227.5671406,11524,-2803712,146432,-2657280,52
5513,275,22,8,0.047512094,0.952487906,1652.780408,1984.309993,2882.741157,3130.232727,5788,225.7410296,11576,-2822656,140800,-2681856,52
5764,290,23,7,0.0479022134,0.952097787,1730.490666,2057.991674,3030.759542,2962.713793,6054,214.6047501,12108,-2951168,148480,-2802688,52
5654,299,23,7,0.0502267764,0.949773224,1702.635738,1992.427877,2981.783516,2886.545151,5953,245.7886045,11906,-2894848,153088,-2741760,52
5459,279,23,7,0.0486232137,0.951376786,1639.545547,1953.324574,2875.871955,2744.824373,5738,257.6560395,11476,-2795008,142848,-2652160,52
5420,273,23,7,0.0479536273,0.952046373,1627.917603,1912.531016,2858.034502,2627.92674,5693,190.1469606,11386,-2775040,139776,-2635264,52
5671,276,22,8,0.0464099546,0.953590045,1703.340796,1970.310581,2978.111797,2889.514493,5947,289.2509728,11894,-2903552,141312,-2762240,52
9559,416,23,7,0.0417042607,0.958295739,2872.998418,2987.421012,5008.475259,4517.512019,9975,1019.93865,19950,-4894208,212992,-4681216,52
9554,421,23,7,0.0422055138,0.957794486,2877.210652,2906.368885,5004.60875,4611.087886,9975,690.3114187,19950,-4891648,215552,-4676096,52
9562,413,23,7,0.0414035088,0.958596491,2875.029407,2958.152353,5003.894583,4620,9975,1140,19950,-4895744,211456,-4684288,52
9565,410,22,8,0.0411027569,0.958897243,2874.166409,2951.487271,5011.028332,4450.765854,9975,655.8185404,19950,-4897280,209920,-4687360,52
9558,417,22,8,0.0418045113,0.958195489,2872.898305,3004.515536,5003.955744,4622.280576,9975,1265.862944,19950,-4893696,213504,-4680192,52
9549,426,23,7,0.0427067669,0.957293233,2865.91508,3068.196811,5022.697141,4210.246479,9975,1243.765586,19950,-4889088,218112,-4670976,52
9556,419,23,7,0.0420050125,0.957994987,2865.371905,3067.000674,5024.938573,4145.553699,9975,512.3266564,19950,-4892672,214528,-4678144,52
9564,411,22,8,0.0412030075,0.958796992,2871.652434,3031.167238,5004.757737,4598.046229,9975,1331.775701,19950,-4896768,210432,-4686336,52
9548,427,23,7,0.0428070175,0.957192982,2874.236891,2946.178997,5011.69669,4458.126464,9975,843.1952663,19950,-4888576,218624,-4669952,52
9578,398,23,7,0.0398957498,0.96010425,2876.011337,2914.3283,5011.821048,4427.271357,9976,991.6500994,19952,-4903936,203776,-4700160,52
4960,220,23,7,0.0424710425,0.957528958,1491.988393,1490.646092,2611.742944,2111.568182,5180,93.97677794,10360,-2539520,112640,-2426880,52
9563,412,23,7,0.0413032581,0.958696742,2869.602185,3051.961516,5011.206839,4449.342233,9975,1145.235362,19950,-4896256,210944,-4685312,52
9576,399,23,7,0.04,0.96,2876.737501,2929.484764,5000.664787,4684.045113,9975,1629.901961,19950,-4902912,204288,-4698624,52
9588,389,23,7,0.0389896763,0.961010324,2876.376581,2968.605412,4993.428452,4879.848329,9977,780.0625489,19954,-4909056,199168,-4709888,52
9558,417,23,7,0.0418045113,0.958195489,2876.802344,2909.397815,5006.497384,4564.023981,9975,1506.797583,19950,-4893696,213504,-4680192,52
9556,418,23,7,0.0419089633,0.958091037,2873.846823,2975.080263,5004.029301,4609.619617,9974,646.4031108,19948,-4892672,214016,-4678656,52
9578,399,23,7,0.0399919816,0.960008018,2873.467853,3025.301655,4999.016392,4748.556391,9977,1191.995221,19954,-4903936,204288,-4699648,52
9546,428,23,7,0.0429115701,0.95708843,2870.535968,3005.616305,5014.299078,4389.780374,9974,1197.358944,19948,-4887552,219136,-4668416,52
9551,423,23,7,0.0424102667,0.957589733,2875.10816,2950.218049,5002.75301,4643.099291,9974,501.9627579,19948,-4890112,216576,-4673536,52
9600,383,23,7,0.0383652209,0.961634779,2872.648636,3026.938654,5018.791875,4320.454308,9983,1706.495726,19966,-4915200,196096,-4719104,52
3290,440,24,6,0.117962466,0.882037534,1049.703082,1192.387479,1814.048632,2250.215909,3730,138.66171,7460,-1684480,225280,-1459200,52
3279,453,23,7,0.121382637,0.878617363,1051.890241,1154.019396,1805.614822,2307.211921,3732,128.1593407,7464,-1678848,231936,-1446912,52
3200,425,24,6,0.117241379,0.882758621,1025.397177,1109.419544,1758.234375,2225.352941,3625,121.7668794,7250,-1638400,217600,-1420800,52
3196,433,22,8,0.119316616,0.880683384,1021.809012,1158.03169,1765.691176,2178.951501,3629,123.6456559,7258,-1636352,221696,-1414656,52
3287,402,24,6,0.108972621,0.891027379,1041.157312,1170.720851,1797.021296,2237.303483,3689,124.1669472,7378,-1682944,205824,-1477120,52
3244,447,23,7,0.121105391,0.878894609,1041.235389,1152.039733,1791.334155,2242.724832,3691,131.5395581,7382,-1660928,228864,-1432064,52
3236,450,23,7,0.122083559,0.877916441,1034.485403,1188.092521,1790.26885,2226.291111,3686,103.2203864,7372,-1656832,230400,-1426432,52
3217,446,24,6,0.121758122,0.878241878,1031.863236,1156.034822,1778.935965,2214.751121,3663,130.7747233,7326,-1647104,228352,-1418752,52
3280,472,23,7,0.125799574,0.874200426,1068.536215,1135.9253,1833.805183,2173.192797,3752,118.3596215,7504,-1679360,241664,-1437696,52
3257,430,24,6,0.116625983,0.883374017,1042.01257,1155.161665,1795.188824,2213.716279,3687,120.2936378,7374,-1667584,220160,-1447424,52
3201,459,24,6,0.125409836,0.874590164,1021.807461,1163.365732,1761.278038,2313.244009,3660,65.33380935,7320,-1638912,235008,-1403904,52
3287,444,24,6,0.119002948,0.880997052,1049.382093,1172.297122,1806.362641,2307.504505,3731,135.3282554,7462,-1682944,227328,-1455616,52
3286,462,24,6,0.123265742,0.876734258,1051.748864,1205.709131,1819.382532,2266.525974,3748,90.22628792,7496,-1682432,236544,-1445888,52
3206,414,24,6,0.114364641,0.885635359,1022.660591,1144.426658,1765.016532,2162.722222,3620,136.0902256,7240,-1641472,211968,-1429504,52
3210,449,24,6,0.122711123,0.877288877,1034.254903,1123.54196,1774.068847,2229.864143,3659,129.5221239,7318,-1643520,229888,-1413632,52
3236,425,23,7,0.1160885,0.8839115,1035.061067,1136.456511,1779.751236,2221.214118,3661,134.1517039,7322,-1656832,217600,-1439232,52
3233,442,22,8,0.120272109,0.879727891,1035.49122,1164.702631,1786.987318,2211.131222,3675,120.3734032,7350,-1655296,226304,-1428992,52
3288,440,22,8,0.118025751,0.881974249,1049.751805,1184.927839,1812.080292,2256.218182,3728,137.7679231,7456,-1683456,225280,-1458176,52
3298,427,23,7,0.114630872,0.885369128,1053.491765,1175.027901,1818.332929,2207.992974,3725,136.1476608,7450,-1688576,218624,-1469952,52
3183,432,24,6,0.119502075,0.880497925,1019.164297,1134.074281,1754.92617,2199.050926,3615,134.3866171,7230,-1629696,221184,-1408512,52
7684,239,24,6,0.0301653414,0.969834659,2285.257943,2344.410372,3965.927121,3835.740586,7923,680.0858369,15846,-3934208,122368,-3811840,52
7677,241,22,8,0.030436979,0.969563021,2282.757353,2372.120535,3964.868568,3788.485477,7918,192.6989535,15836,-3930624,123392,-3807232,52
7712,243,22,8,0.0305468259,0.969453174,2293.195175,2391.143822,3982.8361,3824.518519,7955,696.5849387,15910,-3948544,124416,-3824128,52
7593,237,21,9,0.0302681992,0.969731801,2257.907606,2330.951076,3920.442645,3757.147679,7830,1511.583012,15660,-3887616,121344,-3766272,52
7680,241,21,9,0.0304254513,0.969574549,2283.843613,2366.636061,3966.20638,3795.087137,7921,1151.30814,15842,-3932160,123392,-3808768,52
7553,234,23,7,0.0300500835,0.969949917,2246.50618,2289.940041,3897.533695,3779.940171,7787,1649.788136,15574,-3867136,119808,-3747328,52
7543,237,20,10,0.0304627249,0.969537275,2242.972031,2330.700177,3895.778735,3722.493671,7780,681.8580193,15560,-3862016,121344,-3740672,52
8026,250,23,7,0.0302078299,0.96979217,2386.912447,2454.467885,4142.245577,4018.252,8276,586.9503546,16552,-4109312,128000,-3981312,52
7658,240,22,8,0.0303874399,0.96961256,2277.357817,2357.022192,3953.917733,3808.5375,7898,1035.124509,15796,-3920896,122880,-3798016,52
7559,237,21,9,0.0304002052,0.969599795,2248.189057,2319.463369,3902.653526,3766.025316,7796,994.3877551,15592,-3870208,121344,-3748864,52
7543,234,23,7,0.0300887232,0.969911277,2243.321014,2296.377229,3892.556277,3774.363248,7777,1258.414239,15554,-3862016,119808,-3742208,52
7571,237,21,9,0.0303534836,0.969646516,2251.226295,2334.912591,3909.299432,3751.181435,7808,723.6329935,15616,-3876352,121344,-3755008,52
7817,248,20,10,0.030750155,0.969249845,2324.767115,2427.33201,4038.107586,3872.008065,8065,750.9310987,16130,-4002304,126976,-3875328,52
7549,236,21,9,0.0303147078,0.969685292,2244.698938,2324.722192,3897.875878,3737.033898,7785,712.9120879,15570,-3865088,120832,-3744256,52
7546,236,22,8,0.0303263942,0.969673606,2243.847426,2323.458575,3896.338988,3736.775424,7782,354.5330296,15564,-3863552,120832,-3742720,52
7551,234,23,7,0.0300578035,0.969942197,2245.437816,2304.083239,3896.967686,3764.965812,7785,743.5530086,15570,-3866112,119808,-3746304,52
7541,234,24,6,0.030096463,0.969903537,2242.905213,2290.966171,3891.38894,3778.786325,7775,1548.804781,15550,-3860992,119808,-3741184,52
7544,234,23,7,0.0300848547,0.969915145,2243.480246,2300.413097,3893.251723,3768.547009,7778,1242.492013,15556,-3862528,119808,-3742720,52
7550,237,20,10,0.030435341,0.969564659,2245.506547,2317.51018,3899.057086,3732.898734,7787,765.6833825,15574,-3865600,121344,-3744256,52
7543,235,22,8,0.0302134225,0.969786578,2243.378844,2302.765188,3893.581201,3758.502128,7778,1178.484848,15556,-3862016,120320,-3741696,52
9378,573,26,4,0.0575821525,0.942417847,2844.504805,3192.598534,5025.221156,4170.422339,9951,566.363119,19902,-4801536,293376,-4508160,52
448,36,26,4,0.0743801653,0.925619835,138.3357022,133.4281694,248.734375,164.9166667,484,41.40290847,968,-229376,18432,-210944,52
6919,617,26,4,0.081873673,0.918126327,2120.517383,2701.538687,3744.190201,4041.10859,7536,489.9869961,15072,-3542528,315904,-3226624,52
5864,468,26,4,0.0739102969,0.926089703,1803.738337,2065.712774,3198.450034,2766.168803,6332,561.8456078,12664,-3002368,239616,-2762752,52
2229,245,26,4,0.0990299111,0.900970089,703.0988049,798.0105885,1250.758188,1116.877551,2474,124.0100251,4948,-1141248,125440,-1015808,52
5828,454,26,4,0.0722699777,0.927730022,1791.465963,2044.569573,3168.137612,2799.552863,6282,472.3308271,12564,-2983936,232448,-2751488,52
2436,290,26,4,0.106382979,0.893617021,783.1360958,764.1003065,1396.391215,1087.213793,2726,48.1200353,5452,-1247232,148480,-1098752,52
5896,477,26,4,0.0748470108,0.925152989,1814.023493,2100.908382,3215.22846,2838.079665,6373,334.0146751,12746,-3018752,244224,-2774528,52
6811,589,26,4,0.0795945946,0.920405405,2088.70993,2608.57646,3677.238438,3969.488964,7400,400,14800,-3487232,301568,-3185664,52
2035,247,26,4,0.108238387,0.891761613,653.2382693,682.0262624,1160.832924,982.2186235,2282,39.54254029,4564,-1041920,126464,-915456,52
5877,477,26,4,0.0750708215,0.924929178,1811.968921,2055.340778,3206.76961,2816.87631,6354,469.6230599,12708,-3009024,244224,-2764800,52
5739,443,26,4,0.0716596571,0.928340343,1762.547479,2017.507743,3118.037986,2747.704289,6182,425.4645561,12364,-2938368,226816,-2711552,52
6915,575,26,4,0.0767690254,0.923230975,2116.230532,2645.775978,3729.736804,3935.069565,7490,645.6896552,14980,-3540480,294400,-3246080,52
6816,623,26,4,0.0837478156,0.916252184,2082.544614,2737.897152,3689.765405,4050.784912,7439,310.9949833,14878,-3489792,318976,-3170816,52
1374,183,26,4,0.117533719,0.882466281,447.6635723,453.7355899,790.3937409,693.4535519,1557,29.0052161,3114,-703488,93696,-609792,52
6938,637,26,4,0.0840924092,0.915907591,2130.397528,2702.022499,3756.461228,4131.510204,7575,134.0707965,15150,-3552256,326144,-3226112,52
5985,498,26,4,0.0768162888,0.923183711,1852.29787,2066.230562,3266.199666,2951.166667,6483,441.0204082,12966,-3064320,254976,-2809344,52
6914,635,26,4,0.0841171016,0.915882898,2123.713922,2696.861406,3750.789702,4038.606299,7549,533.1214689,15098,-3539968,325120,-3214848,52
196,16,26,4,0.0754716981,0.924528302,60.734417,56.78468103,109.2346939,73,212,10.6639839,424,-100352,8192,-92160,52
7101,616,26,4,0.0798237657,0.920176234,2184.524164,2670.559323,3845.296437,4016.969156,7717,563.6961286,15434,-3635712,315392,-3320320,52
9039,846,22,8,0.0855842185,0.914415781,2820.68017,3133.662769,4892.695984,5480.468085,9885,414.4654088,19770,-4627968,433152,-4194816,52
9051,837,22,8,0.0846480583,0.915351942,2823.678621,3110.112487,4891.235112,5520.48626,9888,445.4054054,19776,-4634112,428544,-4205568,52
9054,831,22,8,0.0840667678,0.915933232,2820.891323,3129.673993,4889.767617,5522.983153,9885,413.2525084,19770,-4635648,425472,-4210176,52
9033,852,22,8,0.0861911988,0.913808801,2813.836258,3170.628254,4880.769622,5602.773474,9885,504.8518897,19770,-4624896,436224,-4188672,52
8020,626,22,8,0.0724034235,0.927596576,2479.460159,2688.717376,4339.832544,4114.255591,8646,157.3144105,17292,-4106240,320512,-3785728,52
9043,844,22,8,0.0853646202,0.91463538,2820.433635,3133.979284,4889.483357,5528.116114,9887,443.5621355,19774,-4630016,432128,-4197888,52
9108,779,22,8,0.0787903307,0.921209669,2832.163586,3084.226343,4918.819609,5238.406932,9887,547.4529347,19774,-4663296,398848,-4264448,52
9068,816,22,8,0.082557669,0.917442331,2824.28306,3113.272843,4897.118659,5446.811275,9884,550.0278242,19768,-4642816,417792,-4225024,52
9085,801,22,8,0.0810236698,0.91897633,2828.70027,3090.742027,4904.567199,5385.078652,9886,885.049239,19772,-4651520,410112,-4241408,52
9044,844,22,8,0.0853559871,0.914644013,2821.128981,3133.441627,4891.405462,5513.441943,9888,358.5206672,19776,-4630528,432128,-4198400,52
9044,845,22,8,0.0854484781,0.914551522,2817.961682,3185.834609,4902.067669,5404.502959,9889,309.7087379,19778,-4630528,432640,-4197888,52
9085,800,22,8,0.0809307031,0.919069297,2826.708921,3110.799896,4905.497303,5368.89,9885,275.8861289,19770,-4651520,409600,-4241920,52
9061,827,22,8,0.0836367314,0.916363269,2814.434975,3228.080514,4904.396645,5383.891173,9888,344.7698745,19776,-4639232,423424,-4215808,52
9060,830,22,8,0.0839231547,0.916076845,2824.223701,3118.137329,4894.678256,5500.253012,9890,345.8041958,19780,-4638720,424960,-4213760,52
9086,801,22,8,0.0810154749,0.918984525,2821.427373,3177.962666,4911.044024,5317.830212,9887,474.4241843,19774,-4652032,410112,-4241920,52
9074,817,22,8,0.0826003437,0.917399656,2822.99194,3162.938994,4908.896738,5358.086903,9891,243.6206897,19782,-4645888,418304,-4227584,52
9020,867,22,8,0.0876909073,0.912309093,2839.351274,2992.473267,4920.303215,5190.534025,9887,321.0064935,19774,-4618240,443904,-4174336,52
9039,850,22,8,0.0859540904,0.91404591,2821.418879,3128.969031,4890.439761,5525.2,9889,335.4477612,19778,-4627968,435200,-4192768,52
3582,328,22,8,0.083887468,0.916112532,1135.144871,1056.01072,1955.57426,1954.689024,3910,55.4138322,7820,-1833984,167936,-1666048,52
1467,148,22,8,0.0916408669,0.908359133,462.2338468,503.0067848,805.066803,837.0743243,1615,21.71282603,3230,-751104,75776,-675328,52
3697,218,22,8,0.0556832695,0.944316731,1118.840458,1298.509991,1949.311874,2105.33945,3915,160.4508197,7830,-1892864,111616,-1781248,52
3673,205,23,7,0.0528623002,0.9471377,1110.283421,1249.763683,1926.325619,2175.546341,3878,205.6203606,7756,-1880576,104960,-1775616,52
3688,204,23,7,0.0524152107,0.947584789,1114.724939,1259.5542,1936.889371,2120.245098,3892,150.7942658,7784,-1888256,104448,-1783808,52
3661,205,23,7,0.0530263839,0.946973616,1105.720917,1283.289476,1928.868888,2016.204878,3866,91.69829222,7732,-1874432,104960,-1769472,52
3677,225,23,7,0.0576627371,0.942337263,1114.431601,1304.425718,1946.922219,2026.311111,3902,183.1924883,7804,-1882624,115200,-1767424,52
3675,206,23,7,0.0530791033,0.946920897,1109.856545,1284.553603,1932.813333,2087.048544,3881,187.7600387,7762,-1881600,105472,-1776128,52
3700,204,23,7,0.0522540984,0.947745902,1117.149763,1279.292835,1942.611622,2131.848039,3904,191.1851126,7808,-1894400,104448,-1789952,52
3868,226,22,8,0.0552027357,0.944797264,1167.162945,1409.05085,2049.479317,2013.623894,4094,122.5381622,8188,-1980416,115712,-1864704,52
3678,216,23,7,0.0554699538,0.944530046,1112.324341,1306.405311,1943.314845,2018.763889,3894,159.003675,7788,-1883136,110592,-1772544,52
3674,224,23,7,0.0574653669,0.942534633,1113.21987,1305.825237,1946.304845,2001.90625,3898,185.5306997,7796,-1881088,114688,-1766400,52
3939,220,23,7,0.0528973311,0.947102669,1191.751589,1339.379501,2071.150292,2238.45,4159,146.8055065,8318,-2016768,112640,-1904128,52
3680,207,23,7,0.0532544379,0.946745562,1111.169756,1296.32112,1938.058424,2049.628019,3887,170.1094092,7774,-1884160,105984,-1778176,52
3686,207,23,7,0.0531723606,0.946827639,1113.976179,1277.079635,1938.540152,2097.642512,3893,179.2357274,7786,-1887232,105984,-1781248,52
3680,199,23,7,0.0513018819,0.948698118,1110.571507,1262.415862,1929.516848,2133.859296,3879,192.9850746,7758,-1884160,101888,-1782272,52
3677,215,23,7,0.0552415211,0.944758479,1112.464619,1291.586345,1939.087299,2073.274419,3892,222.0193953,7784,-1882624,110080,-1772544,52
3680,213,23,7,0.0547135885,0.945286412,1112.232402,1305.123978,1942.305163,2028.112676,3893,132.6857532,7786,-1884160,109056,-1775104,52
3959,224,23,7,0.0535500837,0.946449916,1196.167018,1390.881012,2087.656479,2168.767857,4183,168.3977456,8366,-2027008,114688,-1912320,52
4101,235,23,7,0.054197417,0.945802583,1237.113634,1472.821193,2158.710558,2339.33617,4336,77.35950045,8672,-2099712,120320,-1979392,52
3941,224,23,7,0.0537815126,0.946218487,1193.748156,1338.166569,2075.840396,2208.964286,4165,190.3564899,8330,-2017792,114688,-1903104,52
516,41,22,8,0.0736086176,0.926391382,157.5571682,193.5980953,281.7926357,243.8536585,557,8.914852753,1114,-264192,20992,-243200,52
5933,705,21,9,0.106206689,0.893793311,1888.754382,2077.273505,3374.133828,2859.723404,6638,117.9040853,13276,-3037696,360960,-2676736,53
8225,1033,20,10,0.111579175,0.888420825,2601.667244,3110.164129,4550.415684,5259.188771,9258,170.8118081,18516,-4211200,528896,-3682304,53
161,40,19,11,0.199004975,0.800995025,56.50340772,63.73499823,101.4968944,99,201,5.423637345,402,-82432,20480,-61952,53
7846,1046,20,10,0.117633828,0.882366172,2503.612173,2939.857557,4372.069717,5004.798279,8892,160.2739726,17784,-4017152,535552,-3481600,53
3419,433,22,8,0.112409138,0.887590862,1087.338666,1240.733421,1968.673004,1593.498845,3852,71.38621201,7704,-1750528,221696,-1528832,53
6457,769,20,10,0.106421257,0.893578743,2053.399164,2338.563178,3626.967787,3500.416125,7226,178.9056697,14452,-3305984,393728,-2912256,53
8856,1049,21,9,0.105906108,0.894093892,2789.20466,3355.9859,4896.217028,5432.380362,9905,214.7192716,19810,-4534272,537088,-3997184,53
5922,664,20,10,0.100819921,0.899180079,1879.7878,2082.058829,3298.470449,3249.170181,6586,123.0797982,13172,-3032064,339968,-2692096,53
5607,753,20,10,0.118396226,0.881603774,1808.813126,2026.62644,3177.108971,3205.750332,6360,165.0661822,12720,-2870784,385536,-2485248,53
613,82,20,10,0.117985612,0.882014388,193.7658747,241.9123764,353.5693312,306.3658537,695,14.32989691,1390,-313856,41984,-271872,53
5526,732,20,10,0.116970278,0.883029722,1779.432622,1998.032555,3120.751176,3195.546448,6258,138.8506767,12516,-2829312,374784,-2454528,53
5412,715,20,10,0.116696589,0.883303411,1747.443371,1916.756661,3081.759608,2929.573427,6127,142.6542491,12254,-2770944,366080,-2404864,53
6369,629,21,9,0.0898828237,0.910117176,1989.677596,2227.841348,3555.628356,2931.166932,6998,124.8973764,13996,-3260928,322048,-2938880,53
301,59,20,10,0.163888889,0.836111111,101.7547757,108.7346036,186.8405316,148.1525424,360,5.270863836,720,-154112,30208,-123904,53
657,91,20,10,0.121657754,0.878342246,211.1279793,224.6441214,388.0913242,276.3736264,748,10.86104254,1496,-336384,46592,-289792,53
674,91,20,10,0.118954248,0.881045752,216.4794778,225.8609702,396.805638,280.7472527,765,11.60497573,1530,-345088,46592,-298496,53
671,91,20,10,0.119422572,0.880577428,213.3883341,230.2989399,397.7883756,261.3956044,762,11.2755253,1524,-343552,46592,-296960,53
796,121,20,10,0.131952017,0.868047983,258.9566745,296.4506118,465.3781407,417.0413223,917,23.7073423,1834,-407552,61952,-345600,53
274,69,20,10,0.201166181,0.798833819,100.0931455,80.488461,183.1934307,127.5507246,343,6.062212796,686,-140288,35328,-104960,53
7048,981,21,9,0.12218209,0.87781791,2246.136526,2745.479857,3959.164869,4416.147808,8029,146.9167429,16058,-3608576,502272,-3106304,53
2918,183,20,10,0.0590132215,0.940986778,880.1706338,937.1940276,1586.885538,978.7923497,3101,55.13869132,6202,-1494016,93696,-1400320,53
7288,419,21,9,0.0543661606,0.945633839,2221.77177,2196.010061,3887.686608,3268.062053,7707,192.0987039,15414,-3731456,214528,-3516928,53
3842,215,20,10,0.0529948238,0.947005176,1154.759042,1361.1797,2053.37038,1593.506977,4057,100.1728395,8114,-1967104,110080,-1857024,53
6306,531,20,10,0.0776656428,0.922334357,1940.308558,2332.127698,3425.924041,3336.772128,6837,135.7355569,13674,-3228672,271872,-2956800,53
5580,475,20,10,0.078447564,0.921552436,1736.65272,1753.343091,3082.364875,2389.355789,6055,117.0726991,12110,-2856960,243200,-2613760,53
5387,355,20,10,0.061825148,0.938174852,1644.052506,1833.143149,2887.711156,2625.501408,5742,137.007874,11484,-2758144,181760,-2576384,53
5431,345,21,9,0.0597299169,0.940270083,1655.036072,1841.909586,2899.783281,2710.878261,5776,140.5352798,11552,-2780672,176640,-2604032,53
5282,353,20,10,0.0626441881,0.937355812,1612.455322,1825.221026,2822.252934,2754.362606,5635,142.51391,11270,-2704384,180736,-2523648,53
7355,412,20,10,0.0530449337,0.946955066,2235.98939,2278.414877,3915.204351,3326.941748,7767,170.179667,15534,-3765760,210944,-3554816,53
80,21,20,10,0.207920792,0.792079208,28.92822746,26.2061425,54.4125,38,101,1.662825156,202,-40960,10752,-30208,53
71,21,20,10,0.22826087,0.77173913,26.54288038,24.4938791,49.1971831,37.38095238,92,1.493264081,184,-36352,10752,-25600,53
71,21,20,10,0.22826087,0.77173913,26.30508597,25.62364979,49.01408451,38,92,1.496421601,184,-36352,10752,-25600,53
78,21,20,10,0.212121212,0.787878788,28.26730908,26.71297,53.1025641,38.47619048,99,1.585522101,198,-39936,10752,-29184,53
5103,348,21,9,0.063841497,0.936158503,1563.288125,1715.4924,2731.13835,2650.652299,5451,103.1019482,10902,-2612736,178176,-2434560,53
3569,467,20,10,0.115708622,0.884291378,1173.325706,983.6931705,2079.112917,1555.271949,4036,69.92376992,8072,-1827328,239104,-1588224,53
5275,348,21,9,0.0618886715,0.938111328,1611.350487,1791.968894,2816.80872,2739.109195,5623,113.2299638,11246,-2700800,178176,-2522624,53
5347,339,20,10,0.0596201196,0.94037988,1631.487938,1781.491869,2854.590986,2668.563422,5686,131.0742278,11372,-2737664,173568,-2564096,53
6616,568,20,10,0.079064588,0.920935412,2060.033721,1898.981001,3688.566052,2473.533451,7184,130.4758445,14368,-3387392,290816,-3096576,53
6417,380,21,9,0.0559070178,0.944092982,1955.073034,2055.213816,3416.499922,3103.481579,6797,152.7759047,13594,-3285504,194560,-3090944,53
5473,346,20,10,0.0594603884,0.940539612,1667.293454,1859.196895,2920.129362,2749.774566,5819,114.8411289,11638,-2802176,177152,-2625024,53
7079,547,20,10,0.0717282979,0.928271702,2207.561958,1970.983509,3871.74276,3059.751371,7626,135.5251466,15252,-3624448,280064,-3344384,53
6195,492,20,10,0.0735755944,0.926424406,1921.91011,1918.550604,3395.612268,2694.126016,6687,123.3763838,13374,-3171840,251904,-2919936,53
7047,508,20,10,0.0672402383,0.932759762,2166.533424,2121.940862,3851.770824,2754.647638,7555,169.622811,15110,-3608064,260096,-3347968,53
6724,611,20,10,0.0832992502,0.91670075,2105.53124,1968.786346,3761.722635,2636.590835,7335,165.7627119,14670,-3442688,312832,-3129856,53
5337,529,20,10,0.0901807024,0.909819298,1680.718698,1732.221652,2985.06839,2413.234405,5866,126.7776097,11732,-2732544,270848,-2461696,53
5422,506,20,10,0.0853576248,0.914642375,1700.362245,1658.337294,3032.293987,2238.059289,5928,131.2956811,11856,-2776064,259072,-2516992,53
5045,469,21,9,0.0850562205,0.914943779,1592.889862,1574.763153,2768.35996,2640.680171,5514,122.1803678,11028,-2583040,240128,-2342912,53
7436,617,21,9,0.0766174097,0.92338259,2316.12421,2273.804074,4094.360947,3215.175041,8053,140.8359566,16106,-3807232,315904,-3491328,53
8067,563,20,10,0.0652375435,0.934762457,2474.645073,2411.17194,4400.190405,3102.005329,8630,196.4936248,17260,-4130304,288256,-3842048,53
782,92,20,10,0.105263158,0.894736842,249.9950725,207.5798668,456.9079284,272.5326087,874,23.40026774,1748,-400384,47104,-353280,53
6839,519,21,9,0.0705354716,0.929464528,2125.18096,2010.727563,3726.148998,3064.793834,7358,197.3183159,14716,-3501568,265728,-3235840,53
8254,608,20,10,0.0686075378,0.931392462,2556.28792,2464.337555,4486.890477,3679.537829,8862,181.1158798,17724,-4226048,311296,-3914752,53
5705,551,21,9,0.0880754476,0.911924552,1794.184038,1711.35287,3209.504294,2289.789474,6256,137.2531812,12512,-2920960,282112,-2638848,53
6173,526,20,10,0.078519182,0.921480818,1924.871975,1955.033739,3396.518549,2804.070342,6699,161.7334621,13398,-3160576,269312,-2891264,53
78,20,20,10,0.204081633,0.795918367,27.72295313,26.82512815,52.76923077,36.75,98,1.601045581,196,-39936,10240,-29696,53
79,21,19,11,0.21,0.79,28.1304843,28.57555526,53.62025316,38.76190476,100,1.598465473,200,-40448,10752,-29696,53
2567,394,20,10,0.133063154,0.866936846,866.7670361,752.6994141,1505.535645,1321.14467,2961,52.24986765,5922,-1314304,201728,-1112576,53
1340,265,20,10,0.165109034,0.834890966,456.7661127,491.8286699,792.6485075,855.3433962,1605,28.23715693,3210,-686080,135680,-550400,53
7158,560,20,10,0.0725576574,0.927442343,2227.051017,2128.706473,3912.040514,3187.919643,7718,189.6314496,15436,-3664896,286720,-3378176,53
205,48,20,10,0.18972332,0.81027668,72.92362339,72.71266403,129.2682927,117.3125,253,4.887000193,506,-104960,24576,-80384,53
5399,399,20,10,0.0688168334,0.931183167,1659.358545,1852.846495,2890.226523,3024.982456,5798,108.719295,11596,-2764288,204288,-2560000,53
4954,355,20,10,0.0668675833,0.933132417,1518.102788,1716.392249,2645.470327,2787.985915,5309,110.6502709,10618,-2536448,181760,-2354688,53
7091,664,20,10,0.0856221792,0.914377821,2223.222433,2116.227813,3978.891553,2800.557229,7755,154.8522364,15510,-3630592,339968,-3290624,53
6545,546,20,10,0.0769990128,0.923000987,2027.975527,1903.216406,3644.061574,2370.518315,7091,143.7461991,14182,-3351040,279552,-3071488,53
5577,407,20,10,0.0680147059,0.931985294,1720.320612,1821.393634,2996.031558,2944.108108,5984,152.8089888,11968,-2855424,208384,-2647040,53
5646,423,20,10,0.0696984676,0.930301532,1737.525835,1921.447612,3018.815976,3251.016548,6069,122.8791253,12138,-2890752,216576,-2674176,53
3162,425,20,10,0.118483412,0.881516588,1044.81887,898.9750055,1837.620493,1469.463529,3587,63.2627866,7174,-1618944,217600,-1401344,53
5645,408,20,10,0.0674045928,0.932595407,1734.611503,1911.27264,3018.746147,3141.198529,6053,135.6566562,12106,-2890240,208896,-2681344,53
5654,427,20,10,0.070218714,0.929781286,1736.450611,1986.758474,3033.008136,3146.822014,6081,150,12162,-2894848,218624,-2676224,53
5693,506,21,9,0.0816260687,0.918373931,1771.618594,1898.304334,3147.809942,2562.090909,6199,136.5719321,12398,-2914816,259072,-2655744,53
195,33,20,10,0.144736842,0.855263158,64.34802726,68.23401369,118.9435897,88.24242424,228,4.923342691,456,-99840,16896,-82944,53
223,48,20,10,0.177121771,0.822878229,78.61805881,72.70916905,140.5829596,114.7083333,271,6.241363427,542,-114176,24576,-89600,53
177,35,20,10,0.16509434,0.83490566,59.59304733,64.85057235,110.6214689,85.65714286,212,5.164433618,424,-90624,17920,-72704,53
77,20,20,10,0.206185567,0.793814433,27.6414469,25.48622177,52.36363636,36.05,97,1.497606917,194,-39424,10240,-29184,53
102,20,19,11,0.163934426,0.836065574,33.09091928,42.21303116,64.02941176,48.6,122,2.340303088,244,-52224,10240,-41984,53
5404,512,20,10,0.0865449628,0.913455037,1699.13859,1556.81217,3039.717432,2101.275391,5916,121.1054248,11832,-2766848,262144,-2504704,53
5470,443,20,10,0.0749196685,0.925080331,1691.145451,1881.226559,2941.983729,3142.41535,5913,153.305678,11826,-2800640,226816,-2573824,53
5631,427,20,10,0.0704853087,0.929514691,1736.699506,1896.904228,3020.26727,3151.255269,6058,141.3109401,12116,-2883072,218624,-2664448,53
5698,431,21,9,0.0703214227,0.929678577,1755.571404,1937.738438,3056.115655,3182.454756,6129,155.2431611,12258,-2917376,220672,-2696704,53
5594,427,20,10,0.0709184521,0.929081548,1722.948666,1920.540958,3000.557562,3147.803279,6021,125.9096612,12042,-2864128,218624,-2645504,53
897,55,20,10,0.0577731092,0.942226891,269.691834,300.8252341,486.9041249,306.8181818,952,31.14164213,1904,-459264,28160,-431104,53
905,63,20,10,0.0650826446,0.934917355,271.7731329,312.6634087,498.1314917,288.6825397,968,40.01653576,1936,-463360,32256,-431104,53
897,66,20,10,0.0685358255,0.931464174,272.3877056,311.7435966,492.5406912,338.7424242,963,69.48051948,1926,-459264,33792,-425472,53
893,57,20,10,0.06,0.94,268.7939341,298.9407626,486.6024636,301.5614035,950,29.13216805,1900,-457216,29184,-428032,53
893,65,20,10,0.0678496868,0.932150313,271.3830864,300.6341621,490.6114222,326.8461538,958,85.61215371,1916,-457216,33280,-423936,53
886,60,21,9,0.0634249471,0.936575053,267.1075358,274.7396444,487.6760722,264.1666667,946,33.26300985,1892,-453632,30720,-422912,53
893,62,21,9,0.064921466,0.935078534,270.5957414,297.5342463,489.1366181,317.5967742,955,64.0509725,1910,-457216,31744,-425472,53
903,59,20,10,0.0613305613,0.938669439,271.8010465,277.3446826,495.6345515,265.1694915,962,34.75433526,1924,-462336,30208,-432128,53
893,58,20,10,0.0609884332,0.939011567,268.6622359,277.2018457,489.731243,264.5862069,951,32.10668467,1902,-457216,29696,-427520,53
897,65,21,9,0.0675675676,0.932432432,271.1238511,319.4148496,492.5507246,329,962,70.99630996,1924,-459264,33280,-425984,53
893,57,21,9,0.06,0.94,268.7205056,278.6429697,488.5587906,270.9122807,950,34.09906676,1900,-457216,29184,-428032,53
909,61,21,9,0.0628865979,0.937113402,274.5147064,308.2831454,496.5280528,321.1639344,970,35.91262495,1940,-465408,31232,-434176,53
895,63,21,9,0.0657620042,0.934237996,270.4667458,309.519295,490.8759777,317.8888889,958,15.06763133,1916,-458240,32256,-425984,53
889,58,20,10,0.0612460401,0.93875396,267.4513561,277.0466978,487.7165354,263.7586207,947,33.13505948,1894,-455168,29696,-425472,53
39,16,18,12,0.290909091,0.709090909,15.13606923,17.40285537,28.76923077,26.125,55,3.806228374,110,-19968,8192,-11776,53
48,14,20,10,0.225806452,0.774193548,17.91123949,14.26516379,34.25,22.07142857,62,4.177897574,124,-24576,7168,-17408,53
897,63,20,10,0.065625,0.934375,270.5121674,288.7280007,494.9052397,275.3968254,960,90.73724008,1920,-459264,32256,-427008,53
893,63,20,10,0.0658995816,0.934100418,270.1907155,297.7395718,490.75028,304.8571429,956,70.81481481,1912,-457216,32256,-424960,53
905,59,21,9,0.0612033195,0.93879668,273.4141404,275.538323,495.5558011,282.2372881,964,34.23295455,1928,-463360,30208,-433152,53
898,63,20,10,0.0655567118,0.934443288,272.1622023,307.9148323,491.3541203,333.4126984,961,73.30282227,1922,-459776,32256,-427520,53
2308,146,22,8,0.0594947025,0.940505297,701.9460297,758.6915672,1243.767764,970.3356164,2454,65.19659936,4908,-1181696,74752,-1106944,53
2353,144,21,9,0.057669203,0.942330797,710.9650638,781.0815447,1271.236294,885.6527778,2497,85.221843,4994,-1204736,73728,-1131008,53
2278,150,21,9,0.0617792422,0.938220758,689.6913355,767.0490445,1238.337138,852.4933333,2428,52.70240938,4856,-1166336,76800,-1089536,53
2266,145,21,9,0.0601410203,0.93985898,684.2385527,723.0728119,1234.776258,756.2965517,2411,69.16236374,4822,-1160192,74240,-1085952,53
2257,141,21,9,0.0587989992,0.941201001,681.1390683,747.7088471,1224.062029,806.3333333,2398,102.7861123,4796,-1155584,72192,-1083392,53
2257,144,21,9,0.0599750104,0.94002499,680.3518069,766.5084064,1226.315906,804.2083333,2401,114.8803828,4802,-1155584,73728,-1081856,53
2296,145,21,9,0.0594018845,0.940598116,690.9896431,824.4779101,1242.110192,886.7310345,2441,73.25930372,4882,-1175552,74240,-1101312,53
69,19,22,8,0.215909091,0.784090909,25.8771596,19.41841374,47.76811594,32.63157895,88,6.048109966,176,-35328,9728,-25600,53
2279,143,21,9,0.059042114,0.940957886,692.3292599,754.1024224,1227.820535,951.3986014,2422,89.93687338,4844,-1166848,73216,-1093632,53
2280,131,22,8,0.0543343011,0.945665699,684.2868054,747.8629984,1231.383772,764.2061069,2411,87.35507246,4822,-1167360,67072,-1100288,53
2262,132,22,8,0.0551378446,0.944862155,682.9938565,752.8274809,1215.567197,887.8939394,2394,87.24489796,4788,-1158144,67584,-1090560,53
2200,132,23,7,0.0566037736,0.943396226,663.4483245,716.3136849,1189.599091,781.5151515,2332,62.18666667,4664,-1126400,67584,-1058816,53
2290,140,22,8,0.0576131687,0.942386831,689.1717439,762.6643364,1241.396943,791.9,2430,81.05403602,4860,-1172480,71680,-1100800,53
2261,135,21,9,0.0563439065,0.943656093,680.9152583,777.8404204,1218.63379,861.2962963,2396,49.51436247,4792,-1157632,69120,-1088512,53
2373,142,21,9,0.0564612326,0.943538767,713.3091642,789.6754581,1284.585756,813.7183099,2515,70.52720135,5030,-1214976,72704,-1142272,53
2268,144,21,9,0.0597014925,0.940298507,686.9682664,743.8532529,1229.075838,850.9305556,2412,139.5026027,4824,-1161216,73728,-1087488,53
2309,141,22,8,0.0575510204,0.94244898,696.5627388,752.9294043,1250.587267,814.6737589,2450,87.28179551,4900,-1182208,72192,-1110016,53
2278,154,22,8,0.0633223684,0.936677632,690.7775451,759.4951127,1241.709833,843.5909091,2432,140.2537486,4864,-1166336,78848,-1087488,53
2260,141,22,8,0.058725531,0.941274469,681.6265814,726.4291603,1228.45354,760.964539,2401,61.50102459,4802,-1157120,72192,-1084928,53
2321,149,21,9,0.0603238866,0.939676113,702.9758407,764.158732,1259.292977,864.8724832,2470,81.95089582,4940,-1188352,76288,-1112064,53
3866,299,20,10,0.0717887155,0.928211285,1181.977214,1424.878021,2098.420848,1883.61204,4165,73.08299702,8330,-1979392,153088,-1826304,53
3827,275,21,9,0.0670404681,0.932959532,1167.066229,1398.213037,2056.892083,1976.461818,4102,76.54413137,8204,-1959424,140800,-1818624,53
3672,258,20,10,0.065648855,0.934351145,1121.981822,1257.14137,1987.869009,1647.131783,3930,94.60760713,7860,-1880064,132096,-1747968,53
3642,234,20,10,0.060371517,0.939628483,1105.103798,1250.500584,1963.868479,1543.662393,3876,80.5151641,7752,-1864704,119808,-1744896,53
3696,257,21,9,0.0650139135,0.934986087,1127.349068,1283.334017,1998.778139,1663.801556,3953,88.67205025,7906,-1892352,131584,-1760768,53
5169,562,21,9,0.0980631652,0.901936835,1653.556124,1533.681811,2932.151867,2257.567616,5731,125.404814,11462,-2646528,287744,-2358784,53
3678,246,21,9,0.0626911315,0.937308869,1117.790257,1295.610496,1983.808864,1643.906504,3924,90.12402389,7848,-1883136,125952,-1757184,53
1273,186,20,10,0.127484578,0.872515422,413.2500783,463.632293,741.9795758,648.0107527,1459,30.18828885,2918,-651776,95232,-556544,53
3646,258,20,10,0.0660860656,0.933913934,1110.4957,1288.957898,1977.171421,1603.848837,3904,81.18111874,7808,-1866752,132096,-1734656,53
6747,556,20,10,0.076133096,0.923866904,2089.752666,2130.658936,3724.777975,2768.847122,7303,148.8585406,14606,-3454464,284672,-3169792,53
5676,543,21,9,0.0873130728,0.912686927,1786.133961,1663.96183,3191.554792,2257.504604,6219,147.5094877,12438,-2906112,278016,-2628096,53
601,73,20,10,0.108308605,0.891691395,189.998338,202.8931509,349.6139767,237.7671233,674,15.44100802,1348,-307712,37376,-270336,53
3691,263,20,10,0.0665149216,0.933485078,1125.238754,1313.879629,1998.307234,1685.486692,3954,82.08428482,7908,-1889792,134656,-1755136,53
4987,535,20,10,0.0968851865,0.903114813,1584.655332,1572.152966,2821.655504,2200.760748,5522,113.5513058,11044,-2553344,273920,-2279424,53
3672,267,21,9,0.0677837014,0.932216299,1124.988348,1246.882742,1993.785131,1642.88764,3939,100.8190427,7878,-1880064,136704,-1743360,53
5700,542,20,10,0.0868311439,0.913168856,1787.362184,1889.277816,3164.759298,2666.559041,6242,120.1771275,12484,-2918400,277504,-2640896,53
5704,515,20,10,0.0828107413,0.917189259,1781.950851,1767.984684,3178.357118,2352.895146,6219,131.9541693,12438,-2920448,263680,-2656768,53
3710,253,20,10,0.0638405249,0.936159475,1127.990875,1317.229265,2003.654717,1664.454545,3963,87.34846815,7926,-1899520,129536,-1769984,53
5579,492,21,9,0.0810410147,0.918958985,1725.666964,1947.253853,3085.278724,2477.207317,6071,133.3406545,12142,-2856448,251904,-2604544,53
3674,254,21,9,0.0646639511,0.935336049,1119.838839,1284.050177,1985.204137,1665.023622,3928,94.10637278,7856,-1881088,130048,-1751040,53
3829,321,21,9,0.0773493976,0.922650602,1186.870428,1282.634674,2101.805955,1761.713396,4150,99.30605408,8300,-1960448,164352,-1796096,53
3702,254,20,10,0.064206269,0.935793731,1130.026065,1252.111461,2002.691518,1625.913386,3956,90.09337281,7912,-1895424,130048,-1765376,53
3742,250,21,9,0.0626252505,0.937374749,1135.406795,1358.227371,2012.969535,1749.984,3992,95.13822688,7984,-1915904,128000,-1787904,53
3767,259,20,10,0.064331843,0.935668157,1147.014902,1341.18593,2030.080966,1772.339768,4026,92.27595691,8052,-1928704,132608,-1796096,53
849,98,20,10,0.103484688,0.896515312,268.8477494,256.6440952,492.9729093,309.6326531,947,17.14647836,1894,-434688,50176,-384512,53
3655,238,21,9,0.0611353712,0.938864629,1112.826891,1226.194532,1970.330506,1588.710084,3893,74.2655475,7786,-1871360,121856,-1749504,53
3654,236,20,10,0.0606683805,0.93933162,1108.871157,1294.719141,1962.188834,1687.105932,3890,72.43947858,7780,-1870848,120832,-1750016,53
3660,246,20,10,0.0629800307,0.937019969,1114.957709,1248.248539,1977.309016,1599.268293,3906,92.20963173,7812,-1873920,125952,-1747968,53
5253,497,20,10,0.0864347826,0.913565217,1651.920594,1540.627452,2948.986484,2098.790744,5750,106.0103245,11500,-2689536,254464,-2435072,53
3793,297,20,10,0.0726161369,0.927383863,1171.576678,1253.290357,2068.958344,1745.912458,4090,74.25562818,8180,-1942016,152064,-1789952,53
3653,253,20,10,0.0647721454,0.935227855,1115.721339,1220.520141,1980.73556,1560.252964,3906,91.90588235,7812,-1870336,129536,-1740800,53
655,99,20,10,0.131299735,0.868700265,216.9249286,177.1904341,396.4503817,252.1212121,754,15.57529436,1508,-335360,50688,-284672,53
3664,251,20,10,0.0641123883,0.935887612,1114.321836,1315.207188,1975.093068,1708.482072,3915,95.81497797,7830,-1875968,128512,-1747456,53
3688,263,20,10,0.0665654265,0.933434574,1124.565679,1302.848538,1998.989696,1653.619772,3951,88.21165439,7902,-1888256,134656,-1753600,53
3642,252,20,10,0.0647149461,0.935285054,1111.000796,1229.798916,1975.442339,1543.666667,3894,80.13994649,7788,-1864704,129024,-1735680,53
3688,257,21,9,0.0651457541,0.934854246,1123.629902,1296.810994,1995.191703,1654.544747,3945,101.3617677,7890,-1888256,131584,-1756672,53
3852,285,21,9,0.0688905004,0.9311095,1176.380664,1399.755261,2083.17731,1877.382456,4137,76.93881346,8274,-1972224,145920,-1826304,53
693,102,20,10,0.128301887,0.871698113,227.8640615,191.6680638,417.9163059,262.6862745,795,14.44141689,1590,-354816,52224,-302592,53
3675,263,20,10,0.0667851701,0.93321483,1120.944291,1280.527805,1996.530612,1591.790875,3938,84.99892079,7876,-1881600,134656,-1746944,53
3697,249,20,10,0.0631018753,0.936898125,1124.262124,1291.137193,1996.967,1625.076305,3946,71.99416165,7892,-1892864,127488,-1765376,53
196,42,19,11,0.176470588,0.823529412,67.57832757,67.7013751,125.1785714,93,238,6.083844581,476,-100352,21504,-78848,53
4292,520,20,10,0.108063175,0.891936825,1378.481503,1429.307894,2447.653774,2066.823077,4812,90.82672707,9624,-2197504,266240,-1931264,53
178,36,19,11,0.168224299,0.831775701,61.08617519,55.90109211,113.6460674,77.11111111,214,5.237395986,428,-91136,18432,-72704,53
87,13,22,8,0.13,0.87,28.08421644,29.56249023,52.73563218,35.53846154,100,2.475247525,200,-44544,6656,-37888,53
5053,550,20,10,0.0981616991,0.901838301,1596.41842,1721.244396,2856.141302,2304.589091,5603,139.2395626,11206,-2587136,281600,-2305536,53
4212,462,21,9,0.0988446727,0.901155327,1341.034393,1313.793369,2394.188746,1820.675325,4674,111.1533888,9348,-2156544,236544,-1920000,53
5213,507,20,10,0.0886363636,0.911363636,1641.308324,1553.654072,2935.257433,2091.840237,5720,139.1727494,11440,-2669056,259584,-2409472,53
100,18,20,10,0.152542373,0.847457627,33.26037282,32.83164124,62.74,41.5,118,4.133099825,236,-51200,9216,-41984,53
3579,420,20,10,0.105026257,0.894973743,1146.155926,1129.170109,2052.011735,1556.785714,3999,86.18534483,7998,-1832448,215040,-1617408,53
5821,543,20,10,0.0853236958,0.914676304,1828.155623,1746.675088,3255.891256,2395.740331,6364,131.9784322,12728,-2980352,278016,-2702336,53
4974,486,20,10,0.089010989,0.910989011,1562.701016,1500.460464,2806.577604,1951.878601,5460,144.6357616,10920,-2546688,248832,-2297856,53
4828,453,21,9,0.0857792085,0.914220792,1518.498727,1387.693502,2710.073529,1904.825607,5281,124.8168282,10562,-2471936,231936,-2240000,53
77,21,20,10,0.214285714,0.785714286,28.1959627,24.631709,53.02597403,36.57142857,98,1.592201462,196,-39424,10752,-28672,53
3621,435,20,10,0.107248521,0.892751479,1161.912004,1236.188177,2043.144159,1906.6,4056,104.9146405,8112,-1853952,222720,-1631232,53
4895,496,21,9,0.0920051938,0.907994806,1539.073325,1601.36563,2755.689479,2106.927419,5391,123.8171796,10782,-2506240,253952,-2252288,53
5856,521,20,10,0.0816998589,0.918300141,1834.528607,1672.54909,3267.78125,2303.504798,6377,122.799923,12754,-2998272,266752,-2731520,53
97,16,20,10,0.14159292,0.85840708,31.52219273,30.0124974,60.71134021,34.5,113,3.884496391,226,-49664,8192,-41472,53
5141,480,21,9,0.085394058,0.914605942,1605.353147,1745.328692,2849.360047,2400.147917,5621,143.5026806,11242,-2632192,245760,-2386432,53
6466,574,20,10,0.0815340909,0.918465909,2016.421477,1856.27319,3621.426693,2383.580139,7040,126.3460158,14080,-3310592,293888,-3016704,53
5175,508,20,10,0.089389407,0.910610593,1613.701995,1746.432067,2910.265314,2146.580709,5683,127.3644106,11366,-2649600,260096,-2389504,53
7775,592,20,10,0.0707541532,0.929245847,2432.757725,2131.630944,4215.254405,3773.521959,8367,156.5095398,16734,-3980800,303104,-3677696,53
7908,587,20,10,0.0690994703,0.93090053,2460.795666,2320.006551,4266.770359,3995.127768,8495,187.9009069,16990,-4048896,300544,-3748352,53
7973,564,20,10,0.0660653625,0.933934637,2469.847652,2373.943917,4285.623354,4034.003546,8537,217.5586137,17074,-4082176,288768,-3793408,53
7921,510,20,10,0.060491045,0.939508955,2438.430669,2341.638761,4234.858099,3923.107843,8431,202.912154,16862,-4055552,261120,-3794432,53
6590,520,20,10,0.0731364276,0.926863572,2031.476636,2049.594073,3635.135357,2546.275,7110,144.2190669,14220,-3374080,266240,-3107840,53
7494,550,21,9,0.0683739433,0.931626057,2333.286977,2149.420582,4040.240459,3780.778182,8044,169.2404797,16088,-3836928,281600,-3555328,53
8005,551,20,10,0.064399252,0.935600748,2471.322758,2447.846518,4283.932792,4199.571688,8556,205.3768603,17112,-4098560,282112,-3816448,53
8003,575,21,9,0.0670319422,0.932968058,2482.784937,2377.894102,4300.855804,4131.446957,8578,187.9491674,17156,-4097536,294400,-3803136,53
227,45,19,11,0.165441176,0.834558824,78.24164028,72.27764028,142.6696035,105.3777778,272,5.290799455,544,-116224,23040,-93184,53
5829,557,20,10,0.0872220482,0.912777952,1836.77912,1686.009419,3275.859496,2331.608618,6386,131.0217481,12772,-2984448,285184,-2699264,53
7441,428,21,9,0.0543906468,0.945609353,2267.692373,2294.460538,3960.183174,3497.17757,7869,199.3161094,15738,-3809792,219136,-3590656,53
7361,458,20,10,0.0585752654,0.941424735,2259.595183,2148.502843,3943.133406,3377.478166,7819,192.4440069,15638,-3768832,234496,-3534336,53
7998,563,20,10,0.0657633454,0.934236655,2480.727985,2302.468287,4307.025131,3911.285968,8561,211.174149,17122,-4094976,288256,-3806720,53
75,20,20,10,0.210526316,0.789473684,26.97305322,25.89034569,51.12,36.3,95,1.538710722,190,-38400,10240,-28160,53
79,19,21,9,0.193877551,0.806122449,27.97701462,25.74238451,52.63291139,36.47368421,98,1.528145954,196,-40448,9728,-30720,53
84,26,20,10,0.236363636,0.763636364,30.74884545,33.88575044,57.64285714,48.57692308,110,1.745754642,220,-43008,13312,-29696,53
8042,605,20,10,0.0699664624,0.930033538,2508.447001,2308.20946,4345.349167,4040.214876,8647,210.1336574,17294,-4117504,309760,-3807744,53
6764,636,20,10,0.0859459459,0.914054054,2121.81674,1978.528962,3802.993791,2610.455975,7400,147.6751147,14800,-3463168,325632,-3137536,53
7888,576,21,9,0.0680529301,0.93194707,2454.154607,2260.921362,4258.235548,3880.065972,8464,203.4615385,16928,-4038656,294912,-3743744,53
7755,566,21,9,0.0680206706,0.931979329,2412.445996,2234.613938,4182.334494,3868.687279,8321,177.0048926,16642,-3970560,289792,-3680768,53
5539,282,21,9,0.0484452843,0.951554716,1662.000153,2006.059209,2907.183246,2985.968085,5821,679.2298716,11642,-2835968,144384,-2691584,54
5142,270,22,8,0.0498891353,0.950110865,1542.213678,1901.345137,2700.474329,2821.255556,5412,398.5272459,10824,-2632704,138240,-2494464,54
5103,271,21,9,0.0504279866,0.949572013,1532.181102,1875.921079,2687.716833,2683.416974,5374,169.4733523,10748,-2612736,138752,-2473984,54
5252,271,22,8,0.0490675358,0.950932464,1576.458411,1908.285015,2761.745811,2766.926199,5523,495.3363229,11046,-2689024,138752,-2550272,54
5138,274,21,9,0.0506282336,0.949371766,1540.359374,1925.167172,2700.89529,2811.59854,5412,677.3466834,10824,-2630656,140288,-2490368,54
5578,282,21,9,0.0481228669,0.951877133,1671.056045,2053.840693,2925.03962,3038.507092,5860,414.7204529,11720,-2855936,144384,-2711552,54
5171,272,21,9,0.0499724417,0.950027558,1552.181855,1896.231745,2718.048347,2797.125,5443,456.6275168,10886,-2647552,139264,-2508288,54
5590,280,21,9,0.0477001704,0.95229983,1674.071508,2059.142618,2931.488193,3015.592857,5870,481.9376026,11740,-2862080,143360,-2718720,54
5553,284,21,9,0.0486551311,0.951344869,1662.902686,2069.259696,2915.976409,2978.119718,5837,794.1496599,11674,-2843136,145408,-2697728,54
5642,285,21,9,0.0480850346,0.951914965,1690.103843,2077.620385,2957.698157,3088.754386,5927,544.7610294,11854,-2888704,145920,-2742784,54
5608,283,21,9,0.0480393821,0.951960618,1682.691664,2022.570376,2947.435984,2917.54417,5891,519.9470432,11782,-2871296,144896,-2726400,54
5157,269,21,9,0.049576115,0.950423885,1547.579857,1889.907135,2711.057592,2760.32342,5426,408.5843373,10852,-2640384,137728,-2502656,54
5137,274,21,9,0.0506375901,0.94936241,1542.783829,1886.175252,2708.350204,2661.937956,5411,138.4595701,10822,-2630144,140288,-2489856,54
5150,271,21,9,0.0499907766,0.950009223,1544.145691,1917.092136,2709.978252,2730.416974,5421,582.9032258,10842,-2636800,138752,-2498048,54
5159,273,22,8,0.050257732,0.949742268,1547.276894,1917.670478,2712.391549,2794.139194,5432,701.8087855,10864,-2641408,139776,-2501632,54
5557,281,21,9,0.0481329222,0.951867078,1664.024517,2059.425904,2915.321576,3002.131673,5838,738.0530973,11676,-2845184,143872,-2701312,54
5137,270,21,9,0.0499352691,0.950064731,1541.776912,1886.727622,2700.999805,2761.081481,5407,456.2869198,10814,-2630144,138240,-2491904,54
5177,273,21,9,0.0500917431,0.949908257,1568.516838,1640.158394,2738.984933,2469.78022,5450,280.3497942,10900,-2650624,139776,-2510848,54
5181,278,21,9,0.0509250779,0.949074922,1555.043971,1922.667865,2727.451457,2777.496403,5459,196.1552282,10918,-2652672,142336,-2510336,54
5340,275,21,9,0.0489759573,0.951024043,1604.004879,1919.658121,2809.548502,2777.930909,5615,344.2673207,11230,-2734080,140800,-2593280,54
1272,190,22,8,0.12995896,0.87004104,408.1784991,486.4035527,712.5023585,858.6842105,1462,140.1725791,2924,-651264,97280,-553984,54
1262,192,22,8,0.132049519,0.867950481,405.1760667,491.7314799,711.1489699,834.9739583,1454,155.3418803,2908,-646144,98304,-547840,54
1289,183,22,8,0.124320652,0.875679348,410.7999318,502.7505696,722.5764158,834.5737705,1472,112.5382263,2944,-659968,93696,-566272,54
1271,194,22,8,0.132423208,0.867576792,407.3752493,496.1444493,714.3595594,855.1237113,1465,112.3466258,2930,-650752,99328,-551424,54
1422,207,22,8,0.127071823,0.872928177,454.4478577,559.8108402,802.7299578,899.2898551,1629,29.12048624,3258,-728064,105984,-622080,54
1266,190,23,7,0.130494505,0.869505495,405.427092,490.7699594,709.8830964,852.5473684,1456,104.8236141,2912,-648192,97280,-550912,54
1271,185,23,7,0.12706044,0.87293956,407.086111,489.1549938,713.256491,833.227027,1456,95.97890574,2912,-650752,94720,-556032,54
1382,196,23,7,0.124207858,0.875792142,442.8828354,529.4369105,778.1483357,869.5408163,1578,130.5210918,3156,-707584,100352,-607232,54
1257,183,22,8,0.127083333,0.872916667,401.1890876,488.9173009,703.7653142,835.4480874,1440,71.25185552,2880,-643584,93696,-549888,54
1263,176,23,7,0.122307158,0.877692842,401.7778142,493.4717988,707.6500396,808.625,1439,129.7565374,2878,-646656,90112,-556544,54
1288,184,22,8,0.125,0.875,409.6829488,510.8546783,724.0582298,823.5923913,1472,46.31843927,2944,-659456,94208,-565248,54
1333,200,22,8,0.130463144,0.869536856,425.9659873,527.9804369,751.0412603,873.365,1533,90.87136929,3066,-682496,102400,-580096,54
1276,186,23,7,0.127222982,0.872777018,408.2671117,494.2359425,716.3847962,835.1935484,1462,168.4331797,2924,-653312,95232,-558080,54
1339,192,22,8,0.12540823,0.87459177,431.1405988,503.478102,754.2113518,848.2135417,1531,63.65904366,3062,-685568,98304,-587264,54
843,83,22,8,0.0896328294,0.910367171,258.1084322,342.0561957,469.1162515,406.4578313,926,13.97103199,1852,-431616,42496,-389120,54
800,78,23,7,0.0888382688,0.911161731,245.2576649,299.8236793,451.37625,317.6923077,878,12.64036856,1756,-409600,39936,-369664,54
1346,188,23,7,0.122555411,0.877444589,429.6551074,517.8333016,754.2682021,862.2340426,1534,101.7241379,3068,-689152,96256,-592896,54
1343,193,22,8,0.125651042,0.874348958,431.1400589,508.9405979,753.6418466,871.8911917,1536,127.3631841,3072,-687616,98816,-588800,54
1260,186,22,8,0.128630705,0.871369295,404.0025189,490.2489435,710.7333333,809.983871,1446,100.1385042,2892,-645120,95232,-549888,54
1339,179,23,7,0.117918314,0.882081686,427.3561093,503.7858084,747.9275579,846.0670391,1518,169.9888018,3036,-685568,91648,-593920,54
1865,155,22,8,0.0767326733,0.923267327,572.9396188,693.9809479,1009.764611,1019.348387,2020,123.4718826,4040,-954880,79360,-875520,54
1813,152,22,8,0.0773536896,0.92264631,556.6620868,680.1502092,980.3838941,1014.203947,1965,159.7560976,3930,-928256,77824,-850432,54
1807,150,21,9,0.0766479305,0.923352069,553.1530939,689.4167687,974.9474267,1027.82,1957,131.8733154,3914,-925184,76800,-848384,54
1783,138,21,9,0.0718375846,0.928162415,544.3107392,672.3929506,959.0173864,986.615942,1921,208.577633,3842,-912896,70656,-842240,54
1823,153,21,9,0.0774291498,0.92257085,559.5545897,686.1071531,986.0104224,1018.163399,1976,189.8174832,3952,-933376,78336,-855040,54
1787,154,21,9,0.0793405461,0.920659454,549.8813737,669.1666191,968.9266928,995.0584416,1941,177.9101742,3882,-914944,78848,-836096,54
1839,160,21,9,0.08004002,0.91995998,566.0092544,690.2594494,996.5106036,1040.10625,1999,170.4177323,3998,-941568,81920,-859648,54
1805,166,21,9,0.0842212075,0.915778792,555.7508639,688.6975246,976.6842105,1087.295181,1971,35.37964459,3942,-924160,84992,-839168,54
1784,155,21,9,0.0799381124,0.920061888,548.649759,673.5103782,967.1283632,1003.051613,1939,153.4018987,3878,-913408,79360,-834048,54
1800,151,21,9,0.0773962071,0.922603793,551.9118882,683.5109886,975.0772222,987,1951,163.400335,3902,-921600,77312,-844288,54
1781,146,22,8,0.0757654385,0.924234561,546.9000369,658.2192926,960.1566536,1010.883562,1927,229.9522673,3854,-911872,74752,-837120,54
1839,155,22,8,0.0777331996,0.9222668,566.270743,672.9422166,991.7063622,1066.23871,1994,172.0448663,3988,-941568,79360,-862208,54
1821,160,21,9,0.0807672892,0.919232711,561.4594567,678.4079603,988.3163097,1021.54375,1981,149.7354497,3962,-932352,81920,-850432,54
1768,149,21,9,0.0777256129,0.922274387,542.6705435,666.3862514,955.7777149,997.2348993,1917,154.3478261,3834,-905216,76288,-828928,54
1811,145,21,9,0.0741308793,0.925869121,553.9782302,681.186704,973.695196,1038.510345,1956,190.8292683,3912,-927232,74240,-852992,54
1805,160,21,9,0.0814249364,0.918575064,557.8692675,663.6613394,981.4204986,1000.81875,1965,70.68345324,3930,-924160,81920,-842240,54
1817,157,22,8,0.0795339412,0.920466059,560.8350166,664.2208722,984.3648872,1023.783439,1974,164.2262895,3948,-930304,80384,-849920,54
1806,148,22,8,0.0757420676,0.924257932,551.7287846,694.389602,972.4861573,1038.682432,1954,96.44619941,3908,-924672,75776,-848896,54
1794,158,21,9,0.080942623,0.919057377,552.479935,675.6527888,974.4704571,999.5443038,1952,131.7139001,3904,-918528,80896,-837632,54
1024,81,21,9,0.0733031674,0.926696833,309.9089793,411.6491567,558.0869141,488.691358,1105,17.72253408,2210,-524288,41472,-482816,54
3583,528,22,8,0.128435904,0.871564096,1171.070942,1238.530188,2007.328217,2386.285985,4111,138.6977058,8222,-1834496,270336,-1564160,54
3563,521,22,8,0.127571009,0.872428991,1166.990223,1205.879984,1993.705024,2376.197697,4084,150.312845,8168,-1824256,266752,-1557504,54
3573,542,22,8,0.131713244,0.868286756,1173.509951,1229.996148,2008.589421,2383.726937,4115,174.2167655,8230,-1829376,277504,-1551872,54
3774,559,22,8,0.129009924,0.870990076,1239.738614,1271.383136,2116.2761,2509.454383,4333,172.0810167,8666,-1932288,286208,-1646080,54
3623,530,22,8,0.127618589,0.872381411,1180.766962,1287.011235,2039.499034,2333.350943,4153,115.2650569,8306,-1854976,271360,-1583616,54
3573,525,22,8,0.128111274,0.871888726,1169.390363,1215.847574,1998.363,2397.52381,4098,104.6208833,8196,-1829376,268800,-1560576,54
3558,544,22,8,0.132618235,0.867381765,1167.747942,1239.783816,2002.716414,2370.566176,4102,96.47224835,8204,-1821696,278528,-1543168,54
3541,518,22,8,0.12761764,0.87238236,1160.769126,1192.299757,1981.464558,2361.783784,4059,157.2646261,8118,-1812992,265216,-1547776,54
3555,501,22,8,0.12352071,0.87647929,1158.035525,1208.323455,1982.243319,2356.728543,4056,152.9988684,8112,-1820160,256512,-1563648,54
3574,524,22,8,0.127867252,0.872132748,1169.419562,1226.217868,2003.350867,2364.265267,4098,182.2953737,8196,-1829888,268288,-1561600,54
2676,325,22,8,0.108297234,0.891702766,847.4092388,997.184261,1483.652466,1643.836923,3001,52.80661622,6002,-1370112,166400,-1203712,54
3547,509,22,8,0.125493097,0.874506903,1158.105478,1209.541793,1982.984212,2345.679764,4056,70.63740857,8112,-1816064,260608,-1555456,54
3567,521,22,8,0.127446184,0.872553816,1165.949436,1230.688007,2000.204654,2347.765835,4088,154.9658832,8176,-1826304,266752,-1559552,54
3633,536,22,8,0.128568002,0.871431998,1189.891034,1248.771644,2039.425268,2393.904851,4169,162.3442368,8338,-1860096,274432,-1585664,54
3773,546,22,8,0.126418152,0.873581848,1233.069707,1287.867498,2111.053273,2498.234432,4319,181.0142498,8638,-1931776,279552,-1652224,54
3255,501,22,8,0.133386581,0.866613419,1062.375413,1168.39545,1829.751459,2195.219561,3756,51.76405733,7512,-1666560,256512,-1410048,54
3308,496,22,8,0.130389064,0.869610936,1077.359661,1172.65156,1851.70526,2241.268145,3804,51.52377082,7608,-1693696,253952,-1439744,54
66,9,22,8,0.12,0.88,21.03083245,17.78333247,40.37878788,20.55555556,75,1.373123398,150,-33792,4608,-29184,54
3599,540,22,8,0.130466296,0.869533704,1182.075198,1229.856377,2022.130036,2389.044444,4139,97.82557315,8278,-1842688,276480,-1566208,54
3561,538,22,8,0.131251525,0.868748475,1170.923398,1217.382806,2003.155293,2360.063197,4099,145.6127886,8198,-1823232,275456,-1547776,54
2134,71,23,7,0.0321995465,0.967800454,634.6352178,687.3983586,1105.312559,1033.492958,2205,227.0854789,4410,-1092608,36352,-1056256,54
1549,52,23,7,0.0324797002,0.9675203,460.6285253,497.2024916,804.0852163,709.0961538,1601,32.28473483,3202,-793088,26624,-766464,54
2178,72,23,7,0.032,0.968,647.6419783,699.6451741,1128.024334,1049.138889,2250,370.675453,4500,-1115136,36864,-1078272,54
2150,71,23,7,0.0319675822,0.968032418,639.279636,690.7674683,1113.585116,1032.71831,2221,295.3457447,4442,-1100800,36352,-1064448,54
2134,71,23,7,0.0321995465,0.967800454,634.6031212,688.539583,1105.231022,1035.943662,2205,378.8659794,4410,-1092608,36352,-1056256,54
2143,71,23,7,0.032068654,0.967931346,637.2347092,689.5243403,1110.009333,1031.760563,2214,212.4760077,4428,-1097216,36352,-1060864,54
3307,111,23,7,0.0324751317,0.967524868,984.5835077,1044.165803,1712.278803,1626.711712,3418,470.7988981,6836,-1693184,56832,-1636352,54
4235,138,23,7,0.0315572833,0.968442717,1260.678618,1310.681455,2189.713341,2103.731884,4373,606.518724,8746,-2168320,70656,-2097664,54
2131,71,24,6,0.0322434151,0.967756585,633.6716831,689.1419831,1103.817457,1031.943662,2202,345.1410658,4404,-1091072,36352,-1054720,54
2113,71,24,6,0.0325091575,0.967490842,628.3044737,689.2419164,1094.43398,1034.943662,2184,266.3414634,4368,-1081856,36352,-1045504,54
2136,71,23,7,0.032170367,0.967829633,635.1411955,689.9300221,1106.335674,1033.732394,2207,490.4444444,4414,-1093632,36352,-1057280,54
4231,138,23,7,0.0315861753,0.968413825,1259.38334,1313.646965,2187.699835,2102.224638,4369,713.8888889,8738,-2166272,70656,-2095616,54
2156,72,23,7,0.0323159785,0.967684022,641.1038013,698.9713439,1116.701763,1048.569444,2228,239.3125671,4456,-1103872,36864,-1067008,54
2130,71,23,7,0.0322580645,0.967741935,633.3827823,688.964235,1103.275587,1032.732394,2201,426.5503876,4402,-1090560,36352,-1054208,54
2127,71,23,7,0.0323020928,0.967697907,632.4545909,689.8193336,1101.747062,1032.183099,2198,171.71875,4396,-1089024,36352,-1052672,54
4217,137,23,7,0.0314653192,0.968534681,1254.803147,1317.158043,2180.043159,2099.218978,4354,603.0470914,8708,-2159104,70144,-2088960,54
4211,137,22,8,0.0315087397,0.96849126,1252.606224,1328.094276,2177.434101,2084.313869,4348,609.8176718,8696,-2156032,70144,-2085888,54
4221,138,23,7,0.0316586373,0.968341363,1256.340381,1314.798784,2182.899076,2091.326087,4359,554.5801527,8718,-2161152,70656,-2090496,54
4058,133,23,7,0.0317346695,0.96826533,1208.003785,1261.794286,2098.670034,2014.533835,4191,702.0100503,8382,-2077696,68096,-2009600,54
2116,72,23,7,0.0329067642,0.967093236,629.3605521,691.109802,1096.886578,1024.361111,2188,33.99098959,4376,-1083392,36864,-1046528,54
1187,100,23,7,0.0777000777,0.922299922,362.8623239,444.0727385,633.6571188,766.77,1287,77.34375,2574,-607744,51200,-556544,54
1231,92,23,7,0.0695389267,0.930461073,373.5126805,470.4119051,654.9642567,756.1413043,1323,52.83546326,2646,-630272,47104,-583168,54
1196,92,23,7,0.0714285714,0.928571429,363.9834102,445.7428724,635.5877926,760.3586957,1288,67.54063975,2576,-612352,47104,-565248,54
1241,96,23,7,0.071802543,0.928197457,378.2944549,464.4736324,661.9508461,760.125,1337,72.34848485,2674,-635392,49152,-586240,54
1248,93,23,7,0.0693512304,0.93064877,379.4526508,461.7155243,662.0560897,791.0215054,1341,70.7278481,2682,-638976,47616,-591360,54
1188,98,23,7,0.0762052877,0.923794712,361.9748308,456.2041857,634.8106061,748.8367347,1286,62.7011214,2572,-608256,50176,-558080,54
1186,95,23,7,0.0741608119,0.925839188,360.6630815,459.6956148,633.8187184,730.6526316,1281,75.66450089,2562,-607232,48640,-558592,54
1186,91,23,7,0.0712607674,0.928739233,361.4499504,434.0997728,629.6913997,760.3186813,1277,63.5007459,2554,-607232,46592,-560640,54
1248,102,23,7,0.0755555556,0.924444444,379.6725357,468.4825533,662.6113782,833.1960784,1350,23.49869452,2700,-638976,52224,-586752,54
1200,101,23,7,0.0776325903,0.92236741,366.3791043,464.0140379,644.37,729.7722772,1301,63.93120393,2602,-614400,51712,-562688,54
1245,97,23,7,0.0722801788,0.927719821,378.0205652,479.3399689,663.1172691,779.0927835,1342,71.76470588,2684,-637440,49664,-587776,54
1194,94,23,7,0.0729813665,0.927018634,363.2626777,454.7451069,636.4455611,746.8085106,1288,71.16022099,2576,-611328,48128,-563200,54
1212,94,23,7,0.0719754977,0.928024502,369.2861189,445.0216316,643.3622112,784.212766,1306,77.83075089,2612,-620544,48128,-572416,54
1207,95,23,7,0.0729646697,0.92703533,367.8879005,451.7062762,643.023198,759.2,1302,70.87642896,2604,-617984,48640,-569344,54
1240,98,22,8,0.0732436472,0.926756353,377.2205475,466.9833177,659.2040323,799.7755102,1338,78.15420561,2676,-634880,50176,-584704,54
1236,96,23,7,0.0720720721,0.927927928,376.2877653,461.6576319,657.2411003,785.7083333,1332,68.58908342,2664,-632832,49152,-583680,54
1274,104,23,7,0.0754716981,0.924528302,388.2565413,490.3470419,681.7935636,783.9038462,1378,57.80201342,2756,-652288,53248,-599040,54
1243,101,23,7,0.0751488095,0.92485119,379.1569852,471.2340783,664.0265487,776.7821782,1344,71.33757962,2688,-636416,51712,-584704,54
1223,101,22,8,0.0762839879,0.923716012,373.1862195,460.6836972,652.3499591,785.4059406,1324,84.54661558,2648,-626176,51712,-574464,54
855,42,23,7,0.0468227425,0.953177258,257.2310881,273.9337079,453.7918129,351.452381,897,129.2507205,1794,-437760,21504,-416256,54
5695,449,22,8,0.0730794271,0.926920573,1741.810679,2123.721624,3054.881651,3295.966592,6144,193.755913,12288,-2915840,229888,-2685952,54
5693,440,22,8,0.0717430295,0.92825697,1740.350864,2112.964664,3052.704022,3251.970455,6133,164.4235925,12266,-2914816,225280,-2689536,54
5722,436,22,8,0.0708022085,0.929197791,1756.686717,2032.917965,3080.595945,3065.116972,6158,182.6757639,12316,-2929664,223232,-2706432,54
5633,435,21,9,0.0716875412,0.928312459,1729.387069,2018.062693,3036.546245,3008.002299,6068,158.2681273,12136,-2884096,222720,-2661376,54
5751,448,22,8,0.0722697209,0.927730279,1764.753189,2080.53368,3096.137889,3149.578125,6199,181.7888563,12398,-2944512,229376,-2715136,54
5705,444,22,8,0.0722068629,0.927793137,1745.136768,2110.896596,3058.475898,3287.31982,6149,190.3125967,12298,-2920960,227328,-2693632,54
4799,298,22,8,0.0584657642,0.941534236,1462.259724,1494.507719,2585.259221,1965.080537,5097,94.40637155,10194,-2457088,152576,-2304512,54
5934,453,22,8,0.0709253171,0.929074683,1819.983239,2126.300286,3183.639198,3329.719647,6387,200.4079071,12774,-3038208,231936,-2806272,54
5056,341,22,8,0.06318325,0.93681675,1554.744145,1537.466823,2729.115111,2252.483871,5397,163.5950288,10794,-2588672,174592,-2414080,54
5704,434,22,8,0.0707070707,0.929292929,1748.968658,2043.854173,3058.420582,3215.115207,6138,202.7080581,12276,-2920448,222208,-2698240,54
5692,410,22,8,0.0671910849,0.932808915,1733.563771,2101.583923,3037.325545,3248.282927,6102,153.5867103,12204,-2914304,209920,-2704384,54
5673,445,22,8,0.0727361883,0.927263812,1733.457546,2123.415142,3039.917328,3309.146067,6118,208.3077971,12236,-2904576,227840,-2676736,54
5720,439,21,9,0.0712778048,0.928722195,1746.983087,2137.113233,3070.608217,3202.371298,6159,198.0385852,12318,-2928640,224768,-2703872,54
5724,441,22,8,0.0715328467,0.928467153,1750.899663,2116.55058,3077.035115,3160.421769,6165,216.4676966,12330,-2930688,225792,-2704896,54
5697,462,22,8,0.0750121773,0.924987823,1742.476119,2142.629677,3054.107952,3399.279221,6159,109.7469708,12318,-2916864,236544,-2680320,54
5714,449,22,8,0.0728541295,0.927145871,1749.624366,2113.764733,3071.012951,3221.821826,6163,215.9425368,12326,-2925568,229888,-2695680,54
5423,413,21,9,0.0707676491,0.929232351,1679.79681,1691.27067,2950.903006,2493.024213,5836,102.8007751,11672,-2776576,211456,-2565120,54
5910,469,22,8,0.0735224957,0.926477504,1813.487173,2154.686007,3175.390694,3374.095949,6379,112.7430187,12758,-3025920,240128,-2785792,54
5700,437,22,8,0.0712074303,0.92879257,1744.476152,2092.63472,3064.716667,3124.869565,6137,196.6356937,12274,-2918400,223744,-2694656,54
2260,160,22,8,0.0661157025,0.933884298,687.2367743,774.4386041,1233.25177,889.13125,2420,37.17357911,4840,-1157120,81920,-1075200,54
6243,409,22,8,0.0614852676,0.938514732,1892.74666,2299.242195,3323.233061,3376.366748,6652,215.2054351,13304,-3196416,209408,-2987008,54
6249,445,22,8,0.0664774425,0.933522558,1900.024644,2337.3442,3339.700272,3457.029213,6694,118.7721789,13388,-3199488,227840,-2971648,54
6369,428,22,8,0.0629689569,0.937031043,1933.85962,2338.140673,3408.588004,3256.32243,6797,201.9310755,13594,-3260928,219136,-3041792,54
6188,414,22,8,0.0627082702,0.93729173,1877.012512,2283.609152,3287.472689,3511.164251,6602,201.4647543,13204,-3168256,211968,-2956288,54
6235,424,22,8,0.0636732242,0.936326776,1893.866117,2290.765481,3316.430473,3529.542453,6659,215.3622251,13318,-3192320,217088,-2975232,54
6572,453,21,9,0.0644839858,0.935516014,1996.275122,2436.160909,3523.853469,3355.540839,7025,205.4694355,14050,-3364864,231936,-3132928,54
6264,432,21,9,0.064516129,0.935483871,1903.107765,2323.031614,3346.556513,3376.680556,6696,211.3636364,13392,-3207168,221184,-2985984,54
6245,424,22,8,0.0635777478,0.936422252,1894.9147,2315.480757,3320.693355,3545.71934,6669,194.7721963,13338,-3197440,217088,-2980352,54
6316,427,22,8,0.0633249296,0.93667507,1920.507375,2289.057436,3384.766783,3183.159251,6743,219.6416938,13486,-3233792,218624,-3015168,54
6243,439,22,8,0.0656988925,0.934301107,1897.823194,2325.072497,3347.378984,3257.895216,6682,215.7571844,13364,-3196416,224768,-2971648,54
6262,422,21,9,0.0631358468,0.936864153,1899.163288,2330.899969,3334.872086,3455.689573,6684,197.810003,13368,-3206144,216064,-2990080,54
6213,403,22,8,0.0609129383,0.939087062,1882.935414,2281.977331,3300.692741,3428.863524,6616,217.9901153,13232,-3181056,206336,-2974720,54
6385,444,21,9,0.0650168399,0.93498316,1943.828094,2331.038452,3411.444949,3466.123874,6829,213.2729544,13658,-3269120,227328,-3041792,54
6313,428,22,8,0.0634920635,0.936507937,1915.385561,2350.611144,3367.595596,3421.214953,6741,213.3903134,13482,-3232256,219136,-3013120,54
6159,443,22,8,0.0671008785,0.932899121,1886.556772,2143.472291,3317.656438,3076.878104,6602,211.1964171,13204,-3153408,226816,-2926592,54
6287,440,22,8,0.0654080571,0.934591943,1916.054268,2279.539088,3362.539049,3384.875,6727,210.0218545,13454,-3218944,225280,-2993664,54
6199,412,22,8,0.0623203751,0.937679625,1888.473311,2181.919208,3315.439264,3163.975728,6611,160.1114071,13222,-3173888,210944,-2962944,54
6258,432,22,8,0.064573991,0.935426009,1903.899422,2290.911074,3344.674497,3357.458333,6690,197.6950355,13380,-3204096,221184,-2982912,54
6204,432,21,9,0.0650994575,0.934900542,1885.76946,2301.994973,3321.262089,3278.833333,6636,177.7182646,13272,-3176448,221184,-2955264,54
2997,195,22,8,0.0610902256,0.938909774,907.1855581,929.1962142,1635.700033,994.025641,3192,48.41498559,6384,-1534464,99840,-1434624,54
1703,105,23,7,0.0580752212,0.941924779,512.727946,634.5431512,895.2125661,1055.133333,1808,109.244713,3616,-871936,53760,-818176,54
1709,102,23,7,0.0563224738,0.943677526,513.919816,631.0675269,896.1012288,1071.852941,1811,118.0573664,3622,-875008,52224,-822784,54
1761,112,23,7,0.0597971169,0.940202883,530.6556689,669.335871,929.8784781,1048.973214,1873,88.93637227,3746,-901632,57344,-844288,54
1709,110,23,7,0.0604727872,0.939527213,515.5922166,639.6671064,901.114687,1048.045455,1819,100,3638,-875008,56320,-818688,54
1711,112,23,7,0.0614371914,0.938562809,515.5564518,648.9143356,901.7504383,1068.580357,1823,110.8206687,3646,-876032,57344,-818688,54
1778,116,22,8,0.0612460401,0.93875396,536.5783227,678.1690171,941.8700787,1033.793103,1894,112.5371361,3788,-910336,59392,-850944,54
648,82,23,7,0.112328767,0.887671233,203.2972819,259.0053083,360.654321,403.7926829,730,31.82214473,1460,-331776,41984,-289792,54
1749,113,23,7,0.0606874329,0.939312567,527.3050793,655.5940515,921.1435106,1091.79646,1862,119.206146,3724,-895488,57856,-837632,54
1687,109,23,7,0.0606904232,0.939309577,508.7400914,636.7550988,890.1268524,1028.091743,1796,111.3453193,3592,-863744,55808,-807936,54
1755,117,23,7,0.0625,0.9375,528.9415028,678.7731573,928.5703704,1055.444444,1872,109.0273733,3744,-898560,59904,-838656,54
1773,112,23,7,0.0594164456,0.940583554,535.0362847,663.0405534,936.2272984,1050.214286,1885,110.4923798,3770,-907776,57344,-850432,54
1705,107,23,7,0.0590507726,0.940949227,514.7124568,626.2112589,897.9272727,1043.102804,1812,93.20987654,3624,-872960,54784,-818176,54
1766,115,23,7,0.0611376927,0.938862307,532.6290553,669.5283121,932.5702152,1070.452174,1881,107.6086957,3762,-904192,58880,-845312,54
1741,112,23,7,0.0604425256,0.939557474,524.7928785,656.003389,917.6398621,1072.5,1853,123.4510326,3706,-891392,57344,-834048,54
1703,110,23,7,0.0606729178,0.939327082,513.9424612,641.8227443,899.7680564,1018.963636,1813,69.59692898,3626,-871936,56320,-815616,54
1718,110,23,7,0.0601750547,0.939824945,517.1918272,655.1745843,905.5768335,1053.863636,1828,101.7817372,3656,-879616,56320,-823296,54
1764,110,23,7,0.0586979723,0.941302028,531.0608876,665.4155111,928.8684807,1075.918182,1874,103.0236394,3748,-903168,56320,-846848,54
1708,112,23,7,0.0615384615,0.938461538,515.1676986,647.8662815,901.8612412,1042.241071,1820,95.78947368,3640,-874496,57344,-817152,54
1754,113,23,7,0.0605249063,0.939475094,529.0291541,660.4853534,925.4378563,1066.902655,1867,94.34057605,3734,-898048,57856,-840192,54
505,43,23,7,0.0784671533,0.921532847,156.042762,181.3047717,275.2831683,265.3023256,548,8.683251466,1096,-258560,22016,-236544,54
2072,120,23,7,0.0547445255,0.945255474,622.5648071,766.7471479,1086.142857,1275.333333,2192,154.2575651,4384,-1060864,61440,-999424,54
2045,119,22,8,0.0549907579,0.945009242,614.3297602,763.6399422,1073.076284,1244.445378,2164,122.7453205,4328,-1047040,60928,-986112,54
2058,123,23,7,0.0563961486,0.943603851,618.4028249,780.8723303,1082.696793,1229.926829,2181,149.793956,4362,-1053696,62976,-990720,54
2041,129,23,7,0.0594470046,0.940552995,614.472563,774.1175599,1075.277315,1247.24031,2170,126.9005848,4340,-1044992,66048,-978944,54
2061,123,23,7,0.0563186813,0.943681319,619.2902666,783.7980112,1084.899078,1219.861789,2184,121.9430486,4368,-1055232,62976,-992256,54
2036,124,23,7,0.0574074074,0.942592593,612.0935069,764.8467015,1069.280452,1264.717742,2160,127.5841701,4320,-1042432,63488,-978944,54
2024,118,23,7,0.0550887021,0.944911298,607.5133689,766.2190817,1062.915514,1218.745763,2142,117.4986286,4284,-1036288,60416,-975872,54
2033,118,23,7,0.0548582055,0.945141795,610.3662086,763.404978,1066.711756,1236.025424,2151,139.3134715,4302,-1040896,60416,-980480,54
1786,115,23,7,0.0604944766,0.939505523,537.9737043,682.4291796,942.7015677,1079.878261,1901,70.04421518,3802,-914432,58880,-855552,54
2083,120,23,7,0.0544711757,0.945528824,625.1846127,782.1296628,1092.559289,1265.875,2203,112.2261844,4406,-1066496,61440,-1005056,54
2118,117,23,7,0.0523489933,0.947651007,636.8109619,771.557638,1111.327195,1238.794872,2235,130.9314587,4470,-1084416,59904,-1024512,54
2038,120,23,7,0.0556070436,0.944392956,612.3329157,764.8425578,1070.262022,1236.391667,2158,429.0258449,4316,-1043456,61440,-982016,54
2042,122,23,7,0.0563770795,0.943622921,613.7687504,761.2833092,1071.315867,1269.696721,2164,100.1851852,4328,-1045504,62464,-983040,54
2093,132,23,7,0.0593258427,0.940674157,630.2360781,801.1128504,1105.702819,1228.704545,2225,120.5308776,4450,-1071616,67584,-1004032,54
2074,122,22,8,0.0555555556,0.944444444,622.6431191,789.0281564,1090.330762,1237.377049,2196,98.38709677,4392,-1061888,62464,-999424,54
2036,119,23,7,0.0552204176,0.944779582,611.4237125,761.039144,1067.674853,1254.655462,2155,96.76695106,4310,-1042432,60928,-981504,54
2037,116,23,7,0.0538783093,0.946121691,611.4226493,752.0117017,1066.015709,1269.887931,2153,119.8107958,4306,-1042944,59392,-983552,54
2058,126,23,7,0.0576923077,0.942307692,618.7443356,781.8717008,1083.039359,1247.02381,2184,124.4444444,4368,-1053696,64512,-989184,54
1807,117,22,8,0.0608108108,0.939189189,544.6970595,677.1461392,951.2772551,1135.82906,1924,110.8294931,3848,-925184,59904,-865280,54
2057,122,23,7,0.0559889858,0.944011014,618.7742179,771.6422881,1082.742829,1212.360656,2179,112.7263321,4358,-1053184,62464,-990720,54
2967,281,20,10,0.0865147783,0.913485222,934.6881629,917.5426777,1652.419953,1329.701068,3248,59.02235144,6496,-1519104,143872,-1375232,55
3030,271,20,10,0.0820963344,0.917903666,945.7208212,979.2588627,1678.347525,1345.232472,3301,66.63302382,6602,-1551360,138752,-1412608,55
3923,403,21,9,0.0931576514,0.906842349,1249.071025,1244.378289,2170.181239,2098.461538,4326,80.46875,8652,-2008576,206336,-1802240,55
3799,383,20,10,0.0915829747,0.908417025,1206.465705,1210.111478,2101.840221,1988.934726,4182,76.80440771,8364,-1945088,196096,-1748992,55
2441,220,21,9,0.0826756858,0.917324314,762.429907,806.0597811,1347.767718,1144.954545,2661,48.95143488,5322,-1249792,112640,-1137152,55
4076,295,21,9,0.0674902768,0.932509723,1242.2004,1476.994766,2206.813543,1898.420339,4371,77.55500355,8742,-2086912,151040,-1935872,55
4164,391,21,9,0.0858397366,0.914160263,1308.122492,1381.992046,2286.445965,2188.053708,4555,81.58696042,9110,-2131968,200192,-1931776,55
4630,449,20,10,0.088403229,0.911596771,1459.520096,1531.791612,2546.039741,2477.719376,5079,96.50389512,10158,-2370560,229888,-2140672,55
3826,328,21,9,0.0789600385,0.921039961,1189.904249,1291.814207,2091.026398,1919.719512,4154,76.3041881,8308,-1958912,167936,-1790976,55
4618,415,20,10,0.0824557918,0.917544208,1448.292998,1489.916166,2534.187527,2325.742169,5033,92.7229182,10066,-2364416,212480,-2151936,55
4540,440,21,9,0.0883534137,0.911646586,1430.375156,1503.252568,2503.844053,2352.813636,4980,89.84304528,9960,-2324480,225280,-2099200,55
2797,283,22,8,0.0918831169,0.908116883,889.0535958,874.126857,1556.51591,1382.208481,3080,55.87808418,6160,-1432064,144896,-1287168,55
3494,340,21,9,0.0886802295,0.91131977,1101.234887,1142.996689,1937.063824,1716.452941,3834,68.20850382,7668,-1788928,174080,-1614848,55
3924,374,21,9,0.0870172173,0.912982783,1234.318159,1305.402769,2153.271916,2109.925134,4298,81.92908883,8596,-2009088,191488,-1817600,55
3691,314,20,10,0.0784019975,0.921598002,1147.177302,1254.323785,1996.615822,2078.044586,4005,71.81280258,8010,-1889792,160768,-1729024,55
4703,448,21,9,0.0869734032,0.913026597,1484.201691,1510.465753,2587.429513,2456.015625,5151,94.09937888,10302,-2407936,229376,-2178560,55
3864,336,21,9,0.08,0.92,1201.503589,1330.50237,2105.2456,2045.925595,4200,74.70651014,8400,-1978368,172032,-1806336,55
3831,365,21,9,0.0869876072,0.913012393,1202.375002,1300.913639,2100.410598,2078.446575,4196,79.81738634,8392,-1961472,186880,-1774592,55
2184,255,21,9,0.104551046,0.895448954,699.4651614,741.8937639,1223.08196,1193.603922,2439,83.98760331,4878,-1118208,130560,-987648,55
2694,259,21,9,0.0877074162,0.912292584,847.4646953,891.7625076,1489.89755,1342.84556,2953,53.96564327,5906,-1379328,132608,-1246720,55
8562,742,20,10,0.0797506449,0.920249355,2662.754096,2800.286632,4726.695048,3796.357143,9304,280.6636501,18608,-4383744,379904,-4003840,55
2400,506,21,9,0.174122505,0.825877495,863.2768515,711.8458648,1451.37375,1463.58498,2906,50.83974808,5812,-1228800,259072,-969728,55
8621,736,21,9,0.0786576894,0.921342311,2674.149509,2813.584689,4764.114836,3682.023098,9357,287.2007366,18714,-4413952,376832,-4037120,55
7954,584,21,9,0.0684000937,0.931599906,2444.559319,2577.328563,4332.06349,3417.393836,8538,283.0901857,17076,-4072448,299008,-3773440,55
7807,639,21,9,0.0756571158,0.924342884,2399.455382,2648.920573,4310.233124,3163.835681,8446,204.1576021,16892,-3997184,327168,-3670016,55
173,57,21,9,0.247826087,0.752173913,61.91248341,73.66926331,107.7976879,138.877193,230,4.212454212,460,-88576,29184,-59392,55
8690,825,21,9,0.0867052023,0.913294798,2726.726095,2784.575121,4846.190219,3829.06303,9515,299.5906801,19030,-4449280,422400,-4026880,55
8674,751,20,10,0.0796816976,0.920318302,2695.762563,2798.636133,4801.458843,3691.306258,9425,319.2750678,18850,-4441088,384512,-4056576,55
9153,769,21,9,0.0775045354,0.922495465,2851.781731,2722.747528,5064.767726,3732.358908,9922,435.5575066,19844,-4686336,393728,-4292608,55
8639,748,21,9,0.0796846703,0.92031533,2689.399875,2778.763221,4772.500058,3787.36631,9387,299.2349378,18774,-4423168,382976,-4040192,55
9120,797,20,10,0.0803670465,0.919632954,2845.002123,2817.169145,5058.900877,3815.843162,9917,277.7093251,19834,-4669440,408064,-4261376,55
8620,839,21,9,0.0886985939,0.911301406,2696.02222,3009.469404,4783.032019,4185.141836,9459,171.8256131,18918,-4413440,429568,-3983872,55
9115,797,21,9,0.0804075868,0.919592413,2843.906575,2810.968744,5056.551399,3812.248432,9912,178.5302594,19824,-4666880,408064,-4258816,55
8519,762,21,9,0.0821032216,0.917896778,2652.767067,2792.028381,4724.876159,3703.282152,9281,250.6346206,18562,-4361728,390144,-3971584,55
5088,470,21,9,0.0845627924,0.915437208,1603.222903,1404.115144,2850.512972,2010.746809,5558,102.0565553,11116,-2605056,240640,-2364416,55
8653,778,21,9,0.0824939031,0.917506097,2690.720681,2886.176061,4801.906853,3760.534704,9431,248.053656,18862,-4430336,398336,-4032000,55
8528,730,22,8,0.0788507237,0.921149276,2657.254721,2618.760696,4720.884029,3561.934247,9258,215.2022315,18516,-4366336,373760,-3992576,55
195,34,20,10,0.148471616,0.851528384,64.80614617,71.97880912,117.0666667,103.1470588,229,5.169300226,458,-99840,17408,-82432,55
8228,740,20,10,0.0825156111,0.917484389,2565.343578,2696.343357,4560.499028,3639.472973,8968,275.683984,17936,-4212736,378880,-3833856,55
8240,753,20,10,0.0837317914,0.916268209,2571.481951,2735.579221,4567.289563,3727.828685,8993,301.5761234,17986,-4218880,385536,-3833344,55
7963,963,21,9,0.107887071,0.892112929,2569.886878,2553.97817,4390.610448,5066.220145,8926,175.1569859,17852,-4077056,493056,-3584000,55
8277,1023,21,9,0.11,0.89,2685.84448,2610.825495,4582.467682,5200.943304,9300,171.3338246,18600,-4237824,523776,-3714048,55
8464,1100,21,9,0.115014638,0.884985362,2761.329124,2692.156041,4709.542179,5343.877273,9564,188.974511,19128,-4333568,563200,-3770368,55
6877,1011,22,8,0.128169371,0.871830629,2228.429946,2349.552116,3796.957103,4948.11276,7888,159.9026961,15776,-3521024,517632,-3003392,55
8313,1538,22,8,0.156126282,0.843873718,2779.714595,2762.976377,4662.768676,6348.784135,9851,177.6235124,19702,-4256256,787456,-3468800,55
3972,407,21,9,0.0929435944,0.907056406,1235.913878,1455.254213,2149.988167,2580.484029,4379,90.98275504,8758,-2033664,208384,-1825280,55
8467,1391,21,9,0.141103672,0.858896328,2799.918213,2747.747319,4707.62844,6280.029475,9858,373.9757208,19716,-4335104,712192,-3622912,55
8270,1149,22,8,0.121987472,0.878012528,2712.925747,2621.320618,4596.46844,5527.150566,9419,191.6378433,18838,-4234240,588288,-3645952,55
8813,1107,21,9,0.111592742,0.888407258,2851.72988,2874.365722,4878.36605,5614.38121,9920,302.2547227,19840,-4512256,566784,-3945472,55
8689,1215,21,9,0.122677706,0.877322294,2866.154254,2721.956983,4862.354932,5597.167078,9904,217.6225005,19808,-4448768,622080,-3826688,55
36,14,21,9,0.28,0.72,14.1568321,15.11250327,25.52777778,25.42857143,50,1.531862745,100,-18432,7168,-11264,55
8080,1079,22,8,0.117807621,0.882192379,2651.543798,2490.867186,4492.55396,5234.832252,9159,183.289974,18318,-4136960,552448,-3584512,55
4245,360,21,9,0.0781758958,0.921824104,1324.470392,1384.812229,2299.243345,2347.297222,4605,92.71189853,9210,-2173440,184320,-1989120,55
8274,1576,21,9,0.16,0.84,2789.679613,2733.960561,4666.513174,6285.180838,9850,265.5702346,19700,-4236288,806912,-3429376,55
8291,1559,21,9,0.158274112,0.841725888,2787.098209,2717.657633,4658.969847,6342.948044,9850,331.9851702,19700,-4244992,798208,-3446784,55
8129,1734,21,9,0.175808578,0.824191422,2737.894994,2785.512083,4585.068274,6558.417532,9863,199.9391851,19726,-4162048,887808,-3274240,55
6329,691,22,8,0.0984330484,0.901566952,1999.608439,2179.58889,3449.369569,4070.40521,7020,134.354067,14040,-3240448,353792,-2886656,55
8337,1075,21,9,0.114215895,0.885784105,2697.404982,2735.097486,4603.195154,5507.665116,9412,167.9814385,18824,-4268544,550400,-3718144,55
7988,949,21,9,0.106187759,0.893812241,2567.210495,2570.954219,4382.33663,5198.469968,8937,157.7024881,17874,-4089856,485888,-3603968,55
8106,1744,21,9,0.177055838,0.822944162,2704.907043,2743.973843,4528.92302,6768.764335,9850,174.4597945,19700,-4150272,892928,-3257344,55
8766,1133,21,9,0.114456006,0.885543994,2848.261278,2703.691841,4813.042665,6009.636364,9899,375.9589821,19798,-4488192,580096,-3908096,55
8800,1094,21,9,0.110572064,0.889427936,2828.672777,2804.234924,4801.512386,6121.806216,9894,335.959253,19788,-4505600,560128,-3945472,55
8512,1120,21,9,0.11627907,0.88372093,2720.40787,2839.232301,4633.739779,6205.477679,9632,173.5808254,19264,-4358144,573440,-3784704,55
8908,1019,21,9,0.10264934,0.89735066,2844.899755,2882.30394,4858.843848,5883.264966,9927,315.2429343,19854,-4560896,521728,-4039168,55
8792,1110,21,9,0.112098566,0.887901434,2836.987784,2782.241536,4810.807552,6065.885586,9902,341.3305757,19804,-4501504,568320,-3933184,55
8749,1140,21,9,0.115279604,0.884720396,2814.356554,2877.29021,4788.709453,6144.461404,9889,313.2404181,19778,-4479488,583680,-3895808,55
6085,488,21,9,0.0742431158,0.925756884,1888.567097,2002.470003,3279.139688,3385.012295,6573,177.4568035,13146,-3115520,249856,-2865664,55
8743,1140,21,9,0.11534959,0.88465041,2822.935857,2772.888849,4779.382134,6189.164912,9883,188.3911552,19766,-4476416,583680,-3892736,55
8676,1201,21,9,0.121595626,0.878404374,2818.367188,2755.922432,4761.061664,6224.422981,9877,370.897484,19754,-4442112,614912,-3827200,55
8889,1029,21,9,0.103750756,0.896249244,2859.788975,2766.79279,4867.496569,5754.270165,9918,369.2479523,19836,-4551168,526848,-4024320,55
8958,971,21,9,0.0977943398,0.90220566,2842.659334,2956.397813,4877.765461,5769.785788,9929,207.2860125,19858,-4586496,497152,-4089344,55
8794,1098,21,9,0.110998787,0.889001213,2829.497201,2838.101599,4812.954401,6016.081056,9892,386.255369,19784,-4502528,562176,-3940352,55
528,51,21,9,0.0880829016,0.911917098,163.9719984,173.3510349,298.6306818,200.6470588,579,20.10416667,1158,-270336,26112,-244224,55
8887,1029,22,8,0.103771682,0.896228318,2844.668763,2840.570245,4848.659728,5907.139942,9916,285.6813598,19832,-4550144,526848,-4023296,55
8772,1120,21,9,0.113222806,0.886777194,2813.917338,2932.886377,4804.123917,6061.609821,9892,401.6240357,19784,-4491264,573440,-3917824,55
8773,1133,22,8,0.114375126,0.885624874,2854.704957,2711.940017,4829.552035,5913.248897,9906,236.0819828,19812,-4491776,580096,-3911680,55
7507,2425,21,9,0.24416029,0.75583971,2446.499993,2345.532907,4094.637272,7665.499381,9932,362.6140927,19864,-3843584,1241600,-2601984,55
8664,1244,21,9,0.125555107,0.874444893,2780.207116,2950.625936,4737.310249,6467.146302,9908,219.4462901,19816,-4435968,636928,-3799040,55
3478,317,21,9,0.0835309618,0.916469038,1090.345899,1147.566979,1890.495687,1980.334385,3795,67.16814159,7590,-1780736,162304,-1618432,55
1144,71,21,9,0.058436214,0.941563786,341.9489369,406.9315128,622.1931818,379.3098592,1215,20.17267143,2430,-585728,36352,-549376,55
2085,334,21,9,0.138073584,0.861926416,692.7080917,730.0430861,1201.497842,1263.07485,2419,46.22587426,4838,-1067520,171008,-896512,55
1819,268,21,9,0.128413991,0.871586009,594.8408377,651.8497136,1044.498076,1040.619403,2087,36.99698635,4174,-931328,137216,-794112,55
2791,575,21,9,0.170825906,0.829174094,972.0627492,944.8678478,1642.493013,1882.544348,3366,63.23501785,6732,-1428992,294400,-1134592,55
2089,359,20,10,0.146650327,0.853349673,699.4219406,736.4732266,1204.196266,1342.64624,2448,76.47610122,4896,-1069568,183808,-885760,55
1997,303,21,9,0.13173913,0.86826087,658.9250498,695.6383201,1146.612919,1176.118812,2300,43.47826087,4600,-1022464,155136,-867328,55
1756,248,21,9,0.123752495,0.876247505,571.0649506,628.2010718,999.2881549,1025.241935,2004,47.91965567,4008,-899072,126976,-772096,55
1863,283,21,9,0.131873253,0.868126747,616.6195942,637.3334955,1069.035427,1102.890459,2146,45.7374254,4292,-953856,144896,-808960,55
1836,276,21,9,0.130681818,0.869318182,607.6343572,623.1187651,1055.96024,1060.09058,2112,64.0388114,4224,-940032,141312,-798720,55
2144,373,20,10,0.148192292,0.851807708,727.0243795,714.5890146,1240.19403,1367.096515,2517,62.89355322,5034,-1097728,190976,-906752,55
1961,286,21,9,0.127280819,0.872719181,643.2107874,684.7786827,1123.196328,1129.51049,2247,41.28996692,4494,-1004032,146432,-857600,55
2469,493,21,9,0.166441594,0.833558406,845.5938258,864.2366567,1435.092345,1713.914807,2962,74.57200403,5924,-1264128,252416,-1011712,55
2053,302,21,9,0.128237792,0.871762208,675.6272774,707.6986017,1176.97321,1184.980132,2355,67.4205554,4710,-1051136,154624,-896512,55
2018,346,21,9,0.146362098,0.853637902,673.2509401,724.8363535,1164.520813,1287.361272,2364,41.76678445,4728,-1033216,177152,-856064,55
2096,321,22,8,0.132809268,0.867190732,700.9658129,675.9713266,1206.47376,1225.495327,2417,64.66024612,4834,-1073152,164352,-908800,55
2334,386,21,9,0.141911765,0.858088235,774.1185817,845.59853,1348.688946,1431.917098,2720,47.51921733,5440,-1195008,197632,-997376,55
1873,269,21,9,0.125583567,0.874416433,614.6574688,643.3439066,1070.237053,1080.29368,2142,189.893617,4284,-958976,137728,-821248,55
1874,274,21,9,0.127560521,0.872439479,621.078541,612.6641598,1071.131804,1097.536496,2148,53.37972167,4296,-959488,140288,-819200,55
1983,286,21,9,0.126046717,0.873953283,652.3166095,671.3880894,1128.090772,1182.905594,2269,43.68502118,4538,-1015296,146432,-868864,55
2612,568,21,9,0.178616352,0.821383648,888.7605821,956.3863829,1509.037519,1965.112676,3180,156.9595262,6360,-1337344,290816,-1046528,55
1996,290,21,9,0.126859143,0.873140857,657.0128978,679.1313074,1140.36022,1165.110345,2286,57.62540963,4572,-1021952,148480,-873472,55
5299,732,21,9,0.121372907,0.878627093,1735.319626,1780.955676,3022.09832,2971.853825,6031,137.38041,12062,-2713088,374784,-2338304,55
484,80,21,9,0.141843972,0.858156028,160.3526076,174.9285278,286.6012397,257.6875,564,25.17857143,1128,-247808,40960,-206848,55
7055,804,21,9,0.102303092,0.897696908,2271.428665,2195.48828,3980.417434,3487.593284,7859,155.5621536,15718,-3612160,411648,-3200512,55
3225,334,20,10,0.0938465861,0.906153414,1031.97905,840.0955209,1830.136124,1295.901198,3559,62.74682652,7118,-1651200,171008,-1480192,55
4434,620,21,9,0.122675109,0.877324891,1456.288571,1477.797921,2530.34258,2507.170968,5054,110.906298,10108,-2270208,317440,-1952768,55
6399,886,22,8,0.121619767,0.878380233,2105.688745,2083.45911,3642.407564,3647.278781,7285,192.1656555,14570,-3276288,453632,-2822656,55
5209,729,20,10,0.122768609,0.877231391,1706.553956,1767.325125,2972.760415,2946.203018,5938,125.4860524,11876,-2667008,373248,-2293760,55
5518,850,21,9,0.133479899,0.866520101,1813.690261,1962.604454,3136.831279,3493.954118,6368,114.821493,12736,-2825216,435200,-2390016,55
5709,805,21,9,0.123579982,0.876420018,1869.765155,1953.109999,3248.151165,3323.801242,6514,182.1079117,13028,-2923008,412160,-2510848,55
4837,594,20,10,0.109372123,0.890627877,1561.753856,1614.18186,2725.228861,2640.848485,5431,148.0239847,10862,-2476544,304128,-2172416,55
6070,796,20,10,0.115933586,0.884066414,1986.676153,1941.316652,3450.754201,3301.925879,6866,143.9111297,13732,-3107840,407552,-2700288,55
7759,940,21,9,0.108058398,0.891941602,2525.811697,2321.383843,4413.611806,3824.931915,8699,221.517698,17398,-3972608,481280,-3491328,55
5645,846,20,10,0.130334309,0.869665691,1855.382856,1982.024245,3217.802657,3434.148936,6491,122.541061,12982,-2890240,433152,-2457088,55
6333,906,21,9,0.125155408,0.874844592,2087.024106,2108.213451,3615.663667,3650.311258,7239,200.2489627,14478,-3242496,463872,-2778624,55
6226,924,20,10,0.129230769,0.870769231,2046.348851,2167.004078,3543.34115,3792.189394,7150,125.6148981,14300,-3187712,473088,-2714624,55
5602,833,21,9,0.129448329,0.870551671,1839.106436,1966.241701,3188.557122,3416.006002,6435,125.3408648,12870,-2868224,426496,-2441728,55
6238,840,22,8,0.118677593,0.881322407,2047.6503,2008.475696,3550.04665,3461.178571,7078,183.2254724,14156,-3193856,430080,-2763776,55
6396,785,21,9,0.109316251,0.890683749,2069.208034,2103.411251,3591.91526,3583.542675,7181,132.0036765,14362,-3274752,401920,-2872832,55
5626,807,21,9,0.125446914,0.874553086,1848.374798,1915.041034,3207.263598,3284.877323,6433,156.9790142,12866,-2880512,413184,-2467328,55
6311,850,21,9,0.118698506,0.881301494,2068.112928,2054.074498,3601.448423,3429.176471,7161,129.2599278,14322,-3231232,435200,-2796032,55
9041,877,21,9,0.0884250857,0.911574914,2838.162234,3082.560624,4922.50448,5340.887115,9918,701.4144272,19836,-4628992,449024,-4179968,55
9070,850,21,9,0.0856854839,0.914314516,2856.2802,2938.635285,4949.445094,5078.462353,9920,981.206726,19840,-4643840,435200,-4208640,55
253,38,21,9,0.130584192,0.869415808,83.62277978,83.2747056,149.2766798,124.1842105,291,15.98901099,582,-129536,19456,-110080,55
9140,787,21,9,0.0792787348,0.920721265,2853.705613,2970.779241,4928.768928,5373.163914,9927,653.9525692,19854,-4679680,402944,-4276736,55
9099,822,21,9,0.082854551,0.917145449,2843.282145,3076.96041,4943.708539,5152.405109,9921,654.8514851,19842,-4658688,420864,-4237824,55
9154,771,21,9,0.0776826196,0.92231738,2868.431942,2824.20801,4969.20319,4889.350195,9925,369.5085629,19850,-4686848,394752,-4292096,55
9128,794,21,9,0.0800241887,0.919975811,2878.376845,2642.292578,5006.312226,4446.328715,9922,236.9149952,19844,-4673536,406528,-4267008,55
9055,864,21,9,0.087105555,0.912894445,2842.278377,3039.32959,4916.997681,5410.678241,9919,778.5714286,19838,-4636160,442368,-4193792,55
5812,414,22,8,0.0664953421,0.933504658,1794.102261,1788.349431,3143.723503,2689.202899,6226,187.4172185,12452,-2975744,211968,-2763776,55
9083,840,21,9,0.084651819,0.915348181,2876.331808,2715.880792,4989.479797,4664.858333,9923,470.5073495,19846,-4650496,430080,-4220416,55
985,76,22,8,0.0716305372,0.928369463,300.8222897,295.1243983,547.5715736,316.2236842,1061,25.73368906,2122,-504320,38912,-465408,55
323,54,21,9,0.143236074,0.856763926,110.1830005,89.90559177,195.9009288,147.7222222,377,7.808616404,754,-165376,27648,-137728,55
9174,759,22,8,0.0764119601,0.92358804,2887.964762,2584.005383,4993.971659,4640.99473,9933,497.1471471,19866,-4697088,388608,-4308480,55
9018,897,21,9,0.0904689864,0.909531014,2840.392076,3061.389069,4932.680639,5212.548495,9915,590.1785714,19830,-4617216,459264,-4157952,55
9143,780,21,9,0.0786052605,0.921394739,2860.584891,2907.974494,4952.491524,5073.45641,9923,585.7733176,19846,-4681216,399360,-4281856,55
9155,772,21,9,0.0777677042,0.922232296,2865.373401,2860.704608,4981.959476,4751.022021,9927,588.4410196,19854,-4687360,395264,-4292096,55
9092,828,21,9,0.0834677419,0.916532258,2848.162352,3004.103613,4926.989221,5328.471014,9920,728.3406755,19840,-4655104,423936,-4231168,55
9094,827,22,8,0.0833585324,0.916641468,2853.379964,2963.135471,4935.422696,5242.257557,9921,525.7551669,19842,-4656128,423424,-4232704,55
254,40,21,9,0.136054422,0.863945578,84.50589082,84.1307576,150.8267717,126.375,294,14.35546875,588,-130048,20480,-109568,55
9112,814,21,9,0.0820068507,0.917993149,2863.999926,2870.383466,4984.547081,4727.896806,9926,440.7637655,19852,-4665344,416768,-4248576,55
8355,907,21,9,0.0979270136,0.902072986,2662.828564,2752.052018,4665.665111,4316.781698,9262,223.019504,18524,-4277760,464384,-3813376,55
4317,331,20,10,0.0712134251,0.928786575,1346.872828,1169.939231,2361.619875,1840.371601,4648,85.0658858,9296,-2210304,169472,-2040832,55
7624,841,20,10,0.0993502658,0.900649734,2429.564187,2564.130063,4218.87618,4361.03805,8465,256.2046005,16930,-3903488,430592,-3472896,55
7678,914,21,9,0.106378026,0.893621974,2454.731299,2676.583931,4271.942954,4502.789934,8592,182.2655919,17184,-3931136,467968,-3463168,55
1396,215,21,9,0.13345748,0.86654252,441.3264906,553.385251,774.0415473,1013.506977,1611,28.22849133,3222,-714752,110080,-604672,55
7603,851,21,9,0.100662408,0.899337592,2421.48084,2581.992937,4191.732474,4547.054054,8454,248.7934079,16908,-3892736,435712,-3457024,55
7420,716,21,9,0.0880039331,0.911996067,2344.060888,2395.767801,4069.828841,4054.72905,8136,167.0979667,16272,-3799040,366592,-3432448,55
7793,844,21,9,0.0977191154,0.902280885,2488.205733,2533.912542,4301.332991,4482.126777,8637,254.5534925,17274,-3990016,432128,-3557888,55
8326,838,22,8,0.0914447839,0.908555216,2633.080495,2757.629572,4563.120106,4775.050119,9164,291.1979663,18328,-4262912,429056,-3833856,55
8032,886,21,9,0.09934963,0.90065037,2563.54227,2669.194034,4469.38633,4369.875847,8918,244.3957249,17836,-4112384,453632,-3658752,55
7720,866,21,9,0.100861868,0.899138132,2458.565753,2628.847232,4257.8,4611.749423,8586,214.2215569,17172,-3952640,443392,-3509248,55
8017,844,21,9,0.0952488432,0.904751157,2551.318212,2619.909679,4427.748659,4461.883886,8861,227.7892031,17722,-4104704,432128,-3672576,55
7956,858,21,9,0.0973451327,0.902654867,2530.777743,2666.531541,4401.229135,4465.648019,8814,236.0471344,17628,-4073472,439296,-3634176,55
7904,853,21,9,0.0974077881,0.902592212,2513.015499,2660.74892,4370.177126,4460.75381,8757,249.9143836,17514,-4046848,436736,-3610112,55
7964,825,21,9,0.0938673342,0.906132666,2518.153618,2711.712359,4384.365394,4497.659394,8789,245.2287946,17578,-4077568,422400,-3655168,55
7902,855,22,8,0.0976361768,0.902363823,2505.618758,2706.998879,4346.428626,4680.02807,8757,250.3430532,17514,-4045824,437760,-3608064,55
7491,771,20,10,0.093318809,0.906681191,2380.058037,2427.374309,4147.487652,3976.164721,8262,153.5117057,16524,-3835392,394752,-3440640,55
8236,933,21,9,0.101755917,0.898244083,2639.552313,2709.022598,4594.722559,4499.174705,9169,164.4073875,18338,-4216832,477696,-3739136,55
7596,771,21,9,0.0921477232,0.907852277,2405.567082,2508.087125,4175.460506,4268.132296,8367,223.4775641,16734,-3889152,394752,-3494400,55
8272,766,21,9,0.084753264,0.915246736,2603.318192,2668.135576,4528.608801,4421.134465,9038,262.0469701,18076,-4235264,392192,-3843072,55
7359,2159,23,7,0.226833368,0.773166632,2627.157902,2265.070512,4204.683109,6650.605836,9518,167.1584124,19036,-3767808,1105408,-2662400,55
6593,1918,22,8,0.225355422,0.774644578,2285.140243,2125.820084,3723.985287,6084.765902,8511,161.3459716,17022,-3375616,982016,-2393600,55
7585,2103,22,8,0.217072667,0.782927333,2717.103472,2272.441617,4339.337376,6666.496434,9688,179.5404003,19376,-3883520,1076736,-2806784,55
9268,683,22,8,0.068636318,0.931363682,2876.980897,2748.012397,5018.612214,4397.771596,9951,866.8118467,19902,-4745216,349696,-4395520,55
7468,1953,22,8,0.207302834,0.792697166,2698.338159,2212.253129,4311.573112,6238.352791,9421,165.2227289,18842,-3823616,999936,-2823680,55
6433,1835,23,7,0.22194001,0.77805999,2253.237156,2051.625422,3653.170682,5821.906812,8268,156.1473088,16536,-3293696,939520,-2354176,55
7928,2000,22,8,0.201450443,0.798549557,2871.228326,2272.376604,4578.594097,6494.231,9928,411.2676056,19856,-4059136,1024000,-3035136,55
7774,2135,22,8,0.215460692,0.784539308,2829.489772,2303.379426,4498.685104,6616.54192,9909,218.6934452,19818,-3980288,1093120,-2887168,55
8063,1885,23,7,0.189485324,0.810514676,2839.924776,2493.08115,4621.763488,6483.314058,9948,199.558676,19896,-4128256,965120,-3163136,55
7317,2125,23,7,0.22505825,0.77494175,2467.007739,2395.493917,4078.999863,6933.816941,9442,197.8625314,18884,-3746304,1088000,-2658304,55
6654,1843,22,8,0.216900082,0.783099918,2372.374705,2052.418841,3810.096934,5833.62344,8497,164.1615147,16994,-3406848,943616,-2463232,55
7383,1958,22,8,0.209613532,0.790386468,2633.433177,2277.019336,4239.191792,6299.212462,9341,188.5547033,18682,-3780096,1002496,-2777600,55
7223,2181,23,7,0.231922586,0.768077414,2441.146881,2333.99073,4023.009553,6952.825309,9404,191.5665105,18808,-3698176,1116672,-2581504,55
7419,2059,22,8,0.217239924,0.782760076,2615.36878,2320.284388,4222.71883,6601.568723,9478,166.368264,18956,-3798528,1054208,-2744320,55
6442,1853,22,8,0.223387583,0.776612417,2304.637432,2007.810202,3696.558833,5717.446303,8295,146.8921551,16590,-3298304,948736,-2349568,55
7595,2076,23,7,0.214662393,0.785337607,2710.543696,2313.991581,4347.037261,6624.859345,9671,174.566787,19342,-3888640,1062912,-2825728,55
7638,2094,23,7,0.215166461,0.784833539,2680.635226,2405.125269,4340.724273,6784.30086,9732,176.9132885,19464,-3910656,1072128,-2838528,55
6726,1963,22,8,0.225917827,0.774082173,2164.324419,2359.008988,3703.892209,6541.684157,8689,274.7075561,17378,-3443712,1005056,-2438656,55
8211,1739,23,7,0.174773869,0.825226131,2986.326871,2093.813876,4813.118012,5742.215641,9950,482.7753518,19900,-4204032,890368,-3313664,55
7735,2183,23,7,0.22010486,0.77989514,2825.531103,2295.010737,4480.926955,6655.222629,9918,176.1634103,19836,-3960320,1117696,-2842624,55
2122,318,21,9,0.130327869,0.869672131,696.7399719,752.1019671,1214.591423,1259.927673,2440,79.14369121,4880,-1086464,162816,-923648,55
2734,512,21,9,0.157732594,0.842267406,928.9584724,965.5619197,1595.652524,1772.201172,3246,61.09542631,6492,-1399808,262144,-1137664,55
2020,283,20,10,0.122883196,0.877116804,660.8302981,692.4206678,1149.814356,1167.600707,2303,62.70078955,4606,-1034240,144896,-889344,55
2086,301,22,8,0.126099707,0.873900293,682.6566708,731.4091277,1190.188878,1220.41196,2387,68.98843931,4774,-1068032,154112,-913920,55
1909,257,20,10,0.118651893,0.881348107,616.1277842,687.2384065,1090.388161,1032.33463,2166,60.85979208,4332,-977408,131584,-845824,55
1920,277,20,10,0.12608102,0.87391898,624.7991657,695.8273429,1096.805208,1114.212996,2197,69.34974747,4394,-983040,141824,-841216,55
2372,385,21,9,0.139644541,0.860355459,786.6923745,841.7208631,1360.882378,1490.623377,2757,49.47954056,5514,-1214464,197120,-1017344,55
2103,305,21,9,0.12666113,0.87333887,688.8862362,736.6490051,1202.931526,1215.314754,2408,44.05415295,4816,-1076736,156160,-920576,55
1944,281,21,9,0.126292135,0.873707865,635.8284855,684.9667242,1109.651235,1136.16726,2225,164.6928201,4450,-995328,143872,-851456,55
1829,242,22,8,0.116851762,0.883148238,596.9201849,602.1210341,1043.068343,982.5785124,2071,46.52886992,4142,-936448,123904,-812544,55
2540,419,21,9,0.141601893,0.858398107,850.2273761,861.7253917,1454.421654,1635.057279,2959,74.62799496,5918,-1300480,214528,-1085952,55
2034,305,20,10,0.130397606,0.869602394,670.2904295,707.116005,1170.985742,1163.42623,2339,66.54338549,4678,-1041408,156160,-885248,55
2151,304,21,9,0.123828921,0.876171079,706.9429963,720.988836,1228.059507,1227.578947,2455,68.28929068,4910,-1101312,155648,-945664,55
2060,303,21,9,0.12822683,0.87177317,675.3154872,724.7294177,1174.406311,1233.627063,2363,43.08898614,4726,-1054720,155136,-899584,55
3057,614,21,9,0.167256878,0.832743122,1055.379546,1042.300755,1783.385672,2097.957655,3671,74.0419524,7342,-1565184,314368,-1250816,55
1422,243,21,9,0.145945946,0.854054054,461.2276931,567.3602519,812.9381153,950.399177,1665,100.9090909,3330,-728064,124416,-603648,55
2168,337,21,9,0.134530938,0.865469062,713.1457024,784.2260127,1251.098708,1265.231454,2505,44.4937833,5010,-1110016,172544,-937472,55
2167,332,21,9,0.132853141,0.867146859,712.4756119,773.4036985,1239.154592,1320.789157,2499,47.42835453,4998,-1109504,169984,-939520,55
696,90,21,9,0.114503817,0.885496183,223.2094405,222.5205855,408.3074713,278.9888889,786,12.67741935,1572,-356352,46080,-310272,55
1411,217,20,10,0.133292383,0.866707617,455.3903437,550.5231718,803.9085755,883.3686636,1628,185.4214123,3256,-722432,111104,-611328,55
3529,168,23,7,0.0454422505,0.95455775,1055.984814,1150.44415,1875.190706,1298.839286,3697,303.2813782,7394,-1806848,86016,-1720832,56
3511,159,23,7,0.0433242507,0.956675749,1048.275922,1105.529456,1864.195956,1201.842767,3670,216.6469894,7340,-1797632,81408,-1716224,56
3368,159,23,7,0.0450808052,0.954919195,1008.53547,1039.934018,1791.994656,1171.006289,3527,303.7898363,7054,-1724416,81408,-1643008,56
3397,160,22,8,0.0449817262,0.955018274,1014.27161,1116.970238,1806.246688,1200.51875,3557,143.6591276,7114,-1739264,81920,-1657344,56
3521,165,22,8,0.0447639718,0.955236028,1053.725726,1107.86495,1871.424311,1247.612121,3686,264.4189383,7372,-1802752,84480,-1718272,56
3633,163,22,8,0.0429399368,0.957060063,1084.837617,1121.747725,1928.776769,1223.680982,3796,263.4281749,7592,-1860096,83456,-1776640,56
2732,163,23,7,0.0563039724,0.943696028,826.0932467,904.6556034,1470.297218,1074.282209,2895,50.60304143,5790,-1398784,83456,-1315328,56
3482,155,22,8,0.0426175419,0.957382458,1038.56315,1075.630327,1849.105686,1142.690323,3637,327.9531109,7274,-1782784,79360,-1703424,56
3355,154,22,8,0.0438871473,0.956112853,1001.912285,1035.058287,1784.76304,1106.590909,3509,288.0952381,7018,-1717760,78848,-1638912,56
3468,157,22,8,0.0433103448,0.956689655,1036.174591,1056.452717,1842.754614,1155.745223,3625,223.4895191,7250,-1775616,80384,-1695232,56
3413,158,22,8,0.0442453094,0.955754691,1018.991805,1124.524957,1811.744506,1229.886076,3571,292.9450369,7142,-1747456,80896,-1666560,56
3425,192,22,8,0.0530826652,0.946917335,1025.975176,1060.982531,1852.477956,1033.416667,3617,63.42275995,7234,-1753600,98304,-1655296,56
3559,161,23,7,0.0432795699,0.95672043,1062.294477,1149.112374,1887.755268,1258.006211,3720,350.2824859,7440,-1822208,82432,-1739776,56
3468,160,22,8,0.0441014333,0.955898567,1035.486027,1119.446501,1842.219723,1213.675,3628,202.6815642,7256,-1775616,81920,-1693696,56
3702,162,23,7,0.0419254658,0.958074534,1104.99041,1141.387033,1961.917882,1260.246914,3864,291.1831198,7728,-1895424,82944,-1812480,56
3390,156,22,8,0.0439932318,0.956006768,1012.515603,1058.48492,1802.651327,1140.019231,3546,232.8299409,7092,-1735680,79872,-1655808,56
3672,159,22,8,0.0415035239,0.958496476,1095.11889,1155.915416,1943.980937,1269.798742,3831,271.7021277,7662,-1880064,81408,-1798656,56
3526,162,22,8,0.0439262473,0.956073753,1051.880587,1157.450098,1872.238798,1240.753086,3688,65.34372785,7376,-1805312,82944,-1722368,56
1740,113,22,8,0.060982191,0.939017809,527.2958967,539.1443639,948.8068966,591.2123894,1853,112.2350091,3706,-890880,57856,-833024,56
3327,156,23,7,0.044788975,0.955211025,993.6660127,1080.035278,1768.999399,1166.185897,3483,269.5820433,6966,-1703424,79872,-1623552,56
146,27,22,8,0.156069364,0.843930636,48.96521306,52.1169151,89.93835616,71.11111111,173,14.14554374,346,-74752,13824,-60928,56
148,28,22,8,0.159090909,0.840909091,49.75277448,53.90363662,91.16216216,74.42857143,176,14.85232068,352,-75776,14336,-61440,56
151,28,22,8,0.156424581,0.843575419,50.55823456,55.15553148,92.64900662,75.71428571,179,17.08015267,358,-77312,14336,-62976,56
148,31,22,8,0.173184358,0.826815642,49.9155075,58.78214245,91.55405405,82.58064516,179,14.63614064,358,-75776,15872,-59904,56
143,25,22,8,0.148809524,0.851190476,47.41128368,52.53746853,86.70629371,71.88,168,13.46153846,336,-73216,12800,-60416,56
150,27,23,7,0.152542373,0.847457627,49.90494787,56.03771021,90.94666667,78.18518519,177,16.32841328,354,-76800,13824,-62976,56
147,27,23,7,0.155172414,0.844827586,49.20228381,54.06476328,89.60544218,76.03703704,174,17.31343284,348,-75264,13824,-61440,56
147,26,22,8,0.150289017,0.849710983,48.54719569,55.58911232,89.18367347,74.65384615,173,12.92974589,346,-75264,13312,-61952,56
142,25,22,8,0.149700599,0.850299401,47.15700771,52.0807066,86.18309859,71.6,167,13.72226787,334,-72704,12800,-59904,56
144,33,22,8,0.186440678,0.813559322,49.65009511,56.9013452,89.58333333,86.45454545,177,9.305993691,354,-73728,16896,-56832,56
145,27,22,8,0.156976744,0.843023256,48.46210086,54.07077616,88.71724138,74.59259259,172,15.85253456,344,-74240,13824,-60416,56
150,30,22,8,0.166666667,0.833333333,50.65523731,56.94230999,92.56,80.2,180,17.85714286,360,-76800,15360,-61440,56
149,30,22,8,0.167597765,0.832402235,50.04178606,58.50079772,91.55033557,82.3,179,18.35897436,358,-76288,15360,-60928,56
145,25,23,7,0.147058824,0.852941176,48.14505727,52.3499914,87.70344828,72.72,170,17.93248945,340,-74240,12800,-61440,56
149,31,23,7,0.172222222,0.827777778,49.89413684,60.90944473,90.74496644,89.32258065,180,14.81481481,360,-76288,15872,-60416,56
148,27,23,7,0.154285714,0.845714286,49.52971813,54.15410111,90.12837838,76.33333333,175,15.25719268,350,-75776,13824,-61952,56
145,27,22,8,0.156976744,0.843023256,48.81210742,50.95211448,89.52413793,70.25925926,172,14.58863444,344,-74240,13824,-60416,56
147,28,22,8,0.16,0.84,49.69650591,51.99121786,90.92517007,72.64285714,175,14.22764228,350,-75264,14336,-60928,56
147,29,22,8,0.164772727,0.835227273,49.3204607,56.91529472,90.26530612,79.55172414,176,15.87015329,352,-75264,14848,-60416,56
146,28,23,7,0.16091954,0.83908046,48.63078574,57.64728254,88.34931507,83.07142857,174,13.19181198,348,-74752,14336,-60416,56
436,53,23,7,0.108384458,0.891615542,137.7054176,131.992219,256.7247706,148.5471698,489,37.44257274,978,-223232,27136,-196096,56
431,54,22,8,0.111340206,0.888659794,135.5396345,152.8911499,252.187935,169.6666667,485,39.33495539,970,-220672,27648,-193024,56
430,59,23,7,0.120654397,0.879345603,135.6349322,167.6971611,251.9930233,194.0338983,489,42.93239684,978,-220160,30208,-189952,56
433,54,22,8,0.110882957,0.889117043,136.2930986,145.7504868,254.5496536,159.4074074,487,28.86781269,974,-221696,27648,-194048,56
429,51,23,7,0.10625,0.89375,135.2975392,127.4078932,252.011655,143.6666667,480,42.4403183,960,-219648,26112,-193536,56
439,53,22,8,0.107723577,0.892276423,138.3898778,135.2901238,258.0842825,150.5471698,492,47.72065955,984,-224768,27136,-197632,56
430,53,22,8,0.109730849,0.890269151,135.6128203,138.8194722,252.8395349,154.0566038,483,35.02538071,966,-220160,27136,-193024,56
429,52,23,7,0.108108108,0.891891892,135.4334359,130.6332707,252.4195804,146.7884615,481,35.13513514,962,-219648,26624,-193024,56
435,53,22,8,0.108606557,0.891393443,136.5751165,143.8728672,255.3724138,155.2641509,488,48.41269841,976,-222720,27136,-195584,56
429,55,23,7,0.113636364,0.886363636,135.4497324,150.9890369,251.7599068,170.2727273,484,42.6056338,968,-219648,28160,-191488,56
427,58,22,8,0.119587629,0.880412371,134.876826,158.8590301,251.7822014,178.3448276,485,45.75471698,970,-218624,29696,-188928,56
429,49,22,8,0.10251046,0.89748954,134.6638604,132.9049445,249.9393939,148.1020408,478,46.18357488,956,-219648,25088,-194560,56
437,56,22,8,0.113590264,0.886409736,137.9728611,144.989469,258.2745995,159.0178571,493,43.32161687,986,-223744,28672,-195072,56
430,53,22,8,0.109730849,0.890269151,136.0381938,126.9334346,254.1465116,143.4528302,483,39.3002441,966,-220160,27136,-193024,56
437,53,23,7,0.108163265,0.891836735,137.5177682,145.9929481,255.576659,162.4150943,490,33.19783198,980,-223744,27136,-196608,56
440,52,23,7,0.105691057,0.894308943,138.2274603,148.6372752,255.9113636,166.8653846,492,47.03632887,984,-225280,26624,-198656,56
432,57,22,8,0.116564417,0.883435583,136.5161782,151.3686183,255.2199074,167.5438596,489,44.45454545,978,-221184,29184,-192000,56
430,51,22,8,0.106029106,0.893970894,135.4856765,129.5518137,252.372093,145.1176471,481,39.58847737,962,-220160,26112,-194048,56
438,52,23,7,0.106122449,0.893877551,137.5264526,147.5951904,255.1849315,163.9230769,490,34.02777778,980,-224256,26624,-197632,56
426,52,22,8,0.108786611,0.891213389,134.4473355,129.9304135,251.056338,144.8269231,478,39.37397035,956,-218112,26624,-191488,56
2943,202,22,8,0.0642289348,0.935771065,902.8914111,954.430863,1587.085967,1367.777228,3145,198.297604,6290,-1506816,103424,-1403392,56
2917,201,23,7,0.0644644003,0.9355356,894.9142284,950.346025,1573.127185,1361.736318,3118,178.6819484,6236,-1493504,102912,-1390592,56
2962,204,22,8,0.0644346178,0.935565382,908.0106926,980.2914381,1595.290007,1412.313725,3166,169.3048128,6332,-1516544,104448,-1412096,56
2968,211,23,7,0.0663730733,0.933626927,910.2026243,1005.053314,1600.809636,1437.947867,3179,113.9426523,6358,-1519616,108032,-1411584,56
2937,203,22,8,0.0646496815,0.935350318,901.1675228,958.1062262,1584.125979,1373.359606,3140,165.6992084,6280,-1503744,103936,-1399808,56
2918,204,23,7,0.065342729,0.934657271,895.4644895,961.7080678,1574.30329,1378.362745,3122,192.3598275,6244,-1494016,104448,-1389568,56
2961,203,22,8,0.064159292,0.935840708,908.2165384,959.126075,1597.506248,1363.615764,3164,194.4683467,6328,-1516032,103936,-1412096,56
2955,203,22,8,0.0642811906,0.935718809,906.7997484,955.4284325,1593.791878,1371.458128,3158,144.9954086,6316,-1512960,103936,-1409024,56
2951,202,23,7,0.0640659689,0.935934031,905.2647694,958.2734833,1590.385971,1381.445545,3153,162.191358,6306,-1510912,103424,-1407488,56
1570,182,22,8,0.103881279,0.896118721,499.8181725,554.0530005,874.4509554,894.1758242,1752,30.3061754,3504,-803840,93184,-710656,56
2943,204,22,8,0.0648236416,0.935176358,902.6553122,965.135807,1588.297655,1367.735294,3147,168.5591859,6294,-1506816,104448,-1402368,56
2950,206,22,8,0.0652724968,0.934727503,904.5373883,985.6214052,1589.823729,1416.339806,3156,179.0130459,6312,-1510400,105472,-1404928,56
2926,211,22,8,0.067261715,0.932738285,897.6694657,998.200599,1579.168489,1427.990521,3137,202.1262887,6274,-1498112,108032,-1390080,56
2750,229,22,8,0.0768714334,0.923128567,854.9401069,914.2595064,1496.746545,1408.982533,2979,52.46565692,5958,-1408000,117248,-1290752,56
2934,204,22,8,0.0650095602,0.93499044,900.2211802,960.2282058,1583.775733,1364.181373,3138,133.8166311,6276,-1502208,104448,-1397760,56
2924,203,22,8,0.0649184522,0.935081548,897.2241668,956.8797156,1577.569767,1368.541872,3127,176.3677383,6254,-1497088,103936,-1393152,56
2925,199,22,8,0.0637003841,0.936299616,897.3658247,942.6445766,1576.075214,1362.964824,3124,174.427694,6248,-1497600,101888,-1395712,56
2948,206,23,7,0.0653138871,0.934686113,904.5047034,975.2603832,1589.786974,1401.665049,3154,179.9201369,6308,-1509376,105472,-1403904,56
2917,202,22,8,0.0647643475,0.935235652,895.0600884,952.6569606,1573.559479,1364.193069,3119,161.0221993,6238,-1493504,103424,-1390080,56
2929,202,23,7,0.064516129,0.935483871,898.4861588,954.9290218,1580.150563,1360.816832,3131,166.4540138,6262,-1499648,103424,-1396224,56
2497,152,22,8,0.0573801435,0.942619857,751.352556,828.3540203,1353.406888,858.3421053,2649,200.3782148,5298,-1278464,77824,-1200640,56
2469,145,22,8,0.0554705432,0.944529457,742.5391764,781.2657513,1336.960308,805.862069,2614,228.2969432,5228,-1264128,74240,-1189888,56
2486,149,22,8,0.0565464896,0.94345351,747.9920222,822.8939319,1345.323813,862.114094,2635,158.1632653,5270,-1272832,76288,-1196544,56
2484,149,22,8,0.0565894417,0.943410558,747.0286536,833.6926658,1343.739533,871.2214765,2633,218.6877076,5266,-1271808,76288,-1195520,56
2089,156,22,8,0.0694877506,0.930512249,637.2560815,627.3835035,1156.215893,678.2051282,2245,39.59435626,4490,-1069568,79872,-989696,56
2479,165,22,8,0.0624054463,0.937594554,748.8643267,750.3511874,1360.43808,752.5090909,2644,62.98237256,5288,-1269248,84480,-1184768,56
2472,151,22,8,0.0575676706,0.942432329,743.6017503,845.0634616,1338.063916,885.3112583,2623,158.489426,5246,-1265664,77312,-1188352,56
2504,147,22,8,0.0554507733,0.944549227,752.9783997,820.224974,1353.420128,858.9251701,2651,244.106814,5302,-1282048,75264,-1206784,56
2465,151,22,8,0.0577217125,0.942278287,741.2068562,849.9458756,1334.355781,886.4172185,2616,209.28,5232,-1262080,77312,-1184768,56
2481,154,22,8,0.0584440228,0.941555977,746.1516961,875.8064396,1342.371624,925.3636364,2635,46.29304287,5270,-1270272,78848,-1191424,56
2518,147,22,8,0.0551594747,0.944840525,756.9638994,830.5632965,1359.91938,871.8911565,2665,206.2693498,5330,-1289216,75264,-1213952,56
2495,148,22,8,0.0559969731,0.944003027,750.7573617,807.7469886,1350.309419,844.7567568,2643,136.5891473,5286,-1277440,75776,-1201664,56
2461,148,22,8,0.0567267152,0.943273285,739.6560628,831.3732889,1331.835839,858.7635135,2609,216.8744805,5218,-1260032,75776,-1184256,56
2485,147,22,8,0.0558510638,0.944148936,747.7948358,799.0242733,1344.928773,835.9183673,2632,187.3309609,5264,-1272320,75264,-1197056,56
2476,151,22,8,0.0574800152,0.942519985,744.6586346,849.4834147,1339.867932,889.8344371,2627,234.9731664,5254,-1267712,77312,-1190400,56
2539,163,22,8,0.0603256847,0.939674315,765.4162805,833.9289192,1383.477353,853.398773,2702,203.6171816,5404,-1299968,83456,-1216512,56
2468,157,22,8,0.0598095238,0.940190476,747.5582436,755.7538816,1343.515802,833.2993631,2625,120.7451702,5250,-1263616,80384,-1183232,56
2478,146,22,8,0.0556402439,0.944359756,745.1558219,806.7163738,1340.396691,839.0205479,2624,196.4071856,5248,-1268736,74752,-1193984,56
2480,146,22,8,0.0555978675,0.944402133,745.8811002,806.0525473,1341.297984,841.3150685,2626,216.6666667,5252,-1269760,74752,-1195008,56
2484,156,22,8,0.0590909091,0.940909091,747.1154968,885.6720525,1344.602254,936.7179487,2640,220.5513784,5280,-1271808,79872,-1191936,56
439,51,22,8,0.104081633,0.895918367,139.0893655,109.716695,258.357631,134.8235294,490,37.86707883,980,-224768,26112,-198656,56
454,55,22,8,0.10805501,0.89194499,143.5237892,140.3071648,266.4889868,160.1636364,509,39.00383142,1018,-232448,28160,-204288,56
456,49,23,7,0.097029703,0.902970297,143.3031447,118.5774525,265.0197368,141.1428571,505,31.66144201,1010,-233472,25088,-208384,56
458,60,22,8,0.115830116,0.884169884,146.1466952,148.3189094,270.5218341,175.3666667,518,46.58273381,1036,-234496,30720,-203776,56
458,57,22,8,0.110679612,0.889320388,145.7451312,135.7757439,270.0720524,161,515,34.19654714,1030,-234496,29184,-205312,56
455,55,22,8,0.107843137,0.892156863,143.5611658,146.2176912,266.3956044,165.3636364,510,44.7761194,1020,-232960,28160,-204800,56
449,50,23,7,0.100200401,0.899799599,141.5200369,118.2443233,262.1603563,140.8,499,48.77810362,998,-229888,25600,-204288,56
461,51,22,8,0.099609375,0.900390625,145.0193796,116.9401704,269.5835141,138.2352941,512,40.09397024,1024,-236032,26112,-209920,56
462,51,23,7,0.0994152047,0.900584795,145.6824205,120.7853514,269.2835498,145.7254902,513,39.19022154,1026,-236544,26112,-210432,56
455,52,23,7,0.102564103,0.897435897,143.7154052,131.4330099,265.2791209,155.3076923,507,43.00254453,1014,-232960,26624,-206336,56
451,48,22,8,0.0961923848,0.903807615,141.7184498,116.6122194,261.7161863,139.9166667,499,43.61888112,998,-230912,24576,-206336,56
455,53,22,8,0.104330709,0.895669291,143.8886382,129.9641405,266.3186813,153.0377358,508,51.41700405,1016,-232960,27136,-205824,56
455,55,22,8,0.107843137,0.892156863,143.7894551,140.9411295,266.9626374,160.6727273,510,42.7852349,1020,-232960,28160,-204800,56
449,54,22,8,0.107355865,0.892644135,142.2535606,126.8324397,264.4721604,148.2962963,503,41.57024793,1006,-229888,27648,-202240,56
457,52,22,8,0.1021611,0.8978389,144.4744566,116.5681909,267.8949672,141.6730769,509,44.45414847,1018,-233984,26624,-207360,56
453,51,23,7,0.101190476,0.898809524,143.462912,113.6269045,264.8852097,142.4901961,504,45,1008,-231936,26112,-205824,56
455,53,22,8,0.104330709,0.895669291,143.2596205,146.9922393,264.5604396,168.1320755,508,41.60524161,1016,-232960,27136,-205824,56
449,51,22,8,0.102,0.898,142.0578986,113.1985052,263.1291759,139.3137255,500,36.46973012,1000,-229888,26112,-203776,56
455,55,22,8,0.107843137,0.892156863,144.3718869,128.7700443,267.9934066,152.1454545,510,37.03703704,1020,-232960,28160,-204800,56
457,51,22,8,0.100393701,0.899606299,144.0864538,117.2019127,267.2188184,140.5294118,508,35.7494722,1016,-233984,26112,-207872,56
2488,149,22,8,0.0565036026,0.943496397,748.351188,836.1934314,1345.34164,879.147651,2637,181.9875776,5274,-1273856,76288,-1197568,56
2495,163,22,8,0.061324304,0.938675696,755.6828648,829.2135277,1355.745491,927.7668712,2658,125.2591894,5316,-1277440,83456,-1193984,56
2505,148,22,8,0.0557859028,0.944214097,753.0934894,794.0446136,1357.601198,809.0540541,2653,215.8665582,5306,-1282560,75776,-1206784,56
2506,153,22,8,0.0575404287,0.942459571,754.4812053,817.0136631,1359.541101,846.1437908,2659,128.6405418,5318,-1283072,78336,-1204736,56
2475,150,22,8,0.0571428571,0.942857143,744.9048418,820.757519,1340.578182,857.96,2625,195.0222883,5250,-1267200,76800,-1190400,56
2498,153,22,8,0.0577140702,0.94228593,752.2647397,822.36486,1354.624099,858.6601307,2651,142.9881338,5302,-1278976,78336,-1200640,56
2519,149,22,8,0.0558470765,0.944152924,758.2911135,782.1071013,1365.38944,812.2818792,2668,210.7424961,5336,-1289728,76288,-1213440,56
2478,149,22,8,0.0567186905,0.943281309,745.4344238,805.111211,1343.192897,828.4966443,2627,174.0888005,5254,-1268736,76288,-1192448,56
2488,148,22,8,0.0561456753,0.943854325,748.7625793,797.027679,1347.57074,829.7972973,2636,204.8174048,5272,-1273856,75776,-1198080,56
2549,151,22,8,0.0559259259,0.944074074,766.4499079,831.8594463,1379.511181,860.7682119,2700,232.1582115,5400,-1305088,77312,-1227776,56
2495,148,22,8,0.0559969731,0.944003027,750.3894423,798.6371089,1351.680962,821.6351351,2643,162.1472393,5286,-1277440,75776,-1201664,56
2489,154,22,8,0.0582671207,0.941732879,749.2017688,840.2083633,1349.686621,874.5194805,2643,197.0917226,5286,-1274368,78848,-1195520,56
2548,156,22,8,0.0576923077,0.942307692,766.3366362,869.4376093,1379.941523,904.2884615,2704,180.0266312,5408,-1304576,79872,-1224704,56
2485,152,22,8,0.057641259,0.942358741,747.9113399,836.8118651,1346.079678,876.2828947,2637,130.8035714,5274,-1272320,77824,-1194496,56
2480,147,22,8,0.0559573658,0.944042634,746.384852,781.5471443,1343.815323,810.9931973,2627,228.0381944,5254,-1269760,75264,-1194496,56
2499,152,22,8,0.057336854,0.942663146,751.9792304,822.8379156,1354.94998,850.0394737,2651,240.5626134,5302,-1279488,77824,-1201664,56
2509,150,22,8,0.056412185,0.943587815,755.2403563,804.7062718,1359.390992,838.3866667,2659,186.0741777,5318,-1284608,76800,-1207808,56
2493,147,22,8,0.0556818182,0.944318182,750.2478245,778.2227615,1350.777778,807.0136054,2640,211.3690953,5280,-1276416,75264,-1201152,56
2476,148,22,8,0.056402439,0.943597561,745.130362,787.2992857,1342.360662,812.9391892,2624,46.21345544,5248,-1267712,75776,-1191936,56
2532,159,22,8,0.0590858417,0.940914158,762.5368855,861.0325191,1374.06793,899.0314465,2691,172.0588235,5382,-1296384,81408,-1214976,56
427,50,23,7,0.104821803,0.895178197,134.3090742,130.2852885,250,145.06,477,45.17045455,954,-218624,25600,-193024,56
440,53,22,8,0.107505071,0.892494929,138.6120052,132.0062514,259.1863636,145.8301887,493,41.92176871,986,-225280,27136,-198144,56
439,53,22,8,0.107723577,0.892276423,138.0466634,143.1859978,257.261959,157.3584906,492,45.13761468,984,-224768,27136,-197632,56
422,52,22,8,0.109704641,0.890295359,133.5728612,125.936163,249.1350711,143.0769231,474,41.0745234,948,-216064,26624,-189440,56
430,50,23,7,0.104166667,0.895833333,135.0977936,134.0230667,251.1674419,148.76,480,38.18615752,960,-220160,25600,-194560,56
429,62,23,7,0.126272912,0.873727088,135.2322339,173.4024727,252.7435897,199.3387097,491,39.78930308,982,-219648,31744,-187904,56
416,51,22,8,0.109207709,0.890792291,131.4352236,116.7167927,246.6129808,131.1176471,467,48.1443299,934,-212992,26112,-186880,56
426,54,23,7,0.1125,0.8875,134.5787847,141.8125997,250.9624413,157.962963,480,43.47826087,960,-218112,27648,-190464,56
432,53,23,7,0.109278351,0.890721649,136.2763712,140.0839828,253.599537,156.6037736,485,37.22179586,970,-221184,27136,-194048,56
430,57,22,8,0.117043121,0.882956879,136.5917511,139.0762759,255.6651163,156,487,34.46567587,974,-220160,29184,-190976,56
434,52,23,7,0.106995885,0.893004115,136.7663525,131.3694314,255.1497696,146.2692308,486,37.79160187,972,-222208,26624,-195584,56
436,52,22,8,0.106557377,0.893442623,137.1443256,131.6832579,256.4288991,144.4807692,488,49.59349593,976,-223232,26624,-196608,56
429,52,22,8,0.108108108,0.891891892,135.3002873,130.8640988,252.5547786,145.6730769,481,37.578125,962,-219648,26624,-193024,56
424,54,22,8,0.112970711,0.887029289,133.5411405,144.7441679,249.9339623,157.5740741,478,43.21880651,956,-217088,27648,-189440,56
431,51,23,7,0.105809129,0.894190871,135.2966128,135.8030694,252.5962877,147.7254902,482,43.65942029,964,-220672,26112,-194560,56
428,53,22,8,0.11018711,0.88981289,134.9778249,133.393507,252.7126168,146.4150943,481,32.47805537,962,-219136,27136,-192000,56
435,51,23,7,0.104938272,0.895061728,137.2674436,128.1688921,254.8252874,146.9019608,486,28.0762565,972,-222720,26112,-196608,56
429,58,23,7,0.119096509,0.880903491,135.5100378,159.3151888,252.7412587,179.3448276,487,36.78247734,974,-219648,29696,-189952,56
432,53,22,8,0.109278351,0.890721649,135.9942759,130.022938,255.537037,140.8113208,485,38.24921136,970,-221184,27136,-194048,56
429,51,22,8,0.10625,0.89375,135.2510556,117.1325449,253.3682984,132.254902,480,48.87983707,960,-219648,26112,-193536,56
451,52,22,8,0.103379722,0.896620278,142.6050927,113.7450695,265.2062084,137.4615385,503,47.85918173,1006,-230912,26624,-204288,56
457,54,22,8,0.105675147,0.894324853,144.4967069,136.1593062,267.5448578,158.2962963,511,36.47394718,1022,-233984,27648,-206336,56
457,55,23,7,0.107421875,0.892578125,144.2188278,148.5972581,266.9562363,169.6181818,512,40.44233807,1024,-233984,28160,-205824,56
459,53,23,7,0.103515625,0.896484375,145.0124366,135.5251012,267.7298475,159.245283,512,36.7816092,1024,-235008,27136,-207872,56
449,53,22,8,0.105577689,0.894422311,141.5841533,133.5584613,263.3385301,151.2075472,502,44.86148347,1004,-229888,27136,-202752,56
455,53,23,7,0.104330709,0.895669291,143.1955615,142.4103698,265.4197802,160.754717,508,37.99551234,1016,-232960,27136,-205824,56
452,52,22,8,0.103174603,0.896825397,142.9838714,115.5822074,265.4358407,140.0576923,504,45.40540541,1008,-231424,26624,-204800,56
453,56,22,8,0.110019646,0.889980354,143.8456894,127.5570988,268.0838852,149.1607143,509,45.69120287,1018,-231936,28672,-203264,56
458,55,22,8,0.107212476,0.892787524,144.6722632,143.5728628,268.1462882,164.1818182,513,29.79094077,1026,-234496,28160,-206336,56
459,57,22,8,0.110465116,0.889534884,145.0815561,147.3565242,270.0043573,165.8596491,516,43.2885906,1032,-235008,29184,-205824,56
457,61,22,8,0.117760618,0.882239382,144.5287895,166.0898401,269.04814,187.9672131,518,40.27993779,1036,-233984,31232,-202752,56
451,53,22,8,0.10515873,0.89484127,143.0577641,109.1500448,266.2195122,135.754717,504,41.89526185,1008,-230912,27136,-203776,56
462,53,23,7,0.102912621,0.897087379,145.6772916,133.7757405,269.8419913,154.7735849,515,38.75094056,1030,-236544,27136,-209408,56
456,53,23,7,0.104125737,0.895874263,143.3978192,149.443041,264.8969298,169.8490566,509,47.08603145,1018,-233472,27136,-206336,56
455,55,23,7,0.107843137,0.892156863,143.7679497,146.9127205,265.9714286,168.8727273,510,36.71706263,1020,-232960,28160,-204800,56
454,55,22,8,0.10805501,0.89194499,143.626859,140.8272302,266.2643172,162.0181818,509,44.72759227,1018,-232448,28160,-204288,56
461,56,23,7,0.108317215,0.891682785,146.3480288,136.7793732,270.8177874,161.7142857,517,45.91474245,1034,-236032,28672,-207360,56
460,54,23,7,0.105058366,0.894941634,145.2430739,136.6488697,269.2456522,157.4444444,514,42.1657096,1028,-235520,27648,-207872,56
451,53,23,7,0.10515873,0.89484127,142.781511,122.9053012,265.0332594,145.8490566,504,51.06382979,1008,-230912,27136,-203776,56
458,52,22,8,0.101960784,0.898039216,144.821087,119.5113866,268.0349345,145.0961538,510,35.66433566,1020,-234496,26624,-207872,56
426,52,22,8,0.108786611,0.891213389,134.2327338,128.9932154,251.4600939,141.5192308,478,45.74162679,956,-218112,26624,-191488,56
432,51,23,7,0.105590062,0.894409938,136.0557484,129.2635366,253.4976852,144.6078431,483,37.01149425,966,-221184,26112,-195072,56
422,50,22,8,0.105932203,0.894067797,132.7959925,129.3851985,247.521327,143.48,472,42.48424842,944,-216064,25600,-190464,56
431,56,22,8,0.114989733,0.885010267,135.7081245,154.414988,253.6937355,169.3928571,487,45.98677998,974,-220672,28672,-192000,56
136,44,22,8,0.244444444,0.755555556,52.52541813,49.74062892,92.35294118,84.77272727,180,5.395683453,360,-69632,22528,-47104,56
432,55,22,8,0.112936345,0.887063655,136.368928,141.7725265,255.2708333,155.4727273,487,39.14790997,974,-221184,28160,-193024,56
429,55,22,8,0.113636364,0.886363636,135.6384473,140.9774661,253.5687646,156.1636364,484,40.29975021,968,-219648,28160,-191488,56
436,52,23,7,0.106557377,0.893442623,137.5725898,128.7674559,256.3073394,145.5,488,36.94171083,976,-223232,26624,-196608,56
425,51,23,7,0.107142857,0.892857143,133.1428233,144.9991237,248.3035294,156.8039216,476,40.23668639,952,-217600,26112,-191488,56
434,54,22,8,0.110655738,0.889344262,136.5783011,144.0280525,255.4308756,156.6481481,488,43.6103664,976,-222208,27648,-194560,56
430,55,22,8,0.113402062,0.886597938,136.0090834,141.3472648,253.9395349,157.4727273,485,50.78534031,970,-220160,28160,-192000,56
428,51,23,7,0.106471816,0.893528184,134.8019256,130.4634303,251.296729,145.1960784,479,44.14746544,958,-219136,26112,-193024,56
428,55,23,7,0.113871636,0.886128364,134.8993769,151.6443796,251.4602804,168.3818182,483,41.42367067,966,-219136,28160,-190976,56
426,50,22,8,0.105042017,0.894957983,134.100412,116.7150376,251.1173709,131,476,35.97883598,952,-218112,25600,-192512,56
430,56,23,7,0.115226337,0.884773663,136.0183554,150.8021367,253.0023256,170.5357143,486,36.56884876,972,-220160,28672,-191488,56
434,52,22,8,0.106995885,0.893004115,136.5011813,131.277795,255.4907834,143.4230769,486,42.55691769,972,-222208,26624,-195584,56
435,51,22,8,0.104938272,0.895061728,136.8279295,126.4467131,255.5954023,140.3333333,486,24.42211055,972,-222720,26112,-196608,56
433,50,23,7,0.103519669,0.896480331,136.3132149,116.6012024,254.6027714,132.86,483,38.33333333,966,-221696,25600,-196096,56
430,57,22,8,0.117043121,0.882956879,135.8636512,151.8204947,254.0883721,167.8947368,487,36.18127786,974,-220160,29184,-190976,56
318,50,22,8,0.135869565,0.864130435,104.1958706,94.3828904,194.9402516,118.1,368,38.0952381,736,-162816,25600,-137216,56
2000,165,22,8,0.0762124711,0.923787529,623.476746,632.3718018,1073.7935,1194.593939,2165,61.14092064,4330,-1024000,84480,-939520,57
1787,126,22,8,0.0658651333,0.934134867,544.0336243,643.4286283,947.734751,1088.404762,1913,104.4213974,3826,-914944,64512,-850432,57
2850,217,22,8,0.070753179,0.929246821,889.3278163,823.0794439,1525.289123,1648.40553,3067,84.67697405,6134,-1459200,111104,-1348096,57
2887,201,22,8,0.0650906736,0.934909326,887.1442851,934.5077142,1532.687219,1714.169154,3088,433.7078652,6176,-1478144,102912,-1375232,57
2097,165,22,8,0.0729442971,0.927055703,648.9207544,689.7576985,1121.381974,1260.090909,2262,75.52587646,4524,-1073664,84480,-989184,57
2930,256,23,7,0.080351538,0.919648462,920.7228821,904.5736932,1586.754266,1670.707031,3186,200.8827238,6372,-1500160,131072,-1369088,57
2953,261,22,8,0.0812072184,0.918792782,936.5339927,820.2997554,1612.6766,1548.931034,3214,273.2993197,6428,-1511936,133632,-1378304,57
2225,167,23,7,0.0698160535,0.930183946,686.3572331,729.4040768,1186.017079,1336.167665,2392,101.9607843,4784,-1139200,85504,-1053696,57
1845,149,22,8,0.0747241725,0.925275827,568.4464592,634.8201211,984.0590786,1163.932886,1994,241.6969697,3988,-944640,76288,-868352,57
2113,184,23,7,0.0801044841,0.919895516,658.5246316,690.4240039,1134.004259,1321.206522,2297,83.04410701,4594,-1081856,94208,-987648,57
2854,219,22,8,0.071265864,0.928734136,884.1302419,899.051601,1520.939383,1746.30137,3073,282.7046918,6146,-1461248,112128,-1349120,57
3038,305,22,8,0.0912354173,0.908764583,969.8035122,916.1608025,1670.761685,1684.334426,3343,212.3888183,6686,-1555456,156160,-1399296,57
2170,178,22,8,0.0758091993,0.924190801,671.9873617,723.8327292,1160.550691,1344.55618,2348,89.75535168,4696,-1111040,91136,-1019904,57
2054,171,22,8,0.0768539326,0.923146067,638.0441026,670.8934566,1099.62999,1273.596491,2225,66.18084474,4450,-1051648,87552,-964096,57
2861,234,22,8,0.0756058158,0.924394184,898.2872328,823.7368271,1538.78539,1660.662393,3095,104.1386272,6190,-1464832,119808,-1345024,57
2906,286,22,8,0.0895989975,0.910401003,928.5239084,842.663517,1589.203028,1670.643357,3192,162.3601221,6384,-1487872,146432,-1341440,57
2067,184,22,8,0.0817414482,0.918258552,646.8402627,662.1512193,1111.97581,1283.543478,2251,78.2412235,4502,-1058304,94208,-964096,57
2933,253,23,7,0.0794099184,0.920590082,920.9780592,892.6556163,1581.173883,1736.395257,3186,269.3153001,6372,-1501696,129536,-1372160,57
3043,294,23,7,0.0881030866,0.911896913,962.8384548,965.0206981,1661.807427,1743.445578,3337,239.2114695,6674,-1558016,150528,-1407488,57
2894,221,22,8,0.0709470305,0.92905297,897.4491109,904.7111458,1544.866966,1729.977376,3115,270.6342311,6230,-1481728,113152,-1368576,57
550,110,22,8,0.166666667,0.833333333,193.4059827,175.3642926,331.2636364,326.6818182,660,28.18104184,1320,-281600,56320,-225280,57
672,129,22,8,0.161048689,0.838951311,232.5397637,223.6868223,403.8526786,386.1395349,801,43.01825994,1602,-344064,66048,-278016,57
1680,256,22,8,0.132231405,0.867768595,551.9709314,600.187805,975.5202381,922.4296875,1936,107.079646,3872,-860160,131072,-729088,57
332,79,22,8,0.192214112,0.807785888,115.2038289,127.8528599,198.8674699,235.9746835,411,32.93269231,822,-169984,40448,-129536,57
651,128,22,8,0.164313222,0.835686778,226.2120331,217.9600738,390.2703533,388.625,779,45.52893045,1558,-333312,65536,-267776,57
448,88,22,8,0.164179104,0.835820896,150.6264769,172.5251266,264.2700893,290.0340909,536,48.24482448,1072,-229376,45056,-184320,57
194,55,23,7,0.220883534,0.779116466,63.52456441,88.20017803,115.7113402,157.7636364,249,4.378406893,498,-99328,28160,-71168,57
815,174,23,7,0.175935288,0.824064712,291.9992705,252.802225,494.1411043,499.0229885,989,64.30429129,1978,-417280,89088,-328192,57
645,117,23,7,0.153543307,0.846456693,220.713742,215.8025791,380.9736434,384.4017094,762,49.28848642,1524,-330240,59904,-270336,57
525,114,22,8,0.178403756,0.821596244,188.3968185,165.0766596,319.08,324.2368421,639,33.77378436,1278,-268800,58368,-210432,57
550,122,23,7,0.181547619,0.818452381,199.3401065,167.731663,337.1418182,333.6065574,672,37.12707182,1344,-281600,62464,-219136,57
631,133,22,8,0.17408377,0.82591623,226.3748569,190.4823183,382.2377179,383.7443609,764,46.55697745,1528,-323072,68096,-254976,57
338,85,22,8,0.200945626,0.799054374,120.1329112,126.9978503,206.112426,235.4117647,423,30,846,-173056,43520,-129536,57
338,84,23,7,0.199052133,0.800947867,119.8366454,125.1041743,204.0621302,241.4285714,422,26.09771181,844,-173056,43008,-130048,57
335,70,23,7,0.172839506,0.827160494,112.5065029,130.5707166,195.7432836,237.7285714,405,28.40112202,810,-171520,35840,-135680,57
1735,271,22,8,0.135094716,0.864905284,568.2449843,638.2443856,1016.151009,922.5055351,2006,127.5270184,4012,-888320,138752,-749568,57
347,86,23,7,0.198614319,0.801385681,122.6114942,129.353033,209.0806916,248.9534884,433,31.62892622,866,-177664,44032,-133632,57
481,90,23,7,0.157618214,0.842381786,164.0158307,168.7123423,283.9480249,296.9666667,571,8.208740656,1142,-246272,46080,-200192,57
255,24,23,7,0.0860215054,0.913978495,78.04218479,94.45909609,143.7882353,99.75,279,4.377157201,558,-130560,12288,-118272,57
177,25,23,7,0.123762376,0.876237624,56.72586878,65.49291259,104.1525424,82.72,202,3.283485046,404,-90624,12800,-77824,57
344,85,23,7,0.198135198,0.801864802,120.1042408,132.5044027,206.5203488,249.3176471,429,37.66461809,858,-176128,43520,-132608,57
460,98,22,8,0.17562724,0.82437276,160.7096857,159.3677272,273.0586957,309.7346939,558,34.27518428,1116,-235520,50176,-185344,57
485,108,22,8,0.182124789,0.817875211,175.247925,151.5355431,297.8721649,293.0833333,593,38.08606294,1186,-248320,55296,-193024,57
1921,303,23,7,0.136241007,0.863758993,628.8897999,715.0883465,1124.384695,1037.151815,2224,172.5368503,4448,-983552,155136,-828416,57
620,103,23,7,0.142461964,0.857538036,209.1630248,205.2776963,359.3935484,377.6893204,723,45.32915361,1446,-317440,52736,-264704,57
546,107,22,8,0.163859112,0.836140888,191.1053108,174.2050113,329.1868132,315.8411215,653,36.78873239,1306,-279552,54784,-224768,57
694,139,24,6,0.166866747,0.833133253,243.3791257,225.3323698,416.3544669,420.2230216,833,53.3974359,1666,-355328,71168,-284160,57
439,89,22,8,0.168560606,0.831439394,150.6498402,160.0639304,261.5307517,279.1460674,528,29.25207756,1056,-224768,45568,-179200,57
490,127,23,7,0.205834684,0.794165316,180.4908055,165.7563643,301.8510204,336.5826772,617,50.781893,1234,-250880,65024,-185856,57
656,107,22,8,0.140235911,0.859764089,219.4246701,225.2220092,382.9314024,376.2897196,763,43.7751004,1526,-335872,54784,-281088,57
1988,283,22,8,0.124614707,0.875385293,641.0092102,743.6711484,1148.957243,1044.978799,2271,134.6176645,4542,-1017856,144896,-872960,57
503,97,23,7,0.161666667,0.838333333,175.7714913,159.2002604,301.0715706,297.5360825,600,37.73584906,1200,-257536,49664,-207872,57
514,126,22,8,0.196875,0.803125,186.8539532,174.1865701,315.0933852,342.5555556,640,43.15576534,1280,-263168,64512,-198656,57
615,151,22,8,0.197127937,0.802872063,226.6997539,196.6839141,384.9544715,377.5761589,766,52.10884354,1532,-314880,77312,-237568,57
460,81,22,8,0.149722736,0.850277264,150.3334595,183.2065888,265.8913043,300.0123457,541,44.89626556,1082,-235520,41472,-194048,57
456,98,22,8,0.176895307,0.823104693,156.0343011,174.3876894,271.6951754,304.5102041,554,9.855897527,1108,-233472,50176,-183296,57
389,99,23,7,0.202868852,0.797131148,138.7804841,143.3473595,235.4215938,280.1717172,488,34.65909091,976,-199168,50688,-148480,57
481,108,23,7,0.18336163,0.81663837,166.6087445,181.5770638,288.3679834,324.537037,589,46.48776638,1178,-246272,55296,-190976,57
375,92,22,8,0.197002141,0.802997859,134.9036166,133.5735475,230.664,247.5978261,467,17.61599396,934,-192000,47104,-144896,57
1883,280,22,8,0.129449838,0.870550162,610.4239192,703.0481803,1097.006904,981.0785714,2163,107.5584286,4326,-964096,143360,-820736,57
578,104,23,7,0.152492669,0.847507331,197.1340407,177.57544,327.9792388,416.6442308,682,54.34262948,1364,-295936,53248,-242688,57
601,106,23,7,0.149929279,0.850070721,207.0454931,186.2966356,352.6855241,361.4528302,707,40.30786773,1414,-307712,54272,-253440,57
359,83,23,7,0.187782805,0.812217195,124.3635062,125.3794994,208.189415,279.0722892,442,40.73732719,884,-183808,42496,-141312,57
493,105,23,7,0.175585284,0.824414716,178.2508051,142.6250349,296.8052738,312.152381,598,42.62295082,1196,-252416,53760,-198656,57
521,104,23,7,0.1664,0.8336,185.3294257,153.4913119,312.9232246,313.3846154,625,41.39072848,1250,-266752,53248,-213504,57
326,81,22,8,0.199017199,0.800982801,116.0255833,115.6223744,194.5337423,242.0987654,407,31.1400153,814,-166912,41472,-125440,57
479,96,22,8,0.166956522,0.833043478,161.4297742,177.1392853,276.993737,342.9166667,575,53.83895131,1150,-245248,49152,-196096,57
469,104,23,7,0.181500873,0.818499127,171.1919687,136.2622582,286.1620469,290.7788462,573,36.89632968,1146,-240128,53248,-186880,57
470,97,22,8,0.171075838,0.828924162,168.2378632,139.3051856,282.6425532,290.5773196,567,40.90909091,1134,-240640,49664,-190976,57
424,83,24,6,0.163708087,0.836291913,150.7679707,121.2848211,253.2617925,257.7710843,507,39.03002309,1014,-217088,42496,-174592,57
2475,324,23,7,0.115755627,0.884244373,803.39334,807.4522024,1429.547071,1174.29321,2799,217.1450737,5598,-1267200,165888,-1101312,57
589,94,22,8,0.137628111,0.862371889,198.3882735,187.7700391,338.417657,364.4468085,683,46.30508475,1366,-301568,48128,-253440,57
562,87,23,7,0.134052388,0.865947612,188.9529999,175.8578889,322.6014235,340.4942529,649,45.13212796,1298,-287744,44544,-243200,57
485,83,22,8,0.146126761,0.853873239,167.2034235,142.5111395,281.7010309,300.8554217,568,36.41025641,1136,-248320,42496,-205824,57
701,141,22,8,0.167458432,0.832541568,248.3911746,214.5602093,420.5149786,426.3971631,842,58.75785066,1684,-358912,72192,-286720,57
574,86,23,7,0.13030303,0.86969697,193.0181589,167.2070236,324.3135889,371.7906977,660,45.80152672,1320,-293888,44032,-249856,57
604,104,23,7,0.146892655,0.853107345,208.9550653,171.1757287,348.3559603,390.1826923,708,49.47589099,1416,-309248,53248,-256000,57
519,103,23,7,0.165594855,0.834405145,184.9901042,149.1673398,311.9788054,309.0873786,622,47.48091603,1244,-265728,52736,-212992,57
500,89,22,8,0.151103565,0.848896435,173.4403944,149.4019606,295.44,292.5280899,589,36.58385093,1178,-256000,45568,-210432,57
2684,312,23,7,0.104138852,0.895861148,856.6852517,888.1835271,1529.688897,1230.195513,2996,214.6131805,5992,-1374208,159744,-1214464,57
2055,155,22,8,0.0701357466,0.929864253,632.0371616,671.0283723,1088.187348,1335.032258,2210,82.98911003,4420,-1052160,79360,-972800,57
1537,268,23,7,0.148476454,0.851523546,520.5952219,509.4049503,922.5588809,790.8283582,1805,167.4397032,3610,-786944,137216,-649728,57
2889,213,22,8,0.0686653772,0.931334623,895.386793,860.0513981,1533.471097,1796.032864,3102,356.9620253,6204,-1479168,109056,-1370112,57
2794,185,22,8,0.0621013763,0.937898624,866.7580559,747.688585,1486.316034,1545.637838,2979,387.3862159,5958,-1430528,94720,-1335808,57
2129,188,23,7,0.0811394044,0.918860596,670.301586,620.8063476,1142.046501,1350.989362,2317,48.84064081,4634,-1090048,96256,-993792,57
2856,213,22,8,0.0694037146,0.930596285,883.8244243,879.0263799,1517.012955,1776.178404,3069,405.952381,6138,-1462272,109056,-1353216,57
1544,292,22,8,0.159041394,0.840958606,529.3417613,520.2239503,939.0233161,809.9794521,1836,158.5492228,3672,-790528,149504,-641024,57
2072,176,22,8,0.0782918149,0.921708185,651.1841773,606.7189048,1113.350386,1255.761364,2248,87.77821164,4496,-1060864,90112,-970752,57
2968,228,23,7,0.071339174,0.928660826,920.9120997,897.3255642,1576.708558,1882.171053,3196,440.8275862,6392,-1519616,116736,-1402880,57
1772,130,22,8,0.0683491062,0.931650894,545.3837262,576.7179104,940.5970655,1100.115385,1902,229.7101449,3804,-907264,66560,-840704,57
2071,182,23,7,0.0807811806,0.919218819,649.2718332,629.6362091,1109.523901,1325.862637,2253,79.16373858,4506,-1060352,93184,-967168,57
1764,135,23,7,0.0710900474,0.928909953,543.7269487,573.4346577,936.1173469,1131.4,1899,177.1455224,3798,-903168,69120,-834048,57
3203,301,22,8,0.0859018265,0.914098174,1014.740768,960.2046342,1736.508586,1922.667774,3504,332.4478178,7008,-1639936,154112,-1485824,57
2057,166,23,7,0.0746738641,0.925326136,639.5214671,640.6709587,1097.203209,1295.355422,2223,78,4446,-1053184,84992,-968192,57
2251,184,22,8,0.0755646817,0.924435318,701.485304,698.5389933,1204.193247,1386.907609,2435,90.5204461,4870,-1152512,94208,-1058304,57
2026,172,22,8,0.0782529572,0.921747043,633.6060123,615.6027312,1083.799605,1284.436047,2198,67.42331288,4396,-1037312,88064,-949248,57
2375,206,22,8,0.0798140256,0.920185974,748.520858,694.9741373,1281.613895,1399.213592,2581,72.17561521,5162,-1216000,105472,-1110528,57
2072,183,22,8,0.0811529933,0.918847007,649.8548554,632.0199167,1110.938224,1321.180328,2255,82.44972578,4510,-1060864,93696,-967168,57
1631,305,23,7,0.157541322,0.842458678,556.2672162,556.4654251,991.679951,844.5442623,1936,34.15666902,3872,-835072,156160,-678912,57
2968,245,22,8,0.0762527233,0.923747277,933.7243159,838.3127586,1596.514825,1734.020408,3213,191.8208955,6426,-1519616,125440,-1394176,57
486,95,22,8,0.163511188,0.836488812,170.1293095,154.8018124,290.7325103,292.3684211,581,39.93127148,1162,-248832,48640,-200192,57
500,103,23,7,0.170812604,0.829187396,177.9762111,153.450076,303.674,293.8737864,603,34.49656751,1206,-256000,52736,-203264,57
488,109,23,7,0.182579564,0.817420436,169.7478412,181.0542944,292.9815574,325.9449541,597,39.72055888,1194,-249856,55808,-194048,57
540,91,22,8,0.144215531,0.855784469,183.2209887,175.6397735,316.6388889,312.2087912,631,36.70738802,1262,-276480,46592,-229888,57
497,93,22,8,0.157627119,0.842372881,172.3109479,159.2252713,295.9396378,293.1505376,590,37.29456384,1180,-254464,47616,-206848,57
458,81,22,8,0.150278293,0.849721707,150.480543,178.8259489,264.6331878,300.345679,539,38.44507846,1078,-234496,41472,-193024,57
619,108,22,8,0.148555708,0.851444292,211.3866789,200.2846455,361.4038772,378.8796296,727,43.04322084,1454,-316928,55296,-261632,57
479,111,23,7,0.188135593,0.811864407,166.9792851,181.0186975,288.5741127,325.3873874,590,47.42765273,1180,-245248,56832,-188416,57
361,85,22,8,0.19058296,0.80941704,124.2461031,139.6480876,214.2354571,262.8470588,446,44.6,892,-184832,43520,-141312,57
615,118,23,7,0.160982265,0.839017735,213.8658456,198.5067445,370.2487805,350.0677966,733,42.41898148,1466,-314880,60416,-254464,57
513,107,22,8,0.172580645,0.827419355,182.5526292,160.3932498,312.5068226,300.8785047,620,44.00283889,1240,-262656,54784,-207872,57
486,241,24,6,0.331499312,0.668500688,186.0702516,201.2910739,303.1481481,486.7136929,727,26.75745307,1454,-248832,123392,-125440,57
2611,343,23,7,0.116113744,0.883886256,834.7655766,961.0928455,1500.424358,1302.994169,2954,202.60631,5908,-1336832,175616,-1161216,57
637,131,23,7,0.170572917,0.829427083,223.8814049,210.6783467,385.7582418,378.3816794,768,60.18808777,1536,-326144,67072,-259072,57
514,97,22,8,0.158756137,0.841243863,178.7231053,163.40374,306.1498054,305.2061856,611,36.32580262,1222,-263168,49664,-213504,57
491,108,22,8,0.180300501,0.819699499,169.3107718,186.7814689,295.0325866,322.5833333,599,48.85807504,1198,-251392,55296,-196096,57
600,119,22,8,0.16550765,0.83449235,208.9873959,199.8866132,361.9983333,349.9243697,719,43.49667272,1438,-307200,60928,-246272,57
534,107,23,7,0.166926677,0.833073323,188.1895474,168.322049,322.1872659,315.0747664,641,24.07059707,1282,-273408,54784,-218624,57
747,136,23,7,0.154020385,0.845979615,257.1983617,239.184559,435.9625167,475.1617647,883,53.35347432,1766,-382464,69632,-312832,57
492,225,23,7,0.313807531,0.686192469,194.0041863,185.89568,305.8821138,475.1511111,717,45.32237674,1434,-251904,115200,-136704,57
2287,280,23,7,0.109076743,0.890923257,717.9551067,906.1445029,1290.321819,1232.364286,2567,145.7694492,5134,-1170944,143360,-1027584,57
4048,283,22,8,0.0653428769,0.934657123,1236.245029,1374.720709,2193.986166,1765.689046,4331,78.03603604,8662,-2072576,144896,-1927680,57
4186,294,22,8,0.065625,0.934375,1273.250508,1532.683152,2256.389154,2014.268707,4480,84.5602114,8960,-2143232,150528,-1992704,57
4172,299,23,7,0.0668754194,0.933124581,1273.079894,1512.991149,2241.269175,2162.478261,4471,81.66210046,8942,-2136064,153088,-1982976,57
2297,300,22,8,0.115517905,0.884482095,730.5794794,878.9009079,1308.637353,1225.21,2597,167.9818887,5194,-1176064,153600,-1022464,57
489,112,22,8,0.186356073,0.813643927,170.6920137,183.2050956,295.3578732,325.6339286,601,48.78246753,1202,-250368,57344,-193024,57
4146,293,22,8,0.0660058572,0.933994143,1260.005009,1537.049003,2235.268934,2003.94198,4439,82.90997385,8878,-2122752,150016,-1972736,57
1918,218,23,7,0.102059925,0.897940075,608.4188552,658.7752409,1088.507299,892.4724771,2136,39.53359245,4272,-982016,111616,-870400,57
4130,284,23,7,0.064340734,0.935659266,1256.747594,1487.349886,2222.985472,1982.306338,4414,77.94455236,8828,-2114560,145408,-1969152,57
371,90,22,8,0.195227766,0.804772234,128.4178053,143.379106,220.8463612,272.8555556,461,46.80203046,922,-189952,46080,-143872,57
631,138,23,7,0.179453836,0.820546164,221.078505,221.6278522,376.118859,425.6086957,769,58.47908745,1538,-323072,70656,-252416,57
1910,218,22,8,0.102443609,0.897556391,601.6197386,700.5676015,1080.415183,925.059633,2128,40.9703504,4256,-977920,111616,-866304,57
4134,248,23,7,0.056595162,0.943404838,1247.088372,1532.532167,2192.768021,2170.362903,4382,78.08267997,8764,-2116608,126976,-1989632,57
4082,261,22,8,0.0600967073,0.939903293,1235.667826,1497.267883,2183.205292,1996.750958,4343,81.97432994,8686,-2089984,133632,-1956352,57
375,80,22,8,0.175824176,0.824175824,126.6204242,145.9320042,220.0826667,265.1125,455,32.06483439,910,-192000,40960,-151040,57
4220,290,23,7,0.0643015521,0.935698448,1288.943502,1436.242645,2278.683412,1918.141379,4510,85.57874763,9020,-2160640,148480,-2012160,57
459,85,22,8,0.15625,0.84375,152.8133947,176.5082572,268.416122,294.5529412,544,48.70188004,1088,-235008,43520,-191488,57
672,45,23,7,0.0627615063,0.937238494,203.8101585,226.9496882,365.7306548,258.4888889,717,11.40267176,1434,-344064,23040,-321024,57
167,20,23,7,0.106951872,0.893048128,52.41514899,57.57158587,97.56287425,64.25,187,3.029321238,374,-85504,10240,-75264,57
360,92,22,8,0.203539823,0.796460177,127.0256361,136.6492118,216.7333333,264.7173913,452,38.93195521,904,-184320,47104,-137216,57
2059,259,22,8,0.111734254,0.888265746,647.4993118,820.9103093,1162.083536,1138.96139,2318,42.91797815,4636,-1054208,132608,-921600,57
1834,297,23,7,0.139371187,0.860628813,604.3558321,675.3654217,1075.167939,1009.387205,2131,125.9456265,4262,-939008,152064,-786944,57
4069,290,22,8,0.0665290204,0.93347098,1237.439672,1514.69837,2189.933399,2040.624138,4359,82.88648032,8718,-2083328,148480,-1934848,57
331,76,22,8,0.186732187,0.813267813,113.0521699,129.7308529,196.1691843,238.1052632,407,31.16385911,814,-169472,38912,-130560,57
4124,289,23,7,0.0654883299,0.93451167,1253.654267,1524.51293,2218.696654,2040.089965,4413,86.73349057,8826,-2111488,147968,-1963520,57
4448,607,23,7,0.12007913,0.87992087,1374.494262,1686.254037,2397.078462,3487.372323,5055,88.85568641,10110,-2277376,310784,-1966592,57
491,93,22,8,0.159246575,0.840753425,162.9607671,191.871962,285.8798371,327.4516129,584,50.12875536,1168,-251392,47616,-203776,57
4329,331,22,8,0.0710300429,0.928969957,1315.001445,1690.777358,2326.830908,2378.486405,4660,85.16081871,9320,-2216448,169472,-2046976,57
1910,200,23,7,0.0947867299,0.90521327,598.2003433,690.1386887,1069.742932,919.48,2110,43.55904211,4220,-977920,102400,-875520,57
4068,275,22,8,0.0633202855,0.936679714,1232.694595,1517.635163,2185.372173,1974.189091,4343,79.57127153,8686,-2082816,140800,-1942016,57
4687,324,23,7,0.0646577529,0.935342247,1431.638047,1604.683852,2530.873266,2146.182099,5011,87.8968602,10022,-2399744,165888,-2233856,57
380,98,22,8,0.205020921,0.794979079,135.6384089,142.0924787,231.0789474,272.1530612,478,22.84894837,956,-194560,50176,-144384,57
1957,218,22,8,0.100229885,0.899770115,614.2719268,724.546853,1103.261625,950.9954128,2175,41.12308565,4350,-1001984,111616,-890368,57
4172,280,23,7,0.0628930818,0.937106918,1262.380545,1581.647353,2234.610499,2105.653571,4452,84.83231707,8904,-2136064,143360,-1992704,57
1824,313,23,7,0.14646701,0.85353299,611.2909961,646.8135567,1076.655702,1024.386581,2137,84.13385827,4274,-933888,160256,-773632,57
4217,283,22,8,0.0628888889,0.937111111,1278.141971,1563.845011,2264.18212,2046.621908,4500,82.76623138,9000,-2159104,144896,-2014208,57
4172,300,22,8,0.0670840787,0.932915921,1271.333014,1517.828336,2253.787872,1996.083333,4472,80.1003045,8944,-2136064,153600,-1982464,57
379,97,23,7,0.203781513,0.796218487,135.7931084,138.3466229,229.7546174,272.6701031,476,31.52317881,952,-194048,49664,-144384,57
4082,278,23,7,0.0637614679,0.936238532,1236.789824,1534.448191,2191.840764,2013.978417,4360,91.59663866,8720,-2089984,142336,-1947648,57
2104,494,22,8,0.190146266,0.809853734,675.0641712,860.246872,1188.269962,1773.240891,2598,51.35402253,5196,-1077248,252928,-824320,57
336,81,23,7,0.194244604,0.805755396,118.298254,124.1436854,201.702381,239.2716049,417,39.04494382,834,-172032,41472,-130560,57
1661,256,22,8,0.133541993,0.866458007,547.3308159,587.3795928,968.6243227,896.5546875,1917,118.6996904,3834,-850432,131072,-719360,57
492,253,23,7,0.339597315,0.660402685,187.4348695,201.6677356,304.0711382,507.0434783,745,39.64874933,1490,-251904,129536,-122368,57
507,125,22,8,0.19778481,0.80221519,184.4596721,171.9947713,310.65286,340.216,632,27.40676496,1264,-259584,64000,-195584,57
327,71,22,8,0.17839196,0.82160804,110.568082,129.506536,193.5351682,226.971831,398,32.20064725,796,-167424,36352,-131072,57
622,117,22,8,0.158322057,0.841677943,215.3163848,201.95714,367.5691318,382.9230769,739,44.73365617,1478,-318464,59904,-258560,57
618,105,23,7,0.145228216,0.854771784,210.1682251,199.6199237,363.736246,351.7809524,723,33.39491917,1446,-316416,53760,-262656,57
641,274,22,8,0.299453552,0.700546448,236.1100678,256.0653928,389.1809672,618.9963504,915,61.57469717,1830,-328192,140288,-187904,57
389,103,23,7,0.209349593,0.790650407,139.6767715,144.2170694,236.3059126,285,492,45.34562212,984,-199168,52736,-146432,57
486,230,23,7,0.32122905,0.67877095,181.5943087,193.6715099,295.8683128,490.8434783,716,46.31306598,1432,-248832,117760,-131072,57
520,99,23,7,0.15993538,0.84006462,181.0140815,165.6933958,308.4,318.4040404,619,41.73971679,1238,-266240,50688,-215552,57
600,87,22,8,0.126637555,0.873362445,197.5855059,202.9333564,345.6766667,332.4367816,687,43.23473883,1374,-307200,44544,-262656,57
735,156,23,7,0.175084175,0.824915825,261.557649,235.1246885,442.9823129,460.2179487,891,44.86404834,1782,-376320,79872,-296448,57
336,73,23,7,0.178484108,0.821515892,114.6146593,127.3788792,197.5982143,239.0684932,409,34.3697479,818,-172032,37376,-134656,57
337,77,22,8,0.185990338,0.814009662,115.032948,132.30817,199.8575668,240.9480519,414,40.7480315,828,-172544,39424,-133120,57
346,77,23,7,0.182033097,0.817966903,115.6755124,138.2540859,201.5982659,258.7402597,423,7.790055249,846,-177152,39424,-137728,57
332,77,23,7,0.188264059,0.811735941,114.0008892,130.0795597,198.1054217,234.7272727,409,26.3022508,818,-169984,39424,-130560,57
528,95,23,7,0.152487961,0.847512039,182.5178066,164.1684798,312.4829545,309.3157895,623,31.68870804,1246,-270336,48640,-221696,57
620,108,22,8,0.148351648,0.851648352,211.0122102,204.4814094,367.1935484,349.037037,728,44.66257669,1456,-317440,55296,-262144,57
607,284,22,8,0.318742985,0.681257015,226.0317616,258.4243373,377.3789127,592.665493,891,57.11538462,1782,-310784,145408,-165376,57
318,79,22,8,0.198992443,0.801007557,113.2004156,112.1199486,189.4371069,237.4936709,397,35.60538117,794,-162816,40448,-122368,57
312,76,23,7,0.195876289,0.804123711,109.9377229,110.8554646,184.3942308,235.9868421,388,37.41562199,776,-159744,38912,-120832,57
726,269,22,8,0.270351759,0.729648241,288.8765019,240.3552247,450.8705234,625.197026,995,62.57861635,1990,-371712,137728,-233984,57
470,87,22,8,0.156193896,0.843806104,154.5921339,175.7942984,266.3744681,347.2068966,557,43.78930818,1114,-240640,44544,-196096,57
678,285,23,7,0.295950156,0.704049844,248.8587917,262.0237478,407.0619469,660.2736842,963,41.50862069,1926,-347136,145920,-201216,57
488,94,22,8,0.161512027,0.838487973,172.0116246,145.2823483,290.204918,298.2234043,582,40.81346424,1164,-249856,48128,-201728,57
2081,283,23,7,0.119712352,0.880287648,685.7922812,634.5400289,1204.309947,1022.123675,2364,114.8688047,4728,-1065472,144896,-920576,57
329,68,22,8,0.171284635,0.828715365,111.8313494,117.6025752,189.8966565,243.0441176,397,38.24662813,794,-168448,34816,-133632,57
318,66,23,7,0.171875,0.828125,108.5709784,112.4065381,183.9213836,233.8333333,384,22.2737819,768,-162816,33792,-129024,57
734,299,22,8,0.289448209,0.710551791,299.8272391,244.7553389,460.9632153,654.5618729,1033,64.88693467,2066,-375808,153088,-222720,57
611,113,22,8,0.156077348,0.843922652,211.3411421,195.8065024,361.7135843,366.7522124,724,57.68924303,1448,-312832,57856,-254976,57
397,77,22,8,0.162447257,0.837552743,132.9325922,139.313402,225.2821159,300.4935065,474,38.7888707,948,-203264,39424,-163840,57
509,84,22,8,0.141652614,0.858347386,173.1436107,158.0082054,294.5874263,311.6190476,593,39.63903743,1186,-260608,43008,-217600,57
596,107,23,7,0.152204836,0.847795164,207.7772072,171.0545151,347.1677852,378.9158879,703,43.47557205,1406,-305152,54784,-250368,57
363,81,23,7,0.182432432,0.817567568,124.6485021,129.1715799,210.1707989,277.7530864,444,44.48897796,888,-185856,41472,-144384,57
300,72,22,8,0.193548387,0.806451613,105.3200677,107.801321,177.5033333,223.9861111,372,23.45523329,744,-153600,36864,-116736,57
544,85,22,8,0.135135135,0.864864865,178.2621967,191.6268035,305.9466912,372.9411765,629,55.27240773,1258,-278528,43520,-235008,57
485,98,22,8,0.168096055,0.831903945,170.7881954,154.3581385,288.7154639,308.255102,583,10.2930791,1166,-248320,50176,-198144,57
778,149,22,8,0.160733549,0.839266451,271.9491038,240.0539943,456.6876607,502.1812081,927,59.76789168,1854,-398336,76288,-322048,57
599,89,23,7,0.129360465,0.870639535,201.5427044,171.9861439,338.3572621,385.8426966,688,43.82165605,1376,-306688,45568,-261120,57
1347,200,22,8,0.129282482,0.870717518,429.1700552,546.4261607,765.7550111,829.53,1547,27.18327183,3094,-689664,102400,-587264,58
1336,197,22,8,0.128506197,0.871493803,427.4359928,533.8033026,766.8817365,767.8020305,1533,144.8960302,3066,-684032,100864,-583168,58
1341,190,22,8,0.124101894,0.875898106,429.4416706,521.7095334,764.3773304,777.4526316,1531,178.4382284,3062,-686592,97280,-589312,58
1339,193,22,8,0.125979112,0.874020888,429.324406,522.0529017,761.8200149,798.9689119,1532,129.1736931,3064,-685568,98816,-586752,58
1346,188,21,9,0.122555411,0.877444589,430.0895534,524.3452171,763.8759287,793.4468085,1534,85.12763596,3068,-689152,96256,-592896,58
1365,191,21,9,0.122750643,0.877249357,434.7130806,541.1415572,776.2227106,794.7748691,1556,141.1978221,3112,-698880,97792,-601088,58
1346,203,22,8,0.131052292,0.868947708,433.2077489,528.0996727,782.0163447,728.4778325,1549,157.5788403,3098,-689152,103936,-585216,58
1336,182,22,8,0.119894598,0.880105402,425.414024,521.7829868,755.7035928,787.3681319,1518,176.1020882,3036,-684032,93184,-590848,58
1352,198,21,9,0.127741935,0.872258065,432.4026722,539.012187,774.4903846,782.3939394,1550,206.1170213,3100,-692224,101376,-590848,58
1361,199,22,8,0.127564103,0.872435897,436.5025382,534.9755434,777.4864071,801.1105528,1560,174.6920493,3120,-696832,101888,-594944,58
1349,187,22,8,0.121744792,0.878255208,429.7471248,530.9765538,765.0630096,793.2941176,1536,145.1795841,3072,-690688,95744,-594944,58
1336,189,21,9,0.123934426,0.876065574,427.9996524,517.6285344,758.9812874,791.4074074,1525,91.70174384,3050,-684032,96768,-587264,58
1345,190,22,8,0.123778502,0.876221498,430.2253799,523.246724,761.7130112,812.5052632,1535,88.77964141,3070,-688640,97280,-591360,58
1345,196,21,9,0.127190136,0.872809864,430.8075381,531.278858,770.7583643,772.6581633,1541,88.46153846,3082,-688640,100352,-588288,58
1333,192,22,8,0.125901639,0.874098361,426.59611,524.8272996,760.288072,781.828125,1525,139.9082569,3050,-682496,98304,-584192,58
1339,198,21,9,0.128822381,0.871177619,429.2655871,530.8878205,767.0589993,782.1262626,1537,117.9585572,3074,-685568,101376,-584192,58
1348,179,22,8,0.117223314,0.882776686,427.7004493,523.8289974,754.6335312,834.5363128,1527,199.8691099,3054,-690176,91648,-598528,58
1325,192,21,9,0.12656559,0.87343441,423.4691025,526.8283465,757.4588679,769.6354167,1517,187.9801735,3034,-678400,98304,-580096,58
1338,198,22,8,0.12890625,0.87109375,428.7326742,522.2131946,754.4334828,863.5555556,1536,26.81564246,3072,-685056,101376,-583680,58
2036,145,21,9,0.0664832646,0.933516735,616.5805894,732.0770742,1111.44499,803.9241379,2181,33.67299676,4362,-1042432,74240,-968192,58
2290,288,21,9,0.111714507,0.888285493,721.7976814,900.7709386,1296.653275,1232.621528,2578,94.60550459,5156,-1172480,147456,-1025024,58
2308,255,21,9,0.0994927819,0.900507218,723.6281826,870.6954451,1274.965338,1345.670588,2563,72.56511891,5126,-1181696,130560,-1051136,58
2289,245,21,9,0.0966850829,0.903314917,714.5882173,869.7694276,1258.914373,1347.714286,2534,80.13915244,5068,-1171968,125440,-1046528,58
2271,264,21,9,0.104142012,0.895857988,711.6371195,886.0513741,1265.125055,1292.731061,2535,85.49747049,5070,-1162752,135168,-1027584,58
2291,259,20,10,0.101568627,0.898431373,719.2388421,870.2326058,1270.817983,1316.915058,2550,91.52907394,5100,-1172992,132608,-1040384,58
2354,290,21,9,0.1096823,0.8903177,741.2375664,922.4207642,1325.371283,1299.193103,2644,92.28621291,5288,-1205248,148480,-1056768,58
2276,275,21,9,0.107800862,0.892199138,717.0879009,879.9206458,1273.497364,1296.712727,2551,80.19490726,5102,-1165312,140800,-1024512,58
2336,280,21,9,0.107033639,0.892966361,733.8923377,913.578552,1309.275685,1302.028571,2616,75.21564117,5232,-1196032,143360,-1052672,58
2322,300,21,9,0.114416476,0.885583524,733.9123509,915.5278427,1312.265289,1305.576667,2622,95.17241379,5244,-1188864,153600,-1035264,58
2335,300,21,9,0.113851992,0.886148008,738.7169813,911.7387772,1325.052248,1263.11,2635,90.67446662,5270,-1195520,153600,-1041920,58
2293,275,21,9,0.107087227,0.892912773,719.5253907,901.6490109,1289.603576,1241.945455,2568,95.00554939,5136,-1174016,140800,-1033216,58
2342,301,21,9,0.113885736,0.886114264,739.1316309,927.7288252,1322.659693,1316.86711,2643,92.8345627,5286,-1199104,154112,-1044992,58
2295,297,21,9,0.114583333,0.885416667,728.4661072,884.3790384,1303.654466,1241.215488,2592,98.25625474,5184,-1175040,152064,-1022976,58
2301,290,21,9,0.111925897,0.888074103,725.2142429,906.0308487,1303.867014,1233.57931,2591,85.68121693,5182,-1178112,148480,-1029632,58
2305,275,21,9,0.106589147,0.893410853,727.4223322,876.7467831,1288.803471,1304.72,2580,92.01141227,5160,-1180160,140800,-1039360,58
2274,253,21,9,0.100118718,0.899881282,711.8372702,869.6531851,1271.025506,1200.853755,2527,80.09508716,5054,-1164288,129536,-1034752,58
2322,291,21,9,0.111366246,0.888633754,731.3125523,917.2559014,1305.252369,1320.945017,2613,77.76785714,5226,-1188864,148992,-1039872,58
2294,258,21,9,0.101097179,0.898902821,720.1261231,867.1949409,1268.685702,1345.98062,2552,87.90905959,5104,-1174528,132096,-1042432,58
2306,289,21,9,0.111368015,0.888631985,727.5745377,901.0213049,1304.578491,1245.508651,2595,89.11401099,5190,-1180672,147968,-1032704,58
2308,253,21,9,0.0987895353,0.901210465,721.7604385,880.3779254,1273.47357,1349.660079,2561,87.73552587,5122,-1181696,129536,-1052160,58
1033,125,22,8,0.107944732,0.892055268,326.6080748,381.6240663,589.749274,494.8,1158,116.0320641,2316,-528896,64000,-464896,58
1029,122,22,8,0.105994787,0.894005213,325.8431943,375.6105098,583.8969874,509.3934426,1151,139.684466,2302,-526848,62464,-464384,58
1026,126,21,9,0.109375,0.890625,325.7249025,376.8259598,584.8557505,508.4603175,1152,58.27010622,2304,-525312,64512,-460800,58
886,105,22,8,0.105953582,0.894046418,275.8068863,361.2072331,496.8814898,488.5619048,991,60.20656136,1982,-453632,53760,-399872,58
1029,129,22,8,0.111398964,0.888601036,325.9937444,384.3600763,589.8610301,496.8527132,1158,109.7630332,2316,-526848,66048,-460800,58
1020,129,22,8,0.11227154,0.88772846,324.2208659,375.5492433,585.4588235,492.3023256,1149,141.5024631,2298,-522240,66048,-456192,58
1061,121,22,8,0.102368866,0.897631134,333.7283101,391.5513962,600.804901,509.9090909,1182,133.8618347,2364,-543232,61952,-481280,58
1034,131,21,9,0.112446352,0.887553648,327.7716917,382.8774992,595.655706,483.1068702,1165,98.56175973,2330,-529408,67072,-462336,58
1034,128,22,8,0.110154905,0.889845095,327.8192494,384.5246174,590.155706,511.578125,1162,115.1635282,2324,-529408,65536,-463872,58
1021,132,21,9,0.114483955,0.885516045,324.5288655,379.4491077,588.5886386,487.3636364,1153,116.1127895,2306,-522752,67584,-455168,58
1025,117,22,8,0.102451839,0.897548161,322.9706108,380.2938239,576.7346341,525.6410256,1142,127.3132664,2284,-524800,59904,-464896,58
1027,124,22,8,0.107732407,0.892267593,324.829234,375.6073641,587.2823759,482.5564516,1151,83.46627991,2302,-525824,63488,-462336,58
1026,117,22,8,0.102362205,0.897637795,324.3686134,371.7269737,577.662768,522.3418803,1143,75.54527429,2286,-525312,59904,-465408,58
1027,129,22,8,0.111591696,0.888408304,325.2516378,385.0983963,588.7020448,497.2790698,1156,115.4845155,2312,-525824,66048,-459776,58
1039,133,22,8,0.113481229,0.886518771,330.8256269,381.2690334,597.4889317,500.6541353,1172,91.27725857,2344,-531968,68096,-463872,58
1023,126,21,9,0.109660574,0.890339426,324.7765852,371.2856203,586.0244379,485.4920635,1149,55.72259942,2298,-523776,64512,-459264,58
1081,137,21,9,0.112479475,0.887520525,344.7321472,396.1410771,617.4810361,546.5255474,1218,125.1798561,2436,-553472,70144,-483328,58
1024,129,21,9,0.111882047,0.888117953,326.1625545,372.5605674,586.8798828,498.5736434,1153,63.00546448,2306,-524288,66048,-458240,58
1032,121,21,9,0.104943625,0.895056375,326.7886556,375.5415809,583.8468992,518.6033058,1153,134.0697674,2306,-528384,61952,-466432,58
1037,118,22,8,0.102164502,0.897835498,326.973431,378.2822005,585.9836066,507.8389831,1155,104.5248869,2310,-530944,60416,-470528,58
1031,123,22,8,0.106585789,0.893414211,326.3749305,378.5306818,585.5043647,510.4065041,1154,93.74492283,2308,-527872,62976,-464896,58
1022,124,21,9,0.108202443,0.891797557,323.3812961,376.6162688,583.5675147,490.5241935,1146,55.52325581,2292,-523264,63488,-459776,58
1035,124,22,8,0.106988783,0.893011217,327.900691,379.9233967,587.5951691,516.6048387,1159,168.4593023,2318,-529920,63488,-466432,58
1026,126,22,8,0.109375,0.890625,323.9465128,388.0041381,585.5194932,503.0555556,1152,148.6451613,2304,-525312,64512,-460800,58
1060,122,21,9,0.10321489,0.89678511,334.5465576,387.686429,599.4141509,522.7377049,1182,185.8490566,2364,-542720,62464,-480256,58
1021,121,21,9,0.105954466,0.894045534,323.0837904,374.5748732,579.1273262,507.1404959,1142,94.06919275,2284,-522752,61952,-460800,58
1036,128,22,8,0.109965636,0.890034364,329.0663384,381.4147054,590.6177606,516.796875,1164,157.9375848,2328,-530432,65536,-464896,58
984,83,22,8,0.0777881912,0.922211809,304.4448392,344.7703804,530.4329268,576.2891566,1067,94.25795053,2134,-503808,42496,-461312,58
1031,127,21,9,0.109671848,0.890328152,327.7475184,378.0283691,586.8331717,519.9685039,1158,132.1917808,2316,-527872,65024,-462848,58
1043,136,21,9,0.115351993,0.884648007,331.691015,389.6735669,601.3787152,502.7352941,1179,192.019544,2358,-534016,69632,-464384,58
1028,118,22,8,0.102966841,0.897033159,324.8638354,375.7665624,578.6848249,528.3305085,1146,94.16598192,2292,-526336,60416,-465920,58
1016,120,22,8,0.105633803,0.894366197,319.6830083,381.9879448,577.7598425,490.1,1136,139.9014778,2272,-520192,61440,-458752,58
1012,118,22,8,0.104424779,0.895575221,319.409704,373.1892477,573.1057312,500.2711864,1130,128.9954338,2260,-518144,60416,-457728,58
1017,126,22,8,0.11023622,0.88976378,322.9907182,375.2710343,580.0530973,507,1143,90.49881235,2286,-520704,64512,-456192,58
1036,129,22,8,0.110729614,0.889270386,328.1159544,379.2351962,596.3812741,475.5348837,1165,150.7115136,2330,-530432,66048,-464384,58
805,92,21,9,0.102564103,0.897435897,252.717979,260.7023746,466.7726708,293.4891304,897,98.35526316,1794,-412160,47104,-365056,58
1029,128,22,8,0.110630942,0.889369058,327.0628208,379.3364464,586.8765792,515.6796875,1157,127.9867257,2314,-526848,65536,-461312,58
1077,129,21,9,0.106965174,0.893034826,341.9717807,389.0884635,611.7901578,534.2868217,1206,95.03546099,2412,-551424,66048,-485376,58
1029,130,21,9,0.11216566,0.88783434,327.1011787,378.0108577,590.7716229,494.7384615,1159,133.6793541,2318,-526848,66560,-460288,58
1015,131,21,9,0.114310646,0.885689354,323.2251748,372.1663884,585.2955665,482.1068702,1146,140.7862408,2292,-519680,67072,-452608,58
1031,131,21,9,0.112736661,0.887263339,327.514266,381.9921331,592.1765276,497.4732824,1162,52.48419151,2324,-527872,67072,-460800,58
1041,130,22,8,0.111016225,0.888983775,330.5761369,383.4990032,595.9577329,506.2615385,1171,176.6214178,2342,-532992,66560,-466432,58
1008,136,22,8,0.118881119,0.881118881,322.3898144,372.5785965,583.9960317,487.2941176,1144,67.81268524,2288,-516096,69632,-446464,58
1025,130,21,9,0.112554113,0.887445887,325.1837124,377.2773946,590.8673171,476.5461538,1155,155.2419355,2310,-524800,66560,-458240,58
1023,128,21,9,0.111207646,0.888792354,324.9119987,376.4424183,586.0860215,495.390625,1151,131.2428734,2302,-523776,65536,-458240,58
1036,131,22,8,0.112253642,0.887746358,329.2047244,386.0338758,592.3561776,517.9160305,1167,165.2974504,2334,-530432,67072,-463360,58
1028,130,21,9,0.112262522,0.887737478,326.6151258,377.3957448,591.0564202,488.1153846,1158,147.5159236,2316,-526336,66560,-459776,58
1021,130,22,8,0.112945265,0.887054735,324.1888407,380.7700385,586.0705191,496.9076923,1151,132.6036866,2302,-522752,66560,-456192,58
1026,125,21,9,0.108601216,0.891398784,325.4750369,378.4029725,583.1539961,517.28,1151,153.2623169,2302,-525312,64000,-461312,58
1020,130,21,9,0.113043478,0.886956522,324.511421,378.3904574,584.3852941,505.7846154,1150,127.63596,2300,-522240,66560,-455680,58
804,89,22,8,0.0996640538,0.900335946,251.9565174,275.5844046,460.8370647,322,893,202.0361991,1786,-411648,45568,-366080,58
1021,130,22,8,0.112945265,0.887054735,323.8326597,384.2665111,585.4348678,501.9,1151,149.6749025,2302,-522752,66560,-456192,58
1022,134,21,9,0.115916955,0.884083045,325.3089753,381.0754164,589.7720157,492.5298507,1156,116.064257,2312,-523264,68608,-454656,58
1020,132,21,9,0.114583333,0.885416667,324.8085068,376.284293,587.6235294,490.5454545,1152,149.8049415,2304,-522240,67584,-454656,58
1023,128,21,9,0.111207646,0.888792354,324.0307555,380.1281412,587.2482893,486.1015625,1151,135.4117647,2302,-523776,65536,-458240,58
1025,128,22,8,0.111014744,0.888985256,325.7996476,379.1320883,584.6195122,515.984375,1153,24.79036766,2306,-524800,65536,-459264,58
1036,136,21,9,0.116040956,0.883959044,329.5721963,384.6416196,599.4797297,487.625,1172,138.8625592,2344,-530432,69632,-460800,58
1020,131,22,8,0.113814075,0.886185925,325.144399,374.3572413,585.9,498.9160305,1151,70.83076923,2302,-522240,67072,-455168,58
1031,121,21,9,0.105034722,0.894965278,326.0649476,375.2347801,585.2453928,501.9834711,1152,87.4715262,2304,-527872,61952,-465920,58
1031,139,22,8,0.118803419,0.881196581,326.1148718,409.6264945,593.0640155,529.3956835,1170,20.75940383,2340,-527872,71168,-456704,58
1034,134,21,9,0.114726027,0.885273973,329.4124426,380.4833263,595.959381,496.0746269,1168,89.09229596,2336,-529408,68608,-460800,58
773,89,21,9,0.10324826,0.89675174,242.7105008,248.7362159,449.1513583,278.1910112,862,22.81630492,1724,-395776,45568,-350208,58
1024,129,21,9,0.111882047,0.888117953,325.0756937,375.862846,588.9150391,482.4186047,1153,134.225844,2306,-524288,66048,-458240,58
1006,122,21,9,0.108156028,0.891843972,319.1505936,367.2285145,573.0705765,493.8278689,1128,125.7525084,2256,-515072,62464,-452608,58
1027,130,22,8,0.112359551,0.887640449,325.6573982,382.7596242,590.0009737,492.0923077,1157,166.4748201,2314,-525824,66560,-459264,58
1038,124,22,8,0.106712565,0.893287435,328.9041337,379.3271416,589.4682081,514.7983871,1162,174.4744745,2324,-531456,63488,-467968,58
1015,124,22,8,0.108867428,0.891132572,321.6469371,373.9235716,579.2118227,494.5967742,1139,128.8461538,2278,-519680,63488,-456192,58
1025,120,21,9,0.104803493,0.895196507,325.0044896,372.6114375,577.097561,538,1145,68.89290012,2290,-524800,61440,-463360,58
1031,124,21,9,0.107359307,0.892640693,326.2711395,375.9519755,588.8031038,488.1774194,1155,53.22580645,2310,-527872,63488,-464384,58
1015,120,22,8,0.105726872,0.894273128,320.2833828,374.3992711,577.7004926,485.95,1135,105.3853296,2270,-519680,61440,-458240,58
1025,128,22,8,0.111014744,0.888985256,324.839959,378.2639994,588.6829268,483.4453125,1153,175.2279635,2306,-524800,65536,-459264,58
1024,120,22,8,0.104895105,0.895104895,323.6100534,376.7977482,579.5996094,511.9166667,1144,121.1864407,2288,-524288,61440,-462848,58
1027,121,22,8,0.105400697,0.894599303,324.7138579,377.5338725,581.993184,510.9008264,1148,156.6166439,2296,-525824,61952,-463872,58
1078,145,22,8,0.118560916,0.881439084,343.8896215,410.3269058,619.7198516,554.6068966,1223,21.64984953,2446,-551936,74240,-477696,58
1011,130,21,9,0.113935145,0.886064855,321.6706076,373.6438009,581.7616222,487.3076923,1141,169.5393759,2282,-517632,66560,-451072,58
1019,124,22,8,0.108486439,0.891513561,323.4476607,373.2873004,579.6830226,508.8629032,1143,126.2983425,2286,-521728,63488,-458240,58
1036,127,22,8,0.109200344,0.890799656,327.3894796,397.2707146,581.8407336,583.2992126,1163,20.83482623,2326,-530432,65024,-465408,58
1013,128,21,9,0.112182296,0.887817704,322.041311,371.3597109,581.9160908,484.609375,1141,169.5393759,2282,-518656,65536,-453120,58
1026,130,22,8,0.112456747,0.887543253,326.6569718,376.4923853,588.0233918,503.3384615,1156,131.8129989,2312,-525312,66560,-458752,58
1032,134,22,8,0.114922813,0.885077187,328.2582122,386.0366734,593.6908915,505.0149254,1166,135.8974359,2332,-528384,68608,-459776,58
1029,122,21,9,0.105994787,0.894005213,324.859693,378.6808561,586.0544218,491.1967213,1151,80.6022409,2302,-526848,62464,-464384,58
1029,125,22,8,0.108318891,0.891681109,326.0145872,381.8996806,584.5179786,519.728,1154,171.7261905,2308,-526848,64000,-462848,58
1025,126,21,9,0.109470026,0.890529974,325.6813744,375.8205716,583.6917073,513.4285714,1151,131.9954128,2302,-524800,64512,-460288,58
1028,125,21,9,0.108412836,0.891587164,326.5796499,377.2372736,582.6702335,530.368,1153,73.62707535,2306,-526336,64000,-462336,58
1083,126,22,8,0.104218362,0.895781638,342.5537158,393.0113211,613.3240997,533.452381,1209,144.2720764,2418,-554496,64512,-489984,58
1029,127,22,8,0.109861592,0.890138408,326.1605836,378.9766952,588.9747328,493.6299213,1156,33.73212722,2312,-526848,65024,-461824,58
1055,130,22,8,0.109704641,0.890295359,333.6228935,397.0189763,601.8312796,521.3307692,1185,159.4885599,2370,-540160,66560,-473600,58
1024,130,21,9,0.112651646,0.887348354,324.8259903,374.2792838,591.6162109,466.3076923,1154,104.2457091,2308,-524288,66560,-457728,58
1022,123,22,8,0.107423581,0.892576419,324.0167162,374.8049534,580.3796477,511.6829268,1145,141.5327565,2290,-523264,62976,-460288,58
1027,142,22,8,0.121471343,0.878528657,326.3888754,404.9196315,592.1927945,532.9788732,1169,21.41025641,2338,-525824,72704,-453120,58
1021,125,22,8,0.109075044,0.890924956,324.1785797,376.3111394,580.2115573,518.68,1146,121.7853348,2292,-522752,64000,-458752,58
1016,118,21,9,0.104056437,0.895943563,320.9846639,372.2544539,574.5944882,506.4152542,1134,138.4615385,2268,-520192,60416,-459776,58
747,90,21,9,0.107526882,0.892473118,236.1369995,234.1894055,437.0977242,268.7888889,837,21.35204082,1674,-382464,46080,-336384,58
1025,131,21,9,0.113321799,0.886678201,325.8893677,379.7862319,588.9063415,497.0763359,1156,150.3250975,2312,-524800,67072,-457728,58
1026,130,21,9,0.112456747,0.887543253,325.9358805,379.9529529,588.8109162,497.1230769,1156,182.0472441,2312,-525312,66560,-458752,58
1017,126,21,9,0.11023622,0.88976378,322.6832028,372.8536101,582.5565388,486.7936508,1143,101.6,2286,-520704,64512,-456192,58
1023,121,22,8,0.105769231,0.894230769,323.5596134,373.9466819,581.2893451,498.1900826,1144,98.70578085,2288,-523776,61952,-461824,58
1076,124,21,9,0.103333333,0.896666667,340.0704245,390.5319742,608.4061338,531.8951613,1200,107.5268817,2400,-550912,63488,-487424,58
1011,126,22,8,0.110817942,0.889182058,321.0121912,371.5516032,579.0039565,488.7301587,1137,86.52968037,2274,-517632,64512,-453120,58
1027,128,22,8,0.110822511,0.889177489,325.6433347,385.1875234,585.3583252,518.9609375,1155,155.6603774,2310,-525824,65536,-460288,58
690,88,21,9,0.11311054,0.88688946,219.8923351,204.9886764,408.4101449,241.2272727,778,21.2568306,1556,-353280,45056,-308224,58
1038,131,22,8,0.112061591,0.887938409,330.0503427,376.3787533,597.7061657,484.3206107,1169,56.6375969,2338,-531456,67072,-464384,58
1044,130,22,8,0.110732538,0.889267462,330.7470211,389.138364,597.5306513,506.9461538,1174,87.15664439,2348,-534528,66560,-467968,58
1038,135,20,10,0.115089514,0.884910486,330.1800932,380.4863867,601.0934489,478.637037,1173,81.12033195,2346,-531456,69120,-462336,58
1036,134,22,8,0.114529915,0.885470085,329.2295031,386.7838317,596.6611969,499.2089552,1170,142.3357664,2340,-530432,68608,-461824,58
1059,132,22,8,0.110831234,0.889168766,335.455448,388.473908,609.3153919,489.1742424,1191,93.19248826,2382,-542208,67584,-474624,58
1063,139,21,9,0.115640599,0.884359401,338.0430778,393.0157787,615.4101599,495.1223022,1202,114.8042025,2404,-544256,71168,-473088,58
1049,150,21,9,0.125104254,0.874895746,335.0693454,407.7171763,610.5452812,526.2533333,1199,21.19497967,2398,-537088,76800,-460288,58
1043,130,22,8,0.110826939,0.889173061,332.1108327,377.6138004,596.8849473,507.6923077,1173,120.8032956,2346,-534016,66560,-467456,58
1049,131,21,9,0.111016949,0.888983051,332.1467353,389.3484739,602.379409,495.3740458,1180,92.47648903,2360,-537088,67072,-470016,58
1029,134,22,8,0.115219261,0.884780739,327.5853455,381.276086,593.5063168,493.641791,1163,106.6972477,2326,-526848,68608,-458240,58
1045,143,21,9,0.12037037,0.87962963,333.6237836,386.5364728,609.8430622,482.3776224,1188,114.5612343,2376,-535040,73216,-461824,58
1043,137,22,8,0.116101695,0.883898305,331.9683339,382.1516595,605.3087248,477.7591241,1180,104.3324492,2360,-534016,70144,-463872,58
1042,129,21,9,0.110162254,0.889837746,330.5560775,381.6841317,597.0767754,496.5271318,1171,101.7376195,2342,-533504,66048,-467456,58
1041,131,21,9,0.111774744,0.888225256,329.8590235,386.1372428,598.5523535,490.7251908,1172,141.8886199,2344,-532992,67072,-465920,58
1065,136,21,9,0.113238968,0.886761032,338.4308866,395.362752,611.9201878,515.4852941,1201,114.5992366,2402,-545280,69632,-475648,58
1042,136,21,9,0.115449915,0.884550085,331.5848198,379.5346397,604.6353167,473.5367647,1178,94.77071601,2356,-533504,69632,-463872,58
1044,134,21,9,0.113752122,0.886247878,332.1272187,380.8076638,602.8275862,485.6641791,1178,52.23946785,2356,-534528,68608,-465920,58
1053,140,21,9,0.117351215,0.882648785,336.1404551,386.1624024,610.5137702,495.3571429,1193,111.0800745,2386,-539136,71680,-467456,58
1045,139,22,8,0.117398649,0.882601351,333.3033109,388.5709823,604.2976077,503.8057554,1184,149.8734177,2368,-535040,71168,-463872,58
1605,211,21,9,0.116189427,0.883810573,514.4244966,593.3359418,906.4492212,924.0995261,1816,107.3286052,3632,-821760,108032,-713728,58
1608,221,22,8,0.120831055,0.879168945,516.8304318,601.7313051,919.9925373,878.6742081,1829,130.0853485,3658,-823296,113152,-710144,58
1632,202,21,9,0.110141767,0.889858233,517.9502149,613.9741234,914.9552696,938.0594059,1834,74.4922827,3668,-835584,103424,-732160,58
1609,206,21,9,0.113498623,0.886501377,514.08531,594.3965974,912.0938471,876.0242718,1815,131.3314038,3630,-823808,105472,-718336,58
1597,197,22,8,0.109810479,0.890189521,507.9575694,592.1730837,898.5115842,889.2994924,1794,107.4895147,3588,-817664,100864,-716800,58
1619,222,20,10,0.120586638,0.879413362,519.2853369,611.6117473,926.1321804,883.5720721,1841,118.621134,3682,-828928,113664,-715264,58
1638,210,21,9,0.113636364,0.886363636,523.5681525,604.8891389,926.7704518,906.7904762,1848,127.6243094,3696,-838656,107520,-731136,58
1611,198,21,9,0.109452736,0.890547264,510.5835851,608.4707307,903.3743017,918.2272727,1809,88.63302303,3618,-824832,101376,-723456,58
1628,206,21,9,0.112322792,0.887677208,518.3408851,610.0132746,917.267199,919.3398058,1834,128.9732771,3668,-833536,105472,-728064,58
1615,210,22,8,0.115068493,0.884931507,515.9918614,601.547376,919.2718266,864.7666667,1825,96.611964,3650,-826880,107520,-719360,58
1609,221,21,9,0.120765027,0.879234973,516.1297761,608.1127193,920.695463,877.6742081,1830,125.3424658,3660,-823808,113152,-710656,58
1632,204,21,9,0.111111111,0.888888889,518.9249838,611.3392625,916.9613971,930.8088235,1836,91.70829171,3672,-835584,104448,-731136,58
1606,217,22,8,0.119034558,0.880965442,514.6585813,604.7527724,914.9775841,889.9631336,1823,128.0196629,3646,-822272,111104,-711168,58
1622,216,21,9,0.117519042,0.882480958,517.8774812,617.1172578,922.8884094,894.0555556,1838,111.9366626,3676,-830464,110592,-719872,58
1604,207,21,9,0.114301491,0.885698509,512.4299022,596.8731566,907.5498753,893.9903382,1811,128.713575,3622,-821248,105984,-715264,58
1603,218,22,8,0.119714443,0.880285557,515.615965,593.3441543,915.6319401,876.940367,1821,130.2575107,3642,-820736,111616,-709120,58
1600,206,21,9,0.11406423,0.88593577,511.8551017,589.8915822,903.263125,905.3398058,1806,129,3612,-819200,105472,-713728,58
1598,222,21,9,0.121978022,0.878021978,515.132742,593.5218088,913.6370463,887.9189189,1820,114.0350877,3640,-818176,113664,-704512,58
1604,219,21,9,0.120131651,0.879868349,514.4460807,604.4458073,917.1197007,874.5022831,1823,119.3844139,3646,-821248,112128,-709120,58
1613,213,22,8,0.116648412,0.883351588,515.409047,607.3741574,918.1680099,878.1502347,1826,115.6428119,3652,-825856,109056,-716800,58
1697,219,21,9,0.114300626,0.885699374,539.5835362,647.4209805,962.7501473,925.56621,1916,125.1469628,3832,-868864,112128,-756736,58
1699,208,22,8,0.109071841,0.890928159,539.1141234,635.2683989,957.3808122,926.3846154,1907,139.1970803,3814,-869888,106496,-763392,58
1696,211,22,8,0.110644992,0.889355008,538.6924464,637.2110714,956.4027123,934.6872038,1907,124.315515,3814,-868352,108032,-760320,58
1691,208,22,8,0.109531332,0.890468668,536.731795,633.711799,949.4145476,954.7596154,1899,123.7940026,3798,-865792,106496,-759296,58
1705,225,22,8,0.116580311,0.883419689,543.2808143,650.5225764,972.088563,915.5733333,1930,132.4639671,3860,-872960,115200,-757760,58
1695,206,21,9,0.108364019,0.891635981,534.6394999,653.4537933,949.7109145,961.6067961,1901,33.34502719,3802,-867840,105472,-762368,58
1720,197,22,8,0.102764737,0.897235263,543.7476461,631.3299929,959.5883721,953.8629442,1917,109.9197248,3834,-880640,100864,-779776,58
1705,196,21,9,0.10310363,0.89689637,539.1631019,626.0974016,951.9964809,942.3316327,1901,131.8307906,3802,-872960,100352,-772608,58
1701,205,21,9,0.107555089,0.892444911,539.1316277,633.4664772,958.1046443,915.2926829,1906,135.177305,3812,-870912,104960,-765952,58
1711,206,22,8,0.107459572,0.892540428,542.3374881,637.7278814,960.3132671,948.092233,1917,144.3524096,3834,-876032,105472,-770560,58
1696,211,21,9,0.110644992,0.889355008,538.7978175,636.8154929,954.3850236,950.9052133,1907,131.0652921,3814,-868352,108032,-760320,58
1696,206,21,9,0.108307045,0.891692955,537.6256779,635.391467,952.2629717,945.2184466,1902,143.9818319,3804,-868352,105472,-762880,58
1710,207,22,8,0.107981221,0.892018779,541.5396445,641.7584829,963.5380117,921.5120773,1917,112.8310771,3834,-875520,105984,-769536,58
1702,213,21,9,0.111227154,0.888772846,540.9570192,637.860193,963.7250294,912.2535211,1915,135.0493653,3830,-871424,109056,-762368,58
1691,212,22,8,0.111403048,0.888596952,537.1103624,638.5581895,953.0928445,943.2830189,1903,133.8255977,3806,-865792,108544,-757248,58
1684,212,21,9,0.111814346,0.888185654,533.5051276,646.0034867,952.1051069,919.8632075,1896,97.73195876,3792,-862208,108544,-753664,58
1705,202,22,8,0.105925537,0.894074463,538.7114665,641.425327,954.6920821,948.1584158,1907,145.3506098,3814,-872960,103424,-769536,58
1698,206,21,9,0.108193277,0.891806723,539.1281275,629.6152314,952.4840989,952.631068,1904,128.3018868,3808,-869376,105472,-763904,58
1712,217,22,8,0.11249352,0.88750648,544.8867428,642.0081808,970.2523364,923.562212,1929,127.3267327,3858,-876544,111104,-765440,58
1713,214,20,10,0.111053451,0.888946549,543.4537697,649.1787357,967.5195563,935.8271028,1927,110.4931193,3854,-877056,109568,-767488,58
7744,422,19,11,0.051677688,0.948322312,2330.298628,2721.93577,4119.978951,3414.085308,8166,266.6884389,16332,-3964928,216064,-3748864,59
2168,246,20,10,0.101905551,0.898094449,673.6496159,863.7532962,1222.67297,1073.780488,2414,57.25806452,4828,-1110016,125952,-984064,59
2216,249,19,11,0.101014199,0.898985801,687.5612597,891.2887956,1244.217058,1133.172691,2465,86.76522351,4930,-1134592,127488,-1007104,59
7764,424,20,10,0.0517830972,0.948216903,2339.583889,2663.057872,4134.634724,3359.580189,8188,288.9202541,16376,-3975168,217088,-3758080,59
2225,247,19,11,0.0999190939,0.900080906,688.5614188,906.7727691,1242.564045,1181.874494,2472,94.67636921,4944,-1139200,126464,-1012736,59
2199,250,20,10,0.102082483,0.897917517,682.8780218,889.2508208,1231.375171,1168.924,2449,87.77777778,4898,-1125888,128000,-997888,59
2286,279,19,11,0.10877193,0.89122807,724.2081021,838.3144886,1306.167979,1093.172043,2565,96.75594115,5130,-1170432,142848,-1027584,59
7882,463,20,10,0.0554823247,0.944517675,2377.019328,2616.086525,4244.406623,2957.390929,8345,249.0301403,16690,-4035584,237056,-3798528,59
2218,246,19,11,0.0998376623,0.900162338,684.8881833,912.0799321,1240.967989,1156.150407,2464,92.21556886,4928,-1135616,125952,-1009664,59
2223,244,19,11,0.0989055533,0.901094447,688.8066302,885.6835369,1249.039136,1096.983607,2467,81.63467902,4934,-1138176,124928,-1013248,59
3233,226,20,10,0.0653368025,0.934663197,984.2656724,992.1477692,1773.652954,1105.530973,3459,60.66292529,6918,-1655296,115712,-1539584,59
2192,252,19,11,0.103109656,0.896890344,678.1906039,902.6519922,1234.398723,1119,2444,88.55072464,4888,-1122304,129024,-993280,59
2254,291,19,11,0.114341847,0.885658153,722.0238015,806.4716334,1294.780834,1104.292096,2545,76.24325944,5090,-1154048,148992,-1005056,59
2205,239,20,10,0.0977905074,0.902209493,680.8217896,898.9949814,1230.130159,1152.104603,2444,94.32651486,4888,-1128960,122368,-1006592,59
2196,239,20,10,0.0981519507,0.901848049,679.1032723,885.8193445,1229.280055,1114.355649,2435,43.35826211,4870,-1124352,122368,-1001984,59
2290,278,19,11,0.108255452,0.891744548,724.034589,847.6930481,1307.30917,1096.611511,2568,86.08783104,5136,-1172480,142336,-1030144,59
7721,415,20,10,0.0510078663,0.948992134,2321.974146,2739.506215,4098.592281,3508.638554,8136,255.5276382,16272,-3953152,212480,-3740672,59
2225,243,20,10,0.0984602917,0.901539708,688.5999181,897.2161927,1244.089888,1146.691358,2468,95.51083591,4936,-1139200,124416,-1014784,59
2325,286,19,11,0.109536576,0.890463424,736.2444489,861.0804816,1328.762581,1120.954545,2611,90.12771833,5222,-1190400,146432,-1043968,59
7731,422,20,10,0.0517600883,0.948239912,2331.38501,2567.365615,4126.059371,3178.236967,8153,247.6609964,16306,-3958272,216064,-3742208,59
2610,379,24,6,0.12679826,0.87320174,842.8793227,974.5103945,1471.723372,1655.295515,2989,79.49468085,5978,-1336320,194048,-1142272,59
2656,373,24,6,0.123142951,0.876857049,854.0696093,982.2636827,1485.620105,1724.203753,3029,94.89348371,6058,-1359872,190976,-1168896,59
1015,151,23,7,0.129502573,0.870497427,335.4789426,343.9522787,582.6748768,589.0463576,1166,25.79075426,2332,-519680,77312,-442368,59
2665,367,24,6,0.121042216,0.878957784,856.1013578,973.5133588,1485.069418,1744.735695,3032,88.81077914,6064,-1364480,187904,-1176576,59
3082,381,24,6,0.110020214,0.889979786,972.0100864,1170.759101,1701.135951,1981.666667,3463,117.4296372,6926,-1577984,195072,-1382912,59
2665,364,24,6,0.120171674,0.879828326,849.5829945,1016.585538,1488.027017,1712.480769,3029,101.3721553,6058,-1364480,186368,-1178112,59
2602,371,24,6,0.124789775,0.875210225,835.6134103,986.0551837,1462.787471,1656.814016,2973,53.42318059,5946,-1332224,189952,-1142272,59
2044,170,24,6,0.0767841012,0.923215899,633.3358812,642.9008043,1130.627691,829.4235294,2214,70.96153846,4428,-1046528,87040,-959488,59
2862,307,24,6,0.0968759861,0.903124014,904.1691411,1006.716648,1591.339623,1525.899023,3169,55.39241391,6338,-1465344,157184,-1308160,59
3146,404,24,6,0.113802817,0.886197183,994.2782145,1205.994962,1742.256516,2034.371287,3550,121.2845917,7100,-1610752,206848,-1403904,59
2729,382,24,6,0.1227901,0.8772099,876.3156142,1011.941444,1524.360572,1782.031414,3111,91.71580189,6222,-1397248,195584,-1201664,59
2662,382,24,6,0.125492773,0.874507227,856.986583,984.8272702,1488.224267,1761.353403,3044,103.221431,6088,-1362944,195584,-1167360,59
3146,388,24,6,0.109790606,0.890209394,996.2760941,1167.028236,1736.801017,2016.414948,3534,125.0530786,7068,-1610752,198656,-1412096,59
2719,397,24,6,0.127406932,0.872593068,872.8315652,1025.748299,1519.725634,1824.060453,3116,54.70505618,6232,-1392128,203264,-1188864,59
3073,393,24,6,0.11338719,0.88661281,973.2543734,1165.128928,1702.842499,1973.221374,3466,103.0014859,6932,-1573376,201216,-1372160,59
2576,372,24,6,0.126187246,0.873812754,830.8594268,947.4763021,1441.092003,1705.841398,2948,91.63817221,5896,-1318912,190464,-1128448,59
2619,368,24,6,0.123200536,0.876799464,840.1839068,972.0847795,1460.148912,1734.913043,2987,92.70639354,5974,-1340928,188416,-1152512,59
2941,384,24,6,0.115488722,0.884511278,939.2084037,1063.564581,1626.103706,1945.583333,3325,104.6914358,6650,-1505792,196608,-1309184,59
2613,379,24,6,0.126671123,0.873328877,836.3954906,1003.959397,1463.770762,1722.150396,2992,102.9593944,5984,-1337856,194048,-1143808,59
3099,384,24,6,0.110249785,0.889750215,975.331301,1192.853335,1711.166183,1990.838542,3483,94.67246534,6966,-1586688,196608,-1390080,59
3480,390,24,6,0.100775194,0.899224806,1097.756637,1252.642188,1908.88908,2172.951282,3870,71.82628062,7740,-1781760,199680,-1582080,59
3501,405,24,6,0.103686636,0.896313364,1103.601936,1282.307329,1920.777207,2236.37037,3906,118.2919443,7812,-1792512,207360,-1585152,59
3336,407,24,6,0.108736308,0.891263692,1053.374878,1214.827211,1825.026978,2257.017199,3743,65.39133473,7486,-1708032,208384,-1499648,59
3432,390,24,6,0.102040816,0.897959184,1077.332336,1291.936048,1888.196387,2116.571795,3822,114.7058824,7644,-1757184,199680,-1557504,59
3471,380,24,6,0.0986756687,0.901324331,1092.788056,1236.694187,1895.341688,2206.039474,3851,122.2539683,7702,-1777152,194560,-1582592,59
3487,420,24,6,0.10749936,0.89250064,1106.229655,1284.834813,1936.99197,2095.207143,3907,86.22820569,7814,-1785344,215040,-1570304,59
3811,380,24,6,0.0906704844,0.909329516,1190.4067,1314.688817,2053.155865,2525.681579,4191,133.1744519,8382,-1951232,194560,-1756672,59
3395,390,24,6,0.103038309,0.896961691,1067.930955,1259.730304,1863.893962,2146.371795,3785,104.1552009,7570,-1738240,199680,-1538560,59
3716,417,24,6,0.100895233,0.899104767,1177.720146,1248.461011,2020.664155,2479.911271,4133,126.7402637,8266,-1902592,213504,-1689088,59
3533,386,24,6,0.0984945139,0.901505486,1112.195916,1257.802186,1928.797622,2245.590674,3919,112.2279496,7838,-1808896,197632,-1611264,59
3878,404,24,6,0.0943484353,0.905651565,1215.866156,1334.01026,2094.496906,2592.683168,4282,135.8502538,8564,-1985536,206848,-1778688,59
3532,390,24,6,0.0994390617,0.900560938,1112.984881,1256.290465,1929.381937,2252.374359,3922,124.3106181,7844,-1808384,199680,-1608704,59
3469,387,24,6,0.100363071,0.899636929,1091.770447,1255.167198,1897.505621,2206.328165,3856,128.0212483,7712,-1776128,198144,-1577984,59
3474,391,24,6,0.101164295,0.898835705,1097.380935,1247.977777,1909.574842,2141.130435,3865,101.5768725,7730,-1778688,200192,-1578496,59
3469,402,24,6,0.103849135,0.896150865,1092.045605,1271.670973,1898.610262,2258.649254,3871,118.4154176,7742,-1776128,205824,-1570304,59
3796,413,24,6,0.0981230696,0.90187693,1193.755541,1327.042541,2060.396207,2514.966102,4209,73.28922166,8418,-1943552,211456,-1732096,59
3551,397,24,6,0.100557244,0.899442756,1123.029085,1217.331311,1932.865953,2346.899244,3948,117.2905526,7896,-1818112,203264,-1614848,59
3521,401,24,6,0.102243753,0.897756247,1112.291303,1266.87693,1933.175234,2210.206983,3922,111.8972896,7844,-1802752,205312,-1597440,59
3805,385,24,6,0.0918854415,0.908114558,1189.259242,1317.035539,2051.372405,2531.618182,4190,127.085229,8380,-1948160,197120,-1751040,59
3780,389,24,6,0.0933077477,0.906692252,1187.017366,1280.591476,2042.170899,2501.179949,4169,122.7982327,8338,-1935360,199168,-1736192,59
3936,416,24,6,0.0955882353,0.904411765,1235.976873,1398.226237,2144.26372,2481.504808,4352,127.3259216,8704,-2015232,212992,-1802240,59
3921,411,24,6,0.0948753463,0.905124654,1226.670021,1437.53882,2141.775822,2402.372263,4332,129.9729973,8664,-2007552,210432,-1797120,59
3933,425,24,6,0.097521799,0.902478201,1236.358671,1424.344426,2155.524282,2401.374118,4358,145.5577822,8716,-2013696,217600,-1796096,59
3973,431,24,6,0.0978655767,0.902134423,1244.008441,1478.055945,2176.230053,2444.658933,4404,149.6940857,8808,-2034176,220672,-1813504,59
4341,441,24,6,0.0922208281,0.907779172,1359.363042,1513.980454,2350.202258,2798.015873,4782,151.0423247,9564,-2222592,225792,-1996800,59
4003,434,24,6,0.0978138382,0.902186162,1257.990341,1435.564359,2184.0662,2541.211982,4437,154.707113,8874,-2049536,222208,-1827328,59
3904,403,24,6,0.0935686092,0.906431391,1224.184902,1386.909781,2126.233094,2422.987593,4307,145.5559311,8614,-1998848,206336,-1792512,59
4292,434,24,6,0.0918324164,0.908167584,1347.404196,1480.44221,2329.832246,2696.453917,4726,105.7743957,9452,-2197504,222208,-1975296,59
2074,146,24,6,0.0657657658,0.934234234,637.8201566,641.4155442,1126.381389,884.8972603,2220,72.45430809,4440,-1061888,74752,-987136,59
3948,427,24,6,0.0976,0.9024,1239.572311,1434.603756,2159.312057,2453.245902,4375,156.0827685,8750,-2021376,218624,-1802752,59
3943,443,24,6,0.101003192,0.898996808,1245.738989,1398.997231,2159.518641,2495.957111,4386,133.7602928,8772,-2018816,226816,-1792000,59
3902,442,24,6,0.10174954,0.89825046,1231.765452,1404.022973,2140.422091,2455.68552,4344,106.4444989,8688,-1997824,226304,-1771520,59
3969,432,24,6,0.0981595092,0.901840491,1245.321623,1460.89119,2175.494583,2435.331019,4401,142.6580227,8802,-2032128,221184,-1810944,59
101,18,24,6,0.151260504,0.848739496,35.12760499,26.26602979,62.24752475,47.38888889,119,18.53582555,238,-51712,9216,-42496,59
3946,424,24,6,0.0970251716,0.902974828,1239.351322,1431.429681,2160.876584,2414.660377,4370,98.13608803,8740,-2020352,217088,-1803264,59
4362,431,24,6,0.0899228041,0.910077196,1363.259134,1523.170343,2359.249885,2779.055684,4793,135.3954802,9586,-2233344,220672,-2012672,59
4293,434,24,6,0.0918129892,0.908187011,1342.179294,1519.110555,2326.220592,2737.702765,4727,143.8964992,9454,-2198016,222208,-1975808,59
4220,432,24,6,0.0928632846,0.907136715,1323.585273,1455.520972,2284.177014,2739.93287,4652,153.6327609,9304,-2160640,221184,-1939456,59
1043,102,24,6,0.0890829694,0.910917031,326.8961847,341.9845985,585.0786194,449.4901961,1145,20.25831564,2290,-534016,52224,-481792,59
3963,430,24,6,0.0978829957,0.902117004,1248.475774,1414.876258,2171.2054,2434.730233,4393,130.3174132,8786,-2029056,220160,-1808896,59
3041,382,24,6,0.111598013,0.888401987,961.7844524,1155.397745,1685.392963,1923.811518,3423,106.6687442,6846,-1556992,195584,-1361408,59
2997,386,24,6,0.114099911,0.885900089,950.1577866,1127.548098,1658.198532,1954.443005,3383,114.2905405,6766,-1534464,197632,-1336832,59
3077,390,24,6,0.112489184,0.887510816,973.7465309,1178.334092,1711.58531,1910.846154,3467,102.1207658,6934,-1575424,199680,-1375744,59
3123,391,24,6,0.111269209,0.888730791,989.4370333,1156.351598,1721.802754,2042.621483,3514,108.2563155,7028,-1598976,200192,-1398784,59
2986,378,24,6,0.112366231,0.887633769,944.1140166,1137.551534,1653.940388,1908.10582,3364,109.826967,6728,-1528832,193536,-1335296,59
3292,383,24,6,0.104217687,0.895782313,1037.246529,1200.569879,1801.425273,2152.370757,3675,111.2624886,7350,-1685504,196096,-1489408,59
3095,389,24,6,0.111653272,0.888346728,983.230627,1133.359929,1708.311793,2014.511568,3484,108.5358255,6968,-1584640,199168,-1385472,59
3021,394,24,6,0.115373353,0.884626647,956.6496789,1157.402955,1676.292618,1951.116751,3415,113.3421839,6830,-1546752,201728,-1345024,59
2912,372,24,6,0.113276492,0.886723508,924.1019343,1088.850992,1612.191621,1879.752688,3284,112.4657534,6568,-1490944,190464,-1300480,59
3020,390,24,6,0.114369501,0.885630499,958.3750233,1141.348832,1676.337748,1931.320513,3410,99.67845659,6820,-1546240,199680,-1346560,59
3327,391,24,6,0.105164067,0.894835933,1049.350549,1209.631004,1820.795311,2188.836317,3718,115.6094527,7436,-1703424,200192,-1503232,59
3005,402,24,6,0.117992369,0.882007631,954.5615076,1142.831178,1668.305491,1970.820896,3407,110.8688578,6814,-1538560,205824,-1332736,59
2996,388,24,6,0.11465721,0.88534279,951.6581702,1120.40022,1659.232977,1949.376289,3384,112.1644017,6768,-1533952,198656,-1335296,59
2990,385,24,6,0.114074074,0.885925926,946.6568718,1136.5336,1656.030435,1936.283117,3375,114.1359486,6750,-1530880,197120,-1333760,59
3002,393,24,6,0.115758468,0.884241532,959.5393635,1106.034776,1673.042305,1888.643766,3395,87.79415568,6790,-1537024,201216,-1335808,59
3006,405,24,6,0.118733509,0.881266491,949.3194706,1180.5327,1669.480373,1977.05679,3411,61.26077586,6822,-1539072,207360,-1331712,59
3143,388,24,6,0.109883886,0.890116114,997.5231879,1126.118056,1724.522431,2101.989691,3531,91.90525768,7062,-1609216,198656,-1410560,59
3194,381,24,6,0.106573427,0.893426573,1010.998097,1148.454727,1751.284909,2095.790026,3575,102.1428571,7150,-1635328,195072,-1440256,59
3225,388,24,6,0.107389981,0.892610019,1023.245499,1153.85409,1771.889302,2098.835052,3613,105.5198598,7226,-1651200,198656,-1452544,59
3057,383,24,6,0.111337209,0.888662791,966.3945571,1157.870027,1691.03631,1955.671018,3440,78.95340831,6880,-1565184,196096,-1369088,59
3413,382,24,6,0.100658762,0.899341238,1072.059909,1259.660037,1870.361559,2144.937173,3795,112.611276,7590,-1747456,195584,-1551872,59
3346,372,24,6,0.100053792,0.899946208,1049.266867,1247.052718,1834.644351,2083.067204,3718,114.5056976,7436,-1713152,190464,-1522688,59
3658,374,24,6,0.0927579365,0.907242063,1145.85151,1261.867612,1976.224166,2410.427807,4032,130.9516077,8064,-1872896,191488,-1681408,59
646,51,24,6,0.0731707317,0.926829268,200.1295244,199.2658729,355.0092879,272.8823529,697,15.71944069,1394,-330752,26112,-304640,59
3433,403,24,6,0.105057351,0.894942649,1076.618261,1276.534669,1872.901835,2306.933002,3836,67.09812839,7672,-1757696,206336,-1551360,59
3407,393,24,6,0.103421053,0.896578947,1076.455008,1242.538644,1877.103317,2103.330789,3800,97.4858902,7600,-1744384,201216,-1543168,59
3423,373,24,6,0.0982613277,0.901738672,1074.832235,1255.086231,1876.930762,2096.439678,3796,107.4136955,7592,-1752576,190976,-1561600,59
3390,383,24,6,0.101510734,0.898489266,1069.911496,1228.030243,1863.957227,2090.955614,3773,73.83561644,7546,-1735680,196096,-1539584,59
3371,375,24,6,0.100106781,0.899893219,1055.565722,1266.002621,1847.130525,2110.544,3746,137.4174615,7492,-1725952,192000,-1533952,59
3349,404,24,6,0.107647216,0.892352784,1064.260899,1210.946491,1852.018812,2084.084158,3753,102.2337238,7506,-1714688,206848,-1507840,59
3361,400,24,6,0.106354693,0.893645307,1063.046717,1239.752002,1855.615888,2094.29,3761,96.85809941,7522,-1720832,204800,-1516032,59
3349,377,24,6,0.101180891,0.898819109,1051.335702,1241.632378,1834.50851,2121.039788,3726,102.9566179,7452,-1714688,193024,-1521664,59
3693,379,24,6,0.0930746562,0.906925344,1155.046086,1302.615469,1998.760899,2404.23219,4072,123.281865,8144,-1890816,194048,-1696768,59
3384,389,24,6,0.103100981,0.896899019,1064.179753,1248.701737,1853.411643,2179.192802,3773,113.8846966,7546,-1732608,199168,-1533440,59
3452,398,24,6,0.103376623,0.896623377,1088.632279,1267.558685,1898.111819,2163.047739,3850,100.6535948,7700,-1767424,203776,-1563648,59
3407,392,24,6,0.103185049,0.896814951,1076.13028,1242.125387,1876.16877,2107.125,3799,103.9113786,7598,-1744384,200704,-1543680,59
3644,393,24,6,0.097349517,0.902650483,1147.852852,1255.218284,1978.205269,2397.259542,4037,109.1081081,8074,-1865728,201216,-1664512,59
1804,167,24,6,0.0847285642,0.915271436,564.8167025,605.6860695,993.8492239,901.2095808,1971,34.31406685,3942,-923648,85504,-838144,59
3371,407,24,6,0.107728957,0.892271043,1060.530884,1259.725496,1847.051617,2241.081081,3778,67.62126365,7556,-1725952,208384,-1517568,59
3767,381,24,6,0.0918514947,0.908148505,1179.916978,1307.821146,2039.093443,2424.569554,4148,119.9537305,8296,-1928704,195072,-1733632,59
2450,366,24,6,0.129971591,0.870028409,791.844299,907.1567362,1373.202041,1644.784153,2816,96.47139431,5632,-1254400,187392,-1067008,59
2469,370,24,6,0.13032758,0.86967242,796.5089804,935.4902674,1390.36209,1617.772973,2839,90.99358974,5678,-1264128,189440,-1074688,59
2465,369,24,6,0.130204658,0.869795342,797.2197021,907.7401207,1380.38499,1665.436314,2834,90.11128776,5668,-1262080,188928,-1073152,59
2455,343,24,6,0.122587563,0.877412437,786.262037,903.7615965,1362.404481,1665.008746,2798,78.11278615,5596,-1256960,175616,-1081344,59
2506,375,24,6,0.130163138,0.869836862,811.9600846,908.3685569,1400.775339,1709.808,2881,92.22151088,5762,-1283072,192000,-1091072,59
2453,360,24,6,0.127977248,0.872022752,792.6869884,895.4468175,1370.93885,1652.716667,2813,89.98720409,5626,-1255936,184320,-1071616,59
2480,357,24,6,0.125837152,0.874162848,796.0782377,941.046825,1391.420161,1610.591036,2837,83.53945819,5674,-1269760,182784,-1086976,59
3195,393,24,6,0.109531773,0.890468227,1011.070028,1186.925037,1762.717371,2052.885496,3588,100.729927,7176,-1635840,201216,-1434624,59
2933,362,24,6,0.109863429,0.890136571,925.0581411,1121.939468,1623.80566,1844.027624,3295,93.95494725,6590,-1501696,185344,-1316352,59
2456,366,24,6,0.129695252,0.870304748,793.2817413,914.9384685,1378.311075,1634.210383,2822,86.48482991,5644,-1257472,187392,-1070080,59
2442,346,24,6,0.1241033,0.8758967,782.7440244,909.5776239,1359.961916,1638.263006,2788,94.63679566,5576,-1250304,177152,-1073152,59
2460,371,24,6,0.131049099,0.868950901,795.7981277,905.2782548,1376.818293,1675.803235,2831,94.58737053,5662,-1259520,189952,-1069568,59
2495,363,24,6,0.127011896,0.872988104,801.3159773,945.9780036,1398.822445,1640.355372,2858,93.12479635,5716,-1277440,185856,-1091584,59
2511,377,24,6,0.130540166,0.869459834,810.5467737,923.9195826,1401.37037,1731.763926,2888,89.21841211,5776,-1285632,193024,-1092608,59
2402,376,24,6,0.135349172,0.864650828,780.2658401,898.6011179,1355.459617,1606.960106,2778,97.43949491,5556,-1229824,192512,-1037312,59
2489,361,24,6,0.126666667,0.873333333,797.369224,947.1664244,1391.488148,1660.00277,2850,99.19944309,5700,-1274368,184832,-1089536,59
2664,367,24,6,0.121082151,0.878917849,858.5660611,933.7018073,1475.106231,1812.841962,3031,90.02079002,6062,-1363968,187904,-1176064,59
2421,348,24,6,0.12567714,0.87432286,775.8220342,912.6827368,1351.080545,1620.974138,2769,87.35015773,5538,-1239552,178176,-1061376,59
2499,365,24,6,0.127444134,0.872555866,804.2832614,933.6756451,1398.295318,1666.684932,2864,87.96068796,5728,-1279488,186880,-1092608,59
1739,192,24,6,0.099430347,0.900569653,549.6279018,622.931477,969.2018401,937,1931,24.18587174,3862,-890368,98304,-792064,59
3002,385,24,6,0.113669914,0.886330086,952.2976077,1123.346025,1660.495336,1955.249351,3387,118.3024799,6774,-1537024,197120,-1339904,59
2478,378,24,6,0.132352941,0.867647059,800.4786444,926.477527,1389.127119,1686.611111,2856,87.52681581,5712,-1268736,193536,-1075200,59
2981,389,24,6,0.115430267,0.884569733,946.9826202,1121.881973,1653.464609,1930.994859,3370,100.3872505,6740,-1526272,199168,-1327104,59
2573,373,24,6,0.126612356,0.873387644,828.6455836,949.098326,1436.433735,1729.187668,2946,93.25735992,5892,-1317376,190976,-1126400,59
2983,397,24,6,0.117455621,0.882544379,949.6486287,1125.488562,1659.240697,1925.377834,3380,108.96196,6760,-1527296,203264,-1324032,59
3056,393,24,6,0.113946071,0.886053929,970.295787,1147.413176,1694.811191,1959.750636,3449,110.7578677,6898,-1564672,201216,-1363456,59
2970,383,24,6,0.114226066,0.885773934,942.4632924,1120.516559,1647.629293,1904.75718,3353,106.4782471,6706,-1520640,196096,-1324544,59
3189,389,24,6,0.108719955,0.891280045,1008.575691,1160.6329,1748.538727,2125.298201,3578,110.2619414,7156,-1632768,199168,-1433600,59
2929,375,24,6,0.113498789,0.886501211,929.4493911,1100.711929,1623.958689,1875.426667,3304,102.9925187,6608,-1499648,192000,-1307648,59
3002,396,24,6,0.116539141,0.883460859,949.746946,1159.916355,1665.997002,1953.479798,3398,116.9304886,6796,-1537024,202752,-1334272,59
2510,360,24,6,0.12543554,0.87456446,807.7634933,916.5230361,1396.87251,1704.819444,2870,94.53227931,5740,-1285120,184320,-1100800,59
2414,382,24,6,0.136623748,0.863376252,785.5375096,898.28144,1361.906794,1629.746073,2796,91.13428944,5592,-1235968,195584,-1040384,59
2478,371,24,6,0.13022113,0.86977887,801.1722612,931.3380142,1397.215093,1610.58221,2849,51.25022486,5698,-1268736,189952,-1078784,59
1289,109,24,6,0.0779685265,0.922031474,402.8645377,392.9614754,709.4957331,581.293578,1398,161.8055556,2796,-659968,55808,-604160,59
2493,367,24,6,0.128321678,0.871678322,803.1711501,929.2004473,1395.057762,1671.256131,2860,96.03760913,5720,-1276416,187904,-1088512,59
2717,374,24,6,0.120996441,0.879003559,871.9267955,978.925102,1505.405226,1840.909091,3091,93.01835691,6182,-1391104,191488,-1199616,59
2993,386,24,6,0.114234981,0.885765019,948.3432265,1137.363762,1659.784831,1924.284974,3379,101.3193403,6758,-1532416,197632,-1334784,59
2476,368,24,6,0.129395218,0.870604782,798.8490781,930.9447966,1391.896607,1628.407609,2844,82.41089539,5688,-1267712,188416,-1079296,59
1772,197,24,6,0.100050787,0.899949213,560.2547681,630.8056626,994.3555305,900.8477157,1969,25.33127493,3938,-907264,100864,-806400,59
1768,195,24,6,0.0993377483,0.900662252,556.871991,643.6448546,990.5277149,904.6820513,1963,25.36831223,3926,-905216,99840,-805376,59
2315,175,24,6,0.0702811245,0.929718876,716.6749527,668.3621908,1269.711879,925.2114286,2490,48.5380117,4980,-1185280,89600,-1095680,59
3958,407,24,6,0.0932416953,0.906758305,1224.599667,1527.648717,2150.369378,2500.326781,4365,76.65964173,8730,-2026496,208384,-1818112,59
4192,394,24,6,0.0859136502,0.91408635,1301.407224,1529.318531,2275.290553,2487.241117,4586,146.752,9172,-2146304,201728,-1944576,59
3850,406,24,6,0.0953947368,0.904605263,1201.545325,1457.450909,2119.096364,2217.672414,4256,121.8088151,8512,-1971200,207872,-1763328,59
2848,200,25,5,0.0656167979,0.934383202,872.9782151,927.0171144,1544.539326,1239.14,3048,77.06700379,6096,-1458176,102400,-1355776,59
3916,376,25,5,0.0876048462,0.912395154,1210.423293,1488.455096,2126.312819,2356.74734,4292,131.858679,8584,-2004992,192512,-1812480,59
3964,360,24,6,0.0832562442,0.916743756,1223.727075,1475.17722,2143.26892,2374.255556,4324,135.8040201,8648,-2029568,184320,-1845248,59
3983,395,25,5,0.0902238465,0.909776153,1236.767303,1497.505417,2171.344715,2372.56962,4378,119.1292517,8756,-2039296,202240,-1837056,59
3800,342,24,6,0.0825688073,0.917431193,1179.51576,1362.515384,2072.563947,2059.678363,4142,129.316266,8284,-1945600,175104,-1770496,59
3961,380,24,6,0.0875374338,0.912462566,1225.169066,1500.357818,2152.258268,2366.357895,4341,142.0949264,8682,-2028032,194560,-1833472,59
3982,389,25,5,0.0889956532,0.911004347,1230.705098,1512.5084,2156.840532,2484.491003,4371,114.0360031,8742,-2038784,199168,-1839616,59
44,6,24,6,0.12,0.88,14.00728485,7.593857167,27.47727273,11,50,3.180661578,100,-22528,3072,-19456,59
3907,418,24,6,0.0966473988,0.903352601,1220.266566,1478.297754,2146.794727,2314.4689,4325,99.53970081,8650,-2000384,214016,-1786368,59
4101,369,24,6,0.0825503356,0.917449664,1271.056382,1465.576092,2213.159961,2483.783198,4470,135.8662614,8940,-2099712,188928,-1910784,59
3986,392,24,6,0.0895386021,0.910461398,1237.270741,1499.356325,2174.852735,2338.438776,4378,139.1608392,8756,-2040832,200704,-1840128,59
3937,382,24,6,0.0884463996,0.9115536,1221.624503,1469.487136,2142.607823,2339.248691,4319,152.9390935,8638,-2015744,195584,-1820160,59
3987,394,24,6,0.0899338051,0.910066195,1237.952105,1497.866163,2173.912466,2363.913706,4381,144.4920844,8762,-2041344,201728,-1839616,59
4123,384,24,6,0.0852007988,0.914799201,1276.033607,1518.357171,2228.836284,2524.182292,4507,152.2120905,9014,-2110976,196608,-1914368,59
4155,394,24,6,0.0866124423,0.913387558,1290.022762,1520.967265,2255.369194,2482.020305,4549,135.02523,9098,-2127360,201728,-1925632,59
4172,395,25,5,0.0864900372,0.913509963,1290.763306,1534.938717,2249.76534,2645.587342,4567,80.73183666,9134,-2136064,202240,-1933824,59
3193,389,24,6,0.108598548,0.891401452,1005.351762,1221.878731,1764.188851,2015.676093,3582,124.0304709,7164,-1634816,199168,-1435648,59
3252,385,24,6,0.105856475,0.894143525,1020.191621,1257.108971,1796.150369,2012.005195,3637,113.2316314,7274,-1665024,197120,-1467904,59
3135,406,24,6,0.114656877,0.885343123,993.7874628,1195.920874,1741.924402,1995.512315,3541,104.5776728,7082,-1605120,207872,-1397248,59
3198,386,24,6,0.107700893,0.892299107,1008.000195,1216.370223,1769.354597,1984.259067,3584,91.17272959,7168,-1637376,197632,-1439744,59
3365,383,24,6,0.102187834,0.897812166,1059.655562,1225.196053,1842.309361,2157.32376,3748,71.80076628,7496,-1722880,196096,-1526784,59
3131,402,24,6,0.113784319,0.886215681,988.9719432,1209.334206,1737.045034,2000.30597,3533,108.6074393,7066,-1603072,205824,-1397248,59
3159,392,24,6,0.110391439,0.889608561,998.1168623,1188.092591,1743.116176,2041,3551,114.5483871,7102,-1617408,200704,-1416704,59
3151,384,24,6,0.108628006,0.891371994,993.3395178,1191.570357,1737.606791,2017.398438,3535,112.79515,7070,-1613312,196608,-1416704,59
3213,391,24,6,0.108490566,0.891509434,1012.711855,1222.107253,1775.373794,2025.40665,3604,114.2313788,7208,-1645056,200192,-1444864,59
3181,399,24,6,0.111452514,0.888547486,1003.550595,1211.218536,1755.693807,2067.989975,3580,113.1121643,7160,-1628672,204288,-1424384,59
3201,390,24,6,0.108604845,0.891395155,1007.545489,1224.357682,1766.996251,2034.053846,3591,123.1481481,7182,-1638912,199680,-1439232,59
3119,384,24,6,0.109620325,0.890379675,985.3769688,1188.578624,1732.178262,1913,3503,104.9116502,7006,-1596928,196608,-1400320,59
3103,404,24,6,0.115198175,0.884801825,982.8239155,1189.344014,1723.170158,1990.794554,3507,109.6280088,7014,-1588736,206848,-1381888,59
3206,396,24,6,0.109938923,0.890061077,1013.972918,1200.272658,1770.644417,2051.305556,3602,113.1281407,7204,-1641472,202752,-1438720,59
3418,379,24,6,0.0998156439,0.900184356,1073.552617,1214.424924,1855.907548,2287.627968,3797,113.9555822,7594,-1750016,194048,-1555968,59
3186,390,24,6,0.109060403,0.890939597,1004.210116,1218.70075,1763.244507,1994.817949,3576,112.1354657,7152,-1631232,199680,-1431552,59
3156,405,24,6,0.113732098,0.886267902,999.9443815,1193.648492,1747.949303,2038.550617,3561,104.2752562,7122,-1615872,207360,-1408512,59
3239,392,24,6,0.10795924,0.89204076,1021.316707,1236.675258,1796.649274,1975.890306,3631,105.9836544,7262,-1658368,200704,-1457664,59
3390,385,24,6,0.101986755,0.898013245,1067.74171,1231.424122,1855.854572,2171.046753,3775,117.0542636,7550,-1735680,197120,-1538560,59
2015,210,24,6,0.0943820225,0.905617978,633.2092341,713.4572784,1125.072457,997.1619048,2225,26.14263894,4450,-1031680,107520,-924160,59
8514,391,21,9,0.0439079169,0.956092083,2561.350846,2765.412151,4453.548273,4441.061381,8905,359.9434115,17810,-4359168,200192,-4158976,60
8314,375,21,9,0.0431580159,0.956841984,2493.90537,2614.19155,4390.291075,3340.866667,8689,211.1543135,17378,-4256768,192000,-4064768,60
9119,459,21,9,0.047922322,0.952077678,2730.752499,3287.968559,4752.558175,5523.427015,9578,407.2278912,19156,-4668928,235008,-4433920,60
8254,433,21,9,0.0498445954,0.950155405,2494.465156,2741.857891,4353.547129,4162.009238,8687,415.248566,17374,-4226048,221696,-4004352,60
9098,468,21,9,0.0489232699,0.95107673,2742.614022,3104.565049,4780.107496,4849.450855,9566,236.7821782,19132,-4658176,239616,-4418560,60
9113,475,21,9,0.049541093,0.950458907,2745.291074,3168.147291,4790.482607,4871.574737,9588,439.8165138,19176,-4665856,243200,-4422656,60
8897,434,21,9,0.0465116279,0.953488372,2660.752643,3272.316284,4647.180847,5051.792627,9331,448.6057692,18662,-4555264,222208,-4333056,60
8767,423,21,9,0.0460282916,0.953971708,2631.463107,3050.552296,4581.951751,4876.297872,9190,843.1192661,18380,-4488704,216576,-4272128,60
8671,462,21,9,0.0505857878,0.949414212,2618.407266,2954.846531,4568.874294,4531.822511,9133,350.7296467,18266,-4439552,236544,-4203008,60
9153,502,21,9,0.0519937856,0.948006214,2748.597725,3366.751901,4797.542445,5383.334661,9655,208.1267515,19310,-4686336,257024,-4429312,60
9087,470,21,9,0.0491786125,0.950821387,2727.818318,3258.482885,4751.961593,5301.761702,9557,300.8183821,19114,-4652544,240640,-4411904,60
9117,466,21,9,0.0486277784,0.951372222,2746.584521,3119.198021,4780.008665,5026.603004,9583,407.4404762,19166,-4667904,238592,-4429312,60
8795,439,21,9,0.0475416937,0.952458306,2657.339777,2820.082451,4626.790108,4431.38041,9234,714.1531323,18468,-4503040,224768,-4278272,60
8643,463,21,9,0.0508455963,0.949154404,2611.069579,2938.018104,4553.010876,4562.63067,9106,349.022614,18212,-4425216,237056,-4188160,60
9464,496,21,9,0.0497991968,0.950200803,2866.026861,2988.781712,5010.260038,4412.659274,9960,636.0153257,19920,-4845568,253952,-4591616,60
8694,436,21,9,0.047754655,0.952245345,2619.834661,2884.927438,4591.216701,4052.699541,9130,420.1564657,18260,-4451328,223232,-4228096,60
8762,466,21,9,0.0504984829,0.949501517,2651.024501,2856.887882,4638.842844,4156.791845,9228,549.9404052,18456,-4486144,238592,-4247552,60
9135,509,21,9,0.0527789299,0.94722107,2757.004295,3228.582818,4817.16486,4918.249509,9644,171.0535651,19288,-4677120,260608,-4416512,60
9022,405,21,9,0.0429617057,0.957038294,2694.034345,3260.734241,4725.401463,4460.014815,9427,141.3979301,18854,-4619264,207360,-4411904,60
8057,389,21,9,0.0460573052,0.953942695,2422.138727,2711.433522,4244.82599,3781.794344,8446,122.9403202,16892,-4125184,199168,-3926016,60
1842,264,23,7,0.125356125,0.874643875,601.0998633,624.5639989,1027.610206,1234.140152,2106,181.865285,4212,-943104,135168,-807936,60
1825,277,23,7,0.131779258,0.868220742,597.8572431,633.0893651,1023.809315,1233.938628,2102,114.612868,4204,-934400,141824,-792576,60
1866,274,21,9,0.128037383,0.871962617,612.2333628,617.3949051,1040.8403,1272.489051,2140,83.65910868,4280,-955392,140288,-815104,60
1783,282,23,7,0.136561743,0.863438257,592.3075347,592.7356494,1006.457095,1200.822695,2065,120.6896552,4130,-912896,144384,-768512,60
1828,261,23,7,0.124940163,0.875059837,598.928677,598.999194,1018.458425,1230.89272,2089,202.815534,4178,-935936,133632,-802304,60
1777,257,23,7,0.126352016,0.873647984,581.8492135,587.8401068,989.738323,1209.455253,2034,180.3191489,4068,-909824,131584,-778240,60
1780,263,23,7,0.128732256,0.871267744,586.859493,594.9187372,1004.009551,1143.760456,2043,206.9908815,4086,-911360,134656,-776704,60
1793,263,23,7,0.127918288,0.872081712,587.9146944,609.1090884,1006.259342,1180.125475,2056,160.7505864,4112,-918016,134656,-783360,60
1769,244,23,7,0.121212121,0.878787879,573.2932084,616.224461,987.258338,1150.127049,2013,224.6651786,4026,-905728,124928,-780800,60
1870,276,23,7,0.12861137,0.87138863,612.8055239,636.5899374,1047.947594,1246.626812,2146,141.370224,4292,-957440,141312,-816128,60
1759,269,23,7,0.132642998,0.867357002,575.6621972,617.6310563,987.6844798,1189.847584,2028,189.5327103,4056,-900608,137728,-762880,60
878,68,23,7,0.0718816068,0.928118393,269.5963929,287.8730302,482.9851936,351.0294118,946,23.84673557,1892,-449536,34816,-414720,60
1820,263,22,8,0.126260202,0.873739798,594.686709,614.9140458,1015.574176,1224.870722,2083,195.0374532,4166,-931840,134656,-797184,60
1868,265,23,7,0.124238162,0.875761838,608.4524726,632.5405778,1039.807281,1258.683019,2133,172.9927007,4266,-956416,135680,-820736,60
1780,280,24,6,0.13592233,0.86407767,589.7270979,605.0655971,1007.495506,1176.742857,2060,181.0193322,4120,-911360,143360,-768000,60
1813,273,23,7,0.130872483,0.869127517,595.0626162,611.3744798,1013.58963,1242.135531,2086,96.57407407,4172,-928256,139776,-788480,60
1786,267,22,8,0.13005358,0.86994642,585.2811669,604.4659398,997.7793953,1222.460674,2053,112.1245221,4106,-914432,136704,-777728,60
1846,271,22,8,0.128011337,0.871988663,604.7626294,623.3010809,1032.394366,1240.232472,2117,174.8142031,4234,-945152,138752,-806400,60
1798,262,23,7,0.127184466,0.872815534,589.1534756,614.9624056,1011.114572,1163.534351,2060,60.82078536,4120,-920576,134144,-786432,60
1832,267,23,7,0.12720343,0.87279657,600.4246151,610.7609764,1022.876638,1236.104869,2099,152.8769119,4198,-937984,136704,-801280,60
2390,337,22,8,0.123579025,0.876420975,791.7551846,746.2750531,1349.560251,1466.406528,2727,128.3294118,5454,-1223680,172544,-1051136,60
2356,343,22,8,0.127084105,0.872915895,780.8377342,757.1385582,1333.045416,1466.457726,2699,126.9520226,5398,-1206272,175616,-1030656,60
2311,318,23,7,0.120958539,0.879041461,761.816846,723.9956054,1296.81826,1447.132075,2629,48.41620626,5258,-1183232,162816,-1020416,60
2357,351,22,8,0.129615953,0.870384047,786.6655628,732.0730188,1333.330929,1496.652422,2708,137.601626,5416,-1206784,179712,-1027072,60
2311,330,23,7,0.124952669,0.875047331,763.3348504,733.5232324,1296.698399,1491.184848,2641,86.27899379,5282,-1183232,168960,-1014272,60
2450,352,22,8,0.125624554,0.874375446,812.566105,767.6042892,1380.987755,1544.269886,2802,134.5175228,5604,-1254400,180224,-1074176,60
2312,334,22,8,0.126228269,0.873771731,768.0780294,718.2037793,1303.187716,1464.10479,2646,62.7311522,5292,-1183744,171008,-1012736,60
2303,323,22,8,0.123000762,0.876999238,760.9936664,723.3580953,1295.091185,1444.755418,2626,130.9072782,5252,-1179136,165376,-1013760,60
2323,324,23,7,0.12240272,0.87759728,765.6610652,739.7930725,1305.651313,1455.555556,2647,139.5361096,5294,-1189376,165888,-1023488,60
2317,342,23,7,0.128619782,0.871380218,769.1809987,747.8754784,1314.123004,1437.564327,2659,112.2414521,5318,-1186304,175104,-1011200,60
2262,328,22,8,0.126640927,0.873359073,749.7071359,722.2159868,1278.166667,1415.036585,2590,112.5108601,5180,-1158144,167936,-990208,60
2399,346,22,8,0.126047359,0.873952641,793.6873177,772.2508099,1355.145477,1496.794798,2745,129.0550071,5490,-1228288,177152,-1051136,60
2264,325,22,8,0.125531093,0.874468907,751.7286121,690.9520629,1269.619258,1471.806154,2589,107.9649708,5178,-1159168,166400,-992768,60
2298,325,22,8,0.123903927,0.876096073,764.0035695,691.6146027,1292.464752,1450.129231,2623,122.5700935,5246,-1176576,166400,-1010176,60
2311,338,22,8,0.127595319,0.872404681,771.4115217,704.8910059,1306.975335,1448.239645,2649,103.8823529,5298,-1183232,173056,-1010176,60
2380,365,22,8,0.132969035,0.867030965,795.2617356,765.3129997,1356.891176,1478.038356,2745,125.9174312,5490,-1218560,186880,-1031680,60
2603,341,22,8,0.115828804,0.884171196,853.6142039,820.3055897,1469.645793,1494.28739,2944,161.7582418,5888,-1332736,174592,-1158144,60
2527,333,22,8,0.116433566,0.883566434,830.1829395,783.0306211,1417.480807,1529.297297,2860,129.2947559,5720,-1293824,170496,-1123328,60
2460,345,22,8,0.122994652,0.877005348,817.3633014,752.7989974,1400.231301,1422.742029,2805,117.7581864,5610,-1259520,176640,-1082880,60
2392,351,22,8,0.127962085,0.872037915,795.4702629,762.5266546,1361.173077,1445.783476,2743,129.3257897,5486,-1224704,179712,-1044992,60
3466,301,20,10,0.0799044332,0.920095567,1071.613426,1204.512534,1854.533756,2223.302326,3767,109.4103979,7534,-1774592,154112,-1620480,60
3521,313,20,10,0.081637976,0.918362024,1092.119552,1213.42487,1888.584209,2242.779553,3834,203.0720339,7668,-1802752,160256,-1642496,60
3464,308,20,10,0.0816542948,0.918345705,1073.856445,1199.576695,1857.962182,2207.457792,3772,310.4526749,7544,-1773568,157696,-1615872,60
3569,318,20,10,0.0818111654,0.918188835,1108.146784,1239.144486,1921.035864,2201.732704,3887,76.8789557,7774,-1827328,162816,-1664512,60
3474,314,20,10,0.0828933474,0.917106653,1080.775599,1196.865314,1871.69977,2146.754777,3788,260.3436426,7576,-1778688,160768,-1617920,60
3514,321,20,10,0.0837027379,0.916297262,1090.616661,1198.223111,1880.320717,2330.476636,3835,87.29797405,7670,-1799168,164352,-1634816,60
3472,348,19,11,0.0910994764,0.908900524,1082.592126,1224.389314,1872.738191,2287.25,3820,66.55052265,7640,-1777664,178176,-1599488,60
3498,326,21,9,0.085251046,0.914748954,1088.294365,1206.349764,1880.333047,2257.653374,3824,69.66660594,7648,-1790976,166912,-1624064,60
3442,317,20,10,0.0843309391,0.915669061,1069.045192,1229.208623,1861.773388,2077.905363,3759,119.0310323,7518,-1762304,162304,-1600000,60
3460,311,20,10,0.082471493,0.917528507,1075.48408,1181.763556,1858.219942,2195.064309,3771,78.18784989,7542,-1771520,159232,-1612288,60
3505,300,20,10,0.0788436268,0.921156373,1083.137097,1212.154275,1873.79087,2244.26,3805,375.6169793,7610,-1794560,153600,-1640960,60
3616,318,21,9,0.080833757,0.919166243,1120.848242,1268.322025,1946.71073,2203.896226,3934,290.5465288,7868,-1851392,162816,-1688576,60
3501,318,21,9,0.0832678712,0.916732129,1087.428631,1202.716594,1878.51928,2256.584906,3819,145.7077451,7638,-1792512,162816,-1629696,60
3450,291,20,10,0.0777866881,0.922213312,1067.218551,1180.816788,1845.954783,2167.927835,3741,114.6842428,7482,-1766400,148992,-1617408,60
3475,326,21,9,0.0857669034,0.914233097,1084.06612,1226.69505,1894.150216,1974.015337,3801,85.10971787,7602,-1779200,166912,-1612288,60
3449,309,20,10,0.0822245875,0.917775412,1070.455815,1228.548578,1869.484778,1991.288026,3758,91.03682171,7516,-1765888,158208,-1607680,60
3522,316,20,10,0.0823345492,0.917665451,1092.343221,1260.177355,1906.79841,2061.066456,3838,266.5277778,7676,-1803264,161792,-1641472,60
3471,315,20,10,0.0832012678,0.916798732,1077.114672,1177.814974,1856.098531,2305.628571,3786,293.261038,7572,-1777152,161280,-1615872,60
3160,280,21,9,0.0813953488,0.918604651,974.6418483,1177.366732,1728.356013,1631.839286,3440,140.9836066,6880,-1617920,143360,-1474560,60
3433,309,20,10,0.0825761625,0.917423838,1066.401648,1220.625179,1864.515001,1949.10356,3742,257.7134986,7484,-1757696,158208,-1599488,60
2055,271,23,7,0.116509028,0.883490972,659.4682337,749.5468948,1151.076886,1257.704797,2326,41.06638418,4652,-1052160,138752,-913408,60
1927,238,22,8,0.109930716,0.890069284,619.1621753,661.9332549,1070.741567,1182.252101,2165,101.9303202,4330,-986624,121856,-864768,60
1964,274,23,7,0.122430742,0.877569258,630.7638217,721.3833577,1094.381874,1299.543796,2238,39.36675462,4476,-1005568,140288,-865280,60
2000,244,23,7,0.108734403,0.891265597,642.0131641,690.3094125,1115.0875,1183.258197,2244,116.4504411,4488,-1024000,124928,-899072,60
1997,258,23,7,0.114412417,0.885587583,639.5784087,731.6016162,1122.261893,1172.414729,2255,123.9010989,4510,-1022464,132096,-890368,60
1792,203,23,7,0.101754386,0.898245614,573.7954703,593.6592225,995.2299107,1022.453202,1995,47.56795422,3990,-917504,103936,-813568,60
1988,260,23,7,0.115658363,0.884341637,639.0242603,718.9668636,1119.17002,1165.253846,2248,129.4185377,4496,-1017856,133120,-884736,60
1996,253,23,7,0.112494442,0.887505558,642.6079906,693.6470684,1114.422345,1208.450593,2249,123.775454,4498,-1021952,129536,-892416,60
2300,258,23,7,0.100860047,0.899139953,734.1392074,773.9678401,1284.917391,1231.205426,2558,137.4529823,5116,-1177600,132096,-1045504,60
1984,265,23,7,0.117830147,0.882169853,637.0863224,726.1212732,1111.72379,1224.396226,2249,83.20384758,4498,-1015808,135680,-880128,60
1982,239,23,7,0.107609185,0.892390815,634.6541745,684.9250381,1099.246216,1208.472803,2221,101.2767898,4442,-1014784,122368,-892416,60
2075,275,23,7,0.117021277,0.882978723,671.650664,727.1826857,1174.826988,1180.578182,2350,121.5098242,4700,-1062400,140800,-921600,60
1963,255,23,7,0.11496844,0.88503156,629.2802893,714.3124535,1099.10647,1189.509804,2218,119.9567334,4436,-1005056,130560,-874496,60
1952,255,23,7,0.115541459,0.884458541,626.7308374,710.479085,1099.244877,1140.4,2207,104.3992431,4414,-999424,130560,-868864,60
2024,260,23,7,0.113835377,0.886164623,648.2107521,739.6261136,1138.883399,1170.653846,2284,89.56862745,4568,-1036288,133120,-903168,60
2096,248,22,8,0.105802048,0.894197952,673.5761071,701.3240323,1168.730916,1204.354839,2344,132.8798186,4688,-1073152,126976,-946176,60
2019,260,23,7,0.114085125,0.885914875,650.1715545,710.6804508,1130.486875,1213.873077,2279,97.4348012,4558,-1033728,133120,-900608,60
2005,256,23,7,0.113224237,0.886775763,642.4173606,725.3146473,1123.233416,1191.828125,2261,103.4782609,4522,-1026560,131072,-895488,60
1987,261,23,7,0.116103203,0.883896797,639.3756533,714.2082667,1115.89532,1190.007663,2248,109.0732654,4496,-1017344,133632,-883712,60
2028,257,23,7,0.112472648,0.887527352,647.1925897,741.7990178,1129.379191,1250.48249,2285,104.0528233,4570,-1038336,131584,-906752,60
1453,201,23,7,0.121523579,0.878476421,478.200369,466.5055703,818.0667584,895.6915423,1654,51.19158155,3308,-743936,102912,-641024,60
1432,203,22,8,0.124159021,0.875840979,470.6154851,477.3666581,809.6222067,877.0985222,1635,48.47316929,3270,-733184,103936,-629248,60
1453,191,22,8,0.116180049,0.883819951,474.3856568,472.8782978,815.6971783,874.2513089,1644,38.6096759,3288,-743936,97792,-646144,60
1437,197,22,8,0.120563035,0.879436965,471.4223359,467.9453399,808.052888,886.4111675,1634,48.86363636,3268,-735744,100864,-634880,60
1439,203,22,8,0.12362972,0.87637028,473.736408,470.5450962,812.0979847,888.1477833,1642,48.73849807,3284,-736768,103936,-632832,60
1439,197,22,8,0.120415648,0.879584352,469.4466185,489.3998484,811.5059069,869.5888325,1636,52.85945073,3272,-736768,100864,-635904,60
1423,191,22,8,0.118339529,0.881660471,468.1251439,441.0725376,796.8032326,887.1937173,1614,43.34049409,3228,-728576,97792,-630784,60
1479,183,22,8,0.110108303,0.889891697,480.1154092,472.3904812,823.7430696,894.1912568,1662,50.95033722,3324,-757248,93696,-663552,60
1427,191,23,7,0.118046972,0.881953028,465.5377782,475.9834646,803.4456903,854.7329843,1618,52.97969876,3236,-730624,97792,-632832,60
1481,193,23,7,0.115292712,0.884707288,480.9153169,499.2208697,832.7272113,874.1243523,1674,46.86450168,3348,-758272,98816,-659456,60
1433,202,22,8,0.123547401,0.876452599,474.2015603,450.7046655,808.9071877,882.5049505,1635,41.09072631,3270,-733696,103424,-630272,60
1488,203,22,8,0.120047309,0.879952691,487.4594887,492.3383833,842.3178763,872.9901478,1691,50.68944844,3382,-761856,103936,-657920,60
1409,180,23,7,0.113278792,0.886721208,456.4620966,473.1944632,788.9105749,842.6666667,1589,47.34803337,3178,-721408,92160,-629248,60
1448,199,23,7,0.120825744,0.879174256,474.1790061,479.6980124,815.1581492,888.3366834,1647,47.67004342,3294,-741376,101888,-639488,60
1442,197,22,8,0.120195241,0.879804759,471.9970696,480.3743711,815.9542302,849.6142132,1639,51.23476086,3278,-738304,100864,-637440,60
1433,200,22,8,0.122473974,0.877526026,469.831917,479.0734085,809.4542917,871.065,1633,52.84789644,3266,-733696,102400,-631296,60
1431,199,22,8,0.12208589,0.87791411,470.3465632,469.3709345,809.1027254,861.5025126,1630,49.27448609,3260,-732672,101888,-630784,60
1443,195,22,8,0.119047619,0.880952381,470.7352886,464.7676442,838.4587665,679.2051282,1638,46.88036634,3276,-738816,99840,-638976,60
1464,200,22,8,0.120192308,0.879807692,480.4800932,469.9882982,844.6393443,743.64,1664,43.4464752,3328,-749568,102400,-647168,60
1523,215,22,8,0.123705409,0.876294591,495.4624109,543.9440268,870.2002626,864.5395349,1738,30.63634761,3476,-779776,110080,-669696,60
1867,237,22,8,0.112642586,0.887357414,598.7006508,671.1280508,1056.044992,1024.57384,2104,123.5466823,4208,-955904,121344,-834560,60
1798,237,23,7,0.116461916,0.883538084,579.532755,644.374006,1018.431034,1014.729958,2035,90.80767515,4070,-920576,121344,-799232,60
1879,234,23,7,0.110743019,0.889256981,605.4419111,645.1565312,1057.689196,1051.465812,2113,116.869469,4226,-962048,119808,-842240,60
1829,244,23,7,0.117703811,0.882296189,589.1120994,662.017323,1043.54784,987.9180328,2073,95.52995392,4146,-936448,124928,-811520,60
1927,248,22,8,0.114022989,0.885977011,620.0906147,682.5325725,1095.455112,1030.072581,2175,117.3772261,4350,-986624,126976,-859648,60
1902,236,23,7,0.110383536,0.889616464,610.3063013,665.8084129,1078.329653,998.3389831,2138,124.664723,4276,-973824,120832,-852992,60
1912,240,23,7,0.111524164,0.888475836,616.5506287,655.388286,1082.442992,1029.154167,2152,109.4051856,4304,-978944,122880,-856064,60
1797,240,23,7,0.117820324,0.882179676,580.4900871,641.4994089,1017.062883,1033.504167,2037,68.30985915,4074,-920064,122880,-797184,60
1833,244,23,7,0.11747713,0.88252287,592.3471183,651.3277517,1038.535188,1042.491803,2077,98.15689981,4154,-938496,124928,-813568,60
1836,250,23,7,0.119846596,0.880153404,594.5119701,655.7237284,1043.45915,1043.8,2086,104.4044044,4172,-940032,128000,-812032,60
1807,247,23,7,0.120253165,0.879746835,584.2848961,652.7509839,1026.907582,1031.834008,2054,90.40492958,4108,-925184,126464,-798720,60
1823,244,23,7,0.118045477,0.881954523,588.7759859,652.4553071,1031.334065,1053.918033,2067,72.34861743,4134,-933376,124928,-808448,60
1850,243,23,7,0.11610129,0.88389871,597.2749167,654.4758999,1047.693514,1041.720165,2093,103.6138614,4186,-947200,124416,-822784,60
1696,193,23,7,0.102170461,0.897829539,543.7792575,547.3623848,956.9964623,839.5803109,1889,67.99856012,3778,-868352,98816,-769536,60
1920,241,23,7,0.111522443,0.888477557,617.5724973,668.9308718,1088.046875,1024.858921,2161,134.6417445,4322,-983040,123392,-859648,60
1822,236,23,7,0.114674441,0.885325559,588.6729459,634.3382182,1030.425357,1022.355932,2058,97.95335554,4116,-932864,120832,-812032,60
1916,233,23,7,0.108422522,0.891577478,617.2165585,643.8654344,1080.514092,1029.656652,2149,115.4755508,4298,-980992,119296,-861696,60
1779,252,23,7,0.124076809,0.875923191,578.6004931,637.96624,1016.996627,1008.964286,2031,100.197336,4062,-910848,129024,-781824,60
2177,262,22,8,0.107421074,0.892578926,697.4077586,753.1220147,1228.96509,1145.507634,2439,90.40029652,4878,-1114624,134144,-980480,60
1837,238,23,7,0.114698795,0.885301205,592.705124,645.4646732,1036.867175,1046.743697,2075,87.0751154,4150,-940544,121856,-818688,60
1575,189,22,8,0.107142857,0.892857143,505.3968082,539.9013079,881.0463492,894.6137566,1764,52.56257449,3528,-806400,96768,-709632,60
1572,212,23,7,0.118834081,0.881165919,515.2457645,502.4401649,879.3015267,990.3679245,1784,43.99506782,3568,-804864,108544,-696320,60
1508,197,22,8,0.115542522,0.884457478,489.8007773,506.068078,845.1193634,913.3248731,1705,48.16384181,3410,-772096,100864,-671232,60
1508,192,23,7,0.112941176,0.887058824,490.4576509,481.4276302,837.755305,950.5989583,1700,54.64480874,3400,-772096,98304,-673792,60
1531,189,22,8,0.109883721,0.890116279,493.0740279,522.1946266,856.0209014,896.7830688,1720,49.84062591,3440,-783872,96768,-687104,60
1521,204,22,8,0.11826087,0.88173913,497.6251225,495.1351693,853.8060487,931.5490196,1725,49.11731207,3450,-778752,104448,-674304,60
1507,203,22,8,0.11871345,0.88128655,493.9229654,480.9266675,842.6854678,950.6305419,1710,52.55070682,3420,-771584,103936,-667648,60
1525,205,23,7,0.11849711,0.88150289,497.6523245,505.9601333,855.3763934,940.8097561,1730,54.53972257,3460,-780800,104960,-675840,60
1555,190,23,7,0.108882521,0.891117479,502.0066554,512.4819374,864.5511254,942.1473684,1745,56.3630491,3490,-796160,97280,-698880,60
1550,207,23,7,0.117814456,0.882185544,506.3266641,509.61768,870.8825806,939.7826087,1757,51.17972619,3514,-793600,105984,-687616,60
1477,188,22,8,0.112912913,0.887087087,479.9661435,481.3251338,824.9932295,895.9042553,1665,53.72700871,3330,-756224,96256,-659968,60
1513,192,22,8,0.112609971,0.887390029,489.49874,510.0366731,846.516193,904.09375,1705,51.44840072,3410,-774656,98304,-676352,60
1569,208,23,7,0.11705121,0.88294879,512.1451646,509.9468254,876.8457616,980.6826923,1777,53.86480752,3554,-803328,106496,-696832,60
1510,198,22,8,0.115925059,0.884074941,492.9388366,484.4155541,842.5874172,945.3484848,1708,52.68352869,3416,-773120,101376,-671744,60
1501,202,23,7,0.11861421,0.88138579,486.4746402,513.8186965,836.5136576,967.0742574,1703,29.99823851,3406,-768512,103424,-665088,60
1507,197,22,8,0.115610329,0.884389671,492.2011603,479.7280156,840.4678169,944.5431472,1704,48.81122887,3408,-771584,100864,-670720,60
1522,202,22,8,0.117169374,0.882830626,496.0835996,503.2206595,852.5453351,937.5049505,1724,50.43885313,3448,-779264,103424,-675840,60
1550,227,22,8,0.127743388,0.872256612,509.2605127,535.0460629,881.7606452,938.4317181,1777,58.28140374,3554,-793600,116224,-677376,60
1509,199,23,7,0.116510539,0.883489461,490.61869,509.4793756,849.353214,893.5276382,1708,53.99936769,3416,-772608,101888,-670720,60
1500,194,22,8,0.114521842,0.885478158,487.9788192,491.5210794,838.5773333,916.4896907,1694,51.91541526,3388,-768000,99328,-668672,60
1506,227,23,7,0.130986728,0.869013272,502.092601,487.6570577,864.2961487,884.938326,1733,75.44623422,3466,-771072,116224,-654848,60
1509,238,22,8,0.136233543,0.863766457,503.6654641,507.1629386,868.7693837,907.1638655,1747,99.94279176,3494,-772608,121856,-650752,60
1400,180,23,7,0.113924051,0.886075949,459.2556812,428.6424967,795.7464286,749.6944444,1580,91.96740396,3160,-716800,92160,-624640,60
1533,226,23,7,0.128482092,0.871517908,506.2610962,513.9103688,871.1017613,940.3584071,1759,58.43853821,3518,-784896,115712,-669184,60
1542,228,23,7,0.128813559,0.871186441,510.88849,510.7251871,881.8651102,910.0833333,1770,95.16129032,3540,-789504,116736,-672768,60
1501,238,23,7,0.136860265,0.863139735,500.9229123,508.5591598,867.7748168,884.0336134,1739,91.81626188,3478,-768512,121856,-646656,60
1503,217,23,7,0.126162791,0.873837209,499.4867596,474.2935287,855.9827013,891.7880184,1720,68.69009585,3440,-769536,111104,-658432,60
1519,229,23,7,0.131006865,0.868993135,503.1389559,513.1291087,869.8025016,905.6593886,1748,68.46846847,3496,-777728,117248,-660480,60
1507,219,22,8,0.126882966,0.873117034,498.2528692,497.219202,859.1386861,893.5114155,1726,81.41509434,3452,-771584,112128,-659456,60
1502,226,22,8,0.130787037,0.869212963,498.4613464,498.5265189,857.1431425,913.3938053,1728,79.22971114,3456,-769024,115712,-653312,60
1447,188,23,7,0.114984709,0.885015291,468.2632433,492.0505849,807.3586731,899.9042553,1635,99.51308582,3270,-740864,96256,-644608,60
1489,229,23,7,0.133294529,0.866705471,494.8422834,500.2423127,851.904634,908.8864629,1718,92.61455526,3436,-762368,117248,-645120,60
1217,195,22,8,0.138101983,0.861898017,408.0891432,400.4592923,697.9104355,760.1076923,1412,77.58241758,2824,-623104,99840,-523264,60
1475,194,23,7,0.116237268,0.883762732,479.2940597,493.238668,824.5464407,914.4793814,1669,83.24189526,3338,-755200,99328,-655872,60
1532,234,23,7,0.132502831,0.867497169,508.5020877,514.8004611,875.0463446,938.8461538,1766,89.73577236,3532,-784384,119808,-664576,60
1538,228,23,7,0.129105323,0.870894677,508.5063246,518.1721544,881.1781534,899.1622807,1766,71.38237672,3532,-787456,116736,-670720,60
1478,221,23,7,0.130076516,0.869923484,488.9048225,500.2462617,846.9350474,870.4977376,1699,94.75738985,3398,-756736,113152,-643584,60
763,124,23,7,0.139797069,0.860202931,256.5714805,249.670641,437.9737877,481.0806452,887,13.78613615,1774,-390656,63488,-327168,60
764,123,23,7,0.138669673,0.861330327,257.4194657,243.1000887,437.1308901,486.6666667,887,14.16028097,1774,-391168,62976,-328192,60
1512,232,23,7,0.133027523,0.866972477,502.4949838,509.4184772,870.4252646,886.0215517,1744,45.73826383,3488,-774144,118784,-655360,60
4590,306,23,7,0.0625,0.9375,1401.232329,1574.581517,2437.319826,2616.202614,4896,498.5743381,9792,-2350080,156672,-2193408,60
8561,1349,23,7,0.136125126,0.863874874,2746.673616,2942.905732,4678.251139,6714.971831,9910,525.1722311,19820,-4383232,690688,-3692544,60
8856,1045,23,7,0.105544894,0.894455106,2822.616281,2921.696467,4821.593496,6047.673684,9901,325.1559934,19802,-4534272,535040,-3999232,60
8834,1073,23,7,0.108307257,0.891692743,2816.014419,2928.478251,4806.489246,6168.4548,9907,229.0106334,19814,-4523008,549376,-3973632,60
8564,1347,23,7,0.135909595,0.864090405,2743.553071,2936.021685,4672.773354,6756.707498,9911,320.9520725,19822,-4384768,689664,-3695104,60
8573,1335,23,7,0.134739604,0.865260396,2731.68689,2888.211442,4648.814767,6917.525843,9908,491.468254,19816,-4389376,683520,-3705856,60
8587,1322,23,7,0.133414068,0.866585932,2757.590012,2834.78676,4671.934086,6793.643722,9909,397.7920514,19818,-4396544,676864,-3719680,60
8584,1328,23,7,0.133979015,0.866020985,2733.318973,2915.505411,4657.365214,6890.064006,9912,496.8421053,19824,-4395008,679936,-3715072,60
8582,1328,24,6,0.134006054,0.865993946,2752.926936,2849.145136,4668.264973,6811.713102,9910,487.2173058,19820,-4393984,679936,-3714048,60
8833,1061,23,7,0.107236709,0.892763291,2819.273228,2942.401921,4820.998415,6000.64656,9894,252.3979592,19788,-4522496,543232,-3979264,60
8584,807,23,7,0.0859333404,0.91406666,2721.395402,2576.42999,4666.520387,5009.572491,9391,163.8346127,18782,-4395008,413184,-3981824,60
8528,1375,22,8,0.138846814,0.861153186,2760.245335,2926.200953,4691.00985,6570.708364,9903,312.594697,19806,-4366336,704000,-3662336,60
8563,1347,24,6,0.13592331,0.86407669,2756.021632,2901.078715,4681.629452,6696.519673,9910,257.2689512,19820,-4384256,689664,-3694592,60
8572,1339,23,7,0.135102411,0.864897589,2736.495473,2916.444024,4660.284648,6849.10829,9911,451.7319964,19822,-4388864,685568,-3703296,60
4113,261,23,7,0.0596707819,0.940329218,1255.247527,1305.768234,2213.867493,1771.984674,4374,548.8080301,8748,-2105856,133632,-1972224,60
8541,1368,23,7,0.138056312,0.861943688,2724.706002,2945.819195,4648.836202,6866.509503,9909,418.6311787,19818,-4372992,700416,-3672576,60
8705,841,23,7,0.0880997276,0.911900272,2746.741893,2787.444729,4720.198736,5325.209275,9546,172.3415779,19092,-4456960,430592,-4026368,60
3166,212,23,7,0.062759029,0.937240971,975.2816659,913.4739615,1711.241314,1364.816038,3378,60.12815949,6756,-1620992,108544,-1512448,60
8588,1324,23,7,0.133575464,0.866424536,2728.402716,2930.816384,4654.874592,6912.964502,9912,325.6241787,19824,-4397056,677888,-3719168,60
2498,272,23,7,0.0981949458,0.901805054,799.0083585,803.2959582,1379.603683,1439.650735,2770,50.13574661,5540,-1278976,139264,-1139712,60
6592,1527,21,9,0.188077349,0.811922651,2328.326937,2152.644995,3834.184618,5034.83628,8119,163.1959799,16238,-3375104,781824,-2593280,61
3341,345,21,9,0.0935973956,0.906402604,1035.214429,1310.557584,1840.392697,1873.591304,3686,72.8458498,7372,-1710592,176640,-1533952,61
4064,392,21,9,0.0879712747,0.912028725,1263.921179,1496.704186,2236.306594,2147.566327,4456,77.98389919,8912,-2080768,200704,-1880064,61
3254,351,21,9,0.0973647712,0.902635229,1009.855557,1291.464238,1806.191149,1773.415954,3605,75.04163197,7210,-1666048,179712,-1486336,61
3335,332,21,9,0.0905372239,0.909462776,1031.429792,1288.344435,1850.5994,1667.256024,3667,81.77966102,7334,-1707520,169984,-1537536,61
3984,363,21,9,0.0835058661,0.916494134,1233.99095,1464.012933,2177.612701,2134.349862,4347,76.55864741,8694,-2039808,185856,-1853952,61
3467,345,21,9,0.0905036726,0.909496327,1069.077475,1376.401251,1906.34987,1908.008696,3812,76.66934835,7624,-1775104,176640,-1598464,61
3112,349,21,9,0.100837908,0.899162092,965.4907659,1259.785959,1730.952121,1731.426934,3461,75.915771,6922,-1593344,178688,-1414656,61
3991,391,20,10,0.0892286627,0.910771337,1236.811463,1518.102445,2180.164871,2307.199488,4382,84.56194519,8764,-2043392,200192,-1843200,61
3401,327,20,10,0.0877145923,0.912285408,1055.414869,1259.108951,1881.23052,1690.492355,3728,75.5267423,7456,-1741312,167424,-1573888,61
3172,347,21,9,0.098607559,0.901392441,981.5569245,1287.066509,1764.039092,1723.07781,3519,72.58663366,7038,-1624064,177664,-1446400,61
3290,344,21,9,0.09466153,0.90533847,1018.838608,1293.407182,1801.770213,1967.938953,3634,81.93912063,7268,-1684480,176128,-1508352,61
4114,438,21,9,0.0962214411,0.903778559,1283.058762,1574.339192,2269.974477,2337.792237,4552,82.43390076,9104,-2106368,224256,-1882112,61
3170,355,21,9,0.10070922,0.89929078,979.5956392,1304.427516,1751.688644,1864.005634,3525,61.86381186,7050,-1623040,181760,-1441280,61
4036,377,21,9,0.0854294131,0.914570587,1253.735859,1472.275726,2210.526759,2169.244032,4413,82.14817573,8826,-2066432,193024,-1873408,61
5115,642,21,9,0.111516415,0.888483585,1622.479734,1902.80096,2829.80958,3270.91433,5757,111.4833462,11514,-2618880,328704,-2290176,61
4026,386,21,9,0.0874886673,0.912511333,1247.021148,1521.868417,2213.442623,2134.088083,4412,79.97099873,8824,-2061312,197632,-1863680,61
3998,372,20,10,0.0851258581,0.914874142,1240.564125,1465.97614,2192.146323,2114.069892,4370,82.57747543,8740,-2046976,190464,-1856512,61
4036,370,20,10,0.0839763958,0.916023604,1248.736086,1501.107123,2206.767096,2167.862162,4406,77.87203959,8812,-2066432,189440,-1876992,61
3371,354,20,10,0.095033557,0.904966443,1042.492367,1348.275753,1861.036784,1881.694915,3725,68.22344322,7450,-1725952,181248,-1544704,61
3831,329,23,7,0.0790865385,0.920913462,1176.182913,1433.521294,2058.542156,2336.18541,4160,331.4741036,8320,-1961472,168448,-1793024,61
3948,330,23,7,0.0771388499,0.92286115,1209.34722,1488.6975,2120.220871,2370.148485,4278,312.4908692,8556,-2021376,168960,-1852416,61
3979,314,23,7,0.0731423247,0.926857675,1216.722411,1450.308753,2119.132697,2500.133758,4293,283.7409121,8586,-2037248,160768,-1876480,61
3876,349,23,7,0.0826035503,0.91739645,1192.711151,1460.925961,2089.373581,2375.395415,4225,256.8389058,8450,-1984512,178688,-1805824,61
3831,323,24,6,0.0777563794,0.922243621,1170.52573,1464.904881,2052.318194,2376.173375,4154,219.5560254,8308,-1961472,165376,-1796096,61
3833,336,23,7,0.0805948669,0.919405133,1175.03663,1457.89763,2059.111662,2380.327381,4169,183.5755174,8338,-1962496,172032,-1790464,61
3867,317,23,7,0.0757648184,0.924235182,1185.184068,1396.469358,2060.065684,2488.157729,4184,286.3791923,8368,-1979904,162304,-1817600,61
3415,246,24,6,0.0671947555,0.932805244,1039.409791,1273.695019,1833.972767,1789.731707,3661,66.5394402,7322,-1748480,125952,-1622528,61
3930,322,24,6,0.0757290687,0.924270931,1201.620274,1406.920524,2083.871756,2646.776398,4252,195.6741832,8504,-2012160,164864,-1847296,61
3797,329,24,6,0.0797382453,0.920261755,1164.325057,1437.797839,2040.208586,2332.306991,4126,286.7268937,8252,-1944064,168448,-1775616,61
3909,334,24,6,0.0787178883,0.921282112,1194.850757,1513.877209,2102.258634,2353.04491,4243,395.4333644,8486,-2001408,171008,-1830400,61
3882,340,24,6,0.0805305542,0.919469446,1189.503099,1494.756883,2091.564915,2339.111765,4222,433.4702259,8444,-1987584,174080,-1813504,61
3940,325,24,6,0.0762016413,0.923798359,1205.528863,1471.800035,2106.947462,2448.836923,4265,230.2915767,8530,-2017280,166400,-1850880,61
3899,317,23,7,0.0751897533,0.924810247,1195.628115,1395.772658,2076.370351,2503.684543,4216,281.8181818,8432,-1996288,162304,-1833984,61
3854,328,22,8,0.0784313725,0.921568627,1181.801374,1453.174016,2071.522833,2326.231707,4182,159.9846978,8364,-1973248,167936,-1805312,61
3840,338,24,6,0.0808999521,0.919100048,1181.124786,1391.397629,2052.180208,2513.488166,4178,240.253019,8356,-1966080,173056,-1793024,61
3988,329,22,8,0.0762103312,0.923789669,1222.143804,1459.458689,2129.004514,2522.592705,4317,292.4796748,8634,-2041856,168448,-1873408,61
3760,323,23,7,0.0791084987,0.920891501,1155.412841,1389.612753,2017.286702,2329.684211,4083,76.16116396,8166,-1925120,165376,-1759744,61
3736,252,22,8,0.0631895687,0.936810431,1138.073667,1331.082601,1993.356799,2011.448413,3988,197.2304649,7976,-1912832,129024,-1783808,61
3866,362,23,7,0.0856196783,0.914380322,1183.713956,1504.618585,2077.497155,2509.674033,4228,73.78708551,8456,-1979392,185344,-1794048,61
3040,288,21,9,0.0865384615,0.913461538,950.1046632,1027.619881,1638.748684,1936.319444,3328,90.26308652,6656,-1556480,147456,-1409024,61
3130,292,22,8,0.0853302162,0.914669784,976.4884705,1048.057175,1681.038019,2038.027397,3422,96.69398135,6844,-1602560,149504,-1453056,61
3047,284,23,7,0.0852596818,0.914740318,952.2432627,1023.612477,1642.669511,1916.309859,3331,90.83719662,6662,-1560064,145408,-1414656,61
3085,285,23,7,0.0845697329,0.915430267,962.1077339,1037.420945,1658.277796,1980.168421,3370,93.50721421,6740,-1579520,145920,-1433600,61
3067,289,23,7,0.0861144219,0.913885578,955.2059682,1045.143701,1646.820998,2014.692042,3356,93.4038408,6712,-1570304,147968,-1422336,61
3125,280,23,7,0.0822320117,0.917767988,971.415896,1056.060302,1675.55328,2009.325,3405,95.67294184,6810,-1600000,143360,-1456640,61
2953,273,23,7,0.0846249225,0.915375077,922.7776466,991.4636685,1592.853369,1836.831502,3226,71.832554,6452,-1511936,139776,-1372160,61
3012,274,23,7,0.0833840536,0.916615946,940.8256421,1002.942697,1623.053785,1868.259124,3286,142.4360642,6572,-1542144,140288,-1401856,61
3101,281,23,7,0.0830869308,0.916913069,966.9297157,1048.421548,1671.1693,1915.86121,3382,84.80441324,6764,-1587712,143872,-1443840,61
3167,279,23,7,0.0809634359,0.919036564,984.8047132,1051.853865,1695.84749,2037.390681,3446,94.33342458,6892,-1621504,142848,-1478656,61
3437,306,22,8,0.0817526049,0.918247395,1065.576821,1212.203211,1851.443992,2102.885621,3743,99.07358391,7486,-1759744,156672,-1603072,61
3023,269,23,7,0.0817132442,0.918286756,942.1106084,996.7130631,1621.752894,1924.605948,3292,91.1406423,6584,-1547776,137728,-1410048,61
3116,289,23,7,0.0848751836,0.915124816,972.594847,1049.061414,1677.325738,1979.820069,3405,97.64840837,6810,-1595392,147968,-1447424,61
3479,292,23,7,0.0774330416,0.922566958,1077.774756,1196.443437,1871.396953,2059.986301,3771,90.17216643,7542,-1781248,149504,-1631744,61
3123,280,22,8,0.0822803409,0.917719659,973.1671959,1040.417423,1677.240154,1978.160714,3403,91.79929862,6806,-1598976,143360,-1455616,61
819,40,23,7,0.0465657742,0.953434226,244.7256279,291.2063315,434.6324786,335.15,859,199.3039443,1718,-419328,20480,-398848,61
3025,277,23,7,0.0838885524,0.916111448,944.7347064,1005.451654,1627.781818,1910.516245,3302,92.18313791,6604,-1548800,141824,-1406976,61
3139,292,23,7,0.085106383,0.914893617,980.1748919,1058.237126,1691.0446,1984.270548,3431,99.19051749,6862,-1607168,149504,-1457664,61
3034,288,23,7,0.0866947622,0.913305238,947.6557553,1033.191324,1635.907713,1931.107639,3322,96.03931772,6644,-1553408,147456,-1405952,61
1052,75,23,7,0.0665483585,0.933451642,318.488149,409.3314254,564.8136882,552.5866667,1127,17.58464659,2254,-538624,38400,-500224,61
3029,319,21,9,0.0952807646,0.904719235,941.371237,1174.033219,1664.148894,1772.786834,3348,75.23595506,6696,-1550848,163328,-1387520,61
3757,349,20,10,0.0849975645,0.915002435,1167.711771,1359.486772,2049.286665,2098.856734,4106,72.58264098,8212,-1923584,178688,-1744896,61
2959,304,20,10,0.0931657983,0.906834202,918.4183659,1140.152239,1620.687056,1742.115132,3263,71.08932462,6526,-1515008,155648,-1359360,61
2876,310,21,9,0.0973006905,0.902699309,893.1305645,1134.756545,1585.982267,1663.245161,3186,60.24962179,6372,-1472512,158720,-1313792,61
3740,339,20,10,0.0831086051,0.916891395,1162.282722,1332.782686,2044.889572,1986.056047,4079,77.32701422,8158,-1914880,173568,-1741312,61
2968,310,21,9,0.0945698597,0.90543014,922.0379127,1145.583321,1626.67217,1762.316129,3278,69.47859262,6556,-1519616,158720,-1360896,61
3735,368,21,9,0.0896904704,0.91030953,1160.154983,1400.393328,2038.861312,2185.350543,4103,84.16410256,8206,-1912320,188416,-1723904,61
2867,311,21,9,0.0978602895,0.902139711,891.786137,1119.730964,1576.798047,1706.594855,3178,74.91749175,6356,-1467904,159232,-1308672,61
3781,383,20,10,0.0919788665,0.908021134,1179.793666,1395.370548,2068.50648,2220.644909,4164,77.26850993,8328,-1935872,196096,-1739776,61
3110,325,20,10,0.0946142649,0.905385735,964.7131685,1211.474919,1704.325723,1848.852308,3435,65.75421133,6870,-1592320,166400,-1425920,61
3725,353,20,10,0.0865620402,0.91343796,1157.985827,1363.701932,2040.178792,2032.33711,4078,79.85118465,8156,-1907200,180736,-1726464,61
3153,277,21,9,0.0807580175,0.919241983,975.9595514,1134.471611,1724.368855,1614.548736,3430,70.97041175,6860,-1614336,141824,-1472512,61
3718,352,21,9,0.0864864865,0.913513514,1154.817342,1369.22823,2035.379236,2036.775568,4070,70.89357255,8140,-1903616,180224,-1723392,61
42,14,21,9,0.25,0.75,15.92029467,16.72344072,29.14285714,26.57142857,56,4.512489927,112,-21504,7168,-14336,61
3122,285,21,9,0.0836513061,0.916348694,968.2836896,1136.954284,1705.564382,1686.863158,3407,60.31155957,6814,-1598464,145920,-1452544,61
6663,1595,20,10,0.19314604,0.80685396,2369.151564,2206.150053,3903.140477,5075.10094,8258,167.5730519,16516,-3411456,816640,-2594816,61
3737,350,21,9,0.0856373868,0.914362613,1163.217378,1344.317682,2044.085363,2043.088571,4087,73.83920506,8174,-1913344,179200,-1734144,61
3100,279,21,9,0.0825688073,0.917431193,961.1361675,1120.933664,1694.407419,1641.028674,3379,64.38643293,6758,-1587200,142848,-1444352,61
3095,279,21,9,0.0826911678,0.917308832,960.1368697,1113.63866,1694.012601,1615.25448,3374,68.01048176,6748,-1584640,142848,-1441792,61
794,94,21,9,0.105855856,0.894144144,250.0331225,288.167638,455.5037783,351.5531915,888,13.26362957,1776,-406528,48128,-358400,61
398,28,23,7,0.0657276995,0.9342723,121.4619193,122.6358472,218.4698492,142.8571429,426,19.69486824,852,-203776,14336,-189440,61
1753,198,23,7,0.101486417,0.898513583,562.3989506,568.6469217,971.364518,1017.040404,1951,119.6932515,3902,-897536,101376,-796160,61
1820,202,23,7,0.099901088,0.900098912,581.9324426,599.0512944,1009.345055,1030.915842,2022,158.5882353,4044,-931840,103424,-828416,61
1775,195,23,7,0.0989847716,0.901015228,569.092391,564.9380436,984.5374648,994.2615385,1970,242.6108374,3940,-908800,99840,-808960,61
1791,198,23,7,0.0995475113,0.900452489,572.8077124,586.1087554,993.0759352,1012.40404,1989,134.2105263,3978,-916992,101376,-815616,61
1831,211,23,7,0.103330069,0.896669931,588.5902911,596.2480072,1018.034954,1051.56872,2042,144.2090395,4084,-937472,108032,-829440,61
1654,200,23,7,0.107874865,0.892125135,533.3927596,547.8038873,921.95526,973.355,1854,123.2712766,3708,-846848,102400,-744448,61
1822,208,23,7,0.102463054,0.897536946,585.0097396,594.0463875,1012.475302,1041.995192,2030,157.3643411,4060,-932864,106496,-826368,61
1783,194,23,7,0.0981284775,0.901871523,571.9760469,558.8025875,987.688166,1001.056701,1977,168.2553191,3954,-912896,99328,-813568,61
1826,203,23,7,0.100049285,0.899950715,584.0916654,599.7935171,1012.711939,1035.581281,2029,78.37002704,4058,-934912,103936,-830976,61
100,22,21,9,0.180327869,0.819672131,35.76433279,29.30827881,64.35,48.54545455,122,22.55083179,244,-51200,11264,-39936,61
1807,195,24,6,0.0974025974,0.902597403,577.7336928,579.3756974,999.4493636,1020.502564,2002,44.73743017,4004,-925184,99840,-825344,61
1754,198,24,6,0.101434426,0.898565574,561.9956649,576.3537362,974.7149373,992.3131313,1952,77.7689243,3904,-898048,101376,-796672,61
1802,206,23,7,0.102589641,0.897410359,579.2689589,582.3607665,1001.396226,1031.650485,2008,129.9676375,4016,-922624,105472,-817152,61
1779,202,23,7,0.101968703,0.898031297,573.7721993,554.7305323,990.1326588,998.6386139,1981,156.107171,3962,-910848,103424,-807424,61
1785,206,23,7,0.103465595,0.896534405,578.0633321,545.2087999,996.362465,992.8592233,1991,172.9800174,3982,-913920,105472,-808448,61
386,35,23,7,0.0831353919,0.916864608,120.8850753,119.3784379,215.1165803,165.6,421,47.46335964,842,-197632,17920,-179712,61
1716,175,23,7,0.0925436277,0.907456372,545.9300545,545.1748528,947.6480186,929.84,1891,54.51138657,3782,-878592,89600,-788992,61
1787,209,21,9,0.104709419,0.895290581,577.4997329,564.7901715,999.8455512,986.9952153,1996,41.40219871,3992,-914944,107008,-807936,61
1790,203,23,7,0.101856498,0.898143502,574.9132786,578.6520282,994.8854749,1015.64532,1993,129.4155844,3986,-916480,103936,-812544,61
9461,502,23,7,0.0503864298,0.94961357,2873.003527,2916.158458,4998.358419,4673.699203,9963,904.9046322,19926,-4844032,257024,-4587008,61
4842,297,23,7,0.057793345,0.942206655,1476.258707,1549.093545,2593.10347,2193.343434,5139,91.34376111,10278,-2479104,152064,-2327040,61
9471,493,24,6,0.0494781212,0.950521879,2871.033458,2902.853351,5015.967585,4339.555781,9964,887.2662511,19928,-4849152,252416,-4596736,61
9480,486,24,6,0.0487658037,0.951234196,2867.367737,3020.199527,5007.33903,4518.49177,9966,1380.33241,19932,-4853760,248832,-4604928,61
9662,327,23,7,0.0327360096,0.96726399,2873.717409,3120.401295,5011.813703,4498.198777,9989,207.2836688,19978,-4946944,167424,-4779520,61
9484,478,24,6,0.0479823329,0.952017667,2872.783605,2923.31907,4994.16027,4730.307531,9962,842.8087986,19924,-4855808,244736,-4611072,61
9463,499,23,7,0.0500903433,0.949909657,2870.268946,2966.490248,4995.171721,4722.230461,9962,1232.920792,19924,-4845056,255488,-4589568,61
1139,91,23,7,0.0739837398,0.92601626,346.2801599,360.9915075,636.261633,355.6373626,1230,23.25581395,2460,-583168,46592,-536576,61
9499,467,23,7,0.0468593217,0.953140678,2876.046932,2887.362521,4993.565954,4778.753747,9966,1196.398559,19932,-4863488,239104,-4624384,61
9506,461,24,6,0.0462526337,0.953747366,2872.134998,2972.991247,4993.843046,4781.032538,9967,1367.215364,19934,-4867072,236032,-4631040,61
9476,485,24,6,0.0486898906,0.951310109,2874.023094,2894.398339,4992.817539,4750.107216,9961,1009.219858,19922,-4851712,248320,-4603392,61
9492,473,23,7,0.0474661315,0.952533869,2877.557941,2816.499545,5006.692689,4507.54334,9965,702.2551092,19930,-4859904,242176,-4617728,61
9481,484,24,6,0.048569995,0.951430005,2871.481543,2965.694001,4995.345217,4741.171488,9965,1162.77713,19930,-4854272,247808,-4606464,61
9469,494,24,6,0.0495834588,0.950416541,2866.090445,3025.615518,5005.631112,4529.038462,9963,1319.602649,19926,-4848128,252928,-4595200,61
9492,473,23,7,0.0474661315,0.952533869,2871.468134,2968.413264,4995.02107,4741.765328,9965,1038.020833,19930,-4859904,242176,-4617728,61
9485,478,22,8,0.0479775168,0.952022483,2872.617624,2939.215031,4990.027833,4822.702929,9963,1251.633166,19926,-4856320,244736,-4611584,61
9460,505,23,7,0.0506773708,0.949322629,2863.792249,3069.676734,5008.191543,4511.09505,9965,1034.787124,19930,-4843520,258560,-4584960,61
9488,477,23,7,0.0478675364,0.952132464,2875.560574,2893.36015,4991.202045,4819.853249,9965,798.4775641,19930,-4857856,244224,-4613632,61
9664,325,24,6,0.0325357894,0.967464211,2875.559725,3080.471551,5009.736651,4556.8,9989,909.7449909,19978,-4947968,166400,-4781568,61
3807,205,23,7,0.0510967099,0.94890329,1140.879639,1317.212804,2037.277646,1434.936585,4012,54.49606085,8024,-1949184,104960,-1844224,61
2946,269,22,8,0.0836702955,0.916329705,918.5314582,987.7951677,1583.443313,1876.936803,3215,89.82956133,6430,-1508352,137728,-1370624,61
2952,267,23,7,0.082945014,0.917054986,919.7532086,997.6412608,1588.389228,1848.932584,3219,89.61581292,6438,-1511424,136704,-1374720,61
2926,266,23,7,0.0833333333,0.916666667,911.3710501,995.0837246,1574.809638,1835.093985,3192,86.24696028,6384,-1498112,136192,-1361920,61
2898,267,23,7,0.0843601896,0.91563981,903.5058635,970.0709391,1555.978951,1876.284644,3165,75.46494993,6330,-1483776,136704,-1347072,61
2961,302,22,8,0.0925528655,0.907447135,924.8992489,1027.485764,1595.185748,1992.950331,3263,57.2255349,6526,-1516032,154624,-1361408,61
2992,265,23,7,0.0813632177,0.918636782,930.8073732,1002.464878,1605.321858,1896.339623,3257,75.48088065,6514,-1531904,135680,-1396224,61
901,47,23,7,0.0495780591,0.950421941,270.7300422,306.3432185,479.9922309,369.212766,948,123.1168831,1896,-461312,24064,-437248,61
2995,276,23,7,0.0843778661,0.915622134,934.0247351,1012.226841,1611.761269,1899.025362,3271,61.61235638,6542,-1533440,141312,-1392128,61
2985,288,23,7,0.0879926673,0.912007333,934.2579775,1014.457876,1612.699162,1888.868056,3273,79.48033026,6546,-1528320,147456,-1380864,61
2959,273,23,7,0.0844678218,0.915532178,925.7263153,981.5744449,1596.082122,1837.805861,3232,71.74250832,6464,-1515008,139776,-1375232,61
3056,264,23,7,0.0795180723,0.920481928,946.9406169,1043.751095,1636.781741,1935.056818,3320,80.99536472,6640,-1564672,135168,-1429504,61
2963,274,21,9,0.0846462774,0.915353723,922.72026,1009.243552,1592.457307,1906.029197,3237,83.794978,6474,-1517056,140288,-1376768,61
3504,284,23,7,0.0749736008,0.925026399,1080.554224,1214.116704,1874.030251,2147.056338,3788,108.6009174,7576,-1794048,145408,-1648640,61
3049,262,23,7,0.0791301722,0.920869828,946.7175684,1003.858614,1629.027878,1969.885496,3311,93.66336634,6622,-1561088,134144,-1426944,61
2964,278,23,7,0.0857495373,0.914250463,923.8735679,1012.726508,1594.831646,1905.834532,3242,79.63645296,6484,-1517568,142336,-1375232,61
3009,277,23,7,0.0842970177,0.915702982,939.151151,1011.366254,1620.120638,1897.465704,3286,84.88762594,6572,-1540608,141824,-1398784,61
2937,262,23,7,0.0819005939,0.918099406,918.2841685,956.1074306,1581.715356,1804.969466,3199,63.23384068,6398,-1503744,134144,-1369600,61
2978,275,23,7,0.0845373501,0.91546265,929.1579244,998.50034,1601.215581,1906.221818,3253,78.25354823,6506,-1524736,140800,-1383936,61
2962,280,22,8,0.0863664405,0.91363356,925.4162071,1013.294795,1600.263673,1846.15,3242,77.89524267,6484,-1516544,143360,-1373184,61
1049,76,23,7,0.0675555556,0.932444444,319.9432287,384.5742859,564.4480458,543.0131579,1125,18.0201826,2250,-537088,38912,-498176,61
2622,263,23,7,0.0911611785,0.908838821,821.0459424,903.4674998,1417.410755,1698.114068,2885,72.43283957,5770,-1342464,134656,-1207808,61
2677,272,23,7,0.0922346558,0.907765344,837.448425,955.4777168,1455.149047,1670.371324,2949,81.39663262,5898,-1370624,139264,-1231360,61
2756,268,23,7,0.0886243386,0.911375661,861.7517583,958.4890962,1493.21045,1710.865672,3024,74.48275862,6048,-1411072,137216,-1273856,61
2616,267,23,7,0.0926118626,0.907388137,820.3134829,903.5184371,1416.356269,1693.250936,2883,74.55391777,5766,-1339392,136704,-1202688,61
2684,259,23,7,0.0880054366,0.911994563,838.9180144,916.4318563,1447.912072,1721.621622,2943,74.60076046,5886,-1374208,132608,-1241600,61
2705,268,23,7,0.090144635,0.909855365,847.5319495,939.6829523,1468.63549,1672.358209,2973,75.39944205,5946,-1384960,137216,-1247744,61
2688,270,23,7,0.0912778905,0.90872211,840.3042504,951.1053837,1457.274182,1700.77037,2958,75.57485948,5916,-1376256,138240,-1238016,61
2623,262,21,9,0.0908145581,0.909185442,821.9277765,920.1094617,1427.184522,1601.335878,2885,70.72811964,5770,-1342976,134144,-1208832,61
3059,302,23,7,0.0898542101,0.91014579,950.6611127,1121.35908,1657.023537,1923.860927,3361,58.77929346,6722,-1566208,154624,-1411584,61
2635,267,21,9,0.0920055134,0.907994487,825.2090241,925.8794828,1429.883871,1664.827715,2902,76.44889357,5804,-1349120,136704,-1212416,61
2628,254,23,7,0.0881332408,0.911866759,820.3053657,914.4807116,1419.825342,1665.755906,2882,81.57373337,5764,-1345536,130048,-1215488,61
2589,252,23,7,0.0887011616,0.911298838,808.6370098,901.7077595,1399.855929,1638.230159,2841,71.47169811,5682,-1325568,129024,-1196544,61
2596,252,23,7,0.0884831461,0.911516854,811.4351453,884.6348427,1399.355932,1683.52381,2848,71.79228636,5696,-1329152,129024,-1200128,61
2604,261,22,8,0.0910994764,0.908900524,813.2976533,941.4203229,1418.544931,1577.218391,2865,67.17467761,5730,-1333248,133632,-1199616,61
2616,263,23,7,0.0913511636,0.908648836,819.349889,918.8622006,1421.01682,1628.821293,2879,80.28443949,5758,-1339392,134656,-1204736,61
2773,279,23,7,0.0914154653,0.908584535,867.5664906,972.7990575,1502.240173,1767.620072,3052,79.21100441,6104,-1419776,142848,-1276928,61
2649,269,23,7,0.0921864291,0.907813571,831.3493689,920.152093,1439.145338,1659.944238,2918,75.73319491,5836,-1356288,137728,-1218560,61
2691,280,23,7,0.0942443622,0.905755638,844.1465273,934.6970984,1457.500186,1759.903571,2971,68.75723212,5942,-1377792,143360,-1234432,61
2639,254,23,7,0.0877981334,0.912201867,824.401742,900.546176,1422.406972,1702.515748,2893,75.39744592,5786,-1351168,130048,-1221120,61
1110,102,21,9,0.0841584158,0.915841584,344.008396,405.6335621,610.5927928,561.9607843,1212,19.02370115,2424,-568320,52224,-516096,61
2873,340,21,9,0.105820106,0.894179894,893.6216987,1157.911337,1584.323007,1798.620588,3213,68.18760611,6426,-1470976,174080,-1296896,61
2832,326,20,10,0.103229892,0.896770108,878.8875942,1147.145874,1562.429732,1727.791411,3158,61.70379054,6316,-1449984,166912,-1283072,61
2840,324,21,9,0.102402023,0.897597977,881.2910163,1130.047936,1555.622535,1818.092593,3164,59.10704278,6328,-1454080,165888,-1288192,61
2818,327,20,10,0.103974563,0.896025437,876.192625,1124.871905,1549.403478,1776.348624,3145,65.83629893,6290,-1442816,167424,-1275392,61
2849,344,21,9,0.107735672,0.892264328,886.3228793,1158.148424,1574.580555,1782.677326,3193,72.84964636,6386,-1458688,176128,-1282560,61
2546,236,21,9,0.0848310568,0.915168943,786.0489051,968.0784704,1391.72663,1389.055085,2782,70.60913706,5564,-1303552,120832,-1182720,61
2891,336,21,9,0.104121475,0.895878525,898.9548179,1155.756836,1590.543411,1815.824405,3227,69.53242836,6454,-1480192,172032,-1308160,61
2907,356,21,9,0.109102053,0.890897947,913.4303893,1131.457092,1609.141039,1818.660112,3263,67.54295177,6526,-1488384,182272,-1306112,61
2869,335,21,9,0.104556804,0.895443196,895.0914825,1123.837442,1576.047752,1829.041791,3204,65.6019656,6408,-1468928,171520,-1297408,61
3087,325,21,9,0.0952520516,0.904747948,959.2667774,1181.257589,1684.276968,1917.584615,3412,67.05974843,6824,-1580544,166400,-1414144,61
3151,393,21,9,0.110891648,0.889108352,986.4085217,1233.474909,1732.482069,2093.356234,3544,75.79127459,7088,-1613312,201216,-1412096,61
3782,374,20,10,0.0899903754,0.910009625,1185.733037,1332.404283,2074.503437,2118.914439,4156,91.98760514,8312,-1936384,191488,-1744896,61
242,52,20,10,0.176870748,0.823129252,84.17586719,80.89214091,154.268595,116,294,5.338659887,588,-123904,26624,-97280,61
2832,338,20,10,0.106624606,0.893375394,882.5589804,1133.136289,1561.959393,1782.739645,3170,59.00967982,6340,-1449984,173056,-1276928,61
2797,328,20,10,0.10496,0.89504,874.5660682,1068.632713,1529.878799,1845.439024,3125,59.08489317,6250,-1432064,167936,-1264128,61
3053,316,21,9,0.0937963787,0.906203621,951.9619963,1151.506352,1679.960367,1733.689873,3369,71.03099304,6738,-1563136,161792,-1401344,61
2968,344,21,9,0.103864734,0.896135266,924.3376859,1175.949554,1632.855121,1860.505814,3312,67.66087845,6624,-1519616,176128,-1343488,61
2644,245,21,9,0.0848044306,0.915195569,820.0563317,955.0929382,1460.834342,1274.118367,2889,151.494494,5778,-1353728,125440,-1228288,61
3729,404,21,9,0.0977498185,0.902250181,1171.853014,1363.8069,2050.034326,2223.596535,4133,85.78248236,8266,-1909248,206848,-1702400,61
2831,337,21,9,0.106376263,0.893623737,881.7344609,1138.152163,1563.230661,1763.175074,3168,66.05504587,6336,-1449472,172544,-1276928,61
2269,228,20,10,0.0913095715,0.908690429,699.0863305,889.3415685,1230.878801,1429.337719,2497,56.06196677,4994,-1161728,116736,-1044992,61
5191,1057,20,10,0.169174136,0.830825864,1832.792219,1568.815744,3027.816798,3599.317881,6248,111.5714286,12496,-2657792,541184,-2116608,61
2374,254,21,9,0.096651446,0.903348554,734.0795075,939.5258463,1295.351727,1493.468504,2628,55.78433454,5256,-1215488,130048,-1085440,61
2145,227,20,10,0.0956998314,0.904300169,662.762798,849.6151841,1170.018648,1342.237885,2372,45.35372849,4744,-1098240,116224,-982016,61
4453,897,21,9,0.167663551,0.832336449,1541.191436,1384.67465,2543.33236,3331.623188,5350,96.88518653,10700,-2279936,459264,-1820672,61
2236,193,21,9,0.0794565665,0.920543434,689.1059077,826.3291358,1219.91458,1158.062176,2429,41.82882728,4858,-1144832,98816,-1046016,61
2126,239,20,10,0.101057082,0.898942918,659.1396233,845.1823115,1163.581373,1355.736402,2365,53.88471178,4730,-1088512,122368,-966144,61
2106,220,21,9,0.0945829751,0.905417025,650.8805384,830.1384611,1148.687085,1305.3,2326,48.67127014,4652,-1078272,112640,-965632,61
2995,271,21,9,0.0829761176,0.917023882,930.4369139,1065.5531,1624.962604,1727.852399,3266,59.45749135,6532,-1533440,138752,-1394688,61
2141,233,21,9,0.098146588,0.901853412,662.7520775,852.3055571,1171.922466,1330.639485,2374,55.36380597,4748,-1096192,119296,-976896,61
2367,253,21,9,0.0965648855,0.903435115,732.4498634,931.78471,1291.114068,1491.869565,2620,54.75444096,5240,-1211904,129536,-1082368,61
2102,228,20,10,0.0978540773,0.902145923,649.3102826,836.2827957,1145.673644,1348.285088,2330,42.73661042,4660,-1076224,116736,-959488,61
2296,246,21,9,0.0967741935,0.903225806,709.8957717,912.6491703,1254.517422,1430.004065,2542,58.02328236,5084,-1175552,125952,-1049600,61
3044,285,20,10,0.0856112947,0.914388705,946.5705033,1097.485063,1654.782194,1774.133333,3329,59.11916178,6658,-1558528,145920,-1412608,61
3000,280,20,10,0.0853658537,0.914634146,933.7951285,1074.233158,1633.762,1712.692857,3280,57.57416184,6560,-1536000,143360,-1392640,61
3809,443,21,9,0.104186265,0.895813735,1214.178667,1302.841913,2093.88816,2406.902935,4252,77.47813411,8504,-1950208,226816,-1723392,61
2316,218,21,9,0.0860299921,0.913970008,715.6272407,882.3036546,1265.105786,1292.93578,2534,46.32541133,5068,-1185792,111616,-1074176,61
2059,227,21,9,0.0993000875,0.900699913,636.9570661,820.3563503,1124.633317,1314.629956,2286,48.3400296,4572,-1054208,116224,-937984,61
2222,241,21,9,0.0978481527,0.902151847,687.6934856,872.1842136,1210.032403,1434.539419,2463,44.86338798,4926,-1137664,123392,-1014272,61
3019,310,21,9,0.0931210574,0.906878943,942.5487545,1099.934051,1641.920503,1889.764516,3329,59.10866477,6658,-1545728,158720,-1387008,61
4392,479,21,9,0.0983370971,0.901662903,1397.414847,1462.360217,2410.022313,2674.192067,4871,102.310439,9742,-2248704,245248,-2003456,62
4920,742,19,11,0.131049099,0.868950901,1610.925632,1694.261506,2753.49878,3348.704852,5662,165.6524283,11324,-2519040,379904,-2139136,62
4468,490,21,9,0.0988301735,0.901169827,1422.292773,1492.830962,2455.524843,2698.114286,4958,103.8542103,9916,-2287616,250880,-2036736,62
3922,512,21,9,0.115471358,0.884528642,1278.911986,1271.320395,2191.99592,2412.865234,4434,84.89373923,8868,-2008064,262144,-1745920,62
2358,241,20,10,0.0927279723,0.907272028,749.2797841,750.9427384,1311.296014,1189.477178,2599,45.66057625,5198,-1207296,123392,-1083904,62
5605,2606,21,9,0.317379126,0.682620874,1966.654078,1997.967122,3214.018555,6024.478895,8211,155.954416,16422,-2869760,1334272,-1535488,62
4163,478,19,11,0.102995044,0.897004956,1333.545663,1384.12478,2304.381696,2465.732218,4641,81.98198198,9282,-2131456,244736,-1886720,62
4830,502,19,11,0.0941485371,0.905851463,1525.000652,1656.625749,2645.780331,2865.854582,5332,104.5080361,10664,-2472960,257024,-2215936,62
5760,877,19,11,0.132138014,0.867861986,1911.808028,1847.679863,3233.813542,3878.491448,6637,118.3698948,13274,-2949120,449024,-2500096,62
4470,505,20,10,0.101507538,0.898492462,1422.592839,1537.595314,2466.151007,2681.39604,4975,115.5632985,9950,-2288640,258560,-2030080,62
931,90,21,9,0.0881488737,0.911851126,285.4083865,348.0482734,524.603652,370.2777778,1021,20.72675599,2042,-476672,46080,-430592,62
4085,481,19,11,0.105343846,0.894656154,1313.098182,1345.077443,2261.311628,2471.939709,4566,99.52048823,9132,-2091520,246272,-1845248,62
4893,795,20,10,0.139767932,0.860232068,1611.232368,1674.548105,2737.121602,3505.383648,5688,175.9356635,11376,-2505216,407040,-2098176,62
4098,492,20,10,0.107189542,0.892810458,1322.017391,1337.614713,2275.005857,2466.20122,4590,97.47292419,9180,-2098176,251904,-1846272,62
4162,489,21,9,0.10513868,0.89486132,1335.09638,1396.084762,2308.33926,2476.314928,4651,97.60755509,9302,-2130944,250368,-1880576,62
4067,498,21,9,0.109090909,0.890909091,1312.658375,1349.914328,2264.788542,2431.726908,4565,81.91279383,9130,-2082304,254976,-1827328,62
4084,505,19,11,0.110045762,0.889954238,1316.913333,1370.253895,2270.445642,2493.574257,4589,84.32561558,9178,-2091008,258560,-1832448,62
5894,1878,20,10,0.241636644,0.758363356,1948.675069,2021.037014,3276.734136,5800.21672,7772,139.8344728,15544,-3017728,961536,-2056192,62
3921,492,21,9,0.111488783,0.888511217,1272.450553,1283.296382,2197.900536,2279.518293,4413,120.2452316,8826,-2007552,251904,-1755648,62
1213,140,20,10,0.103473762,0.896526238,381.7955072,431.0563991,694.4542457,525.7714286,1353,26.29226584,2706,-621056,71680,-549376,62
7840,2030,23,7,0.205673759,0.794326241,2606.839485,2818.057135,4405.026403,6984.225616,9870,317.6697779,19740,-4014080,1039360,-2974720,62
7222,2661,23,7,0.269250228,0.730749772,2406.989051,2530.970215,4045.551371,7374.977076,9883,225.9487883,19766,-3697664,1362432,-2335232,62
5657,644,23,7,0.102205999,0.897794001,1800.911146,1918.695898,3102.701432,3575.262422,6301,130.5636138,12602,-2896384,329728,-2566656,62
5600,634,22,8,0.101700353,0.898299647,1774.185073,2001.626818,3097.615893,3293.132492,6234,111.0042735,12468,-2867200,324608,-2542592,62
5732,624,24,6,0.0981749528,0.901825047,1816.538731,1922.586355,3123.468248,3684.016026,6356,129.9529749,12712,-2934784,319488,-2615296,62
5620,644,24,6,0.102809706,0.897190294,1787.293036,1950.162836,3094.187722,3466.840062,6264,114.5155393,12528,-2877440,329728,-2547712,62
7633,2251,23,7,0.227741805,0.772258195,2535.867652,2643.038449,4259.012577,7260.163039,9884,350.7452094,19768,-3908096,1152512,-2755584,62
7744,2134,24,6,0.216035635,0.783964365,2573.293082,2670.428473,4318.516529,7192.965792,9878,398.4671238,19756,-3964928,1092608,-2872320,62
5703,596,23,7,0.0946181934,0.905381807,1798.62452,1932.400166,3099.737331,3630.95302,6299,123.0513772,12598,-2919936,305152,-2614784,62
5563,593,22,8,0.0963287849,0.903671215,1754.918251,1949.739622,3047.933489,3365.247892,6156,120.5404347,12312,-2848256,303616,-2544640,62
7753,2121,23,7,0.214806563,0.785193437,2573.122767,2666.956838,4319.055462,7198.132013,9874,286.4519872,19748,-3969536,1085952,-2883584,62
121,89,23,7,0.423809524,0.576190476,60.48340769,56.65835482,93.17355372,122.258427,210,10.15965167,420,-61952,45568,-16384,62
5527,562,22,8,0.0922975858,0.907702414,1738.065007,1878.579731,2997.826488,3508.928826,6089,125.8838123,12178,-2829824,287744,-2542080,62
5653,620,22,8,0.0988362825,0.901163718,1792.76957,1923.036517,3093.382275,3534.695161,6273,122.4238876,12546,-2894336,317440,-2576896,62
5749,693,24,6,0.107575287,0.892424713,1833.442474,2003.862026,3165.06662,3689.660895,6442,112.6026918,12884,-2943488,354816,-2588672,62
5678,625,23,7,0.0991591306,0.900840869,1800.970228,1941.745621,3111.485911,3520.0624,6303,121.188233,12606,-2907136,320000,-2587136,62
7401,1302,23,7,0.149603585,0.850396415,2457.69758,2517.787296,4152.232266,5487.546083,8703,158.1788441,17406,-3789312,666624,-3122688,62
5600,623,23,7,0.100112486,0.899887514,1766.456174,2024.455623,3080.602321,3394.226324,6223,110.493608,12446,-2867200,318976,-2548224,62
5677,647,22,8,0.102308665,0.897691335,1801.736571,1980.374886,3118.006341,3552.902628,6324,120.7792208,12648,-2906624,331264,-2575360,62
5703,672,24,6,0.105411765,0.894588235,1821.035737,1967.408274,3150.249693,3508.372024,6375,118.3184855,12750,-2919936,344064,-2575872,62
9250,686,22,8,0.069041868,0.930958132,2814.419136,3479.385986,4932.887784,5448.693878,9936,677.7626194,19872,-4736000,351232,-4384768,62
9231,706,22,8,0.0710475999,0.9289524,2814.642721,3474.24027,4939.040841,5360.71813,9937,558.8863892,19874,-4726272,361472,-4364800,62
9243,691,22,8,0.06955909,0.93044091,2819.68348,3419.350764,4936.521476,5381.87699,9934,801.7756255,19868,-4732416,353792,-4378624,62
9263,674,23,7,0.0678273121,0.932172688,2818.47272,3440.996786,4930.307892,5500.75816,9937,524.1033755,19874,-4742656,345088,-4397568,62
9243,694,22,8,0.0698399919,0.930160008,2822.233761,3389.355884,4932.613654,5453.60951,9937,565.2445961,19874,-4732416,355328,-4377088,62
9236,700,24,6,0.0704508857,0.929549114,2819.994598,3400.150243,4929.173777,5487.381429,9936,459.3619972,19872,-4728832,358400,-4370432,62
9245,691,23,7,0.0695450886,0.930454911,2819.338553,3432.216757,4938.70146,5367.17945,9936,423.7100213,19872,-4733440,353792,-4379648,62
9263,675,23,7,0.0679211109,0.932078889,2822.637769,3423.727896,4945.328619,5301.202963,9938,397.3610556,19876,-4742656,345600,-4397056,62
9203,729,24,6,0.073399114,0.926600886,2813.309007,3438.588662,4927.964142,5452.982167,9932,616.1290323,19864,-4711936,373248,-4338688,62
9219,708,23,7,0.0713206407,0.928679359,2816.789514,3429.574235,4944.769932,5214.398305,9927,404.8531811,19854,-4720128,362496,-4357632,62
9223,713,23,7,0.0717592593,0.928240741,2815.46677,3439.070115,4928.915971,5480.538569,9936,594.6140036,19872,-4722176,365056,-4357120,62
9280,657,23,7,0.0661165342,0.933883466,2835.058693,3276.817205,4939.140733,5390.756469,9937,533.3870102,19874,-4751360,336384,-4414976,62
9221,715,23,7,0.0719605475,0.928039452,2823.321785,3379.737483,4944.398005,5279.331469,9936,271.9211823,19872,-4721152,366080,-4355072,62
9215,717,24,6,0.0721908981,0.927809102,2813.164684,3447.15284,4927.08497,5473.06834,9932,656.010568,19864,-4718080,367104,-4350976,62
9266,674,23,7,0.067806841,0.932193159,2818.855779,3461.890154,4938.781135,5406.563798,9940,541.0996189,19880,-4744192,345088,-4399104,62
9259,679,24,6,0.0683236064,0.931676394,2820.093363,3423.342542,4931.14224,5492.555228,9938,580.1517805,19876,-4740608,347648,-4392960,62
9253,683,23,7,0.0687399356,0.931260064,2817.891123,3436.239652,4929.444829,5497.603221,9936,477.9220779,19872,-4737536,349696,-4387840,62
9231,705,22,8,0.0709541063,0.929045894,2809.370813,3514.352816,4931.297151,5455.619858,9936,537.3715522,19872,-4726272,360960,-4365312,62
5323,312,23,7,0.0553682343,0.944631766,1620.156235,1509.518069,2866.642495,1988.115385,5635,90.4639589,11270,-2725376,159744,-2565632,62
5257,296,24,6,0.0533045201,0.94669548,1588.053396,1571.356868,2830.349819,1829.5,5553,78.35473402,11106,-2691584,151552,-2540032,62
6150,620,22,8,0.0915805022,0.908419498,1926.06804,2179.822211,3347.592846,3761.514516,6770,163.0146882,13540,-3148800,317440,-2831360,62
6248,612,22,8,0.089212828,0.910787172,1951.144845,2218.591889,3391.941741,3824.147059,6860,124.1404271,13720,-3198976,313344,-2885632,62
8236,1642,22,8,0.166227981,0.833772019,2671.352452,2915.130062,4548.012992,6903.133983,9878,275.0765803,19756,-4216832,840704,-3376128,62
6280,647,22,8,0.0934026274,0.906597373,1970.375939,2240.298797,3431.787261,3776.667697,6927,137.9056341,13854,-3215360,331264,-2884096,62
6125,632,21,9,0.0935326328,0.906467367,1916.478203,2248.228808,3362.506286,3538.848101,6757,215.1225724,13514,-3136000,323584,-2812416,62
6243,646,22,8,0.0937726811,0.906227319,1962.309281,2199.457387,3410.275509,3780.580495,6889,130.7458721,13778,-3196416,330752,-2865664,62
8001,1885,21,9,0.19067368,0.80932632,2578.712973,2774.50131,4391.185102,7287.835013,9886,291.9669226,19772,-4096512,965120,-3131392,62
8208,1675,22,8,0.169482951,0.830517049,2675.930473,2984.340782,4568.663012,6771.462687,9883,382.0255122,19766,-4202496,857600,-3344896,62
6304,609,22,8,0.0880948937,0.911905106,1960.549654,2263.740007,3406.998255,3974.587849,6913,146.0595817,13826,-3227648,311808,-2915840,62
5324,435,22,8,0.0755339469,0.924466053,1640.751599,1905.867051,2887.840533,2784.03908,5759,148.9268167,11518,-2725888,222720,-2503168,62
6207,639,22,8,0.0933391762,0.906660824,1945.989359,2209.953956,3382.444015,3822.302034,6846,134.8699764,13692,-3177984,327168,-2850816,62
8090,1788,22,8,0.181008301,0.818991699,2627.859108,2952.720014,4494.137824,6954.589485,9878,350.2836879,19756,-4142080,915456,-3226624,62
8210,1671,21,9,0.169112438,0.830887562,2636.812751,2960.830358,4518.588672,7016.402154,9881,351.5119175,19762,-4203520,855552,-3347968,62
8016,1863,22,8,0.18858184,0.81141816,2570.201941,2821.778944,4396.469561,7278.668814,9879,303.3159349,19758,-4104192,953856,-3150336,62
8701,1181,22,8,0.119510221,0.880489779,2824.310145,2886.585827,4814.62556,5876.245555,9882,479.0111488,19764,-4454912,604672,-3850240,62
6238,642,22,8,0.0933139535,0.906686047,1960.759361,2187.956347,3405.356525,3781.971963,6880,135.7269678,13760,-3193856,328704,-2865152,62
6185,651,22,8,0.0952311293,0.904768871,1941.812427,2227.835112,3386.005497,3727.222734,6836,171.1567351,13672,-3166720,333312,-2833408,62
6244,616,22,8,0.0897959184,0.910204082,1956.757021,2178.719387,3398.607944,3753.769481,6860,134.5889739,13720,-3196928,315392,-2881536,62
8083,1798,22,8,0.181965388,0.818034612,2604.745932,2915.393774,4460.151305,7102.679644,9881,340.7241379,19762,-4138496,920576,-3217920,62
6189,617,22,8,0.0906553041,0.909344696,1934.935734,2224.813722,3377.375343,3665.551053,6806,179.9576943,13612,-3168768,315904,-2852864,62
4594,564,23,7,0.109344707,0.890655293,1489.457268,1433.593018,2534.557031,2945.578014,5158,108.270361,10316,-2352128,288768,-2063360,62
4459,581,22,8,0.115277778,0.884722222,1448.132142,1468.790223,2479.714061,2833.519793,5040,110.0917431,10080,-2283008,297472,-1985536,62
4463,565,24,6,0.112370724,0.887629276,1449.627655,1432.086926,2477.197177,2809.159292,5028,112.2572003,10056,-2285056,289280,-1995776,62
5676,2386,23,7,0.295956338,0.704043662,1930.050385,2009.657231,3211.795102,5981.476949,8062,146.7686146,16124,-2906112,1221632,-1684480,62
4416,558,23,7,0.112183353,0.887816647,1434.769635,1412.796425,2451.637455,2771.315412,4974,106.0554371,9948,-2260992,285696,-1975296,62
4446,562,23,7,0.112220447,0.887779553,1444.652811,1397.868697,2456.923077,2880.882562,5008,110.9191584,10016,-2276352,287744,-1988608,62
3465,346,23,7,0.0907898189,0.909210181,1087.475003,1218.298126,1911.666089,1849.257225,3811,70.06802721,7622,-1774080,177152,-1596928,62
4445,563,23,7,0.112420128,0.887579872,1440.555271,1439.028392,2460.478515,2852.058615,5008,105.9221658,10016,-2275840,288256,-1987584,62
4426,573,23,7,0.114622925,0.885377075,1442.216944,1407.854111,2457.830095,2825.731239,4999,109.2677596,9998,-2266112,293376,-1972736,62
4439,578,22,8,0.115208292,0.884791708,1439.485525,1470.699769,2464.89412,2847.730104,5017,116.2957812,10034,-2272768,295936,-1976832,62
4440,559,23,7,0.111822364,0.888177636,1442.621386,1401.471201,2457.375676,2838.554562,4999,105.6201141,9998,-2273280,286208,-1987072,62
5616,2337,22,8,0.293851377,0.706148623,1910.444418,1982.576444,3176.853276,5899.817287,7953,138.2649513,15906,-2875392,1196544,-1678848,62
4437,568,24,6,0.113486513,0.886513487,1436.847039,1476.536987,2467.490421,2780.387324,5005,96.23149394,10010,-2271744,290816,-1980928,62
5650,918,23,7,0.139768575,0.860231425,1874.412552,1862.477876,3165.132035,4019.172113,6568,116.4745522,13136,-2892800,470016,-2422784,62
4553,589,23,7,0.114546869,0.885453131,1480.312484,1466.110186,2524.859873,2932.03056,5142,109.2415551,10284,-2331136,301568,-2029568,62
4434,556,24,6,0.111422846,0.888577154,1436.984401,1423.03589,2452.816644,2835.892086,4990,106.0573858,9980,-2270208,284672,-1985536,62
4527,578,23,7,0.113222331,0.886777669,1469.023767,1474.700662,2514.137177,2857.380623,5105,100.4328153,10210,-2317824,295936,-2021888,62
4492,549,23,7,0.108906963,0.891093037,1449.183769,1459.265554,2479.175423,2863.214936,5041,102.2930195,10082,-2299904,281088,-2018816,62
4408,548,23,7,0.110573043,0.889426957,1428.235368,1407.363648,2437.508848,2808.224453,4956,112.0759837,9912,-2256896,280576,-1976320,62
4420,543,23,7,0.109409631,0.890590369,1423.430055,1466.971719,2442.514027,2803.414365,4963,90.84751968,9926,-2263040,278016,-1985024,62
6414,498,21,9,0.0720486111,0.927951389,1964.432082,2346.685535,3473.18787,3241.568273,6912,143.7903058,13824,-3283968,254976,-3028992,62
6472,502,21,9,0.0719816461,0.928018354,1985.62382,2315.596573,3512.707046,3162.51992,6974,143.5274748,13948,-3313664,257024,-3056640,62
6688,495,21,9,0.0689127106,0.931087289,2043.195049,2433.147777,3610.624402,3340.363636,7183,133.0185185,14366,-3424256,253440,-3170816,62
6500,490,22,8,0.0701001431,0.929899857,1990.216272,2350.987345,3503.848769,3384.75102,6990,127.8113001,13980,-3328000,250880,-3077120,62
6400,490,21,9,0.0711175617,0.928882438,1959.141004,2343.613857,3448.600156,3405.008163,6890,131.9670561,13780,-3276800,250880,-3025920,62
6381,503,22,8,0.0730679837,0.926932016,1955.788237,2338.367772,3460.197931,3217.986083,6884,157.8537033,13768,-3267072,257536,-3009536,62
6571,512,22,8,0.0722857546,0.927714245,2019.166374,2337.536826,3558.381829,3331.755859,7083,157.5400356,14166,-3364352,262144,-3102208,62
6542,491,21,9,0.0698137352,0.930186265,2002.892388,2350.86637,3535.537603,3270.008147,7033,153.8276465,14066,-3349504,251392,-3098112,62
6350,519,21,9,0.0755568496,0.92444315,1945.500485,2393.553705,3437.317953,3406.639692,6869,124.2808033,13738,-3251200,265728,-2985472,62
6394,492,21,9,0.0714493175,0.928550683,1959.804175,2321.323467,3443.22177,3447.115854,6886,137.2807018,13772,-3273728,251904,-3021824,62
7523,750,21,9,0.090656352,0.909343648,2343.600787,2693.44176,4065.466037,4854.533333,8273,190.2713891,16546,-3851776,384000,-3467776,62
5455,341,22,8,0.0588336784,0.941166322,1655.217575,1786.32047,2944.040697,2169.982405,5796,158.5772914,11592,-2792960,174592,-2618368,62
6474,497,21,9,0.0712953665,0.928704633,1983.362495,2357.643625,3485.344918,3494.533199,6971,145.5323591,13942,-3314688,254464,-3060224,62
6988,751,21,9,0.0970409614,0.902959039,2167.13337,2690.455896,3798.284345,4537.308921,7739,197.5746745,15478,-3577856,384512,-3193344,62
7056,725,21,9,0.0931756844,0.906824316,2180.466891,2701.375989,3816.547336,4615.604138,7781,146.0123851,15562,-3612672,371200,-3241472,62
6380,512,21,9,0.0742890308,0.925710969,1961.010882,2286.422528,3474.916144,3092.408203,6892,128.6060832,13784,-3266560,262144,-3004416,62
6429,521,21,9,0.0749640288,0.925035971,1975.685085,2345.538294,3488.445015,3315.761996,6950,139.7546752,13900,-3291648,266752,-3024896,62
6345,498,22,8,0.0727750986,0.927224901,1945.607728,2317.933827,3432.124507,3293.004016,6843,124.7584321,13686,-3248640,254976,-2993664,62
6460,501,22,8,0.0719724178,0.928027582,1983.884696,2304.564838,3496.713003,3278.393214,6961,138.499801,13922,-3307520,256512,-3051008,62
6486,510,21,9,0.0728987993,0.927101201,1990.913394,2346.474953,3512.539161,3319.954902,6996,153.5894621,13992,-3320832,261120,-3059712,62
4666,553,23,7,0.105958996,0.894041004,1499.342304,1543.217799,2579.873982,2864.191682,5219,119.4005948,10438,-2388992,283136,-2105856,62
4721,541,23,7,0.102812619,0.897187381,1507.744147,1586.802299,2599.489939,2910.833641,5262,109.7622028,10524,-2417152,276992,-2140160,62
4862,647,23,7,0.117444182,0.882555818,1580.725779,1659.718491,2748.336693,2805.072643,5509,107.7871258,11018,-2489344,331264,-2158080,62
4776,545,23,7,0.102424356,0.897575644,1530.042935,1552.248164,2624.966499,2976.772477,5321,107.213379,10642,-2445312,279040,-2166272,62
3143,260,23,7,0.0764031737,0.923596826,974.6926829,1019.25182,1728.07636,1386.776923,3403,65.14165391,6806,-1609216,133120,-1476096,62
4629,523,23,7,0.101513975,0.898486025,1474.106863,1546.659679,2533.080795,2960.797323,5152,117.571885,10304,-2370048,267776,-2102272,62
4683,538,23,7,0.103045394,0.896954606,1501.290975,1511.070819,2569.961563,2968.217472,5221,118.6590909,10442,-2397696,275456,-2122240,62
4697,524,22,8,0.100363915,0.899636085,1502.173607,1526.571031,2581.827975,2872.490458,5221,106.659857,10442,-2404864,268288,-2136576,62
4793,544,23,7,0.101929923,0.898070077,1530.831866,1581.995707,2629.20822,3019.591912,5337,111.3266583,10674,-2454016,278528,-2175488,62
4720,531,23,7,0.101123596,0.898876404,1508.962688,1543.988534,2592.512288,2923.66855,5251,112.2968349,10502,-2416640,271872,-2144768,62
4662,549,23,7,0.105354059,0.894645941,1495.84276,1541.094239,2570.250536,2909.577413,5211,111.6323907,10422,-2386944,281088,-2105856,62
4691,542,23,7,0.103573476,0.896426524,1504.968939,1521.429283,2579.868685,2938.370849,5233,115.5187638,10466,-2401792,277504,-2124288,62
4693,555,23,7,0.105754573,0.894245427,1504.018928,1573.041439,2589.108459,2923.765766,5248,102.7810419,10496,-2402816,284160,-2118656,62
4618,544,23,7,0.105385509,0.894614491,1475.756488,1586.414986,2552.88155,2824.441176,5162,106.235851,10324,-2364416,278528,-2085888,62
5318,598,23,7,0.101081812,0.898918188,1690.619991,1732.97565,2888.372697,3582.140468,5916,147.6416272,11832,-2722816,306176,-2416640,62
3635,400,23,7,0.0991325898,0.90086741,1145.579625,1307.318834,1994.340028,2233.01,4035,137.5255624,8070,-1861120,204800,-1656320,62
6295,927,23,7,0.128357796,0.871642204,2075.881469,2031.994219,3517.269738,4251.391586,7222,140.3147465,14444,-3223040,474624,-2748416,62
4668,547,23,7,0.104889741,0.895110259,1497.668885,1544.97464,2576.92138,2873.219378,5215,109.6740273,10430,-2390016,280064,-2109952,62
4660,538,23,7,0.103501347,0.896498653,1497.205094,1491.047749,2562.46309,2920.302974,5198,106.7570343,10396,-2385920,275456,-2110464,62
3375,386,23,7,0.102632279,0.897367721,1094.390742,1005.035356,1887.070519,1827.92228,3761,65.63699825,7522,-1728000,197632,-1530368,62
4906,558,24,6,0.102122987,0.897877013,1570.051776,1585.792615,2687.497962,3128.163082,5464,121.0456358,10928,-2511872,285696,-2226176,62
4954,551,23,7,0.100090827,0.899909173,1579.537393,1643.391477,2719.847396,3051.072595,5505,113.622291,11010,-2536448,282112,-2254336,62
6188,2402,24,6,0.279627474,0.720372526,2158.915971,2125.942308,3525.455398,6279.278518,8590,171.9031419,17180,-3168256,1229824,-1938432,62
4800,555,23,7,0.103641457,0.896358543,1532.50169,1612.203878,2636.173333,3039.744144,5355,113.6218969,10710,-2457600,284160,-2173440,62
5348,757,23,7,0.123996724,0.876003276,1747.484222,1762.541145,2972.602842,3620.984148,6105,106.7681007,12210,-2738176,387584,-2350592,62
4867,556,24,6,0.102526277,0.897473723,1554.245578,1615.499283,2670.386686,3076.266187,5423,104.148262,10846,-2491904,284672,-2207232,62
6187,2394,23,7,0.278988463,0.721011537,2137.317032,2109.815373,3504.022305,6324.847536,8581,153.7538076,17162,-3167744,1225728,-1942016,62
5713,912,23,7,0.137660377,0.862339623,1871.828139,1917.513685,3168.953264,4215.345395,6625,117.652282,13250,-2925056,466944,-2458112,62
4834,532,23,7,0.0991427507,0.900857249,1542.835978,1556.143309,2642.782168,3053.481203,5366,115.1749302,10732,-2475008,272384,-2202624,62
5678,2295,23,7,0.287846482,0.712153518,1871.631373,1871.071671,3135.224727,6094.35512,7973,154.815534,15946,-2907136,1175040,-1732096,62
4855,566,23,7,0.104408781,0.895591219,1557.723171,1598.250149,2678.462616,2990.097173,5421,116.0813704,10842,-2485760,289792,-2195968,62
4856,573,22,8,0.105544299,0.894455701,1553.609129,1649.685258,2680.67257,3005.914485,5429,126.7865483,10858,-2486272,293376,-2192896,62
4839,579,23,7,0.106866002,0.893133998,1553.741917,1597.083744,2663.715644,3092.143351,5418,108.5119167,10836,-2477568,296448,-2181120,62
4889,536,23,7,0.0988018433,0.901198157,1559.552313,1563.340375,2667.144201,3131.26306,5425,117.3226644,10850,-2503168,274432,-2228736,62
4884,534,23,7,0.0985603544,0.901439646,1556.371211,1574.68035,2664.786855,3118.449438,5418,115.6456777,10836,-2500608,273408,-2227200,62
4855,551,24,6,0.101923788,0.898076212,1552.508159,1584.963496,2662.595675,3063.91833,5406,108.7288817,10812,-2485760,282112,-2203648,62
6453,2364,23,7,0.268118408,0.731881592,2204.136227,2126.531706,3617.475748,6569.620135,8817,176.8706118,17634,-3303936,1210368,-2093568,62
5659,2316,23,7,0.290407524,0.709592476,1880.866046,1953.698588,3158.491783,6014.851036,7975,206.0191165,15950,-2897408,1185792,-1711616,62
4902,566,22,8,0.103511339,0.896488661,1563.50988,1673.670909,2700.335781,3030.388693,5468,98.20402299,10936,-2509824,289792,-2220032,62
4860,544,23,7,0.100666173,0.899333827,1551.953755,1593.976049,2666.260494,3026.257353,5404,100.9338812,10808,-2488320,278528,-2209792,62
5415,1992,20,10,0.268934791,0.731065209,1842.124369,1978.589443,3085.965651,5384.048193,7407,130.0614574,14814,-2772480,1019904,-1752576,62
3912,481,20,10,0.109492374,0.890507626,1263.250271,1301.074402,2182.194785,2317.411642,4393,112.3529412,8786,-2002944,246272,-1756672,62
4010,479,21,9,0.10670528,0.89329472,1286.023192,1354.977252,2218.290025,2468.605428,4489,85.94677388,8978,-2053120,245248,-1807872,62
3362,320,21,9,0.0869092884,0.913090712,1049.947123,1190.245632,1843.810232,1817.228125,3682,64.31441048,7364,-1721344,163840,-1557504,62
4068,502,21,9,0.109846827,0.890153173,1306.43935,1390.590138,2252.745575,2550.928287,4570,79.07942551,9140,-2082816,257024,-1825792,62
4066,472,21,9,0.104010577,0.895989423,1304.439186,1323.671737,2236.640433,2552.565678,4538,88.01396431,9076,-2081792,241664,-1840128,62
5913,1853,22,8,0.238604172,0.761395828,1941.108776,1988.407644,3266.791815,5851.441446,7766,153.3873198,15532,-3027456,948736,-2078720,62
4139,495,21,9,0.106819163,0.893180837,1327.193703,1385.786418,2281.109447,2621.783838,4634,81.69957687,9268,-2119168,253440,-1865728,62
4075,470,21,9,0.103410341,0.896589659,1308.080492,1325.943734,2247.863067,2490.942553,4545,88.59649123,9090,-2086400,240640,-1845760,62
4347,482,21,9,0.099813626,0.900186374,1388.83701,1423.556942,2392.280193,2619.90249,4829,92.26213221,9658,-2225664,246784,-1978880,62
4272,468,21,9,0.0987341772,0.901265823,1361.510991,1410.892395,2346.931414,2585.638889,4740,93.5834156,9480,-2187264,239616,-1947648,62
4068,458,21,9,0.101193106,0.898806894,1300.950889,1335.729601,2239.064159,2480.541485,4526,87.18936621,9052,-2082816,234496,-1848320,62
4411,485,21,9,0.0990604575,0.900939542,1407.987022,1445.796588,2426.375652,2649.717526,4896,97.16213534,9792,-2258432,248320,-2010112,62
5861,1885,20,10,0.243351407,0.756648593,1927.390443,1995.246725,3246.991298,5821.493369,7746,138.4945468,15492,-3000832,965120,-2035712,62
4073,480,20,10,0.105424995,0.894575005,1310.535574,1320.598662,2247.892708,2523.9875,4553,83.03848258,9106,-2085376,245760,-1839616,62
4075,478,21,9,0.104985724,0.895014276,1310.854128,1320.495993,2249.426012,2512.07113,4553,93.01327886,9106,-2086400,244736,-1841664,62
4084,499,21,9,0.108880646,0.891119354,1320.898063,1320.13728,2265.445642,2509.330661,4583,98.60154905,9166,-2091008,255488,-1835520,62
5827,1861,21,9,0.242065557,0.757934443,1926.411308,2009.624844,3242.401064,5729.739387,7688,149.3975904,15376,-2983424,952832,-2030592,62
4061,465,21,9,0.102739726,0.897260274,1303.139177,1317.478304,2239.515637,2472.963441,4526,90.70140281,9052,-2079232,238080,-1841152,62
2115,159,21,9,0.0699208443,0.930079156,651.1632853,698.688207,1150.998582,957.9433962,2274,55.6943424,4548,-1082880,81408,-1001472,62
3892,1258,23,7,0.244271845,0.755728155,1342.780821,1457.125316,2249.427287,3584.303657,5150,110.1368691,10300,-1992704,644096,-1348608,62
2516,309,23,7,0.109380531,0.890619469,805.4874949,890.2247652,1421.029809,1347.618123,2825,52.48978075,5650,-1288192,158208,-1129984,62
2493,313,23,7,0.111546686,0.888453314,798.3247859,892.3093523,1415.196951,1310.335463,2806,53.89934691,5612,-1276416,160256,-1116160,62
3206,535,23,7,0.14300989,0.85699011,1054.622776,1194.228752,1831.96912,2104.893458,3741,102.2969647,7482,-1641472,273920,-1367552,62
2547,318,23,7,0.110994764,0.889005236,815.9595662,910.5766413,1436.47232,1405.188679,2865,67.42763003,5730,-1304064,162816,-1141248,62
3361,609,24,6,0.153400504,0.846599496,1121.843429,1224.815067,1928.695626,2298.996716,3970,100.7102993,7940,-1720832,311808,-1409024,62
2506,331,23,7,0.116672541,0.883327459,806.9782719,903.9300692,1423.405427,1385.646526,2837,57.94526144,5674,-1283072,169472,-1113600,62
2510,310,23,7,0.109929078,0.890070922,806.3150441,873.6006852,1414.510359,1378.029032,2820,60.07669365,5640,-1285120,158720,-1126400,62
2524,311,23,7,0.109700176,0.890299824,809.3700128,888.2446194,1418.131141,1416.935691,2835,61.4967462,5670,-1292288,159232,-1133056,62
2505,325,23,7,0.114840989,0.885159011,804.5019702,905.4723387,1422.303393,1363.061538,2830,56.27361304,5660,-1282560,166400,-1116160,62
2504,319,23,7,0.113000354,0.886999646,804.8963726,886.3041303,1421.409345,1338.141066,2823,59.70812183,5646,-1282048,163328,-1118720,62
2544,323,23,7,0.112661318,0.887338682,817.7981302,900.9603941,1437.124214,1409.393189,2867,56.50374458,5734,-1302528,165376,-1137152,62
2512,323,24,6,0.113932981,0.886067019,807.0145127,898.3009927,1427.885748,1341.117647,2835,50.96171131,5670,-1286144,165376,-1120768,62
2509,311,23,7,0.110283688,0.889716312,803.858116,891.570437,1414.222001,1380.472669,2820,61.35770235,5640,-1284608,159232,-1125376,62
2529,314,23,7,0.110446711,0.889553289,810.9184779,894.1577104,1427.996441,1373.703822,2843,60.96933305,5686,-1294848,160768,-1134080,62
2509,332,22,8,0.11686026,0.88313974,808.2586494,902.2542909,1429.419689,1357.370482,2841,88.01115242,5682,-1284608,169984,-1114624,62
2402,305,23,7,0.112670853,0.887329147,771.5925895,851.8996526,1362.794338,1284.740984,2707,53.94579514,5414,-1229824,156160,-1073664,62
2534,321,22,8,0.112434326,0.887565674,813.1846603,904.1085646,1435.353591,1369.950156,2855,63.62825942,5710,-1297408,164352,-1133056,62
1191,143,22,8,0.107196402,0.892803598,374.8631046,400.5716425,693.5155332,450.8251748,1334,52.31372549,2668,-609792,73216,-536576,62
1178,147,23,7,0.110943396,0.889056604,374.4825904,386.4576011,688.1129032,461.755102,1325,54.05956752,2650,-603136,75264,-527872,62
5545,641,22,8,0.10362108,0.89637892,1761.015428,1926.227324,3040.190442,3554.656786,6186,182.370283,12372,-2839040,328192,-2510848,63
5556,689,22,8,0.110328263,0.889671737,1777.513364,1955.527943,3076.908387,3494.676343,6245,109.025838,12490,-2844672,352768,-2491904,63
5561,655,22,8,0.10537323,0.89462677,1770.113947,1939.312595,3059.422586,3525.170992,6216,185.6630824,12432,-2847232,335360,-2511872,63
5030,612,22,8,0.108472173,0.891527827,1612.307952,1737.370572,2790.887475,3073.102941,5642,156.5917291,11284,-2575360,313344,-2262016,63
5537,696,22,8,0.111663725,0.888336275,1770.770713,1957.732263,3062.010836,3554.46408,6233,142.0464904,12466,-2834944,356352,-2478592,63
5349,672,21,9,0.111609367,0.888390633,1716.95954,1867.391709,2970.732473,3331.522321,6021,173.5658691,12042,-2738688,344064,-2394624,63
5454,622,22,8,0.10236998,0.89763002,1730.854803,1895.667711,2991.418775,3451.33119,6076,160.9110169,12152,-2792448,318464,-2473984,63
5459,626,22,8,0.102875924,0.897124076,1732.294745,1918.97246,3002.03279,3400.252396,6085,152.8510425,12170,-2795008,320512,-2474496,63
5120,604,22,8,0.105520615,0.894479385,1634.735467,1765.760024,2826.520703,3167.490066,5724,156.9509186,11448,-2621440,309248,-2312192,63
5478,635,22,8,0.103876983,0.896123017,1739.900357,1914.097771,3008.025557,3479.491339,6113,180.4309327,12226,-2804736,325120,-2479616,63
5530,650,22,8,0.105177994,0.894822006,1761.861819,1932.368924,3052.489331,3413.883077,6180,158.0158527,12360,-2831360,332800,-2498560,63
5654,693,22,8,0.109185442,0.890814558,1805.926518,1998.730553,3130.314821,3530.415584,6347,116.5014684,12694,-2894848,354816,-2540032,63
5504,647,22,8,0.105186149,0.894813851,1754.430911,1920.082657,3040.292696,3379.760433,6151,184.5484548,12302,-2818048,331264,-2486784,63
5407,617,22,8,0.102423639,0.897576361,1714.40466,1915.097792,2978.287405,3312.317666,6024,171.9668855,12048,-2768384,315904,-2452480,63
5476,635,22,8,0.10391098,0.89608902,1736.712975,1936.567964,3008.360847,3466.822047,6111,170.5078125,12222,-2803712,325120,-2478592,63
4852,503,22,8,0.0939309057,0.906069094,1527.472205,1706.719318,2663.444147,2818.407555,5355,192.7645788,10710,-2484224,257536,-2226688,63
5380,650,22,8,0.107794362,0.892205638,1720.294469,1874.26595,2979.041264,3317.266154,6030,134.2087692,12060,-2754560,332800,-2421760,63
5684,676,22,8,0.106289308,0.893710692,1798.648246,2112.812371,3155.988564,3386.599112,6360,124.5105717,12720,-2910208,346112,-2564096,63
5317,644,22,8,0.108035565,0.891964435,1698.587315,1857.894508,2938.778823,3329.586957,5961,170.3629608,11922,-2722304,329728,-2392576,63
5349,607,22,8,0.101914036,0.898085964,1698.978562,1863.527926,2944.998691,3273.719934,5956,151.7452229,11912,-2738688,310784,-2427904,63
5081,682,22,8,0.118341142,0.881658858,1638.98911,1787.533972,2828.70557,3279.05132,5763,183.1849968,11526,-2601472,349184,-2252288,63
5013,673,22,8,0.118360886,0.881639114,1622.183826,1739.17224,2796.876521,3190.786033,5686,190.8694193,11372,-2566656,344576,-2222080,63
5084,683,22,8,0.118432461,0.881567539,1639.649906,1775.524499,2822.541896,3341.471449,5767,147.4558936,11534,-2603008,349696,-2253312,63
4609,454,22,8,0.089670156,0.910329844,1433.710884,1715.996053,2522.532437,2628.114537,5063,514.5325203,10126,-2359808,232448,-2127360,63
2324,263,22,8,0.101662157,0.898337843,745.2369101,749.3503563,1307.914802,1171.041825,2587,73.74572406,5174,-1189888,134656,-1055232,63
5107,738,21,9,0.126261762,0.873738238,1664.035626,1794.42159,2867.844527,3304.678862,5845,184.7929181,11690,-2614784,377856,-2236928,63
5107,720,21,9,0.123562725,0.876437275,1661.41858,1775.785558,2860.096534,3296.340278,5827,191.4257556,11654,-2614784,368640,-2246144,63
5034,676,21,9,0.118388792,0.881611208,1626.544696,1756.928039,2804.810886,3232.968935,5710,186.6013072,11420,-2577408,346112,-2231296,63
5111,723,21,9,0.123928694,0.876071306,1662.920727,1762.813459,2853.914107,3366.998617,5834,174.5139097,11668,-2616832,370176,-2246656,63
4940,697,21,9,0.12364733,0.87635267,1610.376662,1706.372138,2772.539069,3148.292683,5637,149.3245033,11274,-2529280,356864,-2172416,63
4994,714,21,9,0.125087596,0.874912404,1624.333788,1765.557154,2805.546656,3196.89916,5708,178.8220551,11416,-2556928,365568,-2191360,63
5051,682,21,9,0.118960405,0.881039595,1634.970469,1762.071508,2822.830529,3194.1261,5733,168.9655172,11466,-2586112,349184,-2236928,63
4955,644,21,9,0.115020539,0.884979461,1595.4515,1723.836629,2751.741271,3171.307453,5599,161.7740537,11198,-2536960,329728,-2207232,63
4991,684,22,8,0.120528634,0.879471366,1617.129802,1748.108883,2791.81106,3175.030702,5675,163.9225881,11350,-2555392,350208,-2205184,63
5114,657,21,9,0.113845088,0.886154912,1648.622768,1764.654081,2846.208056,3195.73516,5771,162.7467569,11542,-2618368,336384,-2281984,63
5107,692,21,9,0.119330919,0.880669081,1652.584908,1786.312449,2852.784414,3248.453757,5799,161.9380061,11598,-2614784,354304,-2260480,63
4950,686,22,8,0.12171753,0.87828247,1609.11271,1714.306009,2772.535556,3150.167638,5636,176.6217487,11272,-2534400,351232,-2183168,63
5276,713,22,8,0.119051595,0.880948405,1710.466568,1796.058878,2933.946171,3446.781206,5989,175.1169591,11978,-2701312,365056,-2336256,63
5074,722,21,9,0.124568668,0.875431332,1650.925785,1777.486725,2845.338589,3272.102493,5796,106.1732918,11592,-2597888,369664,-2228224,63
1317,176,21,9,0.117883456,0.882116544,426.6399612,462.1998097,746.0751708,753.9204545,1493,179.8795181,2986,-674304,90112,-584192,63
4770,385,21,9,0.0746847721,0.925315228,1482.130232,1559.458791,2582.27086,2525.085714,5155,602.9239766,10310,-2442240,197120,-2245120,63
4725,404,21,9,0.078767791,0.921232209,1474.129726,1548.183106,2576.446349,2431.128713,5129,371.9361856,10258,-2419200,206848,-2212352,63
4655,392,22,8,0.0776699029,0.922330097,1457.115475,1444.833266,2537.816327,2359.931122,5047,310.9673444,10094,-2383360,200704,-2182656,63
4660,400,21,9,0.0790513834,0.920948617,1452.275009,1553.419646,2537.039056,2454.32,5060,721.8259629,10120,-2385920,204800,-2181120,63
4714,393,22,8,0.0769532015,0.923046799,1468.092162,1544.33177,2560.364446,2477.659033,5107,614.5607702,10214,-2413568,201216,-2212352,63
4667,377,22,8,0.074742268,0.925257732,1455.041332,1453.701421,2538.845082,2320.159151,5044,321.4786488,10088,-2389504,193024,-2196480,63
4494,406,21,9,0.0828571429,0.917142857,1408.820487,1475.031014,2455.129506,2399.256158,4900,655.957162,9800,-2300928,207872,-2093056,63
1814,172,22,8,0.0866062437,0.913393756,572.463104,578.5116137,999.390849,931.372093,1986,34.64154893,3972,-928768,88064,-840704,63
4704,394,21,9,0.0772852099,0.92271479,1468.941491,1497.649538,2560.440901,2418.875635,5098,310.4750305,10196,-2408448,201728,-2206720,63
5237,447,21,9,0.0786418015,0.921358198,1626.68103,1771.108802,2868.032652,2543.362416,5684,299.1578947,11368,-2681344,228864,-2452480,63
2587,241,21,9,0.0852192362,0.914780764,811.6392558,798.3185147,1444.303054,1094.580913,2828,49.4319175,5656,-1324544,123392,-1201152,63
4774,406,21,9,0.0783783784,0.921621622,1497.634977,1442.01156,2612.973188,2326.246305,5180,258.4830339,10360,-2444288,207872,-2236416,63
572,34,22,8,0.0561056106,0.943894389,171.4599088,225.4397625,303.1241259,309.8235294,606,26.98130009,1212,-292864,17408,-275456,63
4698,429,21,9,0.0836746635,0.916325336,1479.121312,1477.973488,2580.537037,2382.902098,5127,493.9306358,10254,-2405376,219648,-2185728,63
4744,382,22,8,0.0745220445,0.925477956,1473.347926,1553.643549,2571.471965,2464.497382,5126,555.3629469,10252,-2428928,195584,-2233344,63
4698,383,21,9,0.0753788624,0.924621138,1453.330704,1621.469533,2545.418689,2486.798956,5081,92.7528295,10162,-2405376,196096,-2209280,63
4727,414,22,8,0.0805290799,0.91947092,1473.42916,1599.959003,2574.978633,2525.572464,5141,549.2521368,10282,-2420224,211968,-2208256,63
4889,440,22,8,0.0825670858,0.917432914,1533.880425,1579.768013,2678.192473,2518.413636,5329,505.1184834,10658,-2503168,225280,-2277888,63
4965,429,22,8,0.0795328142,0.920467186,1532.277342,1805.350196,2716.644109,2475.937063,5394,413.0168453,10788,-2542080,219648,-2322432,63
4745,402,22,8,0.0781037498,0.92189625,1475.760767,1598.727352,2578.474394,2521.186567,5147,518.8508065,10294,-2429440,205824,-2223616,63
2714,305,21,9,0.10102683,0.89897317,854.5900549,983.6025083,1485.716286,1726.085246,3019,282.6779026,6038,-1389568,156160,-1233408,63
2589,250,21,9,0.0880591758,0.911940824,806.7836325,939.4567416,1425.885284,1359.052,2839,66.19258568,5678,-1325568,128000,-1197568,63
2687,294,21,9,0.0986246226,0.901375377,843.301458,985.6941955,1470.914031,1674.57483,2981,133.7971275,5962,-1375744,150528,-1225216,63
2661,304,21,9,0.102529511,0.897470489,841.162864,960.2942883,1464.354378,1646.210526,2965,311.7770768,5930,-1362432,155648,-1206784,63
2700,288,21,9,0.0963855422,0.903614458,846.8844229,964.7543153,1468.748889,1735.916667,2988,219.5444526,5976,-1382400,147456,-1234944,63
2588,281,21,9,0.0979435343,0.902056466,817.6276877,824.5434976,1477.072643,1047.512456,2869,92.78783959,5738,-1325056,143872,-1181184,63
2679,279,21,9,0.0943204868,0.905679513,839.9448015,959.6522497,1460.903695,1658.064516,2958,296.9879518,5916,-1371648,142848,-1228800,63
2664,276,21,9,0.093877551,0.906122449,833.6940419,965.822914,1453.067943,1638.757246,2940,351.2544803,5880,-1363968,141312,-1222656,63
2676,277,21,9,0.0938029123,0.906197088,835.8534521,993.8367259,1467.250374,1571.187726,2953,268.4545455,5906,-1370112,141824,-1228288,63
2725,300,21,9,0.0991735537,0.900826446,857.0982989,986.8952412,1491.502385,1708.27,3025,198.1008513,6050,-1395200,153600,-1241600,63
2693,301,21,9,0.100534402,0.899465598,845.7033798,1008.809087,1485.085407,1608.571429,2994,242.6256078,5988,-1378816,154112,-1224704,63
2580,253,21,9,0.0893046241,0.910695376,804.3739315,943.6909743,1414.620155,1441.268775,2833,297.8969506,5666,-1320960,129536,-1191424,63
2723,279,21,9,0.0929380413,0.907061959,849.8888411,989.5823534,1479.305545,1718.114695,3002,277.4491682,6004,-1394176,142848,-1251328,63
2736,308,21,9,0.101182654,0.898817346,858.6971135,1029.836227,1507.131579,1659.019481,3044,222.027717,6088,-1400832,157696,-1243136,63
2718,286,21,9,0.0952063915,0.904793609,850.313183,990.4421707,1480.956218,1707.241259,3004,225.6949662,6008,-1391616,146432,-1245184,63
2528,263,21,9,0.0942314583,0.905768542,790.3908261,878.0979359,1429.259098,1076.307985,2791,52.46240602,5582,-1294336,134656,-1159680,63
2687,300,21,9,0.100435219,0.899564781,845.1388432,977.5287188,1470.327875,1706.023333,2987,190.9846547,5974,-1375744,153600,-1222144,63
2690,310,21,9,0.103333333,0.896666667,841.7782317,1022.662588,1473.004089,1739.093548,3000,53.56186395,6000,-1377280,158720,-1218560,63
2695,289,21,9,0.096849866,0.903150134,846.5032744,974.5124917,1474.935065,1656.297578,2984,184.1975309,5968,-1379840,147968,-1231872,63
2613,268,21,9,0.0930232558,0.906976744,817.4344793,943.2660322,1423.838883,1608.320896,2881,240.4841402,5762,-1337856,137216,-1200640,63
2950,313,21,9,0.0959239963,0.904076004,932.0847533,1030.238792,1631.195932,1639.578275,3263,429.9077734,6526,-1510400,160256,-1350144,63
2991,322,22,8,0.0971928765,0.902807123,952.2491469,993.9256501,1657.494483,1652.406832,3313,186.6478873,6626,-1531392,164864,-1366528,63
2913,297,22,8,0.0925233645,0.907476636,922.4425175,966.9016796,1604.958119,1610.814815,3210,171.5660075,6420,-1491456,152064,-1339392,63
138,29,21,9,0.173652695,0.826347305,45.66337164,58.02637885,82.15217391,92.79310345,167,3.634385201,334,-70656,14848,-55808,63
2872,326,21,9,0.101938712,0.898061288,922.3661968,912.7736364,1618.860028,1428.941718,3198,64.88131467,6396,-1470464,166912,-1303552,63
2862,307,21,9,0.0968759861,0.903124014,914.2340791,917.19946,1592.539483,1514.713355,3169,209.8675497,6338,-1465344,157184,-1308160,63
2977,334,21,9,0.100875868,0.899124132,947.7122291,1024.824546,1658.542492,1633.338323,3311,204.5089561,6622,-1524224,171008,-1353216,63
3087,316,21,9,0.0928592418,0.907140758,977.9282939,1022.155649,1708.980888,1633.803797,3403,223.2939633,6806,-1580544,161792,-1418752,63
2893,324,21,9,0.100714952,0.899285048,924.4856771,964.8971846,1611.600069,1585.783951,3217,295.4086318,6434,-1481216,165888,-1315328,63
2944,304,22,8,0.0935960591,0.906403941,936.665749,944.7084188,1630.650136,1564.940789,3248,171.2177122,6496,-1507328,155648,-1351680,63
3030,321,21,9,0.0957923008,0.904207699,956.0940159,1060.133785,1688.842244,1554.778816,3351,291.3913043,6702,-1551360,164352,-1387008,63
2906,309,21,9,0.0961119751,0.903888025,920.511994,996.5433684,1607.71989,1610.634304,3215,173.2219828,6430,-1487872,158208,-1329664,63
2950,305,21,9,0.0937019969,0.906298003,935.7435426,969.6330627,1639.377966,1517.95082,3255,86.22516556,6510,-1510400,156160,-1354240,63
2955,308,22,8,0.0943916641,0.905608336,931.9983601,1030.693796,1625.886633,1690.652597,3263,262.0883534,6526,-1512960,157696,-1355264,63
3026,324,21,9,0.0967164179,0.903283582,948.4297212,1126.204841,1676.90813,1662.348765,3350,58.41325196,6700,-1549312,165888,-1383424,63
2996,328,21,9,0.0986762936,0.901323706,954.6294399,1001.370166,1655.807744,1723.628049,3324,229.2413793,6648,-1533952,167936,-1366016,63
2981,334,21,9,0.100754148,0.899245852,952.5878239,994.7050896,1661.027172,1630.982036,3315,116.8487839,6630,-1526272,171008,-1355264,63
2947,322,21,9,0.0985010707,0.901498929,942.0077557,950.2111634,1648.314218,1513.145963,3269,129.107425,6538,-1508864,164864,-1344000,63
2956,315,21,9,0.0963008254,0.903699175,940.5486749,978.2405847,1634.419486,1650.831746,3271,328.4136546,6542,-1513472,161280,-1352192,63
1179,160,22,8,0.119492158,0.880507842,386.4388749,376.1329842,681.7311281,583.55625,1339,18.9794472,2678,-603648,81920,-521728,63
3142,518,21,9,0.141530055,0.858469945,1035.843866,1101.883417,1768.459262,2206.816602,3660,231.2065698,7320,-1608704,265216,-1343488,63
66,11,22,8,0.142857143,0.857142857,21.75069529,20.20514622,41.24242424,25.54545455,77,2.394278607,154,-33792,5632,-28160,63
3491,551,21,9,0.136318654,0.863681346,1144.532328,1221.794876,1956.701232,2432.049002,4042,245.5650061,8084,-1787392,282112,-1505280,63
1941,203,21,9,0.0946828358,0.905317164,617.5560924,631.7596594,1073.265327,1065.182266,2144,200.1867414,4288,-993792,103936,-889856,63
3059,504,21,9,0.141453831,0.858546169,1005.874075,1074.525938,1716.639752,2178.700397,3563,141.2207689,7126,-1566208,258048,-1308160,63
3521,494,22,8,0.123038605,0.876961395,1141.152838,1190.769654,1946.581937,2445.759109,4015,96.93384838,8030,-1802752,252928,-1549824,63
2987,499,21,9,0.143144005,0.856855995,988.8305733,1021.997559,1678.423502,2133.046092,3486,232.0905459,6972,-1529344,255488,-1273856,63
3371,546,21,9,0.139392392,0.860607608,1112.424722,1172.221733,1899.249184,2327.901099,3917,136.9101713,7834,-1725952,279552,-1446400,63
2253,256,21,9,0.102032682,0.897967318,720.0037765,754.5603438,1244.418553,1348.125,2509,267.199148,5018,-1153536,131072,-1022464,63
3403,516,21,9,0.131666241,0.868333759,1112.417207,1171.683352,1898.944755,2362.656977,3919,135.887656,7838,-1742336,264192,-1478144,63
3474,518,22,8,0.129759519,0.870240481,1132.608955,1200.420915,1935.845423,2403.283784,3992,187.4178404,7984,-1778688,265216,-1513472,63
3369,508,21,9,0.131029146,0.868970854,1094.622369,1182.550754,1873.83734,2371.151575,3877,186.7533719,7754,-1724928,260096,-1464832,63
3424,509,21,9,0.129417747,0.870582253,1109.220896,1208.97826,1901.635514,2406.701375,3933,266.2830061,7866,-1753088,260608,-1492480,63
2983,485,21,9,0.139850058,0.860149942,981.1165507,1040.223338,1673.40999,2110.235052,3468,166.0124461,6936,-1527296,248320,-1278976,63
1924,230,21,9,0.106778087,0.893221913,613.5463484,685.9827542,1073.231289,1113.208696,2154,45.86882453,4308,-985088,117760,-867328,63
2077,254,21,9,0.108966109,0.891033891,660.064465,727.0819442,1136.779971,1404.937008,2331,245.6269758,4662,-1063424,130048,-933376,63
3206,500,21,9,0.134916352,0.865083648,1050.74647,1080.203896,1782.856519,2306.466,3706,182.7416174,7412,-1641472,256000,-1385472,63
3437,555,22,8,0.139028056,0.860971944,1134.407097,1186.657395,1933.903986,2384.144144,3992,190.9134385,7984,-1759744,284160,-1475584,63
3361,513,21,9,0.13242127,0.86757873,1090.161368,1190.641486,1867.769116,2394.352827,3874,276.9120801,7748,-1720832,262656,-1458176,63
3551,526,21,9,0.129016434,0.870983566,1154.7788,1194.458141,1962.391721,2556.178707,4077,236.8971528,8154,-1818112,269312,-1548800,63
9420,543,21,9,0.0545016561,0.945498344,2859.30121,2966.009817,5041.92569,3942.405157,9963,1099.668874,19926,-4823040,278016,-4545024,63
9438,528,21,9,0.0529801325,0.947019868,2860.636285,2976.292783,5040.343399,3967.424242,9966,1025.308642,19932,-4832256,270336,-4561920,63
9411,551,21,9,0.0553101787,0.944689821,2859.794303,2859.788781,5054.772181,3730.021779,9962,745.6586826,19924,-4818432,282112,-4536320,63
9393,571,21,9,0.0573063027,0.942693697,2862.720673,2787.20561,5061.521772,3682.584939,9964,1266.073698,19928,-4809216,292352,-4516864,63
9405,559,21,9,0.0561019671,0.943898033,2860.821786,3082.523595,5012.574163,4476.511628,9964,879.435128,19928,-4815360,286208,-4529152,63
9429,530,21,9,0.0532181946,0.946781805,2863.786345,2882.179488,5037.217414,3962.069811,9959,676.5625,19918,-4827648,271360,-4556288,63
9456,510,21,9,0.0511739916,0.948826008,2858.292012,3089.732522,5027.858397,4161.043137,9966,1431.896552,19932,-4841472,261120,-4580352,63
9393,571,21,9,0.0573063027,0.942693697,2864.394759,2899.493232,5041.411264,4013.404553,9964,748.048048,19928,-4809216,292352,-4516864,63
9373,589,21,9,0.0591246738,0.940875326,2869.45403,2863.564225,5030.591059,4200.293718,9962,608.1807082,19924,-4798976,301568,-4497408,63
9377,587,21,9,0.0589120835,0.941087916,2864.502048,2968.213372,5027.558388,4262.717206,9964,668.7248322,19928,-4801024,300544,-4500480,63
9528,442,21,9,0.044332999,0.955667001,2862.239671,3077.288566,5025.427897,4124.791855,9970,947.7186312,19940,-4878336,226304,-4652032,63
9388,578,21,9,0.0579971904,0.94200281,2870.006678,2911.526,5023.434597,4334.873702,9966,673.3783784,19932,-4806656,295936,-4510720,63
9414,550,21,9,0.0551987154,0.944801285,2858.824284,3058.784942,5027.880285,4205.754545,9964,900.0903342,19928,-4819968,281600,-4538368,63
9432,534,21,9,0.0535821794,0.946417821,2859.084317,3039.435265,5034.198049,4088.024345,9966,1060.212766,19932,-4829184,273408,-4555776,63
9479,489,21,9,0.0490569823,0.950943018,2859.322332,2960.828338,5046.858951,3775.705521,9968,1163.127188,19936,-4853248,250368,-4602880,63
9426,539,21,9,0.0540893126,0.945910687,2862.238956,3054.188243,5017.869616,4373.202226,9965,494.7864945,19930,-4826112,275968,-4550144,63
9388,570,21,9,0.0572404097,0.94275959,2859.285374,2880.449248,5049.634427,3824.373684,9958,909.4063927,19916,-4806656,291840,-4514816,63
9488,483,21,9,0.0484404774,0.951559523,2862.847571,3116.641874,5014.236825,4431.318841,9971,1447.169811,19942,-4857856,247296,-4610560,63
9393,569,21,9,0.0571170448,0.942882955,2860.515087,2992.24748,5032.854785,4133.739895,9962,1058.660999,19924,-4809216,291328,-4517888,63
1686,172,21,9,0.0925726588,0.907427341,534.5384706,532.2159819,944.4068802,783.377907,1858,25.26516182,3716,-863232,88064,-775168,63
4152,617,22,8,0.129377228,0.870622772,1366.406117,1397.369752,2334.527697,2724.645057,4769,138.6740331,9538,-2125824,315904,-1809920,63
3901,620,22,8,0.137137801,0.862862199,1295.849557,1339.780136,2224.938734,2487.895161,4521,136.4624208,9042,-1997312,317440,-1679872,63
3740,574,22,8,0.133055169,0.866944831,1235.498667,1273.245027,2114.896791,2435.08885,4314,159.9555061,8628,-1914880,293888,-1620992,63
3992,621,22,8,0.134619553,0.865380447,1320.381066,1366.562236,2261.679609,2598.334944,4613,104.555757,9226,-2043904,317952,-1725952,63
3917,613,21,9,0.135320088,0.864679912,1297.750406,1345.096878,2227.998979,2505.127243,4530,114.6545178,9060,-2005504,313856,-1691648,63
3707,557,22,8,0.130628518,0.869371482,1214.485722,1300.258481,2090.05584,2414.978456,4264,94.81876807,8528,-1897984,285184,-1612800,63
3935,627,21,9,0.137439719,0.862560281,1308.582566,1350.335197,2248.890216,2486.1563,4562,117.4864795,9124,-2014720,321024,-1693696,63
3933,619,23,7,0.135984183,0.864015817,1307.689957,1324.16418,2235.317061,2538.168013,4552,124.8149164,9104,-2013696,316928,-1696768,63
3754,559,22,8,0.129608161,0.870391839,1238.235883,1268.516887,2124.489877,2375.323792,4313,112.8466771,8626,-1922048,286208,-1635840,63
3930,621,22,8,0.136453527,0.863546473,1304.270301,1337.253376,2230.751654,2562.354267,4551,140.2033272,9102,-2012160,317952,-1694208,63
3885,660,22,8,0.145214521,0.854785479,1303.282754,1330.776999,2227.184041,2542.689394,4545,146.3768116,9090,-1989120,337920,-1651200,63
3927,622,21,9,0.136733348,0.863266652,1305.856598,1330.026527,2234.262796,2532.194534,4549,137.473557,9098,-2010624,318464,-1692160,63
3975,669,21,9,0.144056848,0.855943152,1323.612268,1390.768716,2265.923774,2658.659193,4644,145.5799373,9288,-2035200,342528,-1692672,63
2551,327,21,9,0.11362057,0.88637943,828.2139461,849.3365211,1433.553508,1485.889908,2878,76.66489078,5756,-1306112,167424,-1138688,63
3914,617,21,9,0.13617303,0.86382697,1299.285455,1336.602619,2227.725856,2508.795786,4531,125.5124654,9062,-2003968,315904,-1688064,63
4077,647,23,7,0.136960203,0.863039797,1360.331236,1351.044007,2317.732156,2644.599691,4724,126.6827568,9448,-2087424,331264,-1756160,63
3829,477,21,9,0.110775662,0.889224338,1238.095393,1281.859892,2151.290154,2171.238994,4306,115.2878179,8612,-1960448,244224,-1716224,63
437,62,21,9,0.124248497,0.875751503,144.6690665,129.4817865,256.9267735,201.1774194,499,9.244164505,998,-223744,31744,-192000,63
3906,653,21,9,0.143233165,0.856766835,1308.253518,1336.284136,2239.327445,2523.287902,4559,144.8681284,9118,-1999872,334336,-1665536,63
1436,187,21,9,0.115218731,0.884781269,461.3767153,520.0261647,810.8391365,820.9144385,1623,25.6195738,3246,-735232,95744,-639488,63
3989,433,21,9,0.0979194934,0.902080507,1267.66109,1349.523695,2198.474304,2331.498845,4422,199.6388262,8844,-2042368,221696,-1820672,63
3908,388,21,9,0.0903165736,0.909683426,1230.783621,1324.656755,2136.403531,2270.337629,4296,281.8897638,8592,-2000896,198656,-1802240,63
3914,395,22,8,0.0916686006,0.908331399,1235.494559,1316.578907,2141.248084,2291.265823,4309,350.6102522,8618,-2003968,202240,-1801728,63
4917,484,21,9,0.0896130346,0.910386965,1528.070045,1815.223438,2669.830384,3017.654959,5401,471.7030568,10802,-2517504,247808,-2269696,63
3931,405,22,8,0.093404059,0.906595941,1240.438454,1350.891969,2156.840753,2281.666667,4336,219.3222054,8672,-2012672,207360,-1805312,63
3792,402,22,8,0.095851216,0.904148784,1195.959032,1340.065718,2090.552479,2163.034826,4194,160.5666156,8388,-1941504,205824,-1735680,63
3982,412,21,9,0.0937642239,0.906235776,1261.786201,1322.256977,2182.480412,2342.665049,4394,155.9815406,8788,-2038784,210944,-1827840,63
4909,485,21,9,0.0899147201,0.91008528,1526.673234,1807.625243,2666.636178,3009.892784,5394,379.0583275,10788,-2513408,248320,-2265088,63
3988,419,21,9,0.0950760154,0.904923985,1263.994455,1341.930215,2191.53335,2322.656325,4407,110.3405108,8814,-2041856,214528,-1827328,63
3886,393,22,8,0.0918438888,0.908156111,1226.268082,1312.165889,2125.564848,2282.735369,4279,412.632594,8558,-1989632,201216,-1788416,63
3954,439,21,9,0.0999317095,0.90006829,1262.566167,1305.230747,2178.201821,2366.312073,4393,222.9949239,8786,-2024448,224768,-1799680,63
3949,407,21,9,0.0934343434,0.906565657,1243.997647,1378.109697,2169.189921,2268.832924,4356,361.7940199,8712,-2021888,208384,-1813504,63
3931,400,21,9,0.0923574232,0.907642577,1237.233989,1371.590974,2165.01679,2175.6625,4331,149.4478951,8662,-2012672,204800,-1807872,63
3920,395,22,8,0.0915411356,0.908458864,1238.600919,1303.478578,2142.53852,2311.440506,4315,350.8130081,8630,-2007040,202240,-1804800,63
4911,493,21,9,0.0912287195,0.908771281,1528.007475,1806.260771,2664.804113,3078.006085,5404,262.7126884,10808,-2514432,252416,-2262016,63
4805,459,21,9,0.0871960486,0.912803951,1485.658954,1805.357189,2601.259313,2959.540305,5264,159.2256503,10528,-2460160,235008,-2225152,63
3907,415,22,8,0.0960203609,0.903979639,1238.041503,1323.392505,2143.944715,2326.773494,4322,168.236668,8644,-2000384,212480,-1787904,63
3958,402,21,9,0.0922018349,0.907798165,1247.450127,1358.47011,2168.89237,2294.78607,4360,327.8195489,8720,-2026496,205824,-1820672,63
4009,408,22,8,0.0923703871,0.907629613,1265.152317,1362.368056,2196.16438,2335.122549,4417,160.2103736,8834,-2052608,208896,-1843712,63
1829,205,21,9,0.100786627,0.899213373,575.6363226,669.0203678,1031.267906,894.6634146,2034,26.14395887,4068,-936448,104960,-831488,63
6611,869,21,9,0.116176471,0.883823529,2127.346145,2314.863806,3667.846014,4293.222094,7480,132.67116,14960,-3384832,444928,-2939904,63
7948,910,21,9,0.102731994,0.897268006,2559.363607,2500.818584,4383.139155,4834.418681,8858,166.1601951,17716,-4069376,465920,-3603456,63
7621,885,21,9,0.104044204,0.895955796,2441.841321,2542.81564,4212.636399,4605.388701,8506,165.3255588,17012,-3901952,453120,-3448832,63
8104,952,21,9,0.105123675,0.894876325,2614.638271,2590.544305,4492.370434,4836.056723,9056,182.5806452,18112,-4149248,487424,-3661824,63
6350,508,21,9,0.0740740741,0.925925926,1979.998249,1956.654581,3450.968031,3161.149606,6858,194.8295455,13716,-3251200,260096,-2991104,63
8063,897,21,9,0.100111607,0.899888393,2587.998772,2550.217385,4444.222002,4806.597547,8960,168.8018086,17920,-4128256,459264,-3668992,63
8210,989,21,9,0.107511686,0.892488314,2658.238124,2611.931605,4562.285627,4913.078868,9199,184.0904543,18398,-4203520,506368,-3697152,63
8095,949,21,9,0.104931446,0.895068554,2610.667809,2592.012888,4486.985053,4825.443625,9044,193.4131737,18088,-4144640,485888,-3658752,63
7975,942,21,9,0.105640911,0.894359089,2566.191139,2601.9669,4408.953354,4882.696391,8917,191.7222103,17834,-4083200,482304,-3600896,63
6800,655,23,7,0.0878604963,0.912139504,2144.066221,2233.251529,3731.082353,3696,7455,146.2051383,14910,-3481600,335360,-3146240,63
8116,973,21,9,0.107052481,0.892947519,2630.470074,2550.075469,4511.477945,4824.614594,9089,169.6341919,18178,-4155392,498176,-3657216,63
8208,945,21,9,0.103244838,0.896755162,2643.630822,2615.363257,4546.622685,4840.848677,9153,177.8317466,18306,-4202496,483840,-3718656,63
8162,982,21,9,0.107392826,0.892607174,2645.732601,2580.797504,4549.822347,4760.98778,9144,169.5845697,18288,-4178944,502784,-3676160,63
480,46,21,9,0.0874524715,0.912547529,150.5665025,162.701996,265.7645833,239.8695652,526,12.16466235,1052,-245760,23552,-222208,63
948,68,22,8,0.0669291339,0.933070866,289.2784267,332.227502,502.2035865,596.2794118,1016,39.81191223,2032,-485376,34816,-450560,63
8331,1013,21,9,0.108411815,0.891588185,2689.783803,2719.566312,4619.091706,5111.734452,9344,166.470693,18688,-4265472,518656,-3746816,63
8390,950,21,9,0.101713062,0.898286938,2699.005454,2617.325896,4613.028725,5178.062105,9340,181.7120623,18680,-4295680,486400,-3809280,63
7589,955,21,9,0.111774345,0.888225655,2468.688946,2435.036517,4242.091448,4514.144503,8544,191.9568636,17088,-3885568,488960,-3396608,63
8229,923,21,9,0.100852273,0.899147727,2644.18438,2591.192005,4533.880666,4956.472373,9152,176.7136513,18304,-4213248,472576,-3740672,63
8273,889,21,9,0.0970312159,0.902968784,2650.095122,2551.448786,4532.910552,5033.671541,9162,167.8021978,18324,-4235776,455168,-3780608,63
7391,1235,20,10,0.143171806,0.856828194,2428.009294,2503.586036,4108.271276,5541.71498,8626,150.3573296,17252,-3784192,632320,-3151872,64
4948,661,21,9,0.117846318,0.882153682,1560.939494,1746.750285,2682.256063,3723.815431,5609,103.0687247,11218,-2533376,338432,-2194944,64
5282,727,21,9,0.120985189,0.879014811,1679.331785,1858.33944,2880.711094,3908.017882,6009,129.5043103,12018,-2704384,372224,-2332160,64
5268,701,21,9,0.117440107,0.882559893,1668.717129,1778.996293,2848.602316,4010.025678,5969,125.0052356,11938,-2697216,358912,-2338304,64
5365,748,21,9,0.122362179,0.877637821,1704.455303,1861.339314,2917.067474,4060.660428,6113,120.1690584,12226,-2746880,382976,-2363904,64
5146,785,21,9,0.132355421,0.867644579,1658.352238,1767.405487,2824.196463,3895.580892,5931,126.4335962,11862,-2634752,401920,-2232832,64
5515,767,21,9,0.122094874,0.877905126,1748.347739,1958.51236,3003.57262,4133.246415,6282,128.7031346,12564,-2823680,392704,-2430976,64
6644,1022,21,9,0.133315941,0.866684059,2152.428335,2251.87132,3655.507676,4990.624266,7666,156.9936514,15332,-3401728,523264,-2878464,64
5212,753,22,8,0.126236379,0.873763621,1661.647483,1785.059781,2835.62548,4003.074369,5965,126.5916808,11930,-2668544,385536,-2283008,64
5393,721,21,9,0.117926071,0.882073929,1701.755087,1882.462324,2919.361765,4090.758669,6114,132.4523397,12228,-2761216,369152,-2392064,64
2685,179,21,9,0.0625,0.9375,812.9891951,976.8646015,1449.347858,1179.782123,2864,88.20449646,5728,-1374720,91648,-1283072,64
3134,220,21,9,0.0655933214,0.934406679,952.8155303,1115.956361,1700.365029,1351.777273,3354,62.05365402,6708,-1604608,112640,-1491968,64
5407,770,21,9,0.124655982,0.875344018,1713.124281,2007.121294,2964.711485,3961.763636,6177,124.6871215,12354,-2768384,394240,-2374144,64
3686,268,21,9,0.0677794638,0.932220536,1122.309404,1376.779805,1974.083288,2024.492537,3954,68.7054735,7908,-1887232,137216,-1750016,64
5283,724,21,9,0.120526053,0.879473947,1673.778718,1906.64832,2884.056407,3879.223757,6007,111.4678048,12014,-2704896,370688,-2334208,64
7272,1273,21,9,0.148976009,0.851023991,2408.419056,2404.389107,4048.793317,5553.778476,8545,162.1749858,17090,-3723264,651776,-3071488,64
3311,230,21,9,0.064953403,0.935046597,1012.580777,1140.523127,1781.79402,1615.613043,3541,67.38344434,7082,-1695232,117760,-1577472,64
6835,1062,21,9,0.134481449,0.865518551,2230.835485,2285.119454,3778.411412,5046.903013,7897,180.2556494,15794,-3499520,543744,-2955776,64
5163,749,21,9,0.126691475,0.873308525,1642.597805,1863.24735,2826.489444,3852.687583,5912,111.5682204,11824,-2643456,383488,-2259968,64
5258,733,21,9,0.122350192,0.877649808,1660.950458,1917.559441,2866.71472,3923.396999,5991,115.7904909,11982,-2692096,375296,-2316800,64
3266,486,21,9,0.129530917,0.870469083,1076.185065,1097.626811,1840.080527,2121.244856,3752,65.54856744,7504,-1672192,248832,-1423360,64
3263,567,21,9,0.148041775,0.851958225,1073.272754,1175.211249,1835.793135,2374.201058,3830,86.20301598,7660,-1670656,290304,-1380352,64
3310,547,21,9,0.141820067,0.858179933,1087.893465,1178.248808,1862.013293,2334.349177,3857,85.33185841,7714,-1694720,280064,-1414656,64
3340,577,21,9,0.147306612,0.852693388,1105.380943,1156.223745,1876.113174,2438.795494,3917,80.34871795,7834,-1710080,295424,-1414656,64
897,83,21,9,0.0846938776,0.915306122,280.0422139,304.4524389,496.5930881,424.6506024,980,34.32574431,1960,-459264,42496,-416768,64
3385,564,21,9,0.142820967,0.857179033,1115.128508,1185.665992,1901.006795,2419.090426,3949,86.69593853,7898,-1733120,288768,-1444352,64
3757,613,21,9,0.1402746,0.8597254,1243.192217,1315.373075,2128.410168,2535.396411,4370,102.8477289,8740,-1923584,313856,-1609728,64
3278,564,22,8,0.146798542,0.853201458,1083.294076,1166.431557,1850.744051,2332.737589,3842,79.69300975,7684,-1678336,288768,-1389568,64
3466,602,21,9,0.147984267,0.852015733,1145.110023,1233.400289,1954.662435,2494.162791,4068,78.48736253,8136,-1774592,308224,-1466368,64
3286,579,21,9,0.149805951,0.850194049,1089.529503,1164.374269,1857.318624,2362.51468,3865,84.31500873,7730,-1682432,296448,-1385984,64
3545,568,21,9,0.138098711,0.861901289,1164.012325,1256.935399,1995.326657,2441.915493,4113,90.69459757,8226,-1815040,290816,-1524224,64
5007,802,21,9,0.138061629,0.861938371,1642.438637,1783.682445,2817.659676,3450.278055,5809,140.1447527,11618,-2563584,410624,-2152960,64
3410,574,21,9,0.144076305,0.855923695,1121.226402,1206.95946,1913.814956,2459.949477,3984,88.12209688,7968,-1745920,293888,-1452032,64
4144,658,21,9,0.137026239,0.862973761,1361.243593,1461.788029,2332.801641,2834.153495,4802,112.6436782,9604,-2121728,336896,-1784832,64
3740,627,21,9,0.143576826,0.856423174,1235.851019,1326.430404,2114.788235,2596.842105,4367,97.00133274,8734,-1914880,321024,-1593856,64
3383,569,21,9,0.143977733,0.856022267,1112.12888,1206.670907,1901.85102,2420.326889,3952,79.88680008,7904,-1732096,291328,-1440768,64
4929,775,21,9,0.135869565,0.864130435,1608.441175,1783.851962,2769.921891,3377.696774,5704,101.4224751,11408,-2523648,396800,-2126848,64
4599,868,21,9,0.158770807,0.841229193,1525.506639,1683.71909,2608.923027,3396.706221,5467,95.74430823,10934,-2354688,444416,-1910272,64
3744,598,20,10,0.137724551,0.862275449,1231.96035,1333.478905,2118.653579,2502.364548,4342,94.45290407,8684,-1916928,306176,-1610752,64
3292,594,21,9,0.152856408,0.847143592,1086.628979,1167.055322,1848.566221,2469.631313,3886,68.60875706,7772,-1685504,304128,-1381376,64
6936,754,21,9,0.0980494148,0.901950585,2153.221977,2465.204091,3717.647924,5021.603448,7690,161.4867703,15380,-3551232,386048,-3165184,64
8766,1122,21,9,0.113470874,0.886529126,2787.859175,2930.862079,4754.25964,6430.816399,9888,570.2422145,19776,-4488192,574464,-3913728,64
3662,376,21,9,0.0931154037,0.906884596,1146.72696,1328.713335,2005.695248,2153.949468,4038,70.71803853,8076,-1874944,192512,-1682432,64
6544,557,22,8,0.0784396564,0.921560344,2012.172698,2269.455174,3475.613233,4436.692998,7101,148.8679245,14202,-3350528,285184,-3065344,64
6948,800,21,9,0.103252452,0.896747548,2172.916437,2475.545866,3749.451785,4960.54375,7748,136.4805355,15496,-3557376,409600,-3147776,64
7022,772,21,9,0.0990505517,0.900949448,2201.678785,2477.407487,3799.687553,4787.187824,7794,143.615257,15588,-3595264,395264,-3200000,64
2089,178,21,9,0.078517865,0.921482135,636.4036958,830.3358073,1142.902346,1029.522472,2267,52.7086724,4534,-1069568,91136,-978432,64
7203,802,22,8,0.100187383,0.899812617,2238.665866,2580.504674,3868.145911,5214.164589,8005,170.6459177,16010,-3687936,410624,-3277312,64
7180,810,21,9,0.101376721,0.898623279,2239.503472,2416.920448,3837.64415,5394.765432,7990,175.5658097,15980,-3676160,414720,-3261440,64
6921,749,22,8,0.0976531943,0.902346806,2160.375207,2435.73234,3725.602225,4850.990654,7670,137.8256963,15340,-3543552,383488,-3160064,64
7051,784,21,9,0.100063816,0.899936184,2199.983622,2459.196915,3786.794214,5098.015306,7835,162.3497721,15670,-3610112,401408,-3208704,64
8809,1084,21,9,0.109572425,0.890427575,2781.596051,3076.069233,4778.885004,6313.166974,9893,626.9328264,19786,-4510208,555008,-3955200,64
7029,781,21,9,0.1,0.9,2187.836027,2494.62905,3775.232323,5077.909091,7810,163.6973381,15620,-3598848,399872,-3198976,64
7025,772,21,9,0.0990124407,0.900987559,2187.22381,2508.123602,3778.119146,4998.984456,7797,153.3634933,15594,-3596800,395264,-3201536,64
7000,768,21,9,0.0988671473,0.901132853,2189.379815,2426.786891,3766.574286,4959.34375,7768,156.9610022,15536,-3584000,393216,-3190784,64
8837,1055,21,9,0.10665184,0.89334816,2797.251799,2946.769095,4777.904492,6358.707109,9892,469.4826768,19784,-4524544,540160,-3984384,64
7045,764,21,9,0.0978358305,0.90216417,2183.739284,2508.593336,3771.6978,5134.206806,7809,160.4479145,15618,-3607040,391168,-3215872,64
7005,752,21,9,0.0969446951,0.903055305,2181.856083,2439.55842,3757.151892,5014.034574,7757,159.9711281,15514,-3586560,385024,-3201536,64
7023,751,21,9,0.0966040648,0.903395935,2193.357072,2414.039274,3770.864445,4978.221039,7774,153.303096,15548,-3595776,384512,-3211264,64
7054,801,21,9,0.101973265,0.898026735,2208.010862,2433.383893,3793.306067,5114.181024,7855,170.3535025,15710,-3611648,410112,-3201536,64
5259,942,21,9,0.151910982,0.848089018,1712.219933,1796.181154,2898.946568,4229.024416,6201,108.3901416,12402,-2692608,482304,-2210304,64
5245,906,21,9,0.147293123,0.852706877,1718.876502,1773.719386,2904.561678,4068.487859,6151,132.3080232,12302,-2685440,463872,-2221568,64
5253,900,21,9,0.146270112,0.853729888,1713.748181,1770.23343,2896.940605,4127.946667,6153,129.5641188,12306,-2689536,460800,-2228736,64
5210,886,22,8,0.145341207,0.854658793,1703.276654,1768.537153,2882.168906,4026.586907,6096,116.3136806,12192,-2667520,453632,-2213888,64
7180,1407,20,10,0.163852335,0.836147665,2412.201163,2329.066764,4017.342758,5705.797441,8587,165.5484866,17174,-3676160,720384,-2955776,64
5212,882,20,10,0.144732524,0.855267476,1699.990733,1749.951749,2873.057368,4078.333333,6094,134.763379,12188,-2668544,451584,-2216960,64
6617,1150,21,9,0.148062315,0.851937685,2174.220233,2275.865592,3682.775276,5041.829565,7767,139.3683833,15534,-3387904,588800,-2799104,64
5231,916,20,10,0.14901578,0.85098422,1696.143731,1810.791406,2881.333397,4174.260917,6147,108.6618349,12294,-2678272,468992,-2209280,64
5282,888,21,9,0.143922204,0.856077796,1727.158088,1749.681516,2912.481068,4114.650901,6170,113.1279795,12340,-2704384,454656,-2249728,64
7346,1362,20,10,0.156407901,0.843592099,2465.142444,2388.544288,4118.52777,5627.225404,8708,208.975282,17416,-3761152,697344,-3063808,64
5459,919,21,9,0.144089056,0.855910944,1780.301432,1812.709636,3004.339073,4289.384113,6378,130.1367068,12756,-2795008,470528,-2324480,64
5219,887,22,8,0.145266951,0.854733049,1702.88501,1782.988737,2885.25273,4043.446449,6106,112.0366972,12212,-2672128,454144,-2217984,64
5077,831,20,10,0.140656737,0.859343263,1646.025564,1758.563022,2800.223754,3897.051745,5908,115.4131666,11816,-2599424,425472,-2173952,64
7540,1410,21,9,0.157541899,0.842458101,2535.582372,2455.877787,4235.2313,5760.341135,8950,158.4912343,17900,-3860480,721920,-3138560,64
5178,894,21,9,0.147233202,0.852766798,1701.553308,1693.314609,2859.592507,4061.138702,6072,121.2944467,12144,-2651136,457728,-2193408,64
5281,909,21,9,0.146849758,0.853150242,1720.424483,1789.631017,2911.134255,4166.606161,6190,127.7342138,12380,-2703872,465408,-2238464,64
6801,1173,21,9,0.147103085,0.852896915,2242.270358,2289.974796,3784.409205,5165.011083,7974,142.2658341,15948,-3482112,600576,-2881536,64
4986,783,20,10,0.135725429,0.864274571,1610.329647,1687.610115,2733.739872,3848.196679,5769,112.9404855,11538,-2552832,400896,-2151936,64
5184,855,21,9,0.141579732,0.858420268,1697.510349,1731.300437,2867.405093,3945.207018,6039,132.2891566,12078,-2654208,437760,-2216448,64
7312,1458,21,9,0.166248575,0.833751425,2469.703346,2430.541584,4124.406729,5694.906036,8770,159.2807846,17540,-3743744,746496,-2997248,64
9085,833,21,9,0.0839887074,0.916011293,2891.393912,2533.342618,4963.806604,4912.530612,9918,641.1118293,19836,-4651520,426496,-4225024,64
9043,869,21,9,0.0876715093,0.912328491,2870.874705,2757.912826,4946.055181,5065.191024,9912,893.7781785,19824,-4630016,444928,-4185088,64
9047,870,21,9,0.0877281436,0.912271856,2866.738312,2816.526767,4943.744777,5117.636782,9917,668.7120701,19834,-4632064,445440,-4186624,64
8988,921,21,9,0.0929458068,0.907054193,2862.784513,2828.729998,4932.738206,5172.2519,9909,705.2669039,19818,-4601856,471552,-4130304,64
9018,895,21,9,0.0902854837,0.909714516,2868.83624,2776.073869,4932.558439,5203.272626,9913,1185.76555,19826,-4617216,458240,-4158976,64
9038,871,21,9,0.087899889,0.912100111,2886.070486,2579.919104,4957.134432,4932.851894,9909,716.4859002,19818,-4627456,445952,-4181504,64
9043,868,21,9,0.0875794572,0.912420543,2875.622179,2703.905132,4950.065133,5017.830645,9911,797.3451327,19822,-4630016,444416,-4185600,64
9002,907,21,9,0.0915329498,0.90846705,2863.885009,2817.525043,4933.405688,5169.324146,9909,948.2296651,19818,-4609024,464384,-4144640,64
9004,909,21,9,0.0916977706,0.908302229,2869.647564,2778.210901,4944.936362,5076.49505,9913,1045.675105,19826,-4610048,465408,-4144640,64
5111,567,21,9,0.0998591053,0.900140895,1616.905893,1686.52082,2765.552534,3506.070547,5678,231.4716673,11356,-2616832,290304,-2326528,64
9002,907,21,9,0.0915329498,0.90846705,2865.165806,2800.341745,4928.828594,5214.751929,9909,932.173095,19818,-4609024,464384,-4144640,64
8994,907,21,9,0.0916069084,0.908393092,2883.193889,2595.858167,4958.53002,4876.330761,9901,975.4679803,19802,-4604928,464384,-4140544,64
9059,855,21,9,0.0862416784,0.913758322,2870.8103,2758.136222,4938.656695,5157.150877,9914,738.198064,19828,-4638208,437760,-4200448,64
8994,909,21,9,0.0917903666,0.908209633,2884.751719,2587.146346,4948.296642,4988.642464,9903,732.4704142,19806,-4604928,465408,-4139520,64
3774,486,21,9,0.114084507,0.885915493,1220.098248,1272.714058,2097.034711,2390.372428,4260,76.07142857,8520,-1932288,248832,-1683456,64
8955,947,21,9,0.095637245,0.904362755,2857.205909,2858.892154,4925.785371,5194.662091,9902,497.8381096,19804,-4584960,484864,-4100096,64
9025,886,21,9,0.089395621,0.910604379,2860.159847,2865.926393,4941.324432,5105.488713,9911,1021.752577,19822,-4620800,453632,-4167168,64
2300,151,21,9,0.0616075071,0.938392493,700.724225,803.1627967,1223.297826,1267.15894,2451,59.57705396,4902,-1177600,77312,-1100288,64
9153,770,21,9,0.0775975008,0.922402499,2879.667304,2672.293452,4976.062384,4794.84026,9923,445.7771788,19846,-4686336,394240,-4292096,64
8998,902,21,9,0.0911111111,0.908888889,2875.225843,2673.880091,4965.92565,4796.619734,9900,883.9285714,19800,-4606976,461824,-4145152,64
4248,661,22,8,0.134650642,0.865349358,1371.025079,1510.557765,2347.447269,3146.20121,4909,87.45768751,9818,-2174976,338432,-1836544,64
4435,705,21,9,0.137159533,0.862840467,1436.444408,1592.964841,2462.611274,3249.204255,5140,114.0954495,10280,-2270720,360960,-1909760,64
4432,712,21,9,0.138413686,0.861586314,1434.555144,1581.389765,2455.084161,3303.380618,5144,103.4385683,10288,-2269184,364544,-1904640,64
4460,707,22,8,0.136829882,0.863170118,1447.942922,1557.809755,2469.226457,3308.031117,5167,110.2175768,10334,-2283520,361984,-1921536,64
4212,652,21,9,0.134046053,0.865953947,1360.300768,1517.410202,2335.711301,3057.766871,4864,98.76142132,9728,-2156544,333824,-1822720,64
4516,776,21,9,0.146636432,0.853363568,1458.400855,1582.63725,2485.186005,3585.280928,5292,94.6013586,10584,-2312192,397312,-1914880,64
4573,730,21,9,0.137657929,0.862342071,1483.586999,1590.965927,2527.55937,3431.543836,5303,101.0287674,10606,-2341376,373760,-1967616,64
4319,693,21,9,0.138268156,0.861731844,1396.84794,1515.158344,2383.346145,3274.034632,5012,88.72366791,10024,-2211328,354816,-1856512,64
6711,1231,21,9,0.154998741,0.845001259,2248.550596,2267.131084,3786.147221,4981.981316,7942,153.7657309,15884,-3436032,630272,-2805760,64
4422,698,21,9,0.136328125,0.863671875,1435.747101,1555.554029,2452.199231,3246.611748,5120,108.4286319,10240,-2264064,357376,-1906688,64
6214,1219,22,8,0.163998386,0.836001614,2078.8861,2121.961285,3494.360476,4851.931911,7433,140.1131008,14866,-3181568,624128,-2557440,64
4424,711,21,9,0.138461538,0.861538462,1438.752804,1568.329267,2459.395118,3243.763713,5135,113.3053839,10270,-2265088,364032,-1901056,64
6361,1087,21,9,0.14594522,0.85405478,2113.700045,2108.232668,3559.993397,4687.173873,7448,150.343157,14896,-3256832,556544,-2700288,64
6110,1017,21,9,0.142696787,0.857303213,2012.583124,2099.25397,3416.054501,4452.836775,7127,130.818649,14254,-3128320,520704,-2607616,64
4461,717,22,8,0.138470452,0.861529548,1446.671854,1590.051142,2475.289397,3300.090656,5178,99.32860157,10356,-2284032,367104,-1916928,64
1827,136,21,9,0.0692817117,0.930718288,553.9371251,691.951551,995.2391899,804.1470588,1963,55.53041018,3926,-935424,69632,-865792,64
4331,694,22,8,0.138109453,0.861890547,1406.96045,1533.946849,2404.768414,3188.433718,5025,102.6977315,10050,-2217472,355328,-1862144,64
6645,1224,21,9,0.155547083,0.844452917,2219.101193,2249.369332,3736.158465,5014.495098,7869,139.7939243,15738,-3402240,626688,-2775552,64
6575,1141,21,9,0.147874546,0.852125454,2193.764837,2200.928015,3700.349658,4769.839614,7716,182.4976348,15432,-3366400,584192,-2782208,64
1891,176,21,9,0.0851475568,0.914852443,583.1045491,717.5773395,1044.286621,923.4772727,2067,28.72030013,4134,-968192,90112,-878080,64
8378,1483,21,9,0.150390427,0.849609573,2802.301189,2746.360144,4701.688112,6226.465273,9861,261.7038217,19722,-4289536,759296,-3530240,64
5205,844,21,9,0.139527195,0.860472805,1694.869709,1780.443458,2876.978866,3937.85545,6049,130.7326561,12098,-2664960,432128,-2232832,64
5167,833,21,9,0.138833333,0.861166667,1679.186436,1760.328686,2849.417844,3937.644658,6000,125.8917331,12000,-2645504,426496,-2219008,64
4827,725,21,9,0.130583573,0.869416427,1554.158192,1654.74062,2647.281334,3636.828966,5552,107.2435774,11104,-2471424,371200,-2100224,64
7537,1382,21,9,0.154950107,0.845049893,2520.266225,2490.893121,4225.416877,5739.343705,8919,161.9575086,17838,-3858944,707584,-3151360,64
5167,792,21,9,0.132908206,0.867091794,1671.297675,1754.031378,2839.798142,3894.675505,5959,130.5939075,11918,-2645504,405504,-2240000,64
4818,726,21,9,0.130952381,0.869047619,1555.216355,1641.701807,2645.865089,3612.895317,5544,105.8621348,11088,-2466816,371712,-2095104,64
5159,842,21,9,0.140309948,0.859690052,1683.699965,1742.749311,2851.050979,3919.749406,6001,123.8085414,12002,-2641408,431104,-2210304,64
5184,814,21,9,0.135711904,0.864288096,1682.631796,1765.052895,2857.626736,3903.027027,5998,125.3500522,11996,-2654208,416768,-2237440,64
5311,821,21,9,0.133887802,0.866112198,1718.075384,1821.722076,2923.35756,3992.479903,6132,133.0151844,12264,-2719232,420352,-2298880,64
3839,374,21,9,0.088772846,0.911227154,1196.035236,1334.331717,2065.652774,2531.417112,4213,101.2010569,8426,-1965568,191488,-1774080,64
4837,750,21,9,0.1342402,0.8657598,1559.452988,1663.785674,2655.240438,3688.906667,5587,119.8155694,11174,-2476544,384000,-2092544,64
5400,837,21,9,0.134199134,0.865800866,1749.26965,1837.615137,2972.106667,4066.698925,6237,127.7550184,12474,-2764800,428544,-2336256,64
5271,853,21,9,0.139288047,0.860711953,1718.091029,1782.997139,2911.0203,3998.548652,6124,137.6179775,12248,-2698752,436736,-2262016,64
5176,829,21,9,0.138051624,0.861948376,1692.915911,1723.147782,2861.631182,3885.659831,6005,135.4307623,12010,-2650112,424448,-2225664,64
7125,1283,21,9,0.152592769,0.847407231,2376.211174,2390.234547,3998.953965,5345.977397,8408,155.1291513,16816,-3648000,656896,-2991104,64
5275,836,21,9,0.136802487,0.863197513,1718.837712,1782.910134,2914.168152,3950.931818,6111,133.3697076,12222,-2700800,428032,-2272768,64
5230,863,21,9,0.141637945,0.858362055,1708.262821,1764.462679,2890.770937,3993.787949,6093,122.1531676,12186,-2677760,441856,-2235904,64
5330,822,21,9,0.133615085,0.866384915,1729.560617,1796.484368,2934.354409,3998.198297,6152,131.6217373,12304,-2728960,420864,-2308096,64
5254,874,21,9,0.142624021,0.857375979,1721.322955,1784.496358,2914.740008,3964.773455,6128,126.3244692,12256,-2690048,447488,-2242560,64
8969,928,21,9,0.0937657876,0.906234212,2837.433493,3022.858045,4917.43104,5254.109914,9897,500.8603239,19794,-4592128,475136,-4116992,64
8965,937,21,9,0.094627348,0.905372652,2854.57725,2889.114135,4932.599665,5132.334045,9902,775.4111198,19804,-4590080,479744,-4110336,64
9001,905,20,10,0.0913587725,0.908641228,2866.209938,2783.200936,4930.885679,5178.418785,9906,657.7689243,19812,-4608512,463360,-4145152,64
8996,906,21,9,0.0914966673,0.908503333,2842.807605,3002.620807,4932.011672,5145.006623,9902,639.6640827,19804,-4605952,463872,-4142080,64
9077,842,21,9,0.0848875895,0.915112411,2876.431159,2718.56107,4959.433403,4966.108076,9919,549.2248062,19838,-4647424,431104,-4216320,64
9029,877,21,9,0.0885322027,0.911467797,2848.343828,2939.277194,4911.981504,5380.946408,9906,666.6218035,19812,-4622848,449024,-4173824,64
8977,922,20,10,0.0931407213,0.906859279,2870.712046,2718.120076,4929,5154.465293,9899,511.8407446,19798,-4596224,472064,-4124160,64
8967,935,21,9,0.0944253686,0.905574631,2842.569837,2994.43802,4924.690532,5208.612834,9902,691.4804469,19804,-4591104,478720,-4112384,64
4906,534,20,10,0.0981617647,0.901838235,1571.692976,1547.966381,2701.894619,2891.432584,5440,98.24814882,10880,-2511872,273408,-2238464,64
4635,285,21,9,0.0579268293,0.942073171,1413.861789,1506.45673,2472.974973,2257.617544,4920,139.4162652,9840,-2373120,145920,-2227200,64
9042,866,20,10,0.0874041179,0.912595882,2851.054427,2941.765279,4930.003428,5210.271363,9908,817.4917492,19816,-4629504,443392,-4186112,64
2589,248,20,10,0.0874162848,0.912583715,808.9640715,915.4790434,1423.74044,1369.512097,2837,52.61498516,5674,-1325568,126976,-1198592,64
9068,850,20,10,0.0857027627,0.914297237,2872.427676,2760.408272,4966.09131,4889.182353,9918,693.081761,19836,-4642816,435200,-4207616,64
9053,856,21,9,0.0863861136,0.913613886,2862.137791,2842.725425,4952.070695,4985.98014,9909,898.368087,19818,-4635136,438272,-4196864,64
9012,897,21,9,0.0905237663,0.909476234,2869.259614,2770.749503,4954.72692,4957.74359,9909,782.0836622,19818,-4614144,459264,-4154880,64
7447,538,21,9,0.0673763306,0.932623669,2299.790711,2349.579657,4018.096146,3645.618959,7985,152.2983025,15970,-3812864,275456,-3537408,64
3969,230,21,9,0.0547749464,0.945225054,1205.573403,1307.323215,2110.458554,1919.521739,4199,103.3472803,8398,-2032128,117760,-1914368,64
9031,865,20,10,0.0874090542,0.912590946,2864.760891,2768.685204,4959.893589,4829.545665,9896,745.1807229,19792,-4623872,442880,-4180992,64
6085,437,21,9,0.0670039865,0.932996013,1872.777418,1951.413509,3296.709449,2771.226545,6522,150.9722222,13044,-3115520,223744,-2891776,64
9027,881,22,8,0.088918046,0.911081954,2846.956184,2985.607247,4935.65581,5147.583428,9908,475.2038369,19816,-4621824,451072,-4170752,64
5490,883,20,10,0.138553272,0.861446728,1788.073797,1871.359061,3034.202914,4137.006795,6373,129.8756878,12746,-2810880,452096,-2358784,64
5399,835,20,10,0.133942894,0.866057106,1751.94455,1819.726759,2972.030746,4058.08503,6234,131.9644369,12468,-2764288,427520,-2336768,64
5506,861,21,9,0.135228522,0.864771478,1787.030745,1886.54454,3038.538685,4114.209059,6367,132.5905873,12734,-2819072,440832,-2378240,64
6062,915,21,9,0.131145191,0.868854809,1950.15747,2070.364965,3319.63098,4611.092896,6977,135.4231366,13954,-3103744,468480,-2635264,64
5512,828,21,9,0.130599369,0.869400631,1776.445351,1867.997718,3020.241292,4170.772947,6340,119.2626035,12680,-2822144,423936,-2398208,64
5366,842,21,9,0.135631443,0.864368557,1742.778758,1831.120509,2960.8511,4019.963183,6208,119.5916008,12416,-2747392,431104,-2316288,64
5312,802,20,10,0.131174354,0.868825646,1715.802297,1780.244969,2911.310241,4025.779302,6114,124.5721271,12228,-2719744,410624,-2309120,64
5181,604,21,9,0.104407952,0.895592048,1666.269147,1632.823955,2840.193592,3345.963576,5785,132.8968527,11570,-2652672,309248,-2343424,64
8461,1400,21,9,0.141973431,0.858026569,2819.666621,2806.365671,4766.58031,5924.682143,9861,442.3956931,19722,-4332032,716800,-3615232,64
4913,776,21,9,0.136403586,0.863596414,1580.392003,1704.621218,2694.315082,3799.014175,5689,108.0942428,11378,-2515456,397312,-2118144,64
8481,1380,21,9,0.139945239,0.860054761,2816.97544,2810.275859,4763.122509,5962.716667,9861,515.4730789,19722,-4342272,706560,-3635712,64
5346,817,21,9,0.132565309,0.867434691,1730.032445,1829.35738,2943.60101,3987.607099,6163,124.5805539,12326,-2737152,418304,-2318848,64
8376,1478,21,9,0.149989852,0.850010148,2807.227741,2757.025242,4716.148639,6125.253045,9854,280.0227337,19708,-4288512,756736,-3531776,64
5025,763,20,10,0.131824464,0.868175536,1615.607973,1751.071824,2758.71005,3788.791612,5788,106.085044,11576,-2572800,390656,-2182144,64
5484,823,21,9,0.130489932,0.869510068,1763.949738,1885.380888,3006.226295,4138.679222,6307,123.5939643,12614,-2807808,421376,-2386432,64
5446,856,21,9,0.135829895,0.864170105,1771.633992,1844.503162,3005.76625,4078.679907,6302,130.2335193,12604,-2788352,438272,-2350080,64
5378,835,20,10,0.134395622,0.865604378,1743.529658,1847.430308,2966.721086,4010.497006,6213,122.9323308,12426,-2753536,427520,-2326016,64
5403,854,21,9,0.136487134,0.863512866,1759.54957,1844.245273,2988.534148,4017.685012,6257,117.0407782,12514,-2766336,437248,-2329088,64
5426,833,21,9,0.133088353,0.866911647,1761.709699,1839.19507,2992.119056,4028.129652,6259,124.7309685,12518,-2778112,426496,-2351616,64
5444,855,21,9,0.135735831,0.864264169,1766.893874,1844.346328,2998.278288,4116.050292,6299,130.9019119,12598,-2787328,437760,-2349568,64
4406,644,20,10,0.127524752,0.872475248,1409.870474,1490.561412,2400.075352,3383.607143,5050,103.6960986,10100,-2255872,329728,-1926144,64
4403,645,21,9,0.127773376,0.872226624,1405.081748,1527.202541,2401.357256,3365.116279,5048,108.6993971,10096,-2254336,330240,-1924096,64
4344,648,21,9,0.129807692,0.870192308,1393.313132,1490.318121,2374.952118,3311.320988,4992,100.6857604,9984,-2224128,331776,-1892352,64
4544,741,21,9,0.140208136,0.859791864,1457.063767,1633.49116,2498.457967,3529.368421,5285,92.84961349,10570,-2326528,379392,-1947136,64
4449,653,21,9,0.127989024,0.872010976,1425.387847,1542.09833,2434.577208,3348.114855,5102,102.1216974,10204,-2277888,334336,-1943552,64
4430,647,21,9,0.127437463,0.872562537,1421.591536,1518.692378,2423.913544,3326.995363,5077,95.63006216,10154,-2268160,331264,-1936896,64
1903,126,21,9,0.0620995564,0.937900444,574.0285065,696.2831727,1031.104572,771.7698413,2029,54.9269085,4058,-974336,64512,-909824,64
4389,623,22,8,0.124301676,0.875698324,1400.962658,1505.554146,2391.690134,3315.329053,5012,103.4895726,10024,-2247168,318976,-1928192,64
6208,1041,21,9,0.143606015,0.856393985,2045.675514,2113.646749,3464.504671,4582.113353,7249,146.6518309,14498,-3178496,532992,-2645504,64
4421,638,22,8,0.12611188,0.87388812,1412.642851,1526.59262,2412.916987,3341.322884,5059,101.7907445,10118,-2263552,326656,-1936896,64
4423,671,20,10,0.131723596,0.868276404,1420.63771,1544.306616,2426.886955,3342.539493,5094,105.3785685,10188,-2264576,343552,-1921024,64
4424,661,21,9,0.129990167,0.870009833,1416.00143,1541.299241,2419.82708,3367.382753,5085,117.2739852,10170,-2265088,338432,-1926656,64
4454,686,20,10,0.133463035,0.866536965,1430.55864,1580.211993,2449.537719,3355.873178,5140,114.6042363,10280,-2280448,351232,-1929216,64
4404,621,20,10,0.12358209,0.87641791,1396.923992,1524.748105,2390.357402,3382.755233,5025,101.679482,10050,-2254848,317952,-1936896,64
6547,1221,20,10,0.157183316,0.842816684,2196.029498,2126.895689,3667.317703,5049.031122,7768,154.0964094,15536,-3352064,625152,-2726912,64
4481,668,22,8,0.129733929,0.870266071,1428.858075,1617.153924,2457.061817,3366.139222,5149,101.3183786,10298,-2294272,342016,-1952256,64
4434,619,21,9,0.122501484,0.877498516,1409.351569,1557.224117,2416.33604,3319.704362,5053,98.40311587,10106,-2270208,316928,-1953280,64
4506,636,21,9,0.123687281,0.876312719,1435.464882,1511.155671,2443.984909,3474.93239,5142,97.3310619,10284,-2307072,325632,-1981440,64
4469,662,21,9,0.129019684,0.870980316,1427.951662,1555.931837,2440.920788,3410.379154,5131,114.4801428,10262,-2288128,338944,-1949184,64
6469,1235,21,9,0.160306334,0.839693666,2161.237342,2114.23564,3610.313186,5121.088259,7704,137.9162191,15408,-3312128,632320,-2679808,64
2846,252,21,9,0.0813428018,0.918657198,882.6425433,985.1312075,1570.898454,1307.833333,3098,310.1101101,6196,-1457152,129024,-1328128,65
2877,256,20,10,0.0817108203,0.91828918,889.7371724,1017.848785,1590.813347,1299.378906,3133,243.2453416,6266,-1473024,131072,-1341952,65
2851,273,21,9,0.0873879641,0.912612036,886.140977,1002.869253,1591.472817,1259.930403,3124,259.0381426,6248,-1459712,139776,-1319936,65
3140,328,21,9,0.0945790081,0.905420992,979.5107895,1188.304388,1734.911146,1730.564024,3468,308.8156723,6936,-1607680,167936,-1439744,65
3115,333,20,10,0.0965777262,0.903422274,975.3572037,1159.924662,1736.477368,1612.459459,3448,147.0362473,6896,-1594880,170496,-1424384,65
2508,262,21,9,0.0945848375,0.905415162,788.7361821,862.9213068,1409.932217,1151.622137,2770,48.63915716,5540,-1284096,134144,-1149952,65
2840,268,20,10,0.0862290862,0.913770914,887.1790262,959.5276145,1579.007042,1294.798507,3108,109.552344,6216,-1454080,137216,-1316864,65
2861,265,20,10,0.0847728727,0.915227127,887.902007,1003.702448,1589.65152,1281.162264,3126,165.1347068,6252,-1464832,135680,-1329152,65
2901,273,21,9,0.0860113422,0.913988658,902.3290855,1004.840469,1615.798001,1286.794872,3174,134.3776461,6348,-1485312,139776,-1345536,65
2826,250,21,9,0.0812743823,0.918725618,878.0352117,965.6259437,1558.253008,1315.212,3076,211.1187371,6152,-1446912,128000,-1318912,65
2424,247,21,9,0.0924747286,0.907525271,757.5250907,809.0804971,1372.684406,975.9878543,2671,178.5427807,5342,-1241088,126464,-1114624,65
2914,258,21,9,0.0813366961,0.918663304,903.3180548,1022.101763,1605.032944,1377.178295,3172,183.9907193,6344,-1491968,132096,-1359872,65
2847,262,20,10,0.0842714699,0.91572853,886.1540454,991.8625623,1572.924482,1360.225191,3109,272.2416813,6218,-1457664,134144,-1323520,65
3634,394,24,6,0.0978152929,0.902184707,1148.494103,1284.875161,2022.326912,1942.309645,4028,164.5424837,8056,-1860608,201728,-1658880,65
3191,330,21,9,0.093723374,0.906276626,994.3708259,1208.445322,1764.936384,1722.936364,3521,187.3869079,7042,-1633792,168960,-1464832,65
2808,256,20,10,0.0835509138,0.916449086,870.4695631,993.7632627,1554.728989,1288.675781,3064,216.2314749,6128,-1437696,131072,-1306624,65
2861,261,20,10,0.0836002562,0.916399744,889.3294445,998.6739264,1580.780147,1350.157088,3122,225.9044863,6244,-1464832,133632,-1331200,65
3138,334,21,9,0.0961981567,0.903801843,978.7870004,1199.952677,1740.961122,1694.586826,3472,212.8755365,6944,-1606656,171008,-1435648,65
342,57,19,11,0.142857143,0.857142857,112.5980632,93.99006188,213.7690058,117.3859649,399,4.677060134,798,-175104,29184,-145920,65
1766,176,20,10,0.0906282183,0.909371782,549.9975663,566.6976128,1003.215176,653.2670455,1942,30.30586767,3884,-904192,90112,-814080,65
2977,299,23,7,0.0912698413,0.908730159,918.468982,1180.960463,1645.337252,1570.424749,3276,429.3577982,6552,-1524224,153088,-1371136,65
2586,211,23,7,0.0754379693,0.924562031,791.8413311,898.6300923,1429.368523,1026.805687,2797,228.1402936,5594,-1324032,108032,-1216000,65
3262,350,23,7,0.0968992248,0.903100775,1020.923741,1219.657828,1820.31729,1677.722857,3612,224.4872592,7224,-1670144,179200,-1490944,65
2908,289,23,7,0.0903972474,0.909602753,897.0934888,1147.573529,1607.101788,1517.477509,3197,201.8308081,6394,-1488896,147968,-1340928,65
2623,229,23,7,0.0802945302,0.91970547,807.0903246,905.5378317,1460.049562,1042.218341,2852,242.9301533,5704,-1342976,117248,-1225728,65
1832,194,22,8,0.0957551826,0.904244817,568.7303066,621.1350924,1050.073144,668.128866,2026,245.2784504,4052,-937984,99328,-838656,65
2509,215,23,7,0.078928047,0.921071953,771.2917744,870.1797211,1392.70267,1010.04186,2724,46.65981501,5448,-1284608,110080,-1174528,65
2526,217,22,8,0.079110463,0.920889537,774.8438229,909.4689708,1399.311164,1054.082949,2743,239.1455972,5486,-1293312,111104,-1182208,65
2509,224,22,8,0.0819612148,0.918038785,771.5991196,885.3762321,1399.214029,1006.174107,2733,313.0584192,5466,-1284608,114688,-1169920,65
3037,302,22,8,0.0904462414,0.909553759,936.6220743,1203.226949,1674.642081,1623.317881,3339,219.2383454,6678,-1554944,154624,-1400320,65
2536,234,23,7,0.0844765343,0.915523466,781.6607759,911.3388767,1415.675473,1058.470085,2770,295.624333,5540,-1298432,119808,-1178624,65
2512,226,23,7,0.0825420015,0.917457999,771.3560591,901.0728536,1402.11465,1006.986726,2738,240.8091469,5476,-1286144,115712,-1170432,65
2529,228,23,7,0.0826985854,0.917301415,778.2197067,888.3133823,1412.732701,1004.833333,2757,302.6344676,5514,-1294848,116736,-1178112,65
2885,292,23,7,0.0919106075,0.908089393,892.2773803,1133.558606,1587.371924,1605.085616,3177,277.4672489,6354,-1477120,149504,-1327616,65
2912,314,23,7,0.09733416,0.90266584,904.513161,1148.860957,1618.955357,1562.907643,3226,169.343832,6452,-1490944,160768,-1330176,65
3029,311,23,7,0.0931137725,0.906886228,936.9853704,1194.522052,1678.201387,1595.491961,3340,265.5007949,6680,-1550848,159232,-1391616,65
2961,313,22,8,0.0956017104,0.90439829,917.1548879,1174.21025,1646.028031,1556.824281,3274,202.3485785,6548,-1516032,160256,-1355776,65
1733,156,23,7,0.0825833774,0.917416623,531.0829415,548.2132025,980.2250433,553.6858974,1889,27.44841616,3778,-887296,79872,-807424,65
2531,220,23,7,0.0799709197,0.92002908,776.2933498,903.6181228,1406.822995,1021.395455,2751,162.300885,5502,-1295872,112640,-1183232,65
2557,217,23,7,0.0782263879,0.921773612,784.8854461,894.0622072,1417.875244,1029.576037,2774,244.4052863,5548,-1309184,111104,-1198080,65
2150,249,23,7,0.103793247,0.896206753,683.1466843,708.1340383,1232.822791,916.5903614,2399,41.83086312,4798,-1100800,127488,-973312,65
2715,263,23,7,0.0883143049,0.911685695,839.3582229,1021.070017,1510.75175,1270.114068,2978,229.96139,5956,-1390080,134656,-1255424,65
446,111,23,7,0.199281867,0.800718133,167.0870326,124.1974343,289.2914798,237.6486486,557,19.01672926,1114,-228352,56832,-171520,65
2596,213,23,7,0.0758276967,0.924172303,814.6948487,758.25538,1411.681048,1323.57277,2809,345.0859951,5618,-1329152,109056,-1220096,65
2717,263,23,7,0.0882550336,0.911744966,873.3628667,709.3250013,1486.286713,1534.026616,2980,294.4664032,5960,-1391104,134656,-1256448,65
4930,1004,23,7,0.169194473,0.830805527,1691.150695,1648.180651,2825.760041,3663.494024,5934,115.5373832,11868,-2524160,514048,-2010112,65
2287,259,23,7,0.101728201,0.898271799,746.9986751,616.8535132,1278.557499,1228.841699,2546,268.2824025,5092,-1170944,132608,-1038336,65
2194,257,23,7,0.104855161,0.895144839,718.2282193,602.0877046,1235.940747,1141.136187,2451,128.2574568,4902,-1123328,131584,-991744,65
5588,1031,23,7,0.155763711,0.844236289,1917.655537,1668.126842,3165.674302,4092.242483,6619,131.0433578,13238,-2861056,527872,-2333184,65
4513,913,23,7,0.168263914,0.831736086,1547.571051,1530.628463,2596.854864,3290.082147,5426,106.7479835,10852,-2310656,467456,-1843200,65
2264,224,23,7,0.0900321543,0.909967846,719.8635117,700.3448586,1240.811396,1281.78125,2488,44.65984563,4976,-1159168,114688,-1044480,65
2138,196,23,7,0.0839760069,0.916023993,674.2623236,659.5147339,1177.002806,1063.841837,2334,188.9878543,4668,-1094656,100352,-994304,65
4318,830,23,7,0.161227661,0.838772339,1461.435205,1451.78931,2452.660028,3208.361446,5148,103.0012005,10296,-2210816,424960,-1785856,65
2273,209,23,7,0.0842062853,0.915793715,721.8145798,652.9731973,1246.868456,1183.114833,2482,150.2421308,4964,-1163776,107008,-1056768,65
2170,245,23,7,0.101449275,0.898550725,698.3710677,684.5235129,1213.197235,1161.967347,2415,43.22534455,4830,-1111040,125440,-985600,65
2749,255,23,7,0.0848868176,0.915113182,872.7103126,803.1592423,1497.474718,1556.67451,3004,53.38546295,6008,-1407488,130560,-1276928,65
2140,258,23,7,0.107589658,0.892410342,703.2977621,586.8172208,1208.947664,1121.135659,2398,239.3213573,4796,-1095680,132096,-963584,65
4986,919,23,7,0.155630821,0.844369179,1689.11056,1603.290788,2819.543121,3677.065288,5905,122.2567288,11810,-2552832,470528,-2082304,65
4341,805,23,7,0.15643218,0.84356782,1469.904704,1437.498015,2467.233817,3146.545342,5146,100.5470887,10292,-2222592,412160,-1810432,65
5002,831,23,7,0.142465284,0.857534716,1660.19699,1590.525113,2780.997601,3735.632972,5833,113.5487639,11666,-2561024,425472,-2135552,65
2982,295,23,7,0.090021361,0.909978639,921.6046741,1163.695263,1642.036553,1608.305085,3277,300.6422018,6554,-1526784,151040,-1375744,65
2924,306,23,7,0.0947368421,0.905263158,905.0991668,1158.323603,1624.076607,1533.545752,3230,297.4217311,6460,-1497088,156672,-1340416,65
2531,222,23,7,0.0806393026,0.919360697,776.3862984,902.6683179,1409.048597,1011.617117,2753,314.9885584,5506,-1295872,113664,-1182208,65
2899,300,23,7,0.093779306,0.906220694,896.5425383,1146.10155,1611.173853,1492.023333,3199,232.1480406,6398,-1484288,153600,-1330688,65
2518,205,23,7,0.0752846126,0.924715387,771.2078992,898.7000943,1386.049643,1066.6,2723,262.078922,5446,-1289216,104960,-1184256,65
2549,209,22,8,0.0757795504,0.92422045,782.0036554,905.4503701,1402.700667,1096.54067,2758,236.535163,5516,-1305088,107008,-1198080,65
2457,205,23,7,0.0770097671,0.922990233,753.3484069,798.1239826,1369.860399,871.7365854,2662,47.96396396,5324,-1257984,104960,-1153024,65
2892,316,22,8,0.0985037406,0.901496259,898.1144363,1147.545146,1613.456432,1522.531646,3208,71.70317389,6416,-1480704,161792,-1318912,65
2986,307,23,7,0.0932280595,0.90677194,923.043999,1184.473602,1652.347622,1594.986971,3293,338.4378212,6586,-1528832,157184,-1371648,65
2551,232,23,7,0.083363277,0.916636723,785.8212702,889.3178285,1426.98236,1007.344828,2783,255.0870761,5566,-1306112,118784,-1187328,65
2534,221,23,7,0.0802177858,0.919782214,776.9463158,897.4494582,1411.242699,996.8371041,2755,300.1089325,5510,-1297408,113152,-1184256,65
3019,301,23,7,0.0906626506,0.909337349,930.8447914,1196.206428,1669.908248,1566.136213,3320,154.8507463,6640,-1545728,154112,-1391616,65
2522,222,23,7,0.0809037901,0.91909621,775.7491935,910.6861841,1397.786281,1085.238739,2744,297.291441,5488,-1291264,113664,-1177600,65
2528,238,23,7,0.0860448301,0.91395517,780.4979142,897.756239,1416.337025,1034.710084,2766,236.6124893,5532,-1294336,121856,-1172480,65
2913,306,23,7,0.0950605778,0.904939422,901.802183,1156.521435,1616.56059,1547.545752,3219,358.8628763,6438,-1491456,156672,-1334784,65
2913,296,22,8,0.0922405734,0.907759427,901.4772513,1142.031413,1608.712667,1568.462838,3209,141.4279418,6418,-1491456,151552,-1339904,65
2887,293,23,7,0.0921383648,0.907861635,890.199707,1155.792194,1594.731209,1548.808874,3180,208.935611,6360,-1478144,150016,-1328128,65
2869,272,23,7,0.0865966253,0.913403375,881.1394778,1141.506491,1574.713838,1531.827206,3141,175.3768844,6282,-1468928,139264,-1329664,65
2566,245,22,8,0.0871575952,0.912842405,790.7598682,955.112018,1433.924006,1113.538776,2811,49.15194964,5622,-1313792,125440,-1188352,65
2523,225,22,8,0.0818777293,0.918122271,774.8138353,897.7541743,1407.375347,1005.857778,2748,333.9003645,5496,-1291776,115200,-1176576,65
3026,307,23,7,0.0921092109,0.907890789,935.2266115,1194.636437,1671.51388,1622.508143,3333,255.0114767,6666,-1549312,157184,-1392128,65
2986,299,22,8,0.0910197869,0.908980213,919.2828213,1196.587412,1651.853315,1554.585284,3285,310.7852412,6570,-1528832,153088,-1375744,65
2902,291,23,7,0.0911368619,0.908863138,895.5269405,1150.218261,1600.880083,1558.305842,3193,233.4064327,6386,-1485824,148992,-1336832,65
2888,306,23,7,0.0958046337,0.904195366,894.132944,1151.472901,1602.430402,1550.96732,3194,210.5471325,6388,-1478656,156672,-1321984,65
2533,217,23,7,0.0789090909,0.921090909,777.4947975,896.2646281,1404.80379,1033.442396,2750,395.6834532,5500,-1296896,111104,-1185792,65
2914,328,23,7,0.101172116,0.898827884,902.5782867,1191.106191,1617.886754,1653.60061,3242,57.73820125,6484,-1491968,167936,-1324032,65
2567,213,22,8,0.076618705,0.923381295,786.5191188,906.828694,1419.033113,1046.629108,2780,291.4046122,5560,-1314304,109056,-1205248,65
2848,277,22,8,0.08864,0.91136,877.8418312,1112.602036,1576.143961,1427.859206,3125,169.2849404,6250,-1458176,141824,-1316352,65
2659,206,23,7,0.0719022688,0.928097731,811.2413684,941.5970124,1460.096277,1083.247573,2865,248.0519481,5730,-1361408,105472,-1255936,65
2534,201,23,7,0.0734917733,0.926508227,775.3543011,890.2895398,1393.360695,1048.278607,2735,167.8944138,5470,-1297408,102912,-1194496,65
2916,298,23,7,0.0927193528,0.907280647,902.5268603,1143.791152,1614.544925,1538.563758,3214,117.6427526,6428,-1492992,152576,-1340416,65
2912,283,23,7,0.0885758998,0.9114241,897.8299126,1143.482319,1601.861607,1558.265018,3195,216.6101695,6390,-1490944,144896,-1346048,65
2900,309,23,7,0.0962916797,0.90370832,897.9885535,1156.412098,1613.224138,1527.815534,3209,306.7877629,6418,-1484800,158208,-1326592,65
2551,218,23,7,0.078728783,0.921271217,781.9759138,898.3408996,1417.111721,1009.233945,2769,208.5090361,5538,-1306112,111616,-1194496,65
2737,256,23,7,0.0855329101,0.91446709,843.7044031,1019.969127,1521.788089,1231.980469,2993,108.7968012,5986,-1401344,131072,-1270272,65
2786,209,23,7,0.0697829716,0.930217028,847.5685739,1021.798978,1476.086504,1790.110048,2995,211.6607774,5990,-1426432,107008,-1319424,65
2513,219,23,7,0.0801610542,0.919838946,772.2478989,890.6988133,1395.766415,1030.671233,2732,186.2304022,5464,-1286656,112128,-1174528,65
2568,226,22,8,0.0808876163,0.919112384,789.9228708,893.7689112,1430.554907,1021.902655,2794,228.8288288,5588,-1314816,115712,-1199104,65
3046,300,23,7,0.0896592947,0.910340705,941.8183307,1182.950524,1674.813854,1660.16,3346,198.6935867,6692,-1559552,153600,-1405952,65
1790,168,23,7,0.0858018386,0.914198161,550.6641293,551.9362973,1018.407263,564.952381,1958,30.01226242,3916,-916480,86016,-830464,65
1736,200,21,9,0.103305785,0.896694215,553.5882817,539.4619773,997.8485023,713.755,1936,166.0377358,3872,-888832,102400,-786432,65
3850,737,20,10,0.160671463,0.839328537,1311.727358,1360.730973,2246.653247,2541.333786,4587,93.55496635,9174,-1971200,377344,-1593856,65
1847,222,20,10,0.107298212,0.892701788,597.7843826,553.6853169,1059.100162,834.490991,2069,214.8494289,4138,-945664,113664,-832000,65
1788,238,20,10,0.117472853,0.882527147,586.6505937,511.7163127,1045.234899,775.0882353,2026,198.2387476,4052,-915456,121856,-793600,65
1881,211,20,10,0.100860421,0.899139579,605.9022525,559.2155161,1065.069644,880.957346,2092,175.3562448,4184,-963072,108032,-855040,65
2764,257,21,9,0.0850711685,0.914928832,850.6932142,1037.237994,1536.323806,1238.645914,3021,278.9473684,6042,-1415168,131584,-1283584,65
1766,181,20,10,0.0929635336,0.907036466,559.7180905,536.5165563,996.5939977,753.5524862,1947,180.4448563,3894,-904192,92672,-811520,65
1789,231,21,9,0.114356436,0.885643564,588.0042504,507.7691504,1034.16825,827.1991342,2020,63.84323641,4040,-915968,118272,-797696,65
2727,252,21,9,0.084592145,0.915407855,840.5431223,1021.622738,1510.390906,1269.34127,2979,184.5724907,5958,-1396224,129024,-1267200,65
1786,175,21,9,0.0892401836,0.910759816,567.8215134,534.1198782,992.5134378,863.4971429,1961,161.2664474,3922,-914432,89600,-824832,65
1943,210,21,9,0.0975383186,0.902461681,623.6084411,583.19905,1092.254761,935.8571429,2153,158.7758112,4306,-994816,107520,-887296,65
54,19,21,9,0.260273973,0.739726027,20.92094336,21.40352315,37.59259259,35.31578947,73,1.532004197,146,-27648,9728,-17920,65
1989,253,20,10,0.112845674,0.887154326,657.1020511,537.6057901,1141.698341,962.7075099,2242,164.6108664,4484,-1018368,129536,-888832,65
3895,351,21,9,0.0826660386,0.917333961,1209.397581,1380.963837,2139.929653,1941.182336,4246,123.6819109,8492,-1994240,179712,-1814528,65
1880,221,20,10,0.105188006,0.894811994,609.6807425,542.8428969,1073.331383,861.0316742,2101,90.13299013,4202,-962560,113152,-849408,65
3960,342,20,10,0.0794979079,0.920502092,1224.96873,1403.261797,2171.139646,1924.093567,4302,238.2059801,8604,-2027520,175104,-1852416,65
1898,242,21,9,0.113084112,0.886915888,625.9381898,523.7047375,1090.463119,913.9297521,2140,137.7091377,4280,-971776,123904,-847872,65
1896,211,21,9,0.100142383,0.899857617,611.209971,570.9436869,1065.279536,952.6445498,2107,150.1781896,4214,-970752,108032,-862720,65
2362,280,24,6,0.105980318,0.894019682,772.1406148,662.7507059,1337.330652,1187.957143,2642,157.4493445,5284,-1209344,143360,-1065984,65
175,14,23,7,0.0740740741,0.925925926,53.25827283,63.42905405,97.04571429,69.42857143,189,3.037608486,378,-89600,7168,-82432,65
3613,308,22,8,0.07855139,0.92144861,1120.130028,1207.714578,1990.889842,1610.376623,3921,326.2063228,7842,-1849856,157696,-1692160,65
3029,240,23,7,0.0734169471,0.926583053,929.221506,1057.708933,1660.69759,1310.675,3269,222.3809524,6538,-1550848,122880,-1427968,65
3642,350,22,8,0.0876753507,0.912324649,1136.275387,1234.5341,2036.27128,1582.651429,3992,69.45024356,7984,-1864704,179200,-1685504,65
3663,318,23,7,0.0798794273,0.920120573,1137.987497,1226.907938,2018.77068,1671.113208,3981,284.7639485,7962,-1875456,162816,-1712640,65
4694,439,23,7,0.0855250341,0.914474966,1463.067273,1657.102347,2584.557307,2379.268793,5133,487.0018975,10266,-2403328,224768,-2178560,65
3599,333,23,7,0.0846897253,0.915310275,1124.216882,1197.03245,1997.231453,1634.36036,3932,444.7963801,7864,-1842688,170496,-1672192,65
3622,318,23,7,0.0807106599,0.91928934,1126.802077,1197.83888,2001.038377,1622.669811,3940,329.1562239,7880,-1854464,162816,-1691648,65
4711,481,23,7,0.092642527,0.907357473,1466.036068,1788.186073,2597.995967,2581.848233,5192,459.8759965,10384,-2412032,246272,-2165760,65
3668,332,23,7,0.083,0.917,1143.687527,1223.197068,2030.118866,1673.26506,4000,371.0575139,8000,-1878016,169984,-1708032,65
3676,358,23,7,0.0887456619,0.911254338,1156.699154,1187.282375,2051.37296,1669.687151,4034,327.1695053,8068,-1882112,183296,-1698816,65
3016,311,22,8,0.0934776075,0.906522393,944.8263107,1051.986261,1695.645557,1357.109325,3327,129.9101913,6654,-1544192,159232,-1384960,65
158,41,23,7,0.206030151,0.793969849,53.97490062,60.69747296,92.31012658,129.6341463,199,11.7196702,398,-80896,20992,-59904,65
3617,325,23,7,0.0824454592,0.917554541,1127.772124,1203.388079,1999.207631,1663.135385,3942,313.354531,7884,-1851904,166400,-1685504,65
3007,309,23,7,0.0931845597,0.90681544,942.5349079,1065.353721,1681.097439,1438.595469,3316,143.4876677,6632,-1539584,158208,-1381376,65
3536,328,23,7,0.0848861284,0.915113872,1104.314443,1148.396366,1971.346154,1513.719512,3864,68.63232682,7728,-1810432,167936,-1642496,65
3960,342,22,8,0.0794979079,0.920502092,1227.163994,1390.548509,2165.699747,1987.081871,4302,344.7115385,8604,-2027520,175104,-1852416,65
2694,258,22,8,0.087398374,0.912601626,832.6478711,1010.96694,1496.452858,1268.155039,2952,102.8213166,5904,-1379328,132096,-1247232,65
2683,264,22,8,0.0895826264,0.910417374,830.2613801,1006.489035,1497.058144,1239.662879,2947,277.7568332,5894,-1373696,135168,-1238528,65
3710,300,23,7,0.0748129676,0.925187032,1150.822421,1211.684907,2025.321563,1760.373333,4010,254.4416244,8020,-1899520,153600,-1745920,65
4557,445,23,7,0.0889644142,0.911035586,1432.938701,1543.363786,2516.961378,2343.168539,5002,167.5150703,10004,-2333184,227840,-2105344,65
2530,215,23,7,0.0783242259,0.921675774,775.8468952,908.5416598,1399.835178,1057.218605,2745,252.5298988,5490,-1295360,110080,-1185280,65
2542,223,23,7,0.0806509946,0.919349005,778.7196157,903.1578903,1417.817073,986.1165919,2765,225.5301794,5530,-1301504,114176,-1187328,65
3200,357,23,7,0.100365477,0.899634523,1003.689117,1208.760532,1791.61,1665.969188,3557,237.7673797,7114,-1638400,182784,-1455616,65
2519,220,23,7,0.0803212851,0.919678715,773.1115003,898.3002054,1400.524811,1020.490909,2739,300.989011,5478,-1289728,112640,-1177088,65
2900,290,23,7,0.0909090909,0.909090909,894.9994323,1146.790041,1600.475862,1545.741379,3190,229.6616271,6380,-1484800,148480,-1336320,65
2910,297,22,8,0.0926099158,0.907390084,899.0954173,1154.273254,1608.200687,1562.841751,3207,216.8356998,6414,-1489920,152064,-1337856,65
2540,220,22,8,0.0797101449,0.920289855,779.0876656,907.1006274,1410.824016,1030.395455,2760,177.6061776,5520,-1300480,112640,-1187840,65
1931,184,22,8,0.0869976359,0.913002364,593.812913,704.4631085,1085.011911,774.5217391,2115,303.8793103,4230,-988672,94208,-894464,65
2883,316,23,7,0.098780869,0.901219131,894.3231233,1154.252945,1606.510579,1540.601266,3199,186.2048894,6398,-1476096,161792,-1314304,65
3004,320,23,7,0.0962695548,0.903730445,925.6949698,1232.813641,1663.880493,1649.540625,3324,58.12204931,6648,-1538048,163840,-1374208,65
2540,128,23,7,0.047976012,0.952023988,761.3086749,914.7500256,1342.455906,1176.625,2668,257.2806172,5336,-1300480,65536,-1234944,65
2905,299,23,7,0.0933208489,0.906679151,898.582607,1149.15316,1606.214802,1566.408027,3204,256.1151079,6408,-1487360,153088,-1334272,65
2566,221,23,7,0.0792967348,0.920703265,788.1411652,914.3057185,1421.968044,1069.266968,2787,254.9862763,5574,-1313792,113152,-1200640,65
2920,311,23,7,0.0962550294,0.903744971,903.9227965,1164.811884,1625.901027,1523.038585,3231,217.8691841,6462,-1495040,159232,-1335808,65
2558,223,23,7,0.0801869831,0.919813017,785.5910475,888.854596,1425.278342,997.7982063,2781,198.7848463,5562,-1309696,114176,-1195520,65
765,117,23,7,0.132653061,0.867346939,248.4289261,224.11121,468.1228758,267.4273504,882,22.08312469,1764,-391680,59904,-331776,65
2634,208,23,7,0.0731878958,0.926812104,806.8864707,911.5968391,1447.928246,1086.826923,2842,236.2427265,5684,-1348608,106496,-1242112,65
3021,308,22,8,0.0925202764,0.907479724,933.907649,1192.86307,1671.240649,1603.788961,3329,252.5796662,6658,-1546752,157696,-1389056,65
2969,318,22,8,0.0967447521,0.903255248,920.8248598,1175.285824,1653.507915,1555.22956,3287,235.1216023,6574,-1520128,162816,-1357312,65
2972,303,22,8,0.092519084,0.907480916,915.3033741,1200.519567,1633.604307,1681.115512,3275,58.08797446,6550,-1521664,155136,-1366528,65
2915,301,23,7,0.0935945274,0.906405473,902.4835851,1147.110243,1615.572213,1540.009967,3216,235.2596928,6432,-1492480,154112,-1338368,65
2560,229,23,7,0.0821082825,0.917891717,786.7200826,910.1318716,1427.882031,1027.41048,2789,207.514881,5578,-1310720,117248,-1193472,65
2508,218,23,7,0.079970653,0.920029347,769.1027428,906.7470575,1391.917065,1036.573394,2726,273.4202608,5452,-1284096,111616,-1172480,65
2924,310,23,7,0.0958565244,0.904143476,905.4977629,1163.883875,1623.866279,1557.451613,3234,301.9607843,6468,-1497088,158720,-1338368,65
2547,222,23,7,0.0801733478,0.919826652,782.624801,906.7992781,1413.965842,1052.675676,2769,218.8932806,5538,-1304064,113664,-1190400,65
2540,223,23,7,0.0807093739,0.919290626,779.5650127,904.9220254,1413.659055,1021.399103,2763,277.6884422,5526,-1300480,114176,-1186304,65
2552,229,23,7,0.0823444804,0.91765552,783.2651607,910.37833,1425.500784,1006.519651,2781,347.1910112,5562,-1306624,117248,-1189376,65
2589,227,23,7,0.0806107955,0.919389205,795.479485,914.1229168,1440.505601,1043.46696,2816,218.6335404,5632,-1325568,116224,-1209344,65
2628,228,23,7,0.0798319328,0.920168067,807.2302257,915.4904296,1462.364536,1038.166667,2856,206.6570188,5712,-1345536,116736,-1228800,65
2920,294,23,7,0.0914747978,0.908525202,902.3037647,1150.520275,1609.824315,1584.414966,3214,301.2183693,6428,-1495040,150528,-1344512,65
2959,302,23,7,0.0926096289,0.907390371,914.5939531,1171.347345,1634.120311,1600.427152,3261,308.8068182,6522,-1515008,154624,-1360384,65
2535,211,23,7,0.0768390386,0.923160961,776.1543897,918.5742138,1398.342406,1075.037915,2746,287.8406709,5492,-1297920,108032,-1189888,65
2523,229,22,8,0.0832122093,0.916787791,776.6534634,866.3353158,1414.217598,960.9475983,2752,66.65052071,5504,-1291776,117248,-1174528,65
2919,290,23,7,0.090370832,0.909629168,902.5254543,1138.792865,1604.529976,1609.731034,3209,245.3363914,6418,-1494528,148480,-1346048,65
2517,205,23,7,0.0753122704,0.92468773,769.3898826,902.2402706,1388.202225,1033.64878,2722,447.6973684,5444,-1288704,104960,-1183744,65
89,35,23,7,0.282258065,0.717741935,34.85694972,37.05545761,59.58426966,69.91428571,124,7.420706164,248,-45568,17920,-27648,65
2922,280,22,8,0.0874453467,0.912554653,898.8531073,1157.243635,1602.241273,1593.764286,3202,247.8328173,6404,-1496064,143360,-1352704,65
3255,351,23,7,0.0973377704,0.90266223,1018.841613,1224.499301,1811.916436,1725.450142,3606,240.4,7212,-1666560,179712,-1486848,65
1615,165,23,7,0.0926966292,0.907303371,502.5942365,513.2003464,923.149226,570.9333333,1780,27.60974096,3560,-826880,84480,-742400,65
1770,161,22,8,0.0833764889,0.916623511,542.5588832,569.3224704,1001.530508,575.3850932,1931,30.05447471,3862,-906240,82432,-823808,65
98,13,23,7,0.117117117,0.882882883,30.75928631,39.12428989,57.26530612,46.46153846,111,7.097186701,222,-50176,6656,-43520,65
97,14,22,8,0.126126126,0.873873874,30.68065832,38.34729855,57.63917526,44.64285714,111,7.142857143,222,-49664,7168,-42496,65
2577,208,23,7,0.0746858169,0.925314183,787.773445,908.7170543,1422.02988,1033.336538,2785,259.5526561,5570,-1319424,106496,-1212928,65
2597,234,23,7,0.0826563052,0.917343695,799.4986429,903.3307176,1451.602618,1020.871795,2831,335.8244365,5662,-1329664,119808,-1209856,65
3001,308,23,7,0.0930794802,0.90692052,926.9132829,1195.001297,1660.9007,1597.506494,3309,290.0087642,6618,-1536512,157696,-1378816,65
3005,303,23,7,0.0915961306,0.908403869,926.2576477,1199.588567,1663.074875,1569.458746,3308,269.8205546,6616,-1538560,155136,-1383424,65
2528,226,23,7,0.0820624546,0.917937545,775.2099384,926.5401923,1407.338608,1043.730088,2754,47.97073681,5508,-1294336,115712,-1178624,65
2545,216,22,8,0.0782325244,0.921767476,781.7816079,906.5916291,1406.38389,1081.916667,2761,224.6541904,5522,-1303040,110592,-1192448,65
2539,218,23,7,0.0790714545,0.920928546,779.2230221,900.2012603,1408.54549,1034.889908,2757,373.0717185,5514,-1299968,111616,-1188352,65
2565,218,23,7,0.0783327345,0.921667266,787.1838839,902.5808126,1421.860429,1040.66055,2783,425.5351682,5566,-1313280,111616,-1201664,65
2587,221,23,7,0.0787037037,0.921296296,793.0903216,910.5219456,1436.960572,1024.520362,2808,342.0219245,5616,-1324544,113152,-1211392,65
3043,284,22,8,0.0853621882,0.914637812,936.1737061,1189.062663,1667.228064,1629.411972,3327,283.6317136,6654,-1558016,145408,-1412608,65
2922,292,23,7,0.0908525202,0.90914748,903.466814,1143.13597,1607.391513,1608.585616,3214,233.7454545,6428,-1496064,149504,-1346560,65
2609,218,23,7,0.0771135479,0.922886452,800.3597352,914.4621773,1443.379072,1062.394495,2827,258.173516,5654,-1335808,111616,-1224192,65
2912,307,23,7,0.0953712333,0.904628767,900.2920934,1166.804054,1616.73489,1546.117264,3219,148.6149584,6438,-1490944,157184,-1333760,65
2928,291,22,8,0.0904007456,0.909599254,903.1904746,1156.774631,1617.192964,1537.62543,3219,231.4162473,6438,-1499136,148992,-1350144,65
3058,302,23,7,0.0898809524,0.910119048,943.1491398,1206.775598,1686.184107,1622.943709,3360,245.2554745,6720,-1565696,154624,-1411072,65
2888,311,23,7,0.0972178806,0.902782119,895.1156502,1150.838013,1608.706717,1519.14791,3199,299.5318352,6398,-1478656,159232,-1319424,65
2898,312,23,7,0.0971962617,0.902803738,896.1073152,1166.952678,1617.583506,1493.262821,3210,206.0333761,6420,-1483776,159744,-1324032,65
1744,158,23,7,0.0830704522,0.916929548,534.8749353,557.4734822,986.2448394,567.9873418,1902,29.30662558,3804,-892928,80896,-812032,65
9427,527,23,7,0.0529435403,0.94705646,2863.760674,3008.042584,5002.144373,4536.660342,9954,1809.818182,19908,-4826624,269824,-4556800,66
1853,170,22,8,0.0840336134,0.915966387,574.8192055,592.1845084,1040.61306,700.1176471,2023,35.42286815,4046,-948736,87040,-861696,66
9365,586,23,7,0.0588885539,0.941111446,2873.971755,2750.535206,5021.467272,4249.377133,9951,940.5482042,19902,-4794880,300032,-4494848,66
9414,543,23,7,0.0545344983,0.945465502,2873.194605,2804.280833,5019.123221,4283.383057,9957,1308.409987,19914,-4819968,278016,-4541952,66
9350,605,23,7,0.0607734807,0.939226519,2872.586264,2782.659385,5027.362246,4215.128926,9955,818.6677632,19910,-4787200,309760,-4477440,66
9375,573,22,8,0.0575995175,0.942400483,2871.7027,2828.325427,5004.225707,4488.150087,9948,1150.057803,19896,-4800000,293376,-4506624,66
9334,614,24,6,0.0617209489,0.938279051,2872.937028,2746.414414,5023.839083,4224.449511,9948,602.9090909,19896,-4779008,314368,-4464640,66
9313,635,23,7,0.063831926,0.936168074,2877.541409,2764.620404,4996.834425,4646.940157,9948,1310.671937,19896,-4768256,325120,-4443136,66
9302,642,24,6,0.0645615447,0.935438455,2854.309672,2940.801009,5037.287895,4033.781931,9944,944.3494777,19888,-4762624,328704,-4433920,66
9345,601,23,7,0.060426302,0.939573698,2873.242194,2819.948783,4993.771215,4658.301165,9946,1111.284916,19892,-4784640,307712,-4476928,66
9435,520,23,7,0.0522350578,0.947764942,2858.287187,3067.107251,5014.4177,4317.228846,9955,1186.531585,19910,-4830720,266240,-4564480,66
9314,631,23,7,0.0634489693,0.936551031,2875.919551,2759.181836,5002.383187,4539.283677,9945,603.4587379,19890,-4768768,323072,-4445696,66
9246,687,24,6,0.0691633947,0.930836605,2863.371464,2920.153051,4972.6618,4890.800582,9933,659.1240876,19866,-4733952,351744,-4382208,66
9341,609,23,7,0.0612060302,0.93879397,2875.721977,2745.704766,5016.005781,4354.211823,9950,737.5833951,19900,-4782592,311808,-4470784,66
9352,595,22,8,0.0598170303,0.94018297,2869.882249,2831.392303,5011.528229,4384.144538,9947,460.5092593,19894,-4788224,304640,-4483584,66
9354,598,23,7,0.0600884244,0.939911576,2876.35645,2732.619788,5019.217126,4308.312709,9952,1197.593261,19904,-4789248,306176,-4483072,66
9298,647,23,7,0.065057818,0.934942182,2877.575233,2737.971992,5002.470639,4549.479134,9945,441.2156167,19890,-4760576,331264,-4429312,66
7828,698,24,6,0.0818672297,0.91813277,2427.797721,2804.739758,4249.982499,4415.097421,8526,155.4704595,17052,-4007936,357376,-3650560,66
6989,584,22,8,0.0771160702,0.92288393,2170.141823,2369.131215,3785.642581,3803.244863,7573,149.3688363,15146,-3578368,299008,-3279360,66
9362,588,22,8,0.0590954774,0.940904523,2869.389686,2882.413825,5003.389233,4531.454082,9950,1251.572327,19900,-4793344,301056,-4492288,66
9358,585,23,7,0.0588353616,0.941164638,2868.450079,2888.049475,4987.734024,4720.309402,9943,957.8998073,19886,-4791296,299520,-4491776,66
9317,614,23,7,0.0618266036,0.938173396,2862.417586,2922.312475,4981.978427,4723.539088,9931,928.1308411,19862,-4770304,314368,-4455936,66
9372,570,22,8,0.0573325287,0.942667471,2858.109438,3045.079102,4988.725139,4688.282456,9942,836.8686869,19884,-4798464,291840,-4506624,66
9289,638,23,7,0.0642691649,0.935730835,2860.396451,2940.756706,4968.398428,4899.960815,9927,817.037037,19854,-4755968,326656,-4429312,66
9341,603,23,7,0.0606395817,0.939360418,2866.145753,2911.37635,4997.424473,4586.39801,9944,1001.409869,19888,-4782592,308736,-4473856,66
9363,581,23,7,0.0584271923,0.941572808,2863.019956,2968.428559,4994.02072,4625.686747,9944,1100,19888,-4793856,297472,-4496384,66
9330,612,23,7,0.0615570308,0.938442969,2870.572728,2841.27965,4993.017792,4643.45915,9942,1464.212077,19884,-4776960,313344,-4463616,66
9359,587,23,7,0.059018701,0.940981299,2864.87393,2937.739146,4999.909285,4552.436116,9946,952.6819923,19892,-4791808,300544,-4491264,66
9384,563,23,7,0.0565999799,0.94340002,2867.341989,2865.548705,5012.076833,4339.34103,9947,1646.854305,19894,-4804608,288256,-4516352,66
9364,580,23,7,0.0583266291,0.941673371,2868.253551,2864.453003,5002.626976,4486.105172,9944,1053.389831,19888,-4794368,296960,-4497408,66
9291,644,23,7,0.0648213387,0.935178661,2832.368341,3307.818728,4937.066301,5414.281056,9935,780.4399057,19870,-4756992,329728,-4427264,66
9353,591,23,7,0.0594328238,0.940567176,2866.139677,2905.846689,4999.902277,4538.839255,9944,1490.854573,19888,-4788736,302592,-4486144,66
9385,558,22,8,0.0561198833,0.943880117,2864.547438,2938.184837,4995.122216,4583.107527,9943,1453.654971,19886,-4805120,285696,-4519424,66
9341,603,23,7,0.0606395817,0.939360418,2868.354941,2862.936539,5003.288513,4495.558872,9944,931.0861423,19888,-4782592,308736,-4473856,66
9333,610,23,7,0.0613496933,0.938650307,2861.511532,2935.259883,5011.711883,4364.408197,9943,1279.66538,19886,-4778496,312320,-4466176,66
8289,542,23,7,0.0613747028,0.938625297,2549.624172,2431.147415,4463.505851,3689.476015,8831,154.5772799,17662,-4243968,277504,-3966464,66
9380,569,23,7,0.0571916776,0.942808322,2871.44104,2812.73523,5011.912047,4366.502636,9949,1697.78157,19898,-4802560,291328,-4511232,66
9366,578,23,7,0.0581255028,0.941874497,2866.961698,2904.547511,4994.97192,4608.361592,9944,819.1103789,19888,-4795392,295936,-4499456,66
9370,577,23,7,0.0580074394,0.941992561,2867.576046,2899.089253,5000.841942,4538.109185,9947,1433.285303,19894,-4797440,295424,-4502016,66
9307,627,23,7,0.0631165694,0.936883431,2861.889397,2921.419538,4995.401203,4553.342903,9934,614.7277228,19868,-4765184,321024,-4444160,66
9307,626,23,7,0.0630222491,0.936977751,2853.327164,2910.957529,5030.330182,4025.444089,9933,886.0838537,19866,-4765184,320512,-4444672,66
9271,661,23,7,0.0665525574,0.933447443,2852.352797,3065.552979,4960.532305,5050.20121,9932,1154.883721,19864,-4746752,338432,-4408320,66
9317,621,22,8,0.062487422,0.937512578,2856.914043,3033.018748,4984.877214,4738.792271,9938,1557.680251,19876,-4770304,317952,-4452352,66
9341,598,22,8,0.0601670188,0.939832981,2858.76178,3018.909055,4983.443314,4760.010033,9939,969.6585366,19878,-4782592,306176,-4476416,66
9312,623,23,7,0.0627075994,0.937292401,2848.709258,3133.935986,4982.637887,4749.207063,9935,1874.528302,19870,-4767744,318976,-4448768,66
9338,601,24,6,0.06046886,0.93953114,2860.874756,2984.290203,4985.537695,4728.584027,9939,574.5086705,19878,-4781056,307712,-4473344,66
9302,637,23,7,0.0640909548,0.935909045,2853.152882,3090.353138,4978.834767,4840.987441,9939,1479.017857,19878,-4762624,326144,-4436480,66
9316,623,23,7,0.0626823624,0.937317638,2860.538074,2990.959641,4979.887291,4822.150883,9939,1667.61745,19878,-4769792,318976,-4450816,66
9356,580,23,7,0.058373591,0.941626409,2847.15556,3176.254411,4950.895468,5252.47931,9936,956.3041386,19872,-4790272,296960,-4493312,66
9309,627,23,7,0.0631038647,0.936896135,2852.092349,3097.835153,4973.067354,4900.688995,9936,1171.698113,19872,-4766208,321024,-4445184,66
9299,639,23,7,0.0642986516,0.935701348,2850.38594,3124.752017,4965.695559,5024.86385,9938,1025.593395,19876,-4761088,327168,-4433920,66
9292,639,23,7,0.0643439734,0.935656027,2852.394993,3069.024089,4964.438334,4988.70892,9931,1718.16609,19862,-4757504,327168,-4430336,66
9297,636,23,7,0.0640289943,0.935971006,2860.603603,2963.562692,4960.632677,5060.077044,9933,704.4680851,19866,-4760064,325632,-4434432,66
9269,667,23,7,0.0671296296,0.93287037,2865.652994,2879.830457,4994.746035,4603.770615,9936,469.787234,19872,-4745728,341504,-4404224,66
9288,647,23,7,0.0651233015,0.934876699,2858.268006,2998.069363,4980.761843,4784.797527,9935,1166.079812,19870,-4755456,331264,-4424192,66
9299,640,22,8,0.0643927961,0.935607204,2857.984201,3004.659315,4994.23153,4617.923437,9939,1501.359517,19878,-4761088,327680,-4433408,66
9327,610,23,7,0.0613867364,0.938613264,2847.254969,3176.410475,4966.57028,5006.15082,9937,729.0535583,19874,-4775424,312320,-4463104,66
9323,614,23,7,0.0617892724,0.938210728,2865.058681,2906.370413,4987.806715,4683.438111,9937,968.5185185,19874,-4773376,314368,-4459008,66
9323,617,23,7,0.0620724346,0.937927565,2858.199168,3024.412427,4986.017269,4736.030794,9940,1728.695652,19880,-4773376,315904,-4457472,66
9320,618,23,7,0.0621855504,0.93781445,2849.722073,3143.272019,4970.067597,4960.940129,9938,796.9526864,19876,-4771840,316416,-4455424,66
9293,638,23,7,0.0642432786,0.935756721,2853.037263,3055.240598,4978.173679,4788.680251,9931,1320.611702,19862,-4758016,326656,-4431360,66
9280,654,22,8,0.0658345078,0.934165492,2854.254272,3050.284485,4974.660129,4865.900612,9934,1663.9866,19868,-4751360,334848,-4416512,66
9351,587,23,7,0.0590662105,0.940933789,2860.065617,2976.061612,4995.000535,4563.272572,9938,793.7699681,19876,-4787712,300544,-4487168,66
9258,674,23,7,0.0678614579,0.932138542,2861.484865,2933.624024,4983.392957,4734.459941,9932,611.9531731,19864,-4740096,345088,-4395008,66
9274,660,23,7,0.0664384941,0.933561506,2865.217448,2867.181006,4998.470024,4532.324242,9934,408.9748868,19868,-4748288,337920,-4410368,66
9316,622,23,7,0.0625880459,0.937411954,2853.185968,3091.023299,4978.322993,4837.353698,9938,1521.898928,19876,-4769792,318464,-4451328,66
9308,629,23,7,0.0632987823,0.936701218,2861.266705,2969.238283,4980.533412,4798.327504,9937,1382.058414,19874,-4765696,322048,-4443648,66
9298,640,23,7,0.0643992755,0.935600724,2856.362358,3032.120033,4987.798559,4703.65625,9938,1864.540338,19876,-4760576,327680,-4432896,66
9244,680,23,7,0.0685207578,0.931479242,2854.360512,3001.874463,4969.034833,4873.664706,9924,1180.023781,19848,-4732928,348160,-4384768,66
9253,680,22,8,0.0684586731,0.931541327,2857.471578,2974.780652,4994.188912,4597.030882,9933,836.8155013,19866,-4737536,348160,-4389376,66
9309,626,23,7,0.0630095622,0.936990438,2859.636475,2975.221222,4986.943281,4686.301917,9935,912.3048669,19870,-4766208,320512,-4445696,66
9302,632,23,7,0.0636198913,0.936380109,2853.543798,3068.200174,4970.286068,4926.493671,9934,1010.579858,19868,-4762624,323584,-4439040,66
9294,640,22,8,0.0644252064,0.935574794,2844.571055,3184.377751,4970.437594,4924.840625,9934,1419.142857,19868,-4758528,327680,-4430848,66
9283,653,22,8,0.0657206119,0.934279388,2852.729626,3068.860512,4986.932242,4706.468606,9936,1542.857143,19872,-4752896,334336,-4418560,66
9301,632,23,7,0.0636262962,0.936373704,2852.982121,2985.168596,5014.662079,4265.568038,9933,205.3545586,19866,-4762112,323584,-4438528,66
9305,632,22,8,0.0636006843,0.936399316,2851.680879,3106.129538,4972.340247,4919.821203,9937,852.9613734,19874,-4764160,323584,-4440576,66
9269,663,23,7,0.0667539267,0.933246073,2861.907809,2925.046096,4986.295717,4689.748115,9932,945.9047619,19864,-4745728,339456,-4406272,66
9330,608,23,7,0.0611793117,0.938820688,2855.908865,3059.825971,4973.943623,4901.310855,9938,916.7896679,19876,-4776960,311296,-4465664,66
9309,628,23,7,0.0631981483,0.936801852,2854.420159,3069.502349,4974.36642,4889.452229,9937,1184.386174,19874,-4766208,321536,-4444672,66
9245,680,23,7,0.0685138539,0.931486146,2856.817551,2974.859319,4958.870741,5019.139706,9925,897.3779385,19850,-4733440,348160,-4385280,66
9323,617,22,8,0.0620724346,0.937927565,2863.667882,2932.399534,4993.953341,4616.115073,9940,1047.418335,19880,-4773376,315904,-4457472,66
9244,683,23,7,0.0688022565,0.931197744,2856.732081,2984.108827,4964.575292,4956.213763,9927,1044.947368,19854,-4732928,349696,-4383232,66
3404,175,23,7,0.0488963398,0.95110366,1017.387443,1126.572134,1822.789659,1152.194286,3579,103.4692108,7158,-1742848,89600,-1653248,66
9337,604,22,8,0.060758475,0.939241525,2863.688045,2941.363826,4992.557567,4637.75,9941,1282.709677,19882,-4780544,309248,-4471296,66
9296,643,24,6,0.0646946373,0.935305363,2867.315495,2881.685009,4988.844664,4697.55832,9939,1177.606635,19878,-4759552,329216,-4430336,66
4096,317,24,6,0.07183322,0.92816678,1270.574292,1200.42756,2247.288086,1686.432177,4413,77.43463766,8826,-2097152,162304,-1934848,66
9329,614,23,7,0.0617519863,0.938248014,2866.66501,2911.754745,4989.674563,4703.456026,9943,1412.357955,19886,-4776448,314368,-4462080,66
9340,601,24,6,0.0604566945,0.939543306,2860.868966,2999.936772,4980.637901,4821.219634,9941,1297.780679,19882,-4782080,307712,-4474368,66
2824,251,24,6,0.0816260163,0.918373984,887.6886574,789.1489427,1572.594547,1148.776892,3075,56.06198724,6150,-1445888,128512,-1317376,66
9372,576,24,6,0.0579010856,0.942098914,2874.427438,2787.46599,5002.839309,4513.395833,9948,1340.700809,19896,-4798464,294912,-4503552,66
9330,614,23,7,0.0617457763,0.938254224,2869.196582,2826.865104,5011.287031,4383.114007,9944,1278.1491,19888,-4776960,314368,-4462592,66
5537,423,22,8,0.0709731544,0.929026846,1716.721363,1724.731327,3009.547408,2600.274232,5960,106.3905748,11920,-2834944,216576,-2618368,66
9348,594,24,6,0.0597465299,0.94025347,2871.239546,2815.177916,4999.087184,4537.350168,9942,783.4515366,19884,-4786176,304128,-4482048,66
9253,678,22,8,0.0682710704,0.93172893,2851.795321,3051.138593,4986.361612,4688.115044,9931,177.943021,19862,-4737536,347136,-4390400,66
9326,615,23,7,0.0618650035,0.938134996,2865.533169,2919.245144,4988.768175,4701.55935,9941,1186.27685,19882,-4774912,314880,-4460032,66
9309,628,24,6,0.0631981483,0.936801852,2863.927076,2859.1686,5012.699216,4321.235669,9937,224.768152,19874,-4766208,321536,-4444672,66
9354,590,24,6,0.0593322607,0.940667739,2870.863295,2840.297981,4996.009301,4599.777966,9944,958.9199614,19888,-4789248,302080,-4487168,66
9332,607,22,8,0.0610725425,0.938927457,2863.718497,2941.468393,4985.148093,4737.113674,9939,772.2610723,19878,-4777984,310784,-4467200,66
9344,600,22,8,0.0603378922,0.939662108,2869.381094,2866.815127,4994.881956,4623.938333,9944,1065.809218,19888,-4784128,307200,-4476928,66
9370,575,24,6,0.057817999,0.942182001,2862.76074,2982.864977,4992.070544,4662.233043,9945,1232.342007,19890,-4797440,294400,-4503040,66
9250,674,23,7,0.0679161628,0.932083837,2854.768053,2994.177449,4974.777081,4794.008902,9924,798.3909895,19848,-4736000,345088,-4390912,66
9282,652,23,7,0.065633179,0.934366821,2861.064505,2951.30669,4983.35822,4741.739264,9934,1230.978934,19868,-4752384,333824,-4418560,66
9318,621,23,7,0.0624811349,0.937518865,2860.457435,2983.831798,4987.71496,4704.190016,9939,965.8892128,19878,-4770816,317952,-4452864,66
9334,602,23,7,0.0605877617,0.939412238,2860.344707,2975.939106,4985.651275,4702.569767,9936,1162.105263,19872,-4779008,308224,-4470784,66
9268,662,23,7,0.0666666667,0.933333333,2860.578626,2945.181793,4975.568084,4824.546828,9930,857.5129534,19860,-4745216,338944,-4406272,66
2573,343,22,8,0.117626886,0.882373114,838.0274666,848.0660686,1482.461329,1278.755102,2916,51.19382022,5832,-1317376,175616,-1141760,66
9347,592,23,7,0.0595633364,0.940436664,2861.78012,2950.262865,4997.058307,4542.780405,9939,1461.617647,19878,-4785664,303104,-4482560,66
9372,571,23,7,0.0574273358,0.942572664,2864.9838,2940.24162,4990.108942,4674.772329,9943,942.464455,19886,-4798464,292352,-4506112,66
9238,692,23,7,0.0696878147,0.930312185,2864.038766,2880.127804,4989.8517,4640.41185,9930,568.4029765,19860,-4729856,354304,-4375552,66
9380,563,23,7,0.0566227497,0.94337725,2854.99194,3067.837308,5003.22452,4451.776199,9943,1886.717268,19886,-4802560,288256,-4514304,66
9290,635,23,7,0.0639798489,0.936020151,2850.635992,3004.559727,5004.349839,4358.055118,9925,182.0432869,19850,-4756480,325120,-4431360,66
4877,445,23,7,0.0836151823,0.916384818,1534.253335,1503.559071,2697.457658,2267.420225,5322,95.42764927,10644,-2497024,227840,-2269184,66
9348,589,22,8,0.0592734226,0.940726577,2857.305665,3031.178539,4984.435601,4724.022071,9937,1174.586288,19874,-4786176,301568,-4484608,66
9321,617,23,7,0.0620849265,0.937915073,2869.560717,2841.59042,4989.193756,4671.987034,9938,1318.037135,19876,-4772352,315904,-4456448,66
9267,661,23,7,0.0665793715,0.933420629,2861.4252,2923.664228,4976.558649,4795.441755,9928,240.0967352,19856,-4744704,338432,-4406272,66
9352,591,22,8,0.0594388012,0.940561199,2860.383282,2972.894414,5005.540312,4441.257191,9943,619.8877805,19886,-4788224,302592,-4485632,66
9231,701,22,8,0.0705799436,0.929420056,2861.074465,2922.838556,4993.252194,4614.21826,9932,439.8582817,19864,-4726272,358912,-4367360,66
9217,705,23,7,0.0710542229,0.928945777,2858.67644,2934.297124,4954.274059,5055.970213,9922,538.3613673,19844,-4719104,360960,-4358144,66
9283,651,23,7,0.0655325146,0.934467485,2866.052661,2877.817659,4986.243994,4700.218126,9934,348.4391442,19868,-4752896,333312,-4419584,66
9371,572,23,7,0.0575279091,0.942472091,2863.554489,2951.228431,4995.86629,4581.001748,9943,1084.296619,19886,-4797952,292864,-4505088,66
9306,626,24,6,0.0630285944,0.936971406,2864.57385,2895.586667,4981.494949,4743.587859,9932,681.674674,19864,-4764672,320512,-4444160,66
9283,650,23,7,0.0654384375,0.934561562,2864.136908,2869.861723,5001.105785,4479.916923,9933,625.1101322,19866,-4752896,332800,-4420096,66
9326,613,22,8,0.061676225,0.938323775,2852.714953,3107.997052,4973.072593,4923.254486,9939,849.4871795,19878,-4774912,313856,-4461056,66
9313,624,24,6,0.0627956124,0.937204388,2858.016496,3009.947399,4986.212713,4712.105769,9937,1144.815668,19874,-4768256,319488,-4448768,66
9313,622,24,6,0.0626069451,0.937393055,2858.069353,3009.311562,4977.079996,4832.048232,9935,962.6937984,19870,-4768256,318464,-4449792,66
9241,685,22,8,0.069010679,0.930989321,2860.74384,2900.12556,4991.982578,4579.255474,9926,272.542559,19852,-4731392,350720,-4380672,66
9289,647,24,6,0.0651167472,0.934883253,2865.915453,2882.406769,4991.147163,4643.353941,9936,1025.386997,19872,-4755968,331264,-4424704,66
9272,659,24,6,0.0663578693,0.933642131,2864.373227,2898.462658,4974.679357,4843.883156,9931,597.5330927,19862,-4747264,337408,-4409856,66
9257,676,23,7,0.068055975,0.931944025,2864.723038,2876.307329,4995.182673,4581.072485,9933,677.0961145,19866,-4739584,346112,-4393472,66
9255,674,23,7,0.0678819619,0.932118038,2863.288975,2863.666179,5000.029714,4483.991098,9929,189.3040991,19858,-4738560,345088,-4393472,66
9347,592,24,6,0.0595633364,0.940436664,2854.016441,3072.238057,4994.577512,4581.949324,9939,794.4844125,19878,-4785664,303104,-4482560,66
9236,689,24,6,0.0694206549,0.930579345,2856.641784,2975.441843,4958.257579,5026.571843,9925,777.8213166,19850,-4728832,352768,-4376064,66
3227,353,24,6,0.098603352,0.901396648,1028.969087,1053.344766,1812.064146,1593.368272,3580,63.35161918,7160,-1652224,180736,-1471488,66
9323,615,23,7,0.0618836788,0.938116321,2852.958367,3098.798116,4964.350745,5047.55935,9938,900.9972801,19876,-4773376,314880,-4458496,66
9320,613,23,7,0.0617134803,0.93828652,2854.419767,3054.242243,4976.814056,4817.787928,9933,1639.108911,19866,-4771840,313856,-4457984,66
9309,628,24,6,0.0631981483,0.936801852,2857.934895,3019.265098,4977.003652,4850.359873,9937,1695.733788,19874,-4766208,321536,-4444672,66
9314,624,24,6,0.0627892936,0.937210706,2864.439732,2924.246689,4984.959631,4738.745192,9938,585.9669811,19876,-4768768,319488,-4449280,66
9284,654,22,8,0.0658080097,0.93419199,2867.558013,2845.398205,5002.822167,4496.46789,9938,466.7919211,19876,-4753408,334848,-4418560,66
9340,600,24,6,0.060362173,0.939637827,2848.622426,3175.797406,4971.184797,4959.84,9940,1188.995215,19880,-4782080,307200,-4474880,66
9257,668,23,7,0.0673047859,0.932695214,2853.964454,3015.171722,4963.789997,4952.052395,9925,886.9526363,19850,-4739584,342016,-4397568,66
7476,816,22,8,0.0984081042,0.901591896,2336.201168,2570.862982,4014.920546,5352,8292,152.5666973,16584,-3827712,417792,-3409920,66
5633,377,21,9,0.0627287854,0.937271215,1722.030463,1915.441031,2999.784839,3090.893899,6010,109.8118034,12020,-2884096,193024,-2691072,66
6006,473,21,9,0.0730050934,0.926994907,1842.1648,2161.415188,3210.250583,3617.748414,6479,114.8962582,12958,-3075072,242176,-2832896,66
5195,364,21,9,0.0654794028,0.934520597,1586.615528,1839.631578,2771.244658,2904.956044,5559,98.28500707,11118,-2659840,186368,-2473472,66
5589,389,22,8,0.0650719304,0.93492807,1709.893859,1937.97619,2986.137592,3037.809769,5978,110.2545186,11956,-2861568,199168,-2662400,66
5394,370,22,8,0.0641915337,0.935808466,1649.654284,1856.584344,2889.469225,2780.9,5764,105.0865998,11528,-2761728,189440,-2572288,66
5659,385,22,8,0.0636995367,0.936300463,1730.520316,1937.801824,3014.14879,3145.251948,6044,114.4263537,12088,-2897408,197120,-2700288,66
5996,456,22,8,0.0706757595,0.929324241,1841.67669,2101.879501,3207.533522,3475.892544,6452,114.2755933,12904,-3069952,233472,-2836480,66
5556,378,22,8,0.0637007078,0.936299292,1697.33481,1925.033716,2975.222282,2853.994709,5934,113.4825014,11868,-2844672,193536,-2651136,66
1365,116,22,8,0.0783254558,0.921674544,422.9205602,423.2049825,759.203663,526.7931034,1481,30.90567613,2962,-698880,59392,-639488,66
5624,385,21,9,0.0640705608,0.935929439,1722.837172,1896.617033,2998.924964,3093.742857,6009,112.9723632,12018,-2879488,197120,-2682368,66
5619,395,21,9,0.0656800798,0.93431992,1721.391241,1932.43208,3003.921694,3058.402532,6014,111.3085323,12028,-2876928,202240,-2674688,66
7520,881,22,8,0.104868468,0.895131532,2366.750279,2524.751342,4048.371543,5503.799092,8401,153.8644689,16802,-3850240,451072,-3399168,66
5628,387,22,8,0.0643391521,0.935660848,1721.99801,1933.410548,3006.819296,3025.170543,6015,115.6063809,12030,-2881536,198144,-2683392,66
4777,272,22,8,0.0538720539,0.946127946,1444.335271,1662.989817,2534.722001,2354.257353,5049,181.5533981,10098,-2445824,139264,-2306560,66
1793,146,21,9,0.0752965446,0.924703455,552.1408865,599.5620548,988.7947574,739.1849315,1939,40.5818334,3878,-918016,74752,-843264,66
5650,397,22,8,0.0656523896,0.93434761,1727.174159,1989.606577,3025.054867,3008.987406,6047,118.7315924,12094,-2892800,203264,-2689536,66
5667,396,21,9,0.0653142009,0.934685799,1732.541273,1986.245574,3032.804835,3020.482323,6063,108.8119167,12126,-2901504,202752,-2698752,66
5639,388,21,9,0.0643769703,0.93562303,1726.016882,1926.22181,3006.33357,3125.420103,6027,106.8238213,12054,-2887168,198656,-2688512,66
5210,356,21,9,0.0639597557,0.936040244,1587.75709,1853.628295,2771.23167,2963.044944,5566,107.9100427,11132,-2667520,182272,-2485248,66
9298,639,23,7,0.0643051223,0.935694878,2862.956469,2943.10169,4981.355453,4789.217527,9937,1574.801902,19874,-4760576,327168,-4433408,66
9297,639,23,7,0.0643115942,0.935688406,2855.308549,3050.714913,4968.70797,4965.474178,9936,761.3793103,19872,-4760064,327168,-4432896,66
6933,337,23,7,0.0463548831,0.953645117,2081.584134,2406.628733,3649.072984,3356.267062,7270,360.4362915,14540,-3549696,172544,-3377152,66
9322,615,23,7,0.0618899064,0.938110094,2866.198709,2855.344854,5002.893156,4455.256911,9937,1223.768473,19874,-4772864,314880,-4457984,66
9258,667,23,7,0.0672040302,0.93279597,2863.65438,2879.544262,4975.453446,4790.145427,9925,700.9180791,19850,-4740096,341504,-4398592,66
9336,604,23,7,0.0607645875,0.939235412,2864.266923,2933.585048,4988.819087,4687.342715,9940,1731.707317,19880,-4780032,309248,-4470784,66
9251,684,23,7,0.0688475088,0.931152491,2876.009027,2713.15129,5003.025078,4494.290936,9935,653.6184211,19870,-4736512,350208,-4386304,66
9296,641,23,7,0.0645063903,0.93549361,2868.604713,2854.271993,4987.682982,4698.053042,9937,1121.557562,19874,-4759552,328192,-4431360,66
9243,686,24,6,0.0690905429,0.930909457,2856.789993,2965.726055,4992.71308,4591.600583,9929,228.5155351,19858,-4732416,351232,-4381184,66
9293,646,23,7,0.0649964785,0.935003521,2859.888312,2999.083407,4969.24158,4980.910217,9939,1236.19403,19878,-4758016,330752,-4427264,66
9275,664,23,7,0.0668075259,0.933192474,2874.20234,2791.110253,4983.07159,4787.411145,9939,1094.603524,19878,-4748800,339968,-4408832,66
9314,621,23,7,0.0625062909,0.937493709,2865.500663,2890.883898,4986.484861,4690.756844,9935,1507.587253,19870,-4768768,317952,-4450816,66
9260,674,23,7,0.0678477954,0.932152205,2861.136512,2927.422813,4996.507991,4568.962908,9934,486.0078278,19868,-4741120,345088,-4396032,66
8971,923,23,7,0.0932888619,0.906711138,2823.326396,3153.318451,4931.647642,5101.575298,9894,416.2389567,19788,-4593152,472576,-4120576,66
9278,657,23,7,0.066129844,0.933870156,2865.232987,2885.80772,4991.75221,4632.576865,9935,335.6418919,19870,-4750336,336384,-4413952,66
9258,674,23,7,0.0678614579,0.932138542,2877.176714,2711.687458,4985.587168,4704.320475,9932,740.6413125,19864,-4740096,345088,-4395008,66
9286,652,23,7,0.0656067619,0.934393238,2859.839194,2993.707694,4965.479539,5026.760736,9938,1339.3531,19876,-4754432,333824,-4420608,66
9294,643,23,7,0.0647076582,0.935292342,2861.250395,2965.486224,4982.436841,4774.782271,9937,1091.978022,19874,-4758528,329216,-4429312,66
9315,625,22,8,0.0628772636,0.937122736,2869.353455,2863.746929,4983.360601,4778.8256,9940,1159.859977,19880,-4769280,320000,-4449280,66
9284,652,23,7,0.0656199678,0.934380032,2855.377033,3045.827666,4970.876346,4934.662577,9936,870.0525394,19872,-4753408,333824,-4419584,66
9348,591,23,7,0.0594627226,0.940537277,2851.898525,3118.669882,4985.784018,4720.340102,9939,1103.107658,19878,-4786176,302592,-4483584,66
9267,664,23,7,0.0668613433,0.933138657,2838.834983,3227.421482,4953.628682,5138.658133,9931,1241.375,19862,-4744704,339968,-4404736,66
9272,657,23,7,0.0661698056,0.933830194,2847.740914,3115.803865,4965.932701,4951.837139,9929,1406.373938,19858,-4747264,336384,-4410880,66
9259,668,23,7,0.0672912259,0.932708774,2840.760101,3191.082917,4963.895993,4965.441617,9927,1289.220779,19854,-4740608,342016,-4398592,66
9300,632,23,7,0.0636327024,0.936367298,2849.131528,3115.810718,4976.968387,4812.455696,9932,776.5441751,19864,-4761600,323584,-4438016,66
9307,631,23,7,0.0634936607,0.936506339,2864.190796,2928.073307,4984.314602,4750.990491,9938,941.9905213,19876,-4765184,323072,-4442112,66
9261,669,23,7,0.0673716012,0.932628399,2853.544797,3038.097869,4974.424144,4841.962631,9930,1277.992278,19860,-4741632,342528,-4399104,66
9333,600,23,7,0.0604047116,0.939595288,2857.120102,3019.183225,4976.419158,4820.485,9933,1633.717105,19866,-4778496,307200,-4471296,66
9290,642,22,8,0.0646395489,0.935360451,2848.82273,3107.781341,4984.877072,4700.576324,9932,1260.406091,19864,-4756480,328704,-4427776,66
9297,634,23,7,0.0638404994,0.936159501,2853.041821,3059.161258,4974.602022,4839.859621,9931,1385.076709,19862,-4760064,324608,-4435456,66
9308,629,23,7,0.0632987823,0.936701218,2853.201268,3085.176586,4975.921036,4866.581876,9937,1171.816038,19874,-4765696,322048,-4443648,66
9272,660,23,7,0.0664518727,0.933548127,2856.07268,3018.031311,4967.509599,4952.316667,9932,1074.891775,19864,-4747264,337920,-4409344,66
9198,738,22,8,0.0742753623,0.925724638,2864.064556,2707.765046,5052.921505,3916.319783,9936,447.9711452,19872,-4709376,377856,-4331520,66
3237,289,23,7,0.0819625638,0.918037436,1005.331616,1101.312799,1791.516837,1449.692042,3526,61.95747672,7052,-1657344,147968,-1509376,66
9296,646,23,7,0.0649768658,0.935023134,2860.413098,2855.651702,5034.300022,4067.801858,9942,497.1,19884,-4759552,330752,-4428800,66
9286,652,23,7,0.0656067619,0.934393238,2857.604606,3020.387922,4980.234224,4816.619632,9938,1661.87291,19876,-4754432,333824,-4420608,66
9284,649,23,7,0.065337763,0.934662237,2859.55193,2968.881649,4982.345972,4747.474576,9933,1419,19866,-4753408,332288,-4421120,66
9284,651,23,7,0.0655259185,0.934474082,2859.939721,2971.79326,4983.336277,4749.28725,9935,1357.240437,19870,-4753408,333312,-4420096,66
9291,643,22,8,0.0647271995,0.9352728,2846.256522,3160.446793,4962.482295,5040.00311,9934,1089.254386,19868,-4756992,329216,-4427776,66
9291,644,23,7,0.0648213387,0.935178661,2856.544812,3026.140558,4975.598106,4858.381988,9935,1107.580825,19870,-4756992,329728,-4427264,66
3685,765,20,10,0.171910112,0.828089888,1255.544297,1241.604342,2096.788874,2845.500654,4450,95.04485263,8900,-1886720,391680,-1495040,67
4054,730,21,9,0.152591973,0.847408027,1334.839466,1423.059045,2266.405032,3092.758904,4784,108.1618811,9568,-2075648,373760,-1701888,67
3686,724,21,9,0.164172336,0.835827664,1241.6737,1269.006153,2090.223006,2792.393646,4410,100.9846577,8820,-1887232,370688,-1516544,67
1429,85,20,10,0.0561426684,0.943857332,430.6851282,497.2220263,768.5703289,571.3882353,1514,109.1564528,3028,-731648,43520,-688128,67
3604,736,21,9,0.169585253,0.830414747,1220.380089,1228.239629,2045.067425,2784.710598,4340,98.07909605,8680,-1845248,376832,-1468416,67
3481,682,21,9,0.163824165,0.836175835,1170.834884,1184.625681,1966.544097,2671.29912,4163,98.09142319,8326,-1782272,349184,-1433088,67
3500,700,21,9,0.166666667,0.833333333,1183.161617,1201.186228,1988.280857,2661.595714,4200,100.4784689,8400,-1792000,358400,-1433600,67
39,13,20,10,0.25,0.75,14.89163133,15.07927768,27.33333333,24,52,3.857566766,104,-19968,6656,-13312,67
3451,700,20,10,0.168634064,0.831365936,1164.824107,1211.848335,1965.461895,2620.952857,4151,79.70430108,8302,-1766912,358400,-1408512,67
3659,719,21,9,0.164230242,0.835769758,1231.958922,1247.214727,2069.480186,2800.282337,4378,93.36745575,8756,-1873408,368128,-1505280,67
3741,727,20,10,0.162712623,0.837287377,1258.696091,1280.42122,2117.622294,2835.929849,4468,103.9795206,8936,-1915392,372224,-1543168,67
3551,692,20,10,0.163092152,0.836907848,1198.542976,1209.910994,2014.515911,2673.554913,4243,98.05870118,8486,-1818112,354304,-1463808,67
3691,739,20,10,0.166817156,0.833182844,1247.753529,1264.586384,2095.882146,2812.941813,4430,83.98104265,8860,-1889792,378368,-1511424,67
3673,731,20,10,0.165985468,0.834014532,1241.953565,1231.28399,2077.747345,2829.335157,4404,105.0321965,8808,-1880576,374272,-1506304,67
3634,735,21,9,0.168230716,0.831769284,1225.792074,1245.381993,2057.821409,2813.798639,4369,91.92089207,8738,-1860608,376320,-1484288,67
3649,720,20,10,0.164797436,0.835202564,1228.257135,1255.190801,2066.604549,2785.034722,4369,94.13919414,8738,-1868288,368640,-1499648,67
1604,140,21,9,0.0802752294,0.919724771,501.4199237,511.1562334,882.936409,752.9285714,1744,42.37123421,3488,-821248,71680,-749568,67
3742,731,20,10,0.163424994,0.836575006,1257.027215,1292.151735,2117.942544,2846.456908,4473,96.19354839,8946,-1915904,374272,-1541632,67
1431,77,21,9,0.051061008,0.948938992,432.0271324,481.9298264,759.8350804,655.3506494,1508,114.1559425,3016,-732672,39424,-693248,67
3754,745,21,9,0.165592354,0.834407646,1267.595324,1269.804737,2124.769579,2881.026846,4499,101.0784093,8998,-1922048,381440,-1540608,67
1358,144,21,9,0.0958721704,0.90412783,430.1998802,425.6483922,770.2113402,575.0416667,1502,93.875,3004,-695296,73728,-621568,67
1376,150,22,8,0.0982961992,0.901703801,437.8503804,424.1762946,783.0385174,584.2666667,1526,96.39924195,3052,-704512,76800,-627712,67
1350,150,21,9,0.1,0.9,429.2610487,422.0605975,771.177037,564.4066667,1500,125,3000,-691200,76800,-614400,67
1371,154,21,9,0.100983607,0.899016393,437.7176529,423.257219,782.7213713,587.4285714,1525,146.493756,3050,-701952,78848,-623104,67
1356,142,21,9,0.0947930574,0.905206943,428.7248989,424.3069639,768.7876106,565.3169014,1498,139.3488372,2996,-694272,72704,-621568,67
1368,149,21,9,0.0982201714,0.901779829,434.8192402,424.7908559,778.6717836,578.3892617,1517,141.2476723,3034,-700416,76288,-624128,67
1357,144,22,8,0.0959360426,0.904063957,429.4587651,433.8011275,768.7096536,584.1111111,1501,100.6706908,3002,-694784,73728,-621056,67
1215,132,21,9,0.0979955457,0.902004454,386.2129029,372.7964672,692.1679012,506.7727273,1347,103.3768227,2694,-622080,67584,-554496,67
1201,130,21,9,0.0976709241,0.902329076,381.7985006,360.9047967,685.1149042,489.4076923,1331,154.5876887,2662,-614912,66560,-548352,67
1371,147,22,8,0.0968379447,0.903162055,434.878786,428.7339735,778.6528082,580.8707483,1518,128.1012658,3036,-701952,75264,-626688,67
473,64,21,9,0.119180633,0.880819367,152.7418824,160.2307106,276.5496829,213.203125,537,50.04659832,1074,-242176,32768,-209408,67
1375,147,21,9,0.0965834428,0.903416557,435.8869653,427.3978478,781.5243636,574.1972789,1522,133.6259877,3044,-704000,75264,-628736,67
1356,150,22,8,0.0996015936,0.900398406,432.2292743,425.9156774,770.8473451,596.68,1506,131.0704961,3012,-694272,76800,-617472,67
1361,161,21,9,0.105781866,0.894218134,433.7813422,468.6388497,775.0257164,647.1614907,1522,26.74398173,3044,-696832,82432,-614400,67
1418,146,22,8,0.0933503836,0.906649616,447.0497269,448.9128536,802.3631876,589.5821918,1564,78.98989899,3128,-726016,74752,-651264,67
1372,151,21,9,0.0991464215,0.900853578,437.0578794,424.6146838,781.1654519,587.8609272,1523,110.3623188,3046,-702464,77312,-625152,67
1371,145,22,8,0.095646438,0.904353562,434.1494478,430.0322951,777.3953319,579.8413793,1516,104.6961326,3032,-701952,74240,-627712,67
583,93,21,9,0.137573964,0.862426036,193.4672713,195.361446,347.8696398,279.7634409,676,8.928807291,1352,-298496,47616,-250880,67
568,95,21,9,0.143288084,0.856711916,189.694852,193.8886953,340.3415493,282.1263158,663,10.00905797,1326,-290816,48640,-242176,67
1388,153,21,9,0.0992861778,0.900713822,441.6780435,425.7537602,792.4704611,576.2222222,1541,153.1809145,3082,-710656,78336,-632320,67
2619,403,21,9,0.133355394,0.866644606,836.0339469,938.4598677,1435.18404,2007.459057,3022,84.8638023,6044,-1340928,206336,-1134592,67
2866,466,23,7,0.139855942,0.860144058,917.693313,1070.892065,1585.434054,2165.072961,3332,74.79236813,6664,-1467392,238592,-1228800,67
2842,464,23,7,0.140350877,0.859649123,910.3617869,1057.41883,1571.255806,2157.24569,3306,84.48760542,6612,-1455104,237568,-1217536,67
2332,407,23,7,0.148594378,0.851405622,771.7591226,812.4544163,1310.941681,1708.388206,2739,69.57073914,5478,-1193984,208384,-985600,67
2844,443,22,8,0.13477335,0.86522665,907.7096146,1051.233021,1566.524262,2141.383747,3287,81.84760956,6574,-1456128,226816,-1229312,67
2721,453,23,7,0.142722117,0.857277883,880.2015203,959.5144988,1501.967659,2101.260486,3174,90.17045455,6348,-1393152,231936,-1161216,67
2847,456,22,8,0.138056312,0.861943688,911.3074999,1060.002028,1573.777661,2140.375,3303,78.49334601,6606,-1457664,233472,-1224192,67
2709,429,23,7,0.136711281,0.863288719,867.7789261,990.008001,1493.469546,2049.608392,3138,88.6440678,6276,-1387008,219648,-1167360,67
3270,472,24,6,0.126135756,0.873864244,1033.93987,1207.04639,1787.47156,2453.646186,3742,92.07677165,7484,-1674240,241664,-1432576,67
213,27,22,8,0.1125,0.8875,66.98839218,80.62273061,123.8028169,94.44444444,240,14.60742544,480,-109056,13824,-95232,67
2901,463,23,7,0.137633769,0.862366231,927.3728955,1040.777551,1591.136505,2254.952484,3364,106.0195399,6728,-1485312,237056,-1248256,67
2866,459,22,8,0.138045113,0.861954887,920.4666627,1042.927841,1582.114096,2168.052288,3325,94.702364,6650,-1467392,235008,-1232384,67
3317,473,23,7,0.124802111,0.875197889,1050.132337,1220.088697,1814.441363,2463.938689,3790,116.5078389,7580,-1698304,242176,-1456128,67
2877,449,22,8,0.134996993,0.865003007,920.0210936,1035.168974,1579.673966,2200.621381,3326,100.8795875,6652,-1473024,229888,-1243136,67
2835,496,23,7,0.148904233,0.851095767,908.6956038,1047.1186,1564.75485,2244.689516,3331,58.46936984,6662,-1451520,253952,-1197568,67
2689,437,23,7,0.139795266,0.860204734,861.205287,980.429334,1480.928226,2071.590389,3126,88.30508475,6252,-1376768,223744,-1153024,67
2825,440,23,7,0.134762634,0.865237366,900.6703939,1015.646653,1547.030088,2184.965909,3265,80.89692765,6530,-1446400,225280,-1221120,67
697,50,21,9,0.0669344043,0.933065596,213.2865803,221.0137552,381.5035868,269.4,747,13.87702025,1494,-356864,25600,-331264,67
1642,146,20,10,0.081655481,0.918344519,513.2934738,532.0188579,905.4293544,771.5821918,1788,26.89126184,3576,-840704,74752,-765952,67
1660,139,23,7,0.0772651473,0.922734853,515.9942822,551.071282,906.8349398,818.3741007,1799,28.05676856,3598,-849920,71168,-778752,67
2922,420,20,10,0.12567325,0.87432675,937.689751,1043.311609,1611.3282,2090.12381,3342,58.72430153,6684,-1496064,215040,-1281024,67
2868,395,21,9,0.121054245,0.878945755,912.1264217,1055.618627,1578.080893,2023.493671,3263,88.50013561,6526,-1468416,202240,-1266176,67
2865,398,21,9,0.121973644,0.878026356,911.6804029,1060.311901,1578.827574,2014.761307,3263,92.72520602,6526,-1466880,203776,-1263104,67
2696,372,20,10,0.12125163,0.87874837,858.1239078,968.7775012,1477.559718,1947.163978,3068,79.7504549,6136,-1380352,190464,-1189888,67
2767,375,20,10,0.119350732,0.880649268,881.4005629,978.9758362,1514.292736,1993.613333,3142,186.1374408,6284,-1416704,192000,-1224704,67
2878,411,21,9,0.124961995,0.875038005,918.1214243,1043.850123,1582.118833,2085.321168,3289,74.17681552,6578,-1473536,210432,-1263104,67
2865,401,21,9,0.122780159,0.877219841,911.7149396,1046.033582,1573.892147,2059.376559,3266,85.36330371,6532,-1466880,205312,-1261568,67
2800,383,21,9,0.120326736,0.879673264,894.1531198,994.0679955,1537.043571,1993.770235,3183,89.68723584,6366,-1433600,196096,-1237504,67
2714,381,21,9,0.123101777,0.876898223,867.7374786,980.3519204,1495.460206,1922.259843,3095,88.70736601,6190,-1389568,195072,-1194496,67
2876,395,21,9,0.120758178,0.879241822,917.4705346,1029.93792,1579.285814,2048.936709,3271,105.1430408,6542,-1472512,202240,-1270272,67
2759,378,21,9,0.12049729,0.87950271,878.1304735,1003.924913,1516.103298,1955.089947,3137,87.09050527,6274,-1412608,193536,-1219072,67
2889,413,21,9,0.125075712,0.874924288,919.863647,1058.266376,1587.997923,2095.707022,3302,81.35008623,6604,-1479168,211456,-1267712,67
2790,372,21,9,0.117647059,0.882352941,888.2025566,1010.151823,1533.824014,1939.069892,3162,80.78691875,6324,-1428480,190464,-1238016,67
2686,374,21,9,0.122222222,0.877777778,854.2821197,970.2280433,1471.918466,1951.221925,3060,72.80513919,6120,-1375232,191488,-1183744,67
2784,368,21,9,0.116751269,0.883248731,884.2941582,966.9823642,1515.579382,2037.377717,3152,93.14420804,6304,-1425408,188416,-1236992,67
2724,368,21,9,0.119016818,0.880983182,870.7995712,955.9703768,1494.655653,1930.26087,3092,84.89840747,6184,-1394688,188416,-1206272,67
1487,116,21,9,0.0723643169,0.927635683,458.5766153,500.066843,810.66846,690.8793103,1603,30.33686601,3206,-761344,59392,-701952,67
2867,393,21,9,0.120552147,0.879447853,912.7165728,1032.056736,1572.426927,2054.152672,3260,77.91586998,6520,-1467904,201216,-1266688,67
2918,414,20,10,0.1242497,0.8757503,930.7469835,1058.542435,1604.254969,2105.222222,3332,92.1460177,6664,-1494016,211968,-1282048,67
2186,156,21,9,0.0666097353,0.933390265,669.1527085,741.3395756,1184.94419,983.1089744,2342,33.2528752,4684,-1119232,79872,-1039360,67
2900,419,22,8,0.126242844,0.873757156,926.6555758,1064.983085,1600.491724,2071.871122,3319,93.54565953,6638,-1484800,214528,-1270272,67
2902,412,24,6,0.124321062,0.875678938,926.9454028,1046.543711,1595.994831,2090.723301,3314,108.9056852,6628,-1485824,210944,-1274880,67
2708,382,23,7,0.123624595,0.876375405,868.7038532,947.5741518,1488.145864,1952.08377,3090,87.58503401,6180,-1386496,195584,-1190912,67
3381,440,23,7,0.115153101,0.884846899,1069.582048,1237.32469,1850.523514,2375.706818,3821,103.6343911,7642,-1731072,225280,-1505792,67
2805,390,22,8,0.122065728,0.877934272,893.9257139,1009.910863,1539.50303,2018.728205,3195,99.71910112,6390,-1436160,199680,-1236480,67
2773,412,24,6,0.129356358,0.870643642,889.154235,1013.66417,1533.149297,1995.830097,3185,86.69025585,6370,-1419776,210944,-1208832,67
2868,409,22,8,0.124809277,0.875190723,916.6078961,1052.923348,1583.995467,2024.704156,3277,100.3675345,6554,-1468416,209408,-1259008,67
2836,382,23,7,0.118707272,0.881292728,905.1257216,1002.025098,1555.348378,2011.526178,3218,93.3836332,6436,-1452032,195584,-1256448,67
2817,415,22,8,0.128403465,0.871596535,902.1106852,1041.787533,1559.806177,2001.33494,3232,88.49945235,6464,-1442304,212480,-1229824,67
2761,390,22,8,0.123770232,0.876229768,885.6243188,990.2492861,1524.498008,1940.607692,3151,91.30686757,6302,-1413632,199680,-1213952,67
2699,393,23,7,0.127102199,0.872897801,867.5506937,966.6300107,1491.251575,1925.928753,3092,98.22109276,6184,-1381888,201216,-1180672,67
2858,393,24,6,0.120885881,0.879114119,911.412646,1010.3223,1564.955913,2069.928753,3251,96.95794811,6502,-1463296,201216,-1262080,67
2941,407,23,7,0.121565114,0.878434886,937.5999829,1062.822941,1616.216933,2095.65602,3348,87.96636889,6696,-1505792,208384,-1297408,67
2857,406,23,7,0.124425375,0.875574625,910.7170945,1036.704606,1569.679384,2070.546798,3263,95.77340769,6526,-1462784,207872,-1254912,67
2839,397,22,8,0.122682324,0.877317676,907.3312975,1007.686629,1558.418809,2048.148615,3236,95.12051734,6472,-1453568,203264,-1250304,67
2732,397,23,7,0.126877597,0.873122403,876.2418667,981.0848885,1506.711933,1966.115869,3129,60.32388664,6258,-1398784,203264,-1195520,67
2857,403,23,7,0.123619632,0.876380368,913.2822931,1029.010189,1572.60553,2040.933002,3260,96.16519174,6520,-1462784,206336,-1256448,67
2724,393,22,8,0.126082772,0.873917228,872.7179081,975.4785791,1500.085169,1967.356234,3117,87.0913663,6234,-1394688,201216,-1193472,67
2827,425,23,7,0.130688807,0.869311193,902.8145101,1014.61624,1550.716661,2130.592941,3252,57.97824924,6504,-1447424,217600,-1229824,67
1702,146,22,8,0.079004329,0.920995671,530.6839857,556.2012165,932.6551116,829.4315068,1848,26.68592058,3696,-871424,74752,-796672,67
919,97,21,9,0.0954724409,0.904527559,290.3972845,302.9939933,518.6550598,412.2886598,1016,108.4311633,2032,-470528,49664,-420864,67
662,85,21,9,0.113788487,0.886211513,209.7795796,254.0793833,378.4607251,339.2588235,747,13.16763617,1494,-338944,43520,-295424,67
680,75,21,9,0.0993377483,0.900662252,214.9831419,230.3555798,386.1632353,303.9866667,755,45.31812725,1510,-348160,38400,-309760,67
681,73,21,9,0.0968169761,0.903183024,214.9724599,230.527271,384.763583,309.739726,754,66.96269982,1508,-348672,37376,-311296,67
918,90,21,9,0.0892857143,0.910714286,288.3710601,301.9117075,513.3583878,414.1444444,1008,104.6728972,2016,-470016,46080,-423936,67
898,90,21,9,0.0910931174,0.908906883,282.9746032,291.7424376,503.518931,404.5111111,988,72.11678832,1976,-459776,46080,-413696,67
911,96,21,9,0.0953326713,0.904667329,287.3569127,298.0593103,515.8507135,391.5416667,1007,80.23904382,2014,-466432,49152,-417280,67
927,101,21,9,0.0982490272,0.901750973,291.1280128,335.0030212,522.6569579,439.6336634,1028,18.80373148,2056,-474624,51712,-422912,67
666,76,21,9,0.102425876,0.897574124,211.0604925,229.7020031,378.993994,305.8289474,742,44.32497013,1484,-340992,38912,-302080,67
674,74,22,8,0.0989304813,0.901069519,213.3625998,226.1954623,382.2255193,304.1351351,748,73.54965585,1496,-345088,37888,-307200,67
663,73,21,9,0.0991847826,0.900815217,209.9335329,226.8867623,374.5701357,313.369863,736,96.71484888,1472,-339456,37376,-302080,67
935,91,22,8,0.0886939571,0.911306043,292.8803253,305.4234118,524.6545455,398.8901099,1026,95.08804449,2052,-478720,46592,-432128,67
922,95,21,9,0.0934119961,0.906588004,290.2572509,305.0469125,519.7375271,404.7894737,1017,31.8011257,2034,-472064,48640,-423424,67
908,96,21,9,0.0956175299,0.90438247,287.318576,290.4264374,514.1222467,392.5729167,1004,59.83313468,2008,-464896,49152,-415744,67
921,93,22,8,0.0917159763,0.908284024,290.0730852,301.4025959,517.1693811,411.7419355,1014,72.17081851,2028,-471552,47616,-423936,67
918,93,22,8,0.0919881306,0.908011869,289.0122689,300.9622434,516.0653595,406.6451613,1011,71.90611664,2022,-470016,47616,-422400,67
922,93,21,9,0.0916256158,0.908374384,290.0772484,305.1897863,517.4370933,414.4408602,1015,88.41463415,2030,-472064,47616,-424448,67
515,67,21,9,0.115120275,0.884879725,162.5676886,196.0396803,298.8640777,234.8955224,582,8.942839582,1164,-263680,34304,-229376,67
521,63,21,9,0.107876712,0.892123288,164.3973757,192.2275608,298.7600768,240.7301587,584,7.632989152,1168,-266752,32256,-234496,67
537,68,22,8,0.112396694,0.887603306,170.1724356,199.653902,309.3445065,252.8970588,605,9.262094305,1210,-274944,34816,-240128,67
2851,429,21,9,0.130792683,0.869207317,912.9547395,1061.678357,1579.61382,2045.130536,3280,97.70628537,6560,-1459712,219648,-1240064,67
2914,419,21,9,0.125712571,0.874287429,928.5487279,1083.270952,1607.759437,2078.997613,3333,99.67105263,6666,-1491968,214528,-1277440,67
2823,416,21,9,0.128434702,0.871565298,901.6590168,1042.135053,1557.862912,2041.665865,3239,74.11899314,6478,-1445376,212992,-1232384,67
2761,441,21,9,0.137726421,0.862273579,886.884987,1028.978652,1531.884462,2037.346939,3202,56.92444444,6404,-1413632,225792,-1187840,67
2845,413,21,9,0.126764886,0.873235114,906.6972711,1061.843493,1570.805624,2033.823245,3258,80.44444444,6516,-1456640,211456,-1245184,67
2929,413,21,9,0.123578695,0.876421305,933.6751076,1063.429562,1609.827586,2108.881356,3342,93.14381271,6684,-1499648,211456,-1288192,67
2842,422,21,9,0.129289216,0.870710784,908.9660283,1059.562877,1573.730471,2028.2891,3264,96.05650383,6528,-1455104,216064,-1239040,67
3259,425,21,9,0.115363735,0.884636265,1028.659033,1224.821789,1789.117521,2251.849412,3684,95.39098912,7368,-1668608,217600,-1451008,67
2874,397,21,9,0.121369612,0.878630388,911.5578206,1055.928361,1575.831942,2071.574307,3271,88.26227739,6542,-1471488,203264,-1268224,67
2682,398,21,9,0.129220779,0.870779221,859.8392143,975.6464465,1481.142804,1940.48995,3080,83.1982712,6160,-1373184,203776,-1169408,67
2859,423,21,9,0.128884826,0.871115174,921.1481974,1018.178223,1580.852046,2051.411348,3282,96.81415929,6564,-1463808,216576,-1247232,67
2873,439,21,9,0.132548309,0.867451691,924.193554,1050.455904,1592.351201,2076.316629,3312,87.24973656,6624,-1470976,224768,-1246208,67
2709,384,21,9,0.124151309,0.875848691,866.8671807,994.8383419,1499.104097,1884.890625,3093,166.4693219,6186,-1387008,196608,-1190400,67
2712,375,21,9,0.121477162,0.878522838,865.4721418,977.5055713,1491.403392,1924.378667,3087,87.69886364,6174,-1388544,192000,-1196544,67
2848,421,21,9,0.128785561,0.871214439,910.4011605,1065.480255,1577.66573,2022.857482,3269,98.05038992,6538,-1458176,215552,-1242624,67
2652,432,21,9,0.140077821,0.859922179,851.6974997,995.668086,1472.659879,1971.240741,3084,54.10526316,6168,-1357824,221184,-1136640,67
2917,443,21,9,0.131845238,0.868154762,935.6824671,1079.713089,1616.434008,2102.352144,3360,80.01905216,6720,-1493504,226816,-1266688,67
2423,405,21,9,0.14321075,0.85678925,786.8307327,879.156292,1349.425506,1803.822222,2828,56.43584115,5656,-1240576,207360,-1033216,67
2839,441,21,9,0.13445122,0.86554878,913.5903438,1036.927021,1572.759422,2076.589569,3280,94.79768786,6560,-1453568,225792,-1227776,67
2877,415,21,9,0.126063183,0.873936817,930.5444976,1027.608894,1602.811957,1949.368675,3292,85.41774779,6584,-1473024,212480,-1260544,67
4505,874,20,10,0.162483733,0.837516267,1488.495154,1587.588732,2521.705216,3557.469108,5379,125.2094972,10758,-2306560,447488,-1859072,67
4575,895,20,10,0.163619744,0.836380256,1598.381256,1363.298111,2634.15235,3253.562011,5470,131.743738,10940,-2342400,458240,-1884160,67
955,73,20,10,0.0710116732,0.928988327,292.888817,307.1395258,525.8125654,366.5068493,1028,37.23288664,2056,-488960,37376,-451584,67
5006,968,21,9,0.162035487,0.837964513,1649.214634,1776.162346,2799.034559,3962.146694,5974,103.9679777,11948,-2563072,495616,-2067456,67
4539,908,21,9,0.166697265,0.833302735,1519.54003,1604.419671,2569.528751,3496.186123,5447,129.1982922,10894,-2323968,464896,-1859072,67
5237,954,20,10,0.154094654,0.845905346,1844.247988,1409.470614,3051.689326,3339.244235,6191,107.951177,12382,-2681344,488448,-2192896,67
4529,890,21,9,0.164236944,0.835763056,1565.888941,1410.893676,2591.964451,3310.655056,5419,113.3207863,10838,-2318848,455680,-1863168,67
4417,896,21,9,0.168642951,0.831357049,1526.722084,1400.269956,2526.565769,3300,5313,99.79338843,10626,-2261504,458752,-1802752,67
5069,954,21,9,0.158392827,0.841607173,1680.387584,1829.225382,2863.861511,3799.121593,6023,105.0401116,12046,-2595328,488448,-2106880,67
4533,906,21,9,0.166574738,0.833425262,1505.738106,1624.014423,2554.93801,3545.856512,5439,137.3831776,10878,-2320896,463872,-1857024,67
4732,877,21,9,0.156355857,0.843644143,1561.860819,1710.637829,2664.70224,3562,5609,129.6279177,11218,-2422784,449024,-1973760,67
4596,901,20,10,0.163907586,0.836092414,1532.633131,1611.849706,2590.41188,3557.957825,5497,130.8497977,10994,-2353152,461312,-1891840,67
4552,937,20,10,0.170705046,0.829294954,1608.743411,1359.460543,2644.5558,3232.963714,5489,100.4575403,10978,-2330624,479744,-1850880,67
4984,920,21,9,0.155826558,0.844173442,1642.829921,1732.979034,2781.475321,3879.007609,5904,137.8151261,11808,-2551808,471040,-2080768,67
4626,951,21,9,0.170521786,0.829478214,1547.94077,1641.177677,2616.296585,3629.090431,5577,134.0625,11154,-2368512,486912,-1881600,67
4323,860,21,9,0.165927069,0.834072931,1518.466894,1290.503493,2503.768217,3035.518605,5183,123.0824032,10366,-2213376,440320,-1773056,67
4322,874,20,10,0.168206313,0.831793687,1474.975421,1456.121152,2468.469459,3241.511442,5196,127.6972229,10392,-2212864,447488,-1765376,67
4893,907,21,9,0.15637931,0.84362069,1616.766292,1738.906399,2748.094012,3722.685777,5800,130.866426,11600,-2505216,464384,-2040832,67
4533,906,21,9,0.166574738,0.833425262,1516.359997,1605.835191,2565.555261,3492.735099,5439,128.0367232,10878,-2320896,463872,-1857024,67
4670,891,21,9,0.160222981,0.839777019,1536.927796,1676.624983,2615.83212,3646.694725,5561,126.1569873,11122,-2391040,456192,-1934848,67
3103,428,21,9,0.121212121,0.878787879,993.3179782,1108.237524,1709.624235,2174.724299,3531,100.341006,7062,-1588736,219136,-1369600,67
3288,454,21,9,0.121325494,0.878674506,1050.690772,1183.882447,1810.64629,2312.220264,3742,110.9727165,7484,-1683456,232448,-1451008,67
3267,457,21,9,0.122717508,0.877282492,1046.411867,1177.706759,1803.520049,2284.135667,3724,106.4912782,7448,-1672704,233984,-1438720,67
3118,403,21,9,0.11445612,0.88554388,1012.214957,1006.457136,1725.280949,2037.35732,3521,101.0040161,7042,-1596416,206336,-1390080,67
3198,440,21,9,0.120945574,0.879054426,1028.427767,1121.079919,1765.53127,2211.754545,3638,78.06866953,7276,-1637376,225280,-1412096,67
3250,435,20,10,0.118046133,0.881953867,1039.360399,1166.238796,1793.512,2212.737931,3685,112.0401338,7370,-1664000,222720,-1441280,67
3082,417,21,9,0.119176908,0.880823092,990.4084217,1078.169953,1701.055159,2111.745803,3499,75.65405405,6998,-1577984,213504,-1364480,67
3223,438,21,9,0.119639443,0.880360557,1031.256521,1155.545218,1777.702451,2223.187215,3661,102.6640494,7322,-1650176,224256,-1425920,67
3029,452,21,9,0.129847745,0.870152255,970.1514552,1107.538245,1672.415979,2200.603982,3481,60.92054603,6962,-1550848,231424,-1319424,67
41,15,21,9,0.267857143,0.732142857,16.09560225,16.20562317,29.17073171,26.66666667,56,4.060913706,112,-20992,7680,-13312,67
3245,430,22,8,0.117006803,0.882993197,1031.549644,1159.510951,1776.472111,2302.32093,3675,87.83460803,7350,-1661440,220160,-1441280,67
3257,456,21,9,0.122811743,0.877188257,1043.12861,1158.7091,1792.741787,2315.967105,3713,107.2501444,7426,-1667584,233472,-1434112,67
3215,432,21,9,0.118453523,0.881546477,1026.868043,1143.345301,1767.231726,2246.476852,3647,98.22246162,7294,-1646080,221184,-1424896,67
3231,443,21,9,0.120577028,0.879422972,1033.861066,1171.895901,1786.091613,2212.444695,3674,101.7728532,7348,-1654272,226816,-1427456,67
3073,433,20,10,0.123502567,0.876497433,988.1487282,1101.389287,1702.202733,2117.556582,3506,100.4872456,7012,-1573376,221696,-1351680,67
3240,441,21,9,0.119804401,0.880195599,1031.071695,1174.072325,1778.980864,2296.650794,3681,96.99604743,7362,-1658880,225792,-1433088,67
41,16,21,9,0.280701754,0.719298246,16.40624219,16.52649388,29.3902439,28,57,4.589371981,114,-20992,8192,-12800,67
3060,413,20,10,0.118917363,0.881082637,982.3931047,1101.017115,1699.072222,2018.014528,3473,103.5788846,6946,-1566720,211456,-1355264,67
3241,436,20,10,0.118574925,0.881425075,1040.293476,1132.187459,1786.087936,2232.321101,3677,95.18508931,7354,-1659392,223232,-1436160,67
3242,441,21,9,0.119739343,0.880260657,1039.064109,1161.393115,1791.851018,2210.668934,3683,76.6014975,7366,-1659904,225792,-1434112,67
3273,432,21,9,0.11659919,0.88340081,1033.549439,1239.407095,1800.181179,2253.175926,3705,94.73280491,7410,-1675776,221184,-1454592,67
2851,427,21,9,0.130262355,0.869737645,913.1813166,1074.228856,1584.978604,2003.529274,3278,78.17791557,6556,-1459712,218624,-1241088,67
2719,403,21,9,0.129083921,0.870916079,871.9797864,993.2607354,1503.507907,1952.766749,3122,101.0355987,6244,-1392128,206336,-1185792,67
2879,412,21,9,0.125189912,0.874810088,918.9521168,1060.790467,1588.716568,2046.288835,3291,85.7477853,6582,-1474048,210944,-1263104,67
2833,421,20,10,0.129379226,0.870620774,907.2888068,1053.863439,1570.305683,2012.372922,3254,85.09414226,6508,-1450496,215552,-1234944,67
2705,403,21,9,0.12966538,0.87033462,867.8239776,989.6969318,1496.602957,1943.114144,3108,84.52542834,6216,-1384960,206336,-1178624,67
2714,410,20,10,0.131241997,0.868758003,871.0313671,1015.386291,1509.141489,1915.707317,3124,72.70188504,6248,-1389568,209920,-1179648,67
2711,398,21,9,0.128015439,0.871984561,864.0090558,974.9736526,1485.548875,2028.070352,3109,93.25134973,6218,-1388032,203776,-1184256,67
2783,400,21,9,0.125667609,0.874332391,890.2591939,1025.373607,1539.464247,1957.5175,3183,91.12510736,6366,-1424896,204800,-1220096,67
2835,412,21,9,0.126886357,0.873113643,904.7243891,1062.738694,1569.271252,2000.592233,3247,96.35014837,6494,-1451520,210944,-1240576,67
757,106,20,10,0.122827346,0.877172654,242.7387852,262.032502,448.5059445,314.1226415,863,15.35314001,1726,-387584,54272,-333312,67
2859,419,21,9,0.127821843,0.872178157,916.8363966,1047.870526,1582.789787,2026.455847,3278,91.61542761,6556,-1463808,214528,-1249280,67
2901,412,21,9,0.124358587,0.875641413,923.8374337,1042.802102,1589.487763,2132.371359,3313,109.8474801,6626,-1485312,210944,-1274368,67
2842,410,20,10,0.126076261,0.873923739,904.6861129,1060.961541,1567.527797,2035.278049,3252,90.05815564,6504,-1455104,209920,-1245184,67
2904,407,21,9,0.122923588,0.877076412,924.3521049,1061.075742,1595.908402,2084.761671,3311,85.57766865,6622,-1486848,208384,-1278464,67
2869,424,20,10,0.128757971,0.871242029,915.6671851,1066.707191,1584.236319,2071.691038,3293,98.74062969,6586,-1468928,217088,-1251840,67
2903,450,21,9,0.134208172,0.865791828,930.45546,1081.655509,1608.45918,2119.164444,3353,109.7545008,6706,-1486336,230400,-1255936,67
41,14,20,10,0.254545455,0.745454545,15.73444862,16.09997465,28.70731707,25.92857143,55,4.414125201,110,-20992,7168,-13824,67
1683,149,21,9,0.0813318777,0.918668122,524.7748981,558.6454782,927.2774807,794.7651007,1832,26.03382123,3664,-861696,76288,-785408,67
900,68,20,10,0.0702479339,0.929752066,274.7866008,275.2929189,498.4022222,300.5,968,18.274495,1936,-460800,34816,-425984,67
8963,771,20,10,0.0792069036,0.920793096,2767.039435,3241.558772,4901.646324,4470.54345,9734,339.5186606,19468,-4589056,394752,-4194304,68
9181,758,20,10,0.0762652178,0.923734782,2840.478138,2805.866452,5091.419344,3499.352243,9939,586.7178276,19878,-4700672,388096,-4312576,68
9152,794,20,10,0.0798310879,0.920168912,2841.889319,2717.868928,5112.370192,3372.819899,9946,619.6884735,19892,-4685824,406528,-4279296,68
2991,409,20,10,0.120294118,0.879705882,957.360754,1138.090514,1687.494149,1795.611247,3400,59.38864629,6800,-1531392,209408,-1321984,68
9007,896,20,10,0.090477633,0.909522367,2832.10072,3108.355296,4969.772843,4773.339286,9903,984.3936382,19806,-4611584,458752,-4152832,68
9132,793,20,10,0.0798992443,0.920100756,2849.331487,2884.163746,5043.246277,4038.9029,9925,880.6566105,19850,-4675584,406016,-4269568,68
6905,1399,21,9,0.168473025,0.831526975,2358.202069,2579.01003,4134.575815,4240.967834,8304,149.4869487,16608,-3535360,716288,-2819072,68
7087,1585,19,11,0.18277214,0.81722786,2449.440245,2691.828316,4242.580923,4756.439748,8672,166.8013079,17344,-3628544,811520,-2817024,68
9287,661,19,11,0.0664455167,0.933554483,2840.907663,3122.79594,5042.220631,4023.030257,9948,1465.095729,19896,-4754944,338432,-4416512,68
8937,964,20,10,0.0973639026,0.902636097,2843.938371,2969.744557,4983.765469,4647.239627,9901,952.9355149,19802,-4575744,493568,-4082176,68
9009,901,20,10,0.0909182644,0.909081736,2836.361094,3005.253021,5025.763348,4252.944506,9910,642.6718547,19820,-4612608,461312,-4151296,68
8158,1607,21,9,0.164567332,0.835432668,2826.602706,2775.728057,4909.220642,4749.889857,9765,180,19530,-4176896,822784,-3354112,68
9279,669,20,10,0.0672496984,0.932750302,2842.004733,3089.150463,5046.20929,3979.895366,9948,1246.616541,19896,-4750848,342528,-4408320,68
9148,767,20,10,0.0773575391,0.922642461,2821.563634,3295.150281,4982.154132,4669.91395,9915,1277.706186,19830,-4683776,392704,-4291072,68
208,55,19,11,0.209125475,0.790874525,73.13929888,85.31606962,130.2836538,138.4909091,263,46.14035088,526,-106496,28160,-78336,68
7519,1784,20,10,0.191766097,0.808233903,2649.1827,2805.586924,4567.104003,5009.809978,9303,164.62573,18606,-3849728,913408,-2936320,68
9047,867,21,9,0.087452088,0.912547912,2831.737202,3102.387943,5012.378468,4384.852364,9914,771.5175097,19828,-4632064,443904,-4188160,68
9352,609,21,9,0.0611384399,0.93886156,2858.916397,2899.846741,5053.468349,3868.152709,9961,682.260274,19922,-4788224,311808,-4476416,68
8054,1730,20,10,0.176819297,0.823180703,2863.74364,2627.171315,4928.043953,4727.025434,9784,512.2513089,19568,-4123648,885760,-3237888,68
6390,1375,19,11,0.177076626,0.822923374,2236.532551,2264.216536,3873.044131,3929.267636,7765,137.0455348,15530,-3271680,704000,-2567680,68
6760,1241,20,10,0.155105612,0.844894388,2303.547823,2305.282191,3930.473669,4385.172442,8001,141.460396,16002,-3461120,635392,-2825728,68
8398,1436,19,11,0.146023998,0.853976002,2868.252983,2660.256594,4918.113598,4913.91156,9834,596.723301,19668,-4299776,735232,-3564544,68
8422,1405,20,10,0.142973441,0.857026559,2880.928333,2546.246827,4949.228806,4702.827758,9827,556.1403509,19654,-4312064,719360,-3592704,68
9248,688,19,11,0.0692431562,0.930756844,2855.079318,2765.858862,5059.06715,3751.109012,9936,738.7360595,19872,-4734976,352256,-4382720,68
9081,827,19,11,0.0834679047,0.916532095,2846.412085,2981.765083,4988.640678,4579.613059,9908,1044.046365,19816,-4649472,423424,-4226048,68
9273,668,20,10,0.0671964591,0.932803541,2855.056395,2877.871426,5044.578993,3949.595808,9941,1212.317073,19882,-4747776,342016,-4405760,68
9172,746,19,11,0.0752167776,0.924783222,2842.571484,2925.605542,5040.66147,3961.627346,9918,1268.286445,19836,-4696064,381952,-4314112,68
6764,1358,19,11,0.167200197,0.832799803,2334.336207,2344.683734,3971.86369,4507.96539,8122,146.0003595,16244,-3463168,695296,-2767872,68
9320,627,20,10,0.0630340806,0.936965919,2854.548343,2804.718309,5061.790773,3669.039872,9947,873.309921,19894,-4771840,321024,-4450816,68
9283,662,20,10,0.0665661136,0.933433886,2855.769576,2876.050249,5047.944522,3922.07855,9945,861.7850953,19890,-4752896,338944,-4413952,68
9420,543,19,11,0.0545016561,0.945498344,2855.222671,2927.045385,5056.717728,3685.791897,9963,585.7142857,19926,-4823040,278016,-4545024,68
9231,710,20,10,0.0714213862,0.928578614,2853.706447,2769.370424,5069.25631,3693.529577,9941,1066.630901,19882,-4726272,363520,-4362752,68
9251,666,20,10,0.0671574065,0.932842594,2840.446805,3038.268832,5018.597017,4131.174174,9917,737.8720238,19834,-4736512,340992,-4395520,68
8874,993,20,10,0.100638492,0.899361508,2815.087388,3124.913786,4952.957516,4764.585096,9867,344.7589099,19734,-4543488,508416,-4035072,68
9346,599,20,10,0.060231272,0.939768728,2850.955708,2836.024755,5060.36315,3609.901503,9945,772.7272727,19890,-4785152,306688,-4478464,68
9257,682,19,11,0.0686185733,0.931381427,2854.732345,2862.793012,5046.443664,3932.406158,9939,877.2285966,19878,-4739584,349184,-4390400,68
6496,1673,19,11,0.204798629,0.795201371,2325.53406,2441.953335,3984.434113,4475.481769,8169,143.190184,16338,-3325952,856576,-2469376,68
9098,811,19,11,0.0818447876,0.918155212,2849.394928,2967.490012,4980.126072,4673.12947,9909,571.4532872,19818,-4658176,415232,-4242944,68
1898,260,20,10,0.120481928,0.879518072,612.4326843,682.5671557,1096.314015,956.7576923,2158,29.30870569,4316,-971776,133120,-838656,68
1713,321,20,10,0.157817109,0.842182891,563.3210106,697.0475271,1005.005254,1084.17757,2034,30.04875166,4068,-877056,164352,-712704,68
3005,204,21,9,0.063571206,0.936428794,905.7174784,1127.374333,1629.947088,1237.519608,3209,494.4530046,6418,-1538560,104448,-1434112,68
3185,255,22,8,0.074127907,0.925872093,964.6284717,1291.96045,1728.84741,1616.239216,3440,334.3051506,6880,-1630720,130560,-1500160,68
2950,213,23,7,0.0673411318,0.932658868,889.3616611,1137.744212,1607.269492,1232.023474,3163,520.2302632,6326,-1510400,109056,-1401344,68
2947,180,23,7,0.0575631596,0.94243684,887.1125394,1109.327877,1575.950119,1368.35,3127,338.4199134,6254,-1508864,92160,-1416704,68
2950,192,23,7,0.0611075748,0.938892425,887.8730387,1122.74694,1590.427119,1280.692708,3142,540.7917384,6284,-1510400,98304,-1412096,68
2951,201,22,8,0.0637690355,0.936230964,889.3687009,1119.309211,1599.094544,1244.776119,3152,442.6966292,6304,-1510912,102912,-1408000,68
3075,236,23,7,0.0712775596,0.92872244,927.5802178,1262.714052,1664.001626,1551.741525,3311,351.8597237,6622,-1574400,120832,-1453568,68
2983,181,23,7,0.0572060683,0.942793932,898.2206889,1117.338005,1593.990949,1393.121547,3164,245.8430458,6328,-1527296,92672,-1434624,68
2945,199,23,7,0.0632951654,0.936704835,887.1758676,1121.817481,1593.951443,1255.040201,3144,333.0508475,6288,-1507840,101888,-1405952,68
2949,202,23,7,0.0641066328,0.935893367,888.7550944,1130.764583,1596.579179,1275.564356,3151,336.2860192,6302,-1509888,103424,-1406464,68
2969,217,23,7,0.0681104834,0.931889517,895.9728041,1162.68214,1613.944426,1313.778802,3186,275.1295337,6372,-1520128,111104,-1409024,68
3143,244,23,7,0.0720401535,0.927959846,958.8079819,1178.030704,1709.059179,1500.020492,3387,245.7910015,6774,-1609216,124928,-1484288,68
2942,208,23,7,0.066031746,0.933968254,887.4060466,1118.161587,1600.480286,1222.173077,3150,533.8983051,6300,-1506304,106496,-1399808,68
2947,183,23,7,0.0584664537,0.941533546,886.85241,1107.178085,1581.677638,1304.978142,3130,384.0490798,6260,-1508864,93696,-1415168,68
3229,214,23,7,0.0621550973,0.937844903,976.1389149,1227.986643,1716.218953,1809.228972,3443,227.1108179,6886,-1653248,109568,-1543680,68
3284,256,23,7,0.0723163842,0.927683616,994.2705277,1318.215775,1781.500914,1629.378906,3540,206.0535506,7080,-1681408,131072,-1550336,68
2968,222,22,8,0.0695924765,0.930407524,895.7147146,1152.183579,1621.663747,1245.707207,3190,379.7619048,6380,-1519616,113664,-1405952,68
3201,237,23,7,0.0689354276,0.931064572,966.7947781,1289.796735,1721.402374,1693.805907,3438,208.3636364,6876,-1638912,121344,-1517568,68
3206,259,23,7,0.0747474747,0.925252525,968.9140675,1321.151222,1743.746101,1599.980695,3465,263.8994669,6930,-1641472,132608,-1508864,68
2958,190,23,7,0.0603557814,0.939644219,894.2897867,1068.259558,1593.23428,1282.836842,3148,80.5321054,6296,-1514496,97280,-1417216,68
6117,1395,19,11,0.185702875,0.814297125,2175.533142,2113.149061,3690.240314,4047.045161,7512,131.6508938,15024,-3131904,714240,-2417664,68
8521,1324,20,10,0.13448451,0.86551549,2794.351142,2961.929022,4776.102922,5868.400302,9845,678.4975879,19690,-4362752,677888,-3684864,68
5237,635,20,10,0.108140327,0.891859673,1656.137378,1972.832661,2908.88123,3164.27874,5872,240.2618658,11744,-2681344,325120,-2356224,68
7127,1736,21,9,0.195870473,0.804129527,2536.916238,2582.70027,4306.940087,4945.422811,8863,162.9527487,17726,-3649024,888832,-2760192,68
6896,1705,20,10,0.198232764,0.801767236,2461.104922,2512.053294,4181.764501,4783.256891,8601,151.5861826,17202,-3530752,872960,-2657792,68
5128,572,20,10,0.100350877,0.899649123,1614.966776,1882.289531,2875.413807,2627.146853,5700,337.4777975,11400,-2625536,292864,-2332672,68
8568,1287,20,10,0.130593607,0.869406393,2791.584437,3079.193336,4818.39986,5657.645688,9855,486.4264561,19710,-4386816,658944,-3727872,68
5141,608,20,10,0.105757523,0.894242477,1620.790479,1956.94263,2871.602606,2903.726974,5749,254.1556145,11498,-2632192,311296,-2320896,68
6526,1570,19,11,0.193922925,0.806077075,2341.022811,2276.111761,3950.608183,4455.405732,8096,141.9603717,16192,-3341312,803840,-2537472,68
1489,157,20,10,0.0953827461,0.904617254,471.658476,493.2559989,835.3277367,711.3248408,1646,74.98861048,3292,-762368,80384,-681984,68
2480,301,20,10,0.108234448,0.891765552,799.6698242,770.0886253,1425.926613,1103.232558,2781,49.48398577,5562,-1269760,154112,-1115648,68
8488,1353,20,10,0.137486028,0.862513972,2775.5929,3091.965869,4787.801013,5756.619364,9841,531.9459459,19682,-4345856,692736,-3653120,68
5509,1273,20,10,0.187702743,0.812297257,1949.634243,1955.804579,3311.982574,3735.617439,6782,121.5847974,13564,-2820608,651776,-2168832,68
8549,1303,20,10,0.13225741,0.86774259,2812.421074,2897.915587,4794.562288,5792.14505,9852,690.8835905,19704,-4377088,667136,-3709952,68
5273,611,20,10,0.103840925,0.896159075,1656.903054,2009.31631,2916.961881,3162.89689,5884,245.0645564,11768,-2699776,312832,-2386944,68
5394,651,20,10,0.107692308,0.892307692,1711.814009,1991.704129,3042.743975,2859.407066,6045,214.7424512,12090,-2761728,333312,-2428416,68
5381,671,19,11,0.110872439,0.889127561,1703.267074,2064.367612,3020.750046,3072.611028,6052,211.0917335,12104,-2755072,343552,-2411520,68
8508,1332,20,10,0.135365854,0.864634146,2805.000431,2932.649578,4794.361189,5726.197447,9840,638.961039,19680,-4356096,681984,-3674112,68
5382,604,19,11,0.100902105,0.899097895,1690.548455,2031.089998,2988.985321,3033.728477,5986,172.1104083,11972,-2755584,309248,-2446336,68
8470,1370,20,10,0.139227642,0.860772358,2805.351933,2882.424836,4771.223731,5843.39781,9840,662.6262626,19680,-4336640,701440,-3635200,68
8790,1095,21,9,0.1107739,0.8892261,2782.988469,3289.628006,4858.78339,5619.040183,9885,819.6517413,19770,-4500480,560640,-3939840,68
6220,533,21,9,0.0789278839,0.921072116,1913.578563,2311.163277,3399.472026,3114.756098,6753,319.2907801,13506,-3184640,272896,-2911744,68
5387,1391,21,9,0.20522278,0.79477722,1927.807245,2026.18817,3298.361054,3742.458663,6778,118.1659693,13556,-2758144,712192,-2045952,68
5164,1291,20,10,0.2,0.8,1841.706588,1928.958988,3167.649109,3469.403563,6455,117.2357428,12910,-2643968,660992,-1982976,68
5220,1318,20,10,0.201590701,0.798409299,1881.220612,1883.706615,3196.263985,3559.554628,6538,117.4631692,13076,-2672640,674816,-1997824,68
6232,592,21,9,0.0867526377,0.913247362,1932.955798,2321.127982,3422.280648,3309.538851,6824,122.5354642,13648,-3190784,303104,-2887680,68
6194,565,21,9,0.0835922474,0.916407753,1913.899704,2309.589956,3399.795124,3162.989381,6759,549.9593165,13518,-3171328,289280,-2882048,68
5351,1304,20,10,0.1959429,0.8040571,1919.129728,1914.971133,3276.657073,3538.687117,6655,116.8774148,13310,-2739712,667648,-2072064,68
6361,584,20,10,0.0840892729,0.915910727,1965.171192,2352.575936,3512.34743,3044.422945,6945,437.3425693,13890,-3256832,299008,-2957824,68
6168,538,21,9,0.0802266627,0.919773337,1915.851651,2123.802883,3382.518645,3020.810409,6706,358.0352376,13412,-3158016,275456,-2882560,68
8753,1128,20,10,0.114158486,0.885841514,2784.368523,3270.044828,4862.522107,5549.968972,9881,865.9947415,19762,-4481536,577536,-3904000,68
6372,552,20,10,0.0797227036,0.920277296,1961.247687,2378.619357,3481.689422,3240.987319,6924,444.9871465,13848,-3262464,282624,-2979840,68
6195,523,20,10,0.0778505508,0.922149449,1907.231692,2282.292591,3369.131719,3245.41109,6718,320.5152672,13436,-3171840,267776,-2904064,68
5871,1434,20,10,0.196303901,0.803696099,2094.827888,2156.91658,3612.265372,3819.773361,7305,134.5799558,14610,-3005952,734208,-2271744,68
4869,1169,21,9,0.193607155,0.806392845,1731.235311,1773.035031,2964.530499,3248.453379,6038,106.0600738,12076,-2492928,598528,-1894400,68
5810,540,21,9,0.0850393701,0.91496063,1792.637594,2150.549858,3225.260757,2640.111111,6350,479.6072508,12700,-2974720,276480,-2698240,68
8690,1187,20,10,0.120178192,0.879821808,2780.76316,3219.698013,4834.188953,5706.319292,9877,832.7993255,19754,-4449280,607744,-3841536,68
8675,1153,21,9,0.117317867,0.882682133,2784.628466,3197.183143,4887.570375,5117.114484,9828,303.052729,19656,-4441600,590336,-3851264,68
4566,1123,20,10,0.197398488,0.802601512,1622.903811,1696.081692,2783.65703,3094.414069,5689,101.3178985,11378,-2337792,574976,-1762816,68
414,67,20,10,0.139293139,0.860706861,139.0476928,117.8875927,251.6666667,175.0895522,481,46.02870813,962,-211968,34304,-177664,68
6865,1400,20,10,0.16938899,0.83061101,2376.779163,2355.185974,4021.696868,4678.782857,8265,145.8701024,16530,-3514880,716800,-2798080,68
5935,600,19,11,0.0918133129,0.908186687,1891.44895,1767.690119,3316.063353,2792.573333,6535,333.4183673,13070,-3038720,307200,-2731520,68
7937,1289,20,10,0.139713852,0.860286148,2681.929573,2545.567156,4609.413758,4638.660978,9226,162.7160494,18452,-4063744,659968,-3403776,68
8389,1440,20,10,0.14650524,0.85349476,2838.190688,2781.309211,4829.815711,5411.257639,9829,482.7603143,19658,-4295168,737280,-3557888,68
5965,618,19,11,0.093878171,0.906121829,1902.158422,1788.83164,3349.924728,2732.904531,6583,404.1129527,13166,-3054080,316416,-2737664,68
326,82,19,11,0.200980392,0.799019608,118.706353,110.2528386,211.0337423,178.5243902,408,7.456140351,816,-166912,41984,-124928,68
5781,562,20,10,0.0886016081,0.911398392,1834.528335,1696.88944,3226.341117,2613.021352,6343,272.1149721,12686,-2959872,287744,-2672128,68
6720,717,20,10,0.0964098427,0.903590157,2132.165843,2255.953564,3752.598512,3404.101813,7437,227.0839695,14874,-3440640,367104,-3073536,68
8148,1654,20,10,0.168741073,0.831258927,2840.876032,2772.170872,4886.571797,4975.039903,9802,231.6162571,19604,-4171776,846848,-3324928,68
5925,616,20,10,0.0941752026,0.905824797,1888.762808,1786.205993,3329.979747,2703.702922,6541,457.4125874,13082,-3033600,315392,-2718208,68
7985,1820,20,10,0.185619582,0.814380418,2796.389887,2886.996996,4754.985348,5552.393956,9805,205.3403141,19610,-4088320,931840,-3156480,68
6995,1048,20,10,0.130299639,0.869700361,2322.502792,2315.251093,4008.683345,4110.883588,8043,153.2875929,16086,-3581440,536576,-3044864,68
6813,982,20,10,0.125978191,0.874021809,2242.409155,2303.446017,3902.629238,3865.882892,7795,160.8211265,15590,-3488256,502784,-2985472,68
6112,688,20,10,0.101176471,0.898823529,1966.271726,1849.526287,3460.686518,2865.819767,6800,450.3311258,13600,-3129344,352256,-2777088,68
6143,644,20,10,0.0948872845,0.905112715,1962.036831,1831.736237,3455.374573,2808.559006,6787,375.8028793,13574,-3145216,329728,-2815488,68
6895,1370,19,11,0.165759226,0.834240774,2380.602494,2373.268442,4054.479768,4528.180292,8265,146.9333333,16530,-3530240,701440,-2828800,68
7184,1097,20,10,0.132471924,0.867528076,2400.857175,2317.005947,4120.063614,4278.107566,8281,156.2158083,16562,-3678208,561664,-3116544,68
6826,978,20,10,0.125320349,0.874679651,2255.267564,2234.558557,3893.061822,3968.374233,7804,180.8993973,15608,-3494912,500736,-2994176,68
7447,1151,20,10,0.133868341,0.866131659,2472.548146,2533.234454,4268.281321,4501.485665,8598,192.9533214,17196,-3812864,589312,-3223552,68
7632,1039,20,10,0.119824703,0.880175297,2478.393324,2676.442477,4325.853774,4410.529355,8671,155.0053629,17342,-3907584,531968,-3375616,68
7251,867,20,10,0.106799704,0.893200296,2277.172983,2820.705598,4024.265619,4354.176471,8118,180.1198136,16236,-3712512,443904,-3268608,68
3582,393,20,10,0.0988679245,0.901132075,1141.668529,1063.029645,2045.802624,1461.157761,3975,69.73684211,7950,-1833984,201216,-1632768,68
8680,1178,20,10,0.119496855,0.880503145,2773.655651,3129.43944,4784.832719,5995.46944,9858,703.640257,19716,-4444160,603136,-3841024,68
7943,1841,23,7,0.18816435,0.81183565,2824.666189,2763.92518,4772.281002,5411.185225,9784,223.1751825,19568,-4066816,942592,-3124224,68
5973,623,20,10,0.0944511825,0.905548817,1856.715083,2309.552305,3299.745856,3286.555377,6596,269.8854337,13192,-3058176,318976,-2739200,68
8722,1142,20,10,0.115774534,0.884225466,2798.612155,3111.060931,4842.252924,5621.76007,9864,548.6095662,19728,-4465664,584704,-3880960,68
8839,1041,20,10,0.105364372,0.894635628,2784.698479,3295.100371,4861.47347,5611.504323,9880,810.5004102,19760,-4525568,532992,-3992576,68
8653,1206,20,10,0.122324779,0.877675221,2769.149103,3230.218122,4815.882584,5748.787728,9859,528.916309,19718,-4430336,617472,-3812864,68
4577,670,20,10,0.127692014,0.872307986,1492.454512,1622.20756,2671.209307,2301.497015,5247,91.74680888,10494,-2343424,343040,-2000384,68
8118,1707,22,8,0.173740458,0.826259542,2840.868231,2796.173717,4852.409214,5201.152314,9825,188.5434657,19650,-4156416,873984,-3282432,68
6677,1501,23,7,0.183541208,0.816458792,2328.737764,2414.303606,3958.964056,4670.171885,8178,143.2224168,16356,-3418624,768512,-2650112,68
8729,1154,20,10,0.116766164,0.883233836,2798.105069,3091.309184,4822.260969,5847.720971,9883,778.8022065,19766,-4469248,590848,-3878400,68
6025,1297,23,7,0.177137394,0.822862606,2087.676617,2184.037245,3573.062075,4072.323824,7322,135.1920236,14644,-3084800,664064,-2420736,68
6023,632,20,10,0.0949661908,0.905033809,1864.058872,2370.99153,3292.286734,3668.349684,6655,116.5703276,13310,-3083776,323584,-2760192,68
6157,1352,22,8,0.180050606,0.819949394,2128.366147,2273.190409,3646.065941,4251.085059,7509,131.8293539,15018,-3152384,692224,-2460160,68
5125,1053,22,8,0.170443509,0.829556491,1794.084984,1730.42273,3084.077463,3115.891738,6178,108.9978829,12356,-2624000,539136,-2084864,68
6438,640,20,10,0.0904210229,0.909578977,1992.578641,2496.333682,3539.710469,3537.382813,7078,308.5440279,14156,-3296256,327680,-2968576,68
8660,1208,20,10,0.12241589,0.87758411,2780.338958,3225.448627,4845.132794,5575.162252,9868,875.5989352,19736,-4433920,618496,-3815424,68
3586,406,20,10,0.101703407,0.898296593,1143.651311,1176.504114,2033.839654,1666.697044,3992,71.95385725,7984,-1836032,207872,-1628160,68
2331,304,19,11,0.115370019,0.884629981,755.2409749,729.9296436,1358.456456,1007.789474,2635,41.01167315,5270,-1193472,155648,-1037824,68
7488,838,23,7,0.100648571,0.899351429,2375.188169,2580.602187,4102.841213,4705.520286,8326,159.075277,16652,-3833856,429056,-3404800,68
4941,532,23,7,0.0972044582,0.902795542,1577.346625,1595.084812,2720.103218,2893.930451,5473,96.01754386,10946,-2529792,272384,-2257408,68
5948,764,23,7,0.113825983,0.886174017,1938.356601,1895.574811,3311.609112,3705.990838,6712,164.0674652,13424,-3045376,391168,-2654208,68
7753,886,23,7,0.102558166,0.897441834,2479.890984,2570.063182,4268.956275,4766.6614,8639,197.8699038,17278,-3969536,453632,-3515904,68
7592,846,23,7,0.100260725,0.899739275,2404.53032,2627.195928,4153.388567,4812.783688,8438,184.2760428,16876,-3887104,433152,-3453952,68
7085,787,23,7,0.0999745935,0.900025407,2261.894762,2332.55479,3895.129711,4308.937738,7872,160.9815951,15744,-3627520,402944,-3224576,68
6122,801,23,7,0.115701286,0.884298714,2002.951344,1933.75436,3419.665305,3785.561798,6923,151.8201754,13846,-3134464,410112,-2724352,68
5350,514,23,7,0.0876534789,0.912346521,1664.909382,1937.170284,2905.379439,3214.785992,5864,218.0736333,11728,-2739200,263168,-2476032,68
5883,719,23,7,0.108906392,0.891093608,1903.166589,1882.779423,3253.868944,3691.226704,6602,130.603363,13204,-3012096,368128,-2643968,68
6348,808,23,7,0.112912241,0.887087759,2062.423747,2061.23639,3535.803245,3913.944307,7156,136.1491629,14312,-3250176,413696,-2836480,68
5891,751,23,7,0.113068353,0.886931647,1914.779173,1903.392765,3277.941266,3663.183755,6642,151.0575392,13284,-3016192,384512,-2631680,68
6010,750,23,7,0.110946746,0.889053254,1946.324042,1968.226841,3344.399334,3669.786667,6760,148.0183928,13520,-3077120,384000,-2693120,68
5994,751,23,7,0.111341735,0.888658265,1946.356664,1925.169265,3334.094595,3683.517976,6745,159.7205778,13490,-3068928,384512,-2684416,68
6165,794,23,7,0.114096853,0.885903147,1997.804015,2036.332646,3421.375669,3935.187657,6959,122.9288112,13918,-3156480,406528,-2749952,68
6228,764,23,7,0.109267735,0.890732265,2014.037178,2028.590942,3459.382787,3799.073298,6992,161.2546125,13984,-3188736,391168,-2797568,68
5746,804,23,7,0.122748092,0.877251908,1885.941543,1899.159521,3234.028716,3571.885572,6550,136.3447127,13100,-2941952,411648,-2530304,68
5941,718,23,7,0.107823998,0.892176002,1930.420888,1839.138925,3303.600572,3548.438719,6659,124.723731,13318,-3041792,367616,-2674176,68
6361,772,23,7,0.108229357,0.891770643,2064.692246,2006.223711,3548.629304,3718.367876,7133,135.2227488,14266,-3256832,395264,-2861568,68
1105,129,23,7,0.104538088,0.895461912,348.1666103,418.7478876,616.0651584,629.7906977,1234,18.4619988,2468,-565760,66048,-499712,68
1064,117,23,7,0.0990685859,0.900931414,331.871147,414.1968077,590.1419173,598.8034188,1181,17.60846876,2362,-544768,59904,-484864,68
305,36,26,4,0.105571848,0.894428152,96.50949154,104.239915,176.0032787,128.6111111,341,37.06521739,682,-156160,18432,-137728,68
286,36,26,4,0.111801242,0.888198758,90.94111243,99.58814493,166.3356643,123.0833333,322,36.26126126,644,-146432,18432,-128000,68
293,36,26,4,0.109422492,0.890577508,93.09069268,99.67200453,170.1433447,123.1388889,329,7.166194729,658,-150016,18432,-131584,68
289,36,26,4,0.110769231,0.889230769,91.84794549,98.13675816,168.3944637,119.6944444,325,37.18535469,650,-147968,18432,-129536,68
292,36,26,4,0.109756098,0.890243902,92.80493366,98.52393251,169.8527397,121.0833333,328,29.68325792,656,-149504,18432,-131072,68
245,33,26,4,0.118705036,0.881294964,78.79147877,82.33966249,144.2040816,104.5757576,278,14.5473574,556,-125440,16896,-108544,68
292,36,26,4,0.109756098,0.890243902,92.82892682,98.70846525,169.760274,121.8333333,328,6.319845857,656,-149504,18432,-131072,68
290,36,26,4,0.110429448,0.889570552,92.07851591,100.7502259,168.3965517,124.0555556,326,34.46088795,652,-148480,18432,-130048,68
286,36,26,4,0.111801242,0.888198758,90.99879201,96.08850087,167.1433566,116.6666667,322,29.21960073,644,-146432,18432,-128000,68
286,36,26,4,0.111801242,0.888198758,90.86872699,100.6415532,166.1783217,124.3333333,322,30.57929725,644,-146432,18432,-128000,68
288,36,26,4,0.111111111,0.888888889,91.42798366,101.2108025,167.2361111,124.6111111,324,30.56603774,648,-147456,18432,-129024,68
283,36,26,4,0.112852665,0.887147335,89.99705268,99.67541071,164.6961131,123.0833333,319,30.17975402,638,-144896,18432,-126464,68
287,36,26,4,0.111455108,0.888544892,91.32223569,99.31962993,166.8083624,123.6666667,323,32.82520325,646,-146944,18432,-128512,68
286,36,26,4,0.111801242,0.888198758,90.94656631,99.26827972,166.4160839,122.4444444,322,18.52704258,644,-146432,18432,-128000,68
289,36,26,4,0.110769231,0.889230769,91.89157284,98.91943973,168.1072664,122,325,6.596306069,650,-147968,18432,-129536,68
627,56,26,4,0.0819912152,0.918008785,194.0025115,222.0544496,347.0015949,286,683,62.48856359,1366,-321024,28672,-292352,68
288,36,26,4,0.111111111,0.888888889,91.50453992,100.9352408,167.1527778,125.2777778,324,27.13567839,648,-147456,18432,-129024,68
288,36,26,4,0.111111111,0.888888889,91.43116839,100.8682179,167.3298611,123.8611111,324,7.730851825,648,-147456,18432,-129024,68
290,36,26,4,0.110429448,0.889570552,92.22731933,98.848599,168.6137931,122.3055556,326,6.003683241,652,-148480,18432,-130048,68
154,22,26,4,0.125,0.875,49.41114713,56.84406683,90.92207792,71.54545455,176,18.20062048,352,-78848,11264,-67584,68
1785,241,20,10,0.118953603,0.881046397,568.6000935,693.229012,1011.076751,1031.448133,2026,120.6670637,4052,-913920,123392,-790528,68
2251,341,20,10,0.131558642,0.868441358,737.0227054,818.2668304,1299.138161,1279.085044,2592,123.2524964,5184,-1152512,174592,-977920,68
2853,567,19,11,0.165789474,0.834210526,968.4192084,1065.816141,1682.246758,1852.663139,3420,79.94389902,6840,-1460736,290304,-1170432,68
3175,600,20,10,0.158940397,0.841059603,1062.300312,1199.607232,1845.170079,2114.641667,3775,108.7896254,7550,-1625600,307200,-1318400,68
1888,289,20,10,0.132751493,0.867248507,611.063562,731.7842194,1087.041843,1101.792388,2177,104.9662488,4354,-966656,147968,-818688,68
2882,566,20,10,0.164153132,0.835846868,976.0148053,1063.263151,1682.660305,1937.542403,3448,100.9072286,6896,-1475584,289792,-1185792,68
1886,288,20,10,0.132474701,0.867525299,616.9869905,691.6777446,1093.484624,1048.309028,2174,140.4392765,4348,-965632,147456,-818176,68
2944,596,20,10,0.168361582,0.831638418,996.6361512,1110.449135,1724.086617,1999.763423,3540,106.7551267,7080,-1507328,305152,-1202176,68
3165,568,20,10,0.152156443,0.847843557,1050.019974,1192.34673,1824.275197,2105.070423,3733,113.4305682,7466,-1620480,290816,-1329664,68
1806,239,20,10,0.116870416,0.883129584,575.5869845,691.6841012,1022.045404,1030.213389,2045,137.8961564,4090,-924672,122368,-802304,68
1882,263,20,10,0.122610723,0.877389277,607.5730166,692.2459339,1083.435175,998.3269962,2145,163.3663366,4290,-963584,134656,-828928,68
1913,289,21,9,0.131244323,0.868755677,621.7164079,720.5407487,1105.869315,1072.577855,2202,38.76760563,4404,-979456,147968,-831488,68
210,53,20,10,0.201520913,0.798479087,73.25280736,84.96273553,129.5047619,141.8867925,263,49.25093633,526,-107520,27136,-80384,68
1888,272,20,10,0.125925926,0.874074074,613.55344,683.3707537,1092.197564,999.3051471,2160,187.6629018,4320,-966656,139264,-827392,68
993,135,20,10,0.119680851,0.880319149,321.1460437,343.1129363,577.0080564,472.4962963,1128,19.38477402,2256,-508416,69120,-439296,68
1800,242,20,10,0.118511263,0.881488737,574.8578464,688.4332223,1020.086667,1032.012397,2042,165.210356,4084,-921600,123904,-797696,68
2930,559,20,10,0.160217827,0.839782173,986.7980021,1091.470542,1711.726621,1919.402504,3489,87.2468117,6978,-1500160,286208,-1213952,68
1782,225,21,9,0.112107623,0.887892377,569.9315595,648.7237933,1007.257576,978.2,2007,157.0422535,4014,-912384,115200,-797184,68
1914,257,20,10,0.118378627,0.881621373,614.7559546,705.5080086,1095.42372,1015.817121,2171,163.4789157,4342,-979968,131584,-848384,68
1894,269,20,10,0.124364309,0.875635691,611.1010745,710.5396042,1078.386484,1107.442379,2163,150.7317073,4326,-969728,137728,-832000,68
8358,682,21,9,0.0754424779,0.924557522,2597.3112,2722.273864,4486.752333,4934.082111,9040,168.8772651,18080,-4279296,349184,-3930112,69
9234,697,22,8,0.0701842715,0.929815729,2854.632368,3020.207496,4955.239874,5108.552367,9931,1056.489362,19862,-4727808,356864,-4370944,69
8147,617,22,8,0.0704016431,0.929598357,2542.971705,2345.933859,4394.025531,4230.314425,8764,150.7914659,17528,-4171264,315904,-3855360,69
8331,682,21,9,0.0756684789,0.924331521,2592.78909,2695.149023,4484.834834,4777.759531,9013,174.7382706,18026,-4265472,349184,-3916288,69
8284,677,22,8,0.0755496038,0.924450396,2572.101534,2738.212304,4453.463906,4817.940916,8961,158.7141339,17922,-4241408,346624,-3894784,69
8799,682,22,8,0.0719333404,0.92806666,2724.847872,2865.031417,4713.698716,5093.234604,9481,238.8762913,18962,-4505088,349184,-4155904,69
8553,709,21,9,0.0765493414,0.923450659,2660.871309,2822.277254,4623.683854,4725.789845,9262,179.8795883,18524,-4379136,363008,-4016128,69
8477,686,22,8,0.0748663102,0.92513369,2638.381485,2718.620558,4565.226849,4789.268222,9163,231.3304721,18326,-4340224,351232,-3988992,69
8749,727,21,9,0.0767201351,0.923279865,2718.498587,2911.24,4710.553549,5074.818432,9476,190.2811245,18952,-4479488,372224,-4107264,69
9168,752,22,8,0.0758064516,0.924193548,2838.052416,3081.260107,4905.515052,5630.848404,9920,641.2411118,19840,-4694016,385024,-4308992,69
8639,680,21,9,0.0729692027,0.927030797,2674.741225,2870.434256,4643.268087,4872.569118,9319,193.4606602,18638,-4423168,348160,-4075008,69
8674,657,21,9,0.0704104598,0.92958954,2677.309285,2893.406048,4651.220314,4861.127854,9331,244.7796432,18662,-4441088,336384,-4104704,69
8532,693,21,9,0.0751219512,0.924878049,2646.318748,2838.802386,4585.365096,4953.232323,9225,162.5837152,18450,-4368384,354816,-4013568,69
8549,661,22,8,0.0717698154,0.928230185,2646.462698,2797.907182,4584.443327,4877.835098,9210,203.4010601,18420,-4377088,338432,-4038656,69
1102,62,21,9,0.0532646048,0.946735395,333.7982737,326.6079303,592.392922,406.6612903,1164,21.7936716,2328,-564224,31744,-532480,69
8490,672,22,8,0.0733464309,0.926653569,2627.592206,2847.23013,4566.750177,4767.848214,9162,188.4797367,18324,-4346880,344064,-4002816,69
8228,705,21,9,0.0789208553,0.921079145,2561.951522,2759.065523,4449.676471,4669.18156,8933,225.5238576,17866,-4212736,360960,-3851776,69
8336,667,21,9,0.0740864156,0.925913584,2587.899644,2684.881015,4462.610005,4994.286357,9003,221.3126844,18006,-4268032,341504,-3926528,69
8585,681,21,9,0.073494496,0.926505504,2657.302741,2826.014987,4588.394059,5202.126285,9266,168.228032,18532,-4395520,348672,-4046848,69
8516,699,22,8,0.0758545849,0.924145415,2648.313908,2790.475663,4589.57574,4832.46495,9215,233.7053005,18430,-4360192,357888,-4002304,69
4449,463,23,7,0.0942589577,0.905741042,1394.969133,1556.518399,2411.149472,2892.276458,4912,94.68003084,9824,-2277888,237056,-2040832,69
4398,432,23,7,0.0894409938,0.910559006,1371.623761,1508.169836,2363.476808,2945.125,4830,119.9404023,9660,-2251776,221184,-2030592,69
4366,422,23,7,0.0881370092,0.911862991,1363.164207,1494.660714,2351.562758,2838.727488,4788,92.75474622,9576,-2235392,216064,-2019328,69
4394,442,23,7,0.0913978495,0.908602151,1375.195834,1547.459745,2384.152025,2759.959276,4836,133.03989,9672,-2249728,226304,-2023424,69
9402,515,23,7,0.0519310275,0.948068972,2860.373351,2685.429648,5018.310998,3876.2,9917,423.2607768,19834,-4813824,263680,-4550144,69
4440,469,23,7,0.0955388063,0.904461194,1394.602545,1575.261274,2419.376126,2792.249467,4909,86.51744801,9818,-2273280,240128,-2033152,69
992,93,22,8,0.0857142857,0.914285714,310.6296608,303.2833225,556.6854839,397.0215054,1085,27.15215215,2170,-507904,47616,-460288,69
4337,424,23,7,0.0890569208,0.910943079,1360.255112,1492.009226,2358.528245,2610.858491,4761,111.6295428,9522,-2220544,217088,-2003456,69
9234,656,23,7,0.0663296259,0.933670374,2878.849698,2453.323525,4976.735109,4505.827744,9890,525.5047821,19780,-4727808,335872,-4391936,69
8639,1212,23,7,0.123033195,0.876966805,2805.498319,2832.481571,4759.621831,6111.924917,9851,795.0766747,19702,-4423168,620544,-3802624,69
4418,413,22,8,0.0854895467,0.914510453,1374.853505,1552.352553,2385.06134,2746.961259,4831,131.9584813,9662,-2262016,211456,-2050560,69
6452,578,23,7,0.0822190612,0.917780939,2025.079279,2072.917929,3526.471637,3393.027682,7030,142.4518744,14060,-3303424,295936,-3007488,69
4464,462,23,7,0.0937880633,0.906211937,1396.108084,1555.372926,2408.792563,2992.101732,4926,89.17451122,9852,-2285568,236544,-2049024,69
4962,460,22,8,0.0848395426,0.915160457,1544.442774,1724.75595,2674.804111,3107.336957,5422,99.85267035,10844,-2540544,235520,-2305024,69
2172,143,23,7,0.0617710583,0.938228942,662.3037627,692.5816951,1176.893186,871.034965,2315,41.64418061,4630,-1112064,73216,-1038848,69
4438,477,23,7,0.0970498474,0.902950153,1391.73777,1551.046276,2400.585399,2992.184486,4915,100.5523732,9830,-2272256,244224,-2028032,69
4012,284,23,7,0.0661080074,0.933891993,1240.899047,1223.671825,2156.675723,2033.003521,4296,98.2841455,8592,-2054144,145408,-1908736,69
4358,475,23,7,0.0982826402,0.90171736,1373.435207,1527.677586,2374.99587,2802.376842,4833,94.50527962,9666,-2231296,243200,-1988096,69
4902,502,23,7,0.0928941525,0.907105848,1539.147367,1693.430283,2659.21277,3125.197211,5404,102.8353949,10808,-2509824,257024,-2252800,69
354,45,23,7,0.112781955,0.887218045,113.8045819,122.980689,197.0141243,223.4888889,399,6.458400777,798,-181248,23040,-158208,69
5869,583,21,9,0.0903595784,0.909640422,1845.84706,2007.309242,3202.793321,3465.152659,6452,655.0253807,12904,-3004928,298496,-2706432,69
6378,647,21,9,0.0920996441,0.907900356,2006.799685,2218.266262,3495.497962,3685.531685,7025,136.1170316,14050,-3265536,331264,-2934272,69
8878,984,21,9,0.0997769215,0.900223078,2817.278526,2946.564689,4829.695202,5850.019309,9862,562.8995434,19724,-4545536,503808,-4041728,69
6288,647,21,9,0.093294881,0.906705119,1991.086039,2091.72269,3445.102735,3690.531685,6935,125.316227,13870,-3219456,331264,-2888192,69
6320,614,21,9,0.088549178,0.911450822,1980.22339,2188.534673,3438.737184,3763.560261,6934,183.4876952,13868,-3235840,314368,-2921472,69
6399,589,21,9,0.0842873497,0.91571265,2003.386076,2123.442884,3458.565245,3884.901528,6988,187.3960847,13976,-3276288,301568,-2974720,69
6424,600,21,9,0.0854214123,0.914578588,2011.434654,2149.411176,3473.277086,3932.446667,7024,185.3787279,14048,-3289088,307200,-2981888,69
6509,662,21,9,0.0923162739,0.907683726,2053.628937,2194.96363,3550.423414,3935.800604,7171,140.4151165,14342,-3332608,338944,-2993664,69
6402,664,21,9,0.0939711294,0.906028871,2019.977081,2204.790943,3506.523274,3793.597892,7066,145.6006594,14132,-3277824,339968,-2937856,69
6368,663,21,9,0.0942966861,0.905703314,2016.126813,2141.255154,3491.513505,3751.188537,7031,132.2610986,14062,-3260416,339456,-2920960,69
8199,1046,21,9,0.113142239,0.886857761,2645.967706,2685.559686,4511.485791,5497.096558,9245,165.621641,18490,-4197888,535552,-3662336,69
6451,616,21,9,0.0871656997,0.9128343,2024.867961,2156.489573,3497.68408,3914.314935,7067,126.1964286,14134,-3302912,315392,-2987520,69
6354,651,21,9,0.0929336188,0.907066381,1998.387664,2213.823552,3469.001889,3834.834101,7005,145.6946755,14010,-3253248,333312,-2919936,69
6415,647,21,9,0.0916171056,0.908382894,2018.871274,2224.57201,3527.298675,3573.156105,7062,181.4957594,14124,-3284480,331264,-2953216,69
6414,597,21,9,0.0851519042,0.914848096,2014.7193,2073.443118,3466.644839,3928.820771,7011,127.9613068,14022,-3283968,305664,-2978304,69
6373,642,21,9,0.0915181753,0.908481825,2008.951287,2164.096807,3484.005649,3746.186916,7015,193.9988938,14030,-3262976,328704,-2934272,69
6351,613,21,9,0.0880241241,0.911975876,1998.447776,2126.346003,3471.69186,3594.477977,6964,166.2449272,13928,-3251712,313856,-2937856,69
6355,687,21,9,0.0975575121,0.902442488,2019.80096,2120.186446,3484.976082,3859.359534,7042,145.1360264,14084,-3253760,351744,-2902016,69
8711,1118,21,9,0.11374504,0.88625496,2778.035252,3114.162241,4797.258639,5832.392665,9829,453.7857802,19658,-4460032,572416,-3887616,69
3031,214,21,9,0.0659476117,0.934052388,929.9891648,991.1596758,1641.547014,1360.308411,3245,48.86312302,6490,-1551872,109568,-1442304,69
8696,1112,21,9,0.113376835,0.886623165,2838.493001,2688.886604,4822.083947,5549.005396,9808,334.0599455,19616,-4452352,569344,-3883008,69
8637,1205,21,9,0.122434465,0.877565535,2809.258099,2836.067278,4771.338543,5997.80249,9842,623.3058898,19684,-4422144,616960,-3805184,69
6125,619,21,9,0.0917852906,0.908214709,1938.640779,2026.021297,3372.019918,3377.250404,6744,118.2742897,13488,-3136000,316928,-2819072,69
2563,226,21,9,0.0810326282,0.918967372,791.9021776,878.8300384,1423.686305,1069.676991,2789,48.82703081,5578,-1312256,115712,-1196544,69
7035,681,21,9,0.0882581649,0.911741835,2204.113462,2431.747843,3827.178394,4182.064611,7716,137.5646283,15432,-3601920,348672,-3253248,69
3008,255,21,9,0.0781489427,0.921851057,936.1934292,916.6907636,1665.992021,1231.027451,3263,56.31687953,6526,-1540096,130560,-1409536,69
6081,524,21,9,0.079333838,0.920666162,1898.752464,1969.94553,3276.111001,3615.045802,6605,156.9256355,13210,-3113472,268288,-2845184,69
6187,630,21,9,0.0924160188,0.907583981,1960.714247,2030.563666,3393.175853,3564.403175,6817,128.6226415,13634,-3167744,322560,-2845184,69
6999,668,21,9,0.0871266467,0.912873353,2187.576397,2421.127915,3791.077725,4283.72006,7667,147.5274197,15334,-3583488,342016,-3241472,69
6114,596,21,9,0.0888226528,0.911177347,1931.848308,1940.773807,3314.911187,3771.875839,6710,131.6718995,13420,-3130368,305152,-2825216,69
6905,627,21,9,0.0832448221,0.916755178,2154.922661,2340.648854,3730.353802,4164.569378,7532,207.5502893,15064,-3535360,321024,-3214336,69
7073,643,21,9,0.0833333333,0.916666667,2205.738659,2405.575531,3816.599321,4319.407465,7716,175.5232029,15432,-3621376,329216,-3292160,69
6994,679,21,9,0.0884921152,0.911507885,2194.445825,2393.487159,3806.089648,4155.39028,7673,136.4331437,15346,-3580928,347648,-3233280,69
8675,1170,21,9,0.118842052,0.881157948,2836.380046,2811.906274,4842.223746,5521.917949,9845,482.8347229,19690,-4441600,599040,-3842560,69
6143,657,21,9,0.0966176471,0.903382353,1944.559548,2111.286058,3373.757285,3650.546423,6800,127.603678,13600,-3145216,336384,-2808832,69
6143,648,21,9,0.0954204094,0.904579591,1953.374153,2020.51816,3381.442292,3534.006173,6791,120.2159674,13582,-3145216,331776,-2813440,69
6140,579,21,9,0.0861735377,0.913826462,1935.058404,1951.510504,3326.194625,3718.488774,6719,186.1734553,13438,-3143680,296448,-2847232,69
6381,620,21,9,0.0885587773,0.911441223,1991.843842,2252.032408,3457.728569,3946.346774,7001,133.0482706,14002,-3267072,317440,-2949632,69
6097,613,21,9,0.0913561848,0.908643815,1930.428035,1996.298343,3341.949975,3490.270799,6710,178.5049215,13420,-3121664,313856,-2807808,69
3439,237,21,9,0.0644722524,0.935527748,1054.462422,1135.881798,1852.121838,1640.839662,3676,58.57233907,7352,-1760768,121344,-1639424,69
9206,737,21,9,0.0741224982,0.925877502,2850.811331,3103.119279,4968.771997,5012.321574,9943,476.882494,19886,-4713472,377344,-4336128,69
9277,668,21,9,0.0671694319,0.932830568,2854.786766,3081.277564,4961.601703,5131.296407,9945,176.4549326,19890,-4749824,342016,-4407808,69
9148,698,21,9,0.0708917327,0.929108267,2825.864441,3039.223033,4905.132488,5164.224928,9846,175.414217,19692,-4683776,357376,-4326400,69
9230,713,21,9,0.0717087398,0.92829126,2853.764206,3060.069838,4948.506501,5276.130435,9943,189.7519084,19886,-4725760,365056,-4360704,69
9217,729,21,9,0.0732957973,0.926704203,2850.535779,3120.019397,4976.190409,4939.484225,9946,185.1107389,19892,-4719104,373248,-4345856,69
9205,727,21,9,0.0731977447,0.926802255,2858.595314,2934.900298,5002.554699,4509.988996,9932,995.1903808,19864,-4712960,372224,-4340736,69
9231,711,21,9,0.0715147858,0.928485214,2846.423122,3153.735507,4956.414581,5167.355837,9942,380.0458716,19884,-4726272,364032,-4362240,69
8948,945,21,9,0.0955220863,0.904477914,2843.573999,2958.55331,4921.173447,5191.546032,9893,487.0999508,19786,-4581376,483840,-4097536,69
9244,700,21,9,0.0703942076,0.929605792,2860.486307,3000.26294,4976.513306,4919.501429,9944,877.6699029,19888,-4732928,358400,-4374528,69
9167,659,21,9,0.0670669652,0.932933035,2827.809488,2938.13706,4891.57707,5218.45827,9826,201.2287528,19652,-4693504,337408,-4356096,69
9229,714,21,9,0.0718093131,0.928190687,2857.147559,3034.942274,4969.425832,5005.273109,9943,606.6503966,19886,-4725248,365568,-4359680,69
8754,671,21,9,0.071193634,0.928806366,2705.704718,2900.334231,4695.414439,4942.424739,9425,185.860777,18850,-4482048,343552,-4138496,69
9158,693,21,9,0.070348188,0.929651812,2824.214506,3080.422771,4908.090959,5162.66811,9851,186.0434372,19702,-4688896,354816,-4334080,69
9215,728,21,9,0.0732173388,0.926782661,2848.967474,3124.442623,4961.087683,5110.127747,9943,245.0825733,19886,-4718080,372736,-4345344,69
9219,711,21,9,0.0716012085,0.928398792,2847.999876,3088.689488,4948.697473,5183.365682,9930,809.2909535,19860,-4720128,364032,-4356096,69
9194,750,21,9,0.0754223652,0.924577635,2846.035971,3155.25345,4966.94007,5040.657333,9944,928.4780579,19888,-4707328,384000,-4323328,69
9242,703,21,9,0.0706887883,0.929311212,2859.421126,3017.12041,4969.974681,5012.772404,9945,958.0924855,19890,-4731904,359936,-4371968,69
9201,732,21,9,0.0736937481,0.926306252,2857.334372,2969.643856,4994.424845,4622.278689,9933,901.3611615,19866,-4710912,374784,-4336128,69
545,54,21,9,0.0901502504,0.90984975,171.4372259,183.8728136,303.3155963,266.537037,599,9.034690799,1198,-279040,27648,-251392,69
9171,757,21,9,0.0762489927,0.923751007,2845.872767,3097.993303,4958.018537,5043.022457,9928,672.1733243,19856,-4695552,387584,-4307968,69
4402,430,23,7,0.0889900662,0.911009934,1377.74691,1495.17826,2375.182871,2839.472093,4832,134.1104635,9664,-2253824,220160,-2033664,69
8818,1070,23,7,0.108211974,0.891788026,2832.448509,2984.905495,4885.205375,5433.154206,9888,294.636472,19776,-4514816,547840,-3966976,69
4386,413,23,7,0.0860595957,0.913940404,1372.200722,1479.751316,2369.516872,2723.726392,4799,130.0542005,9598,-2245632,211456,-2034176,69
4941,457,23,7,0.0846609856,0.915339014,1536.788762,1692.512809,2652.477434,3207.899344,5398,103.8876059,10796,-2529792,233984,-2295808,69
4417,449,22,8,0.0922729141,0.907727086,1389.030582,1501.585001,2396.133122,2801.093541,4866,125.8014478,9732,-2261504,229888,-2031616,69
4412,452,22,8,0.0929276316,0.907072368,1381.171539,1553.861361,2391.00612,2837.524336,4864,86.18001417,9728,-2258944,231424,-2027520,69
4435,468,23,7,0.0954517642,0.904548236,1390.707691,1554.738943,2402.628861,2919.865385,4903,104.8097478,9806,-2270720,239616,-2031104,69
8746,1105,22,8,0.112171353,0.887828647,2817.010731,2832.343774,4792.253144,5984.597285,9851,624.6670894,19702,-4477952,565760,-3912192,69
4543,493,22,8,0.0978951549,0.902104845,1432.108948,1589.717873,2476.986353,2901.048682,5036,93.71045776,10072,-2326016,252416,-2073600,69
4467,461,23,7,0.0935470779,0.906452922,1396.606264,1585.070709,2418.293262,2912.234273,4928,106.2526951,9856,-2287104,236032,-2051072,69
4381,439,22,8,0.0910788382,0.908921162,1374.618315,1524.169075,2384.065282,2674.305239,4820,107.3257626,9640,-2243072,224768,-2018304,69
4342,417,23,7,0.0876234503,0.91237655,1354.051368,1485.017151,2334.766467,2850.992806,4759,84.61948791,9518,-2223104,213504,-2009600,69
4963,489,23,7,0.0896918562,0.910308144,1553.235737,1711.138727,2684.093089,3156.899796,5452,97.88150808,10904,-2541056,250368,-2290688,69
4420,463,22,8,0.094818759,0.905181241,1385.989158,1568.406433,2402.48371,2819.239741,4883,136.6256295,9766,-2263040,237056,-2025984,69
4914,452,22,8,0.0842340663,0.915765934,1532.452263,1693.682099,2657.636956,2964.674779,5366,129.5822265,10732,-2515968,231424,-2284544,69
4909,481,22,8,0.0892393321,0.910760668,1541.148239,1648.040749,2656.593604,3092.571726,5390,132.5627152,10780,-2513408,246272,-2267136,69
4482,476,23,7,0.0960064542,0.903993546,1409.58989,1557.811025,2434.214636,2905.905462,4958,91.72987974,9916,-2294784,243712,-2051072,69
4342,384,23,7,0.0812526449,0.918747355,1349.70069,1476.503802,2333.105942,2707.174479,4726,129.2669584,9452,-2223104,196608,-2026496,69
4421,472,22,8,0.0964643368,0.903535663,1386.103808,1602.623306,2412.092965,2773.957627,4893,99.5118975,9786,-2263552,241664,-2021888,69
526,91,22,8,0.147487844,0.852512156,180.2427308,162.7944052,304.4562738,335.2637363,617,9.890990702,1234,-269312,46592,-222720,69
6831,622,21,9,0.0834563263,0.916543674,2142.751629,2243.851402,3720.001757,3803.856913,7453,150.7178969,14906,-3497472,318464,-3179008,69
6635,644,21,9,0.0884736914,0.911526309,2088.587649,2227.693985,3639.917257,3640.852484,7279,158.0673181,14558,-3397120,329728,-3067392,69
6799,640,21,9,0.086033069,0.913966931,2136.453893,2227.392228,3685.040888,4091.385938,7439,133.7709045,14878,-3481088,327680,-3153408,69
6739,652,21,9,0.0882153971,0.911784603,2117.3904,2272.018682,3666.452589,4001.398773,7391,139.1902072,14782,-3450368,333824,-3116544,69
9002,901,21,9,0.0909825305,0.909017469,2830.847223,3110.059145,4923.995779,5231.793563,9903,617.0093458,19806,-4609024,461312,-4147712,69
6864,718,21,9,0.0946979689,0.905302031,2174.763532,2304.335394,3766.438374,4031.086351,7582,153.8555195,15164,-3514368,367616,-3146752,69
6671,658,21,9,0.0897803247,0.910219675,2093.901029,2316.517166,3646.114076,3856.471125,7329,150.6784539,14658,-3415552,336896,-3078656,69
6700,651,21,9,0.0885593797,0.91144062,2097.574275,2337.696201,3646.484478,3979.769585,7351,139.276241,14702,-3430400,333312,-3097088,69
6848,649,21,9,0.0865679605,0.913432039,2153.473051,2255.315974,3722.454877,4029.093991,7497,140.8151766,14994,-3506176,332288,-3173888,69
6642,618,21,9,0.0851239669,0.914876033,2092.204297,2088.136622,3669.597109,3210.300971,7260,166.1327231,14520,-3400704,316416,-3084288,69
6856,679,21,9,0.0901128069,0.909887193,2158.764711,2329.830116,3754.302655,3906.30486,7535,196.7362924,15070,-3510272,347648,-3162624,69
6689,681,21,9,0.0924016282,0.907598372,2111.317309,2278.370995,3675.470175,3784.016153,7370,167.0822943,14740,-3424768,348672,-3076096,69
6743,642,21,9,0.0869329722,0.913067028,2121.723547,2235.135689,3688.794009,3737.176012,7385,195.8366481,14770,-3452416,328704,-3123712,69
6650,611,21,9,0.084148189,0.915851811,2086.962298,2185.955202,3615.830075,3796.106383,7261,192.3443709,14522,-3404800,312832,-3091968,69
6705,579,21,9,0.0794892916,0.920510708,2095.980272,2171.373738,3627.285906,3818.683938,7284,169.1200371,14568,-3432960,296448,-3136512,69
6815,693,21,9,0.092301545,0.907698455,2149.393985,2324.317011,3731.110932,3984.50938,7508,155.3486447,15016,-3489280,354816,-3134464,69
9121,794,21,9,0.0800806858,0.919919314,2859.417879,2871.60557,4927.904506,5303.719144,9915,486.5063788,19830,-4669952,406528,-4263424,69
6703,637,21,9,0.0867847411,0.913215259,2115.785675,2150.234653,3664.897061,3729.458399,7340,177.9393939,14680,-3431936,326144,-3105792,69
6751,623,21,9,0.084486032,0.915513968,2123.027788,2185.904454,3677.038217,3800.866774,7374,188.2082695,14748,-3456512,318976,-3137536,69
6742,657,21,9,0.0887957832,0.911204217,2129.137987,2204.058114,3697.918718,3721.357686,7399,162.3655914,14798,-3451904,336384,-3115520,69
9314,637,21,9,0.064013667,0.935986333,2858.224715,3018.81076,5014.792892,4408.783359,9951,488.7524558,19902,-4768768,326144,-4442624,69
9351,597,21,9,0.0600120627,0.939987937,2850.285717,3179.480206,4989.747193,4735.678392,9948,716.1987041,19896,-4787712,305664,-4482048,69
9317,634,21,9,0.0637121897,0.93628781,2853.140294,3117.777004,5003.089192,4577.908517,9951,703.748232,19902,-4770304,324608,-4445696,69
9291,658,21,9,0.0661373002,0.9338627,2844.245955,3207.958876,5005.608976,4542.799392,9949,926.3500931,19898,-4756992,336896,-4420096,69
9295,657,21,9,0.066016881,0.933983119,2849.620216,3173.518587,4994.132437,4727.042618,9952,1316.402116,19904,-4759040,336384,-4422656,69
9273,674,21,9,0.0677591234,0.932240877,2856.825413,2969.922616,5027.330422,4240.271513,9947,645.0713359,19894,-4747776,345088,-4402688,69
9271,675,21,9,0.067866479,0.932133521,2857.699602,2974.887706,5020.810053,4323.705185,9946,879.3987622,19892,-4746752,345600,-4401152,69
9313,634,21,9,0.0637378104,0.93626219,2846.390734,3207.133243,4990.717921,4728.425868,9947,1188.410992,19894,-4768256,324608,-4443648,69
8743,1085,21,9,0.11039886,0.88960114,2810.380395,2879.010555,4798.843989,5846.463594,9828,407.4626866,19656,-4476416,555520,-3920896,69
9365,585,21,9,0.0587939698,0.94120603,2842.190672,3314.288622,4966.564976,5118.536752,9950,853.3447684,19900,-4794880,299520,-4495360,69
9342,612,21,9,0.061482821,0.938517179,2866.413768,2945.298266,5005.91854,4543.699346,9954,1230.407911,19908,-4783104,313344,-4469760,69
9270,676,21,9,0.0679670219,0.932032978,2864.539414,2925.40902,5005.493528,4534.772189,9946,618.9172371,19892,-4746240,346112,-4400128,69
9230,715,21,9,0.0718954248,0.928104575,2852.398754,3072.100848,5003.690466,4576.813986,9945,984.6534653,19890,-4725760,366080,-4359680,69
9023,880,21,9,0.088861961,0.911138039,2856.123823,2857.658592,4914.748864,5333.951136,9903,594.7747748,19806,-4619776,450560,-4169216,69
9284,666,21,9,0.0669346734,0.933065327,2861.297172,2974.785641,5012.276605,4462.836336,9950,1444.121916,19900,-4753408,340992,-4412416,69
9352,601,21,9,0.0603838039,0.939616196,2860.146915,3057.773265,4993.276732,4723.72213,9953,753.4443603,19906,-4788224,307712,-4480512,69
9325,623,21,9,0.0626256534,0.937374347,2859.731525,3017.727206,5001.202574,4574.81862,9948,1229.666255,19896,-4774400,318976,-4455424,69
9300,645,21,9,0.0648567119,0.935143288,2868.830383,2892.645692,4987.014301,4770.933333,9945,400.5235602,19890,-4761600,330240,-4431360,69
9316,629,21,9,0.0632478632,0.936752137,2844.769055,3232.131678,4968.319343,5042.324324,9945,827.3710483,19890,-4769792,322048,-4447744,69
6090,541,21,9,0.0815864877,0.918413512,1904.381455,1960.493895,3357.958292,2843.678373,6631,119.326975,13262,-3118080,276992,-2841088,69
4719,403,21,9,0.078680203,0.921319797,1464.673925,1591.964755,2531.759059,2909.756824,5122,131.0309542,10244,-2416128,206336,-2209792,69
4691,461,21,9,0.0894798137,0.910520186,1466.557014,1650.540566,2545.435515,2892.603037,5152,89.02712977,10304,-2401792,236032,-2165760,69
4664,403,21,9,0.0795342412,0.920465759,1449.244573,1556.365382,2499.689966,2931.076923,5067,102.2397094,10134,-2387968,206336,-2181632,69
8497,1349,21,9,0.137009953,0.862990047,2839.741618,2717.305559,4792.720137,5747.248332,9846,442.3180593,19692,-4350464,690688,-3659776,69
4673,439,21,9,0.0858763693,0.914123631,1457.450856,1616.960775,2523.723946,2905.389522,5112,116.0236042,10224,-2392576,224768,-2167808,69
4820,506,21,9,0.0950056327,0.904994367,1511.717443,1722.40513,2625.395643,3026.470356,5326,102.0893234,10652,-2467840,259072,-2208768,69
4783,505,21,9,0.0954992436,0.904500756,1497.765464,1691.972428,2590.337236,3157.491089,5288,92.77192982,10576,-2448896,258560,-2190336,69
4741,480,21,9,0.0919364106,0.908063589,1485.73683,1659.311874,2573.394642,2982.43125,5221,98.82642438,10442,-2427392,245760,-2181632,69
4772,464,21,9,0.0886172651,0.911382735,1490.186922,1681.705311,2587.082565,2941.612069,5236,95.04447268,10472,-2443264,237568,-2205696,69
4756,452,21,9,0.0867895545,0.913210445,1484.732021,1635.816267,2566.83852,3000.778761,5208,91.65786695,10416,-2435072,231424,-2203648,69
4846,481,21,9,0.090294725,0.909705275,1514.282205,1726.146268,2632.965745,2976.665281,5327,101.6021362,10654,-2481152,246272,-2234880,69
4764,475,21,9,0.0906661577,0.909333842,1481.35241,1719.865803,2571.462427,3106.806316,5239,95.49763033,10478,-2439168,243200,-2195968,69
4666,467,21,9,0.0909799338,0.909020066,1464.885912,1596.672534,2530.870767,2927.982869,5133,108.9577584,10266,-2388992,239104,-2149888,69
4757,487,21,9,0.0928680397,0.90713196,1492.740013,1670.978258,2588.96153,2950.102669,5244,98.51587451,10488,-2435584,249344,-2186240,69
4779,439,21,9,0.0841318513,0.915868149,1491.585029,1628.965835,2582.27851,2905.835991,5218,142.2961549,10436,-2446848,224768,-2222080,69
4864,476,21,9,0.0891385768,0.910861423,1518.62002,1698.193993,2627.833882,3106.483193,5340,112.2792262,10680,-2490368,243712,-2246656,69
4694,420,21,9,0.0821274932,0.917872507,1464.328775,1564.477297,2527.222199,2895.890476,5114,123.6460348,10228,-2403328,215040,-2188288,69
4713,476,21,9,0.0917325111,0.908267489,1471.405989,1704.724404,2561.979206,2921.947479,5189,97.75810098,10378,-2413056,243712,-2169344,69
4762,438,21,9,0.0842307692,0.915769231,1478.006252,1689.502909,2566.724066,2967.716895,5200,128.968254,10400,-2438144,224256,-2213888,69
204,27,21,9,0.116883117,0.883116883,64.04834355,83.12388494,117.4705882,104.8888889,231,3.738469008,462,-104448,13824,-90624,69
6303,623,21,9,0.0899509096,0.91004909,1996.253377,2021.814025,3445.742186,3643.158909,6926,187.1891892,13852,-3227136,318976,-2908160,69
6217,615,21,9,0.0900175644,0.909982436,1956.125249,2101.256776,3384.654174,3738.427642,6832,187.8987899,13664,-3183104,314880,-2868224,69
5105,463,21,9,0.0831537356,0.916846264,1595.188326,1734.713487,2789.650343,2727.712743,5568,340.3422983,11136,-2613760,237056,-2376704,69
6302,629,21,9,0.0907516953,0.909248305,1985.355564,2119.493839,3431.93875,3807.262321,6931,135.6360078,13862,-3226624,322048,-2904576,69
6280,638,21,9,0.0922231859,0.907776814,1987.99144,2051.966386,3424.177389,3807.189655,6918,128.6591036,13836,-3215360,326656,-2888704,69
3027,224,21,9,0.0689018763,0.931098124,935.9034919,884.7503431,1654.855302,1236.066964,3251,56.79594689,6502,-1549824,114688,-1435136,69
6176,610,21,9,0.089890952,0.910109048,1942.722425,2107.238197,3375.1216,3579.57377,6786,143.6494496,13572,-3162112,312320,-2849792,69
6312,614,21,9,0.0886514583,0.911348542,1983.240404,2135.49768,3434.543409,3761.177524,6926,206.6845718,13852,-3231744,314368,-2917376,69
6248,605,21,9,0.088282504,0.911717496,1965.998361,2090.153527,3407.255442,3630.907438,6853,183.7265416,13706,-3198976,309760,-2889216,69
6373,591,21,9,0.0848650201,0.91513498,1995.643502,2140.037905,3454.975522,3779.307953,6964,173.3632064,13928,-3262976,302592,-2960384,69
6397,655,21,9,0.0928814521,0.907118548,2015.793323,2180.830248,3485.430514,3927.601527,7052,130.762099,14104,-3275264,335360,-2939904,69
6296,618,21,9,0.0893838588,0.910616141,1986.770693,2060.627909,3426.740629,3770.867314,6914,142.9693962,13828,-3223552,316416,-2907136,69
5632,523,21,9,0.0849715678,0.915028432,1751.024241,1989.763433,3040.64027,3480.313576,6155,117.708931,12310,-2883584,267776,-2615808,69
8846,1015,21,9,0.102930737,0.897069263,2888.755465,2444.33433,4914.654307,5073.457143,9861,616.6979362,19722,-4529152,519680,-4009472,69
6319,623,21,9,0.0897435897,0.91025641,1993.912186,2064.597155,3433.669568,3855.208668,6942,145.199749,13884,-3235328,318976,-2916352,69
6300,612,21,9,0.0885416667,0.911458333,1983.813418,2088.232042,3428.365079,3746.124183,6912,129.3897417,13824,-3225600,313344,-2912256,69
8991,912,21,9,0.0920933051,0.907906695,2852.066615,2900.719462,4916.547881,5301.506579,9903,670.4807041,19806,-4603392,466944,-4136448,69
8968,917,21,9,0.0927668184,0.907233182,2845.998731,2893.697403,4900.502453,5358.613959,9885,971.021611,19770,-4591616,469504,-4122112,69
6590,653,21,9,0.0901560127,0.909843987,2073.720758,2235.459199,3592.806222,3916.620214,7243,131.4519056,14486,-3374080,334336,-3039744,69
324,28,21,9,0.0795454545,0.920454545,97.49458904,138.2245797,178.7067901,150.9642857,352,13.33333333,704,-165888,14336,-151552,69
505,41,24,6,0.0750915751,0.924908425,153.6710998,198.6816064,275.2376238,252.097561,546,94.62738302,1092,-258560,20992,-237568,70
504,45,23,7,0.0819672131,0.918032787,154.2750025,196.8541805,277.8412698,243.1777778,549,130.7142857,1098,-258048,23040,-235008,70
90,22,23,7,0.196428571,0.803571429,33.026469,25.44285446,59.68888889,43.45454545,112,3.388804841,224,-46080,11264,-34816,70
504,44,24,6,0.0802919708,0.919708029,153.6609272,202.8754592,275.140873,267.1590909,548,131.7307692,1096,-258048,22528,-235520,70
510,40,24,6,0.0727272727,0.927272727,154.9446863,201.2782139,275.454902,276.075,550,127.6102088,1100,-261120,20480,-240640,70
509,50,24,6,0.0894454383,0.910554562,155.4468056,212.3380286,280.6836935,273.04,559,9.725121781,1118,-260608,25600,-235008,70
509,42,25,5,0.0762250454,0.923774955,154.4454126,205.2181255,273.8762279,301.7380952,551,103.1835206,1102,-260608,21504,-239104,70
537,49,23,7,0.0836177474,0.916382253,164.1619816,210.5574719,297.9124767,245.1428571,586,85.42274052,1172,-274944,25088,-249856,70
504,42,24,6,0.0769230769,0.923076923,153.566965,199.5893346,274.406746,262.6190476,546,126.6821346,1092,-258048,21504,-236544,70
515,50,23,7,0.0884955752,0.911504425,157.5587397,211.547276,284.1553398,271.1,565,9.851787271,1130,-263680,25600,-238080,70
506,48,23,7,0.0866425993,0.913357401,154.7055331,206.6101643,278.7905138,263.8958333,554,106.5384615,1108,-259072,24576,-234496,70
492,45,23,7,0.0837988827,0.916201117,152.8280496,175.0553126,271.4105691,242.6444444,537,84.83412322,1074,-251904,23040,-228864,70
500,46,24,6,0.0842490842,0.915750916,152.6457166,203.0615624,275.198,255.0434783,546,147.5675676,1092,-256000,23552,-232448,70
527,46,22,8,0.0802792321,0.919720768,160.8700837,209.4295531,288.8197343,266.1521739,573,84.01759531,1146,-269824,23552,-246272,70
515,52,22,8,0.0917107584,0.908289242,159.1577903,168.2878583,294.9398058,175.6538462,567,112.7236581,1134,-263680,26624,-237056,70
534,49,23,7,0.0840480274,0.915951973,162.4508339,221.9382791,293.0430712,280.6326531,583,39.12751678,1166,-273408,25088,-248320,70
494,46,24,6,0.0851851852,0.914814815,151.2556198,196.6326507,273.1761134,241.7608696,540,60.40268456,1080,-252928,23552,-229376,70
507,41,24,6,0.0748175182,0.925182482,154.5695597,197.1592091,275.5147929,261.9512195,548,122.3214286,1096,-259584,20992,-238592,70
562,68,23,7,0.107936508,0.892063492,173.8038336,238.1259008,316.4359431,307.7647059,630,114.5454545,1260,-287744,34816,-252928,70
501,43,25,5,0.0790441176,0.920955882,152.7623087,200.1119887,273.1017964,265.4883721,544,104.4145873,1088,-256512,22016,-234496,70
536,42,24,6,0.0726643599,0.92733564,162.5990404,212.9919742,288.0597015,307.8809524,578,208.6642599,1156,-274432,21504,-252928,70
43,16,23,7,0.271186441,0.728813559,16.92780458,17.28393401,30.23255814,29.375,59,2.880859375,118,-22016,8192,-13824,70
541,42,23,7,0.0720411664,0.927958834,165.7622214,194.9736188,294.6099815,258.3809524,583,203.1358885,1166,-276992,21504,-255488,70
538,44,24,6,0.0756013746,0.924398625,163.0168131,219.937059,292.105948,284.0909091,582,110.2272727,1164,-275456,22528,-252928,70
539,41,23,7,0.0706896552,0.929310345,164.586821,192.905842,294.6716141,235.6585366,580,118.3673469,1160,-275968,20992,-254976,70
534,40,24,6,0.0696864111,0.930313589,161.3854019,215.1491213,287.3558052,289.425,574,105.7090239,1148,-273408,20480,-252928,70
538,42,24,6,0.0724137931,0.927586207,163.3076801,213.2337459,290.0557621,296.1904762,580,150.2590674,1160,-275456,21504,-253952,70
548,45,23,7,0.0758853288,0.924114671,165.8707274,225.929929,297.6551095,289.0222222,593,77.4151436,1186,-280576,23040,-257536,70
533,39,24,6,0.0681818182,0.931818182,161.4796399,208.1799909,285.5422139,299.5897436,572,116.0243408,1144,-272896,19968,-252928,70
531,38,24,6,0.0667838313,0.933216169,160.9175951,205.2507621,285.3163842,280.5789474,569,89.32496075,1138,-271872,19456,-252416,70
532,42,22,8,0.0731707317,0.926829268,161.3790658,212.8696771,287.9887218,281.3095238,574,146.8030691,1148,-272384,21504,-250880,70
539,44,23,7,0.0754716981,0.924528302,163.2795411,220.6906514,291.9183673,293,583,149.8714653,1166,-275968,22528,-253440,70
557,45,23,7,0.0747508306,0.925249169,171.008423,198.2814859,305.5547576,251.3111111,602,121.8623482,1204,-285184,23040,-262144,70
542,51,23,7,0.0860033727,0.913996627,164.9813774,225.9123193,295.1402214,316.7647059,593,10.40533427,1186,-277504,26112,-251392,70
530,43,24,6,0.07504363,0.92495637,161.0045656,212.3209837,286.7924528,289.5581395,573,116.4634146,1146,-271360,22016,-249344,70
535,41,24,6,0.0711805556,0.928819444,163.7987133,192.8429653,290.9850467,256.0731707,576,92.90322581,1152,-273920,20992,-252928,70
528,47,24,6,0.0817391304,0.91826087,160.8434855,215.4796958,288.2575758,285.106383,575,89.56386293,1150,-270336,24064,-246272,70
529,40,23,7,0.0702987698,0.92970123,160.0982181,211.6700484,285.2362949,281.875,569,110.7003891,1138,-270848,20480,-250368,70
541,48,22,8,0.0814940577,0.918505942,166.3471264,202.917056,298.5009242,255.5416667,589,10.40268456,1178,-276992,24576,-252416,70
561,55,24,6,0.0892857143,0.910714286,173.8536339,209.4116828,312.6934046,265.7272727,616,85.91352859,1232,-287232,28160,-259072,70
496,44,22,8,0.0814814815,0.918518519,151.2312414,200.9883328,270.8024194,267.0909091,540,95.57522124,1080,-253952,22528,-231424,70
487,45,23,7,0.0845864662,0.915413534,148.9244639,196.9649966,266.8336756,262.8888889,532,135.7142857,1064,-249344,23040,-226304,70
499,45,23,7,0.0827205882,0.917279412,152.4131544,200.2234998,274.3226453,252.2888889,544,130.1435407,1088,-255488,23040,-232448,70
500,39,24,6,0.0723562152,0.927643785,151.9897831,195.9472215,269.562,275.6153846,539,101.5065913,1078,-256000,19968,-236032,70
497,42,24,6,0.0779220779,0.922077922,151.7606378,195.2694589,270.4285714,264.9285714,539,60.42600897,1078,-254464,21504,-232960,70
498,43,22,8,0.0794824399,0.92051756,151.6776332,201.0066877,270.6927711,274.5581395,541,120.7589286,1082,-254976,22016,-232960,70
501,41,23,7,0.0756457565,0.924354244,152.6479924,196.3417634,272.9401198,253.902439,542,71.22207622,1084,-256512,20992,-235520,70
487,37,24,6,0.070610687,0.929389313,149.3966175,171.6303041,264.5975359,234.8918919,524,110.5485232,1048,-249344,18944,-230400,70
496,44,22,8,0.0814814815,0.918518519,153.362702,173.0232213,275.2741935,216.6818182,540,129.1866029,1080,-253952,22528,-231424,70
499,38,24,6,0.0707635009,0.929236499,153.4024339,171.9704304,271.3226453,238.5,537,75.74047955,1074,-255488,19456,-236032,70
494,43,23,7,0.0800744879,0.919925512,150.3123463,200.9250861,270.0789474,256.6046512,537,145.1351351,1074,-252928,22016,-230912,70
522,61,22,8,0.104631218,0.895368782,160.9097883,221.5215979,291.1149425,299.5737705,583,54.08163265,1166,-267264,31232,-236032,70
500,41,24,6,0.0757855823,0.924214418,152.3316222,196.5032238,269.808,285.5365854,541,90.46822742,1082,-256000,20992,-235008,70
500,48,22,8,0.0875912409,0.912408759,153.039818,201.978262,277.31,245.2291667,548,87.96147673,1096,-256000,24576,-231424,70
496,40,24,6,0.0746268657,0.925373134,152.9193629,169.4458542,272.0846774,224.05,536,110.7438017,1072,-253952,20480,-233472,70
496,39,24,6,0.0728971963,0.927102804,150.6908709,195.1052246,266.6068548,285.7179487,535,96.57039711,1070,-253952,19968,-233984,70
515,56,22,8,0.0980735552,0.901926445,162.1072123,187.1151348,287.9436893,268.125,571,96.77966102,1142,-263680,28672,-235008,70
495,41,22,8,0.0764925373,0.923507463,152.8341257,168.627239,272.5151515,220.0243902,536,134.3358396,1072,-253440,20992,-232448,70
497,45,22,8,0.0830258303,0.91697417,151.725562,201.3494033,272.167002,264.1333333,542,51.81644359,1084,-254464,23040,-231424,70
356,40,23,7,0.101010101,0.898989899,108.9050204,154.2984426,198.2050562,201.125,396,6.431703752,792,-182272,20480,-161792,70
523,57,23,7,0.0982758621,0.901724138,161.8142981,211.8869075,291.5659656,280.7192982,580,86.30952381,1160,-267776,29184,-238592,70
478,42,23,7,0.0807692308,0.919230769,145.3894421,195.8496925,259.8786611,267.5714286,520,91.3884007,1040,-244736,21504,-223232,70
508,51,23,7,0.091234347,0.908765653,156.5308462,202.1675526,282.1161417,258.9215686,559,100,1118,-260096,26112,-233984,70
483,46,23,7,0.0869565217,0.913043478,148.6514854,188.5632989,267.2339545,241.5434783,529,117.5555556,1058,-247296,23552,-223744,70
477,45,23,7,0.0862068966,0.913793103,145.8799306,194.0636958,262.6457023,249.3555556,522,97.20670391,1044,-244224,23040,-221184,70
482,40,23,7,0.0766283525,0.923371648,148.0086064,177.5016743,263.8174274,233.575,522,129.528536,1044,-246784,20480,-226304,70
469,37,23,7,0.0731225296,0.92687747,143.7815295,172.0201205,254.4328358,241.6756757,506,98.63547758,1012,-240128,18944,-221184,70
477,44,23,7,0.084452975,0.915547025,145.5166251,195.6187154,261.3689727,257,521,97.74859287,1042,-244224,22528,-221696,70
473,46,23,7,0.0886319846,0.911368015,144.8488084,193.6763666,259.7885835,262.173913,519,9.371614301,1038,-242176,23552,-218624,70
470,42,23,7,0.08203125,0.91796875,144.0502664,184.5288663,257.0765957,250.047619,512,111.0629067,1024,-240640,21504,-219136,70
493,43,23,7,0.0802238806,0.919776119,152.4058661,150.4909147,276.643002,175.1395349,536,104.8923679,1072,-252416,22016,-230400,70
503,54,23,7,0.0969479354,0.903052065,155.7251962,201.6174412,280.2166998,267.6666667,557,92.67886855,1114,-257536,27648,-229888,70
475,46,23,7,0.0882917466,0.911708253,145.8688109,190.3385962,262.4673684,245.8478261,521,100.1923077,1042,-243200,23552,-219648,70
469,41,23,7,0.0803921569,0.919607843,143.20953,187.1101881,255.3816631,256.8536585,510,45.65801253,1020,-240128,20992,-219136,70
473,44,23,7,0.085106383,0.914893617,146.6028844,172.0718831,261.9069767,227.75,517,129.25,1034,-242176,22528,-219648,70
474,43,23,7,0.083172147,0.916827853,147.1895285,165.1818376,262.5864979,219.4651163,517,95.56377079,1034,-242688,22016,-220672,70
480,45,22,8,0.0857142857,0.914285714,147.0913831,192.3915709,264.1708333,250.5111111,525,97.4025974,1050,-245760,23040,-222720,70
493,46,23,7,0.0853432282,0.914656772,151.0208301,196.5610484,272.198783,246.4347826,539,101.1257036,1078,-252416,23552,-228864,70
337,43,23,7,0.113157895,0.886842105,103.5472883,148.3983246,188.462908,206.4651163,380,5.706562547,760,-172544,22016,-150528,70
478,40,23,7,0.0772200772,0.922779923,145.9085945,187.4391568,259.1025105,264.25,518,65.56962025,1036,-244736,20480,-224256,70
520,46,23,7,0.0812720848,0.918727915,158.9129129,207.357974,283.2269231,286.5869565,566,90.12738854,1132,-266240,23552,-242688,70
504,37,23,7,0.0683918669,0.931608133,153.3251086,190.1044655,272.1349206,255.5405405,541,113.1799163,1082,-258048,18944,-239104,70
513,45,24,6,0.0806451613,0.919354839,157.0033874,201.2165838,280.8109162,264.5555556,558,41.73522812,1116,-262656,23040,-239616,70
510,48,22,8,0.0860215054,0.913978495,156.4429312,203.7652474,280.2647059,271.375,558,77.0718232,1116,-261120,24576,-236544,70
509,40,23,7,0.072859745,0.927140255,154.7643157,199.2285606,273.8153242,290.075,549,110.4627767,1098,-260608,20480,-240128,70
517,48,23,7,0.0849557522,0.915044248,158.5116689,206.1290712,282.7040619,286.1875,565,108.0305927,1130,-264704,24576,-240128,70
515,45,23,7,0.0803571429,0.919642857,157.7480543,200.5367686,281.7145631,266.6,560,98.93992933,1120,-263680,23040,-240640,70
518,43,23,7,0.0766488414,0.923351159,157.7745033,205.5939094,281.4092664,276.0697674,561,112.6506024,1122,-265216,22016,-243200,70
514,44,23,7,0.0788530466,0.921146953,157.6149304,195.8537401,281.3190661,258.25,558,88.43106181,1116,-263168,22528,-240640,70
506,43,23,7,0.0783242259,0.921675774,154.4150325,200.1775199,275.3794466,270.5348837,549,104.7709924,1098,-259072,22016,-237056,70
514,40,23,7,0.0722021661,0.927797834,156.3388308,200.3818838,277.4396887,278.275,554,167.8787879,1108,-263168,20480,-242688,70
555,48,23,7,0.07960199,0.92039801,170.0066569,215.4257403,301.3495495,309.5208333,603,59.7029703,1206,-284160,24576,-259584,70
516,47,23,7,0.0834813499,0.91651865,157.6872558,208.3337808,281.6724806,285.5957447,563,123.4649123,1126,-264192,24064,-240128,70
511,40,22,8,0.0725952813,0.927404719,155.4329542,199.4869419,276.6575342,267.6,551,121.3656388,1102,-261632,20480,-241152,70
521,43,23,7,0.0762411348,0.923758865,159.2940822,200.5967625,282.4510557,283.0930233,564,164.9122807,1128,-266752,22016,-244736,70
557,47,23,7,0.0778145695,0.92218543,170.6323146,213.378777,303.3482944,292.4468085,604,109.2224231,1208,-285184,24064,-261120,70
520,41,23,7,0.073083779,0.926916221,159.8610358,183.1987442,283.6038462,247.9756098,561,86.57407407,1122,-266240,20992,-245248,70
513,40,23,7,0.0723327306,0.927667269,156.0757388,199.7358865,277.2319688,274.025,553,80.49490539,1106,-262656,20480,-242176,70
508,44,23,7,0.0797101449,0.920289855,156.7315942,185.51127,278.4074803,254.4772727,552,9.754373564,1104,-260096,22528,-237568,70
519,45,23,7,0.079787234,0.920212766,158.573698,205.4730213,282.4354528,283.2444444,564,56.79758308,1128,-265728,23040,-242688,70
491,40,23,7,0.0753295669,0.924670433,151.2696198,171.2820317,269.2281059,226.375,531,138.28125,1062,-251392,20480,-230912,70
485,43,23,7,0.0814393939,0.918560606,147.8608844,196.6512921,264.6226804,263.1162791,528,88.29431438,1056,-248320,22016,-226304,70
477,43,23,7,0.0826923077,0.917307692,146.0336873,189.4653546,260.9727463,255.255814,520,86.66666667,1040,-244224,22016,-222208,70
487,40,23,7,0.0759013283,0.924098672,150.3607576,165.004392,267.899384,216.525,527,134.4387755,1054,-249344,20480,-228864,70
485,41,22,8,0.0779467681,0.922053232,149.6365301,174.3366181,265.371134,241.3658537,526,146.9273743,1052,-248320,20992,-227328,70
489,42,23,7,0.0790960452,0.920903955,148.7946826,198.1555197,266.4376278,260.9047619,531,60,1062,-250368,21504,-228864,70
486,45,23,7,0.0847457627,0.915254237,148.4334856,198.0018631,265.0925926,275.8,531,105.7768924,1062,-248832,23040,-225792,70
486,42,23,7,0.0795454545,0.920454545,148.0623245,195.1952407,265.8950617,248.3571429,528,9.345132743,1056,-248832,21504,-227328,70
485,43,23,7,0.0814393939,0.918560606,149.7700779,171.6094652,269.0082474,213.6511628,528,88.7394958,1056,-248320,22016,-226304,70
483,41,23,7,0.0782442748,0.921755725,147.3699677,189.5199892,264.6066253,237.6829268,524,99.24242424,1048,-247296,20992,-226304,70
489,45,23,7,0.0842696629,0.915730337,149.5071731,197.4376551,268.4192229,257.5111111,534,203.0418251,1068,-250368,23040,-227328,70
487,38,23,7,0.0723809524,0.927619048,148.0014345,191.3256658,263.1129363,261.5526316,525,118.7782805,1050,-249344,19456,-229888,70
484,39,23,7,0.0745697897,0.92543021,147.3521512,188.777687,263.8615702,238.8974359,523,178.4982935,1046,-247808,19968,-227840,70
486,39,23,7,0.0742857143,0.925714286,147.9127482,191.0654854,262.4444444,269.9230769,525,100.7677543,1050,-248832,19968,-228864,70
490,43,23,7,0.0806754221,0.919324578,149.0669451,199.8321659,268.455102,250.4186047,533,144.0540541,1066,-250880,22016,-228864,70
484,39,23,7,0.0745697897,0.92543021,148.581781,176.2403587,263.9566116,237.7179487,523,98.8657845,1046,-247808,19968,-227840,70
509,59,23,7,0.103873239,0.896126761,156.2127313,214.4597858,279.2239686,330.0169492,568,83.77581121,1136,-260608,30208,-230400,70
507,41,23,7,0.0748175182,0.925182482,154.5444895,197.236026,275.6942801,259.7317073,548,71.54046997,1096,-259584,20992,-238592,70
488,45,23,7,0.0844277674,0.915572233,149.3332799,195.9816998,268.1188525,254.8666667,533,141.005291,1066,-249856,23040,-226816,70
512,45,23,7,0.0807899461,0.919210054,155.8447342,208.9142467,279.4707031,273.6444444,557,116.7714885,1114,-262144,23040,-239104,70
467,39,23,7,0.0770750988,0.922924901,141.8958311,188.6490259,252.5546039,264.8205128,506,76.20481928,1012,-239104,19968,-219136,70
465,42,23,7,0.0828402367,0.917159763,141.3176908,193.5698954,253.8129032,256.0714286,507,56.45879733,1014,-238080,21504,-216576,70
476,40,24,6,0.0775193798,0.92248062,144.7839502,191.2319992,257.3529412,272.15,516,82.03497615,1032,-243712,20480,-223232,70
467,41,24,6,0.0807086614,0.919291339,142.795126,183.7066791,256.2955032,234.0487805,508,105.3941909,1016,-239104,20992,-218112,70
476,42,23,7,0.0810810811,0.918918919,145.0187372,193.2608546,260.2647059,250.8333333,518,195.4716981,1036,-243712,21504,-222208,70
473,39,24,6,0.076171875,0.923828125,143.8147046,188.3028042,254.7505285,277.7179487,512,111.3043478,1024,-242176,19968,-222208,70
473,39,23,7,0.076171875,0.923828125,143.670667,190.7905213,255.9598309,263.0512821,512,112.5274725,1024,-242176,19968,-222208,70
474,43,23,7,0.083172147,0.916827853,144.8595947,190.3494978,260.3945148,243.627907,517,53.29896907,1034,-242688,22016,-220672,70
477,47,23,7,0.0896946565,0.910305344,146.084973,196.1747173,263.0188679,257.2340426,524,107.5975359,1048,-244224,24064,-220160,70
501,46,23,7,0.084095064,0.915904936,152.635582,205.7897692,275.7724551,254.6956522,547,65.43062201,1094,-256512,23552,-232960,70
62,18,23,7,0.225,0.775,23.50119,19.5334471,42.87096774,32.33333333,80,1.588877855,160,-31744,9216,-22528,70
470,44,23,7,0.0856031128,0.914396887,143.5854431,191.7494101,258.7574468,244.0681818,514,137.8016086,1028,-240640,22528,-218112,70
472,38,24,6,0.0745098039,0.925490196,143.3468152,188.8556661,255.3877119,256.8947368,510,47.75280899,1020,-241664,19456,-222208,70
479,45,24,6,0.0858778626,0.914122137,146.4072263,193.3124586,265.2025052,233.7333333,524,107.81893,1048,-245248,23040,-222208,70
475,38,24,6,0.0740740741,0.925925926,144.8118542,183.988144,256.3052632,265.6842105,513,34.56873315,1026,-243200,19456,-223744,70
480,41,23,7,0.0786948177,0.921305182,145.9005425,195.2097211,260.1041667,271.4878049,521,94.72727273,1042,-245760,20992,-224768,70
472,43,24,6,0.0834951456,0.916504854,144.621026,185.852099,260.1144068,234.7906977,515,76.98056801,1030,-241664,22016,-219648,70
476,45,22,8,0.0863723608,0.913627639,145.8557005,190.9476252,262.802521,241.9333333,521,110.8510638,1042,-243712,23040,-220672,70
467,42,23,7,0.0825147348,0.917485265,143.4277832,177.7666054,258.1220557,220.2857143,509,48.94230769,1018,-239104,21504,-217600,70
484,46,24,6,0.0867924528,0.913207547,147.5370147,201.1983992,266.7665289,252.173913,530,40.64417178,1060,-247808,23552,-224256,70
509,45,23,7,0.0812274368,0.918772563,155.695789,201.305328,278.5500982,265.6222222,554,102.9739777,1108,-260608,23040,-237568,70
501,41,22,8,0.0756457565,0.924354244,152.7256224,196.351904,270.994012,277.6829268,542,126.3403263,1084,-256512,20992,-235520,70
508,46,23,7,0.083032491,0.916967509,155.8982367,198.5237531,278.761811,263.5652174,554,103.9399625,1108,-260096,23552,-236544,70
506,48,23,7,0.0866425993,0.913357401,155.7063882,199.0299904,277.6403162,276.0208333,554,181.6393443,1108,-259072,24576,-234496,70
504,46,22,8,0.0836363636,0.916363636,153.9744931,203.5811984,276.7321429,262,550,122.2222222,1100,-258048,23552,-234496,70
505,41,23,7,0.0750915751,0.924908425,154.4843942,192.012297,273.7920792,269.902439,546,117.9265659,1092,-258560,20992,-237568,70
504,47,23,7,0.0852994555,0.914700544,154.6291101,200.0152982,277.2539683,262.5531915,551,118.75,1102,-258048,24064,-233984,70
502,46,23,7,0.0839416058,0.916058394,156.3273401,170.7963445,278.6693227,229,548,89.54248366,1096,-257024,23552,-233472,70
507,44,23,7,0.0798548094,0.920145191,156.8957681,157.1663526,283.6646943,187.6818182,551,167.4772036,1102,-259584,22528,-237056,70
505,45,23,7,0.0818181818,0.918181818,154.7404741,198.4667401,275.5049505,275.4444444,550,58.32449629,1100,-258560,23040,-235520,70
553,46,22,8,0.0767946578,0.923205342,170.9986245,184.2276269,304.9837251,240.0869565,599,78.60892388,1198,-283136,23552,-259584,70
503,41,23,7,0.0753676471,0.924632353,155.7259565,164.2838188,276.5805169,222.4390244,544,42.20325834,1088,-257536,20992,-236544,70
569,64,23,7,0.101105845,0.898894155,175.4758377,232.9963703,311.9876977,361.5625,633,57.28506787,1266,-291328,32768,-258560,70
501,46,22,8,0.084095064,0.915904936,153.5104049,198.4769084,275.8562874,253.7826087,547,102.6266417,1094,-256512,23552,-232960,70
495,37,23,7,0.0695488722,0.930451128,150.2621408,191.894389,267.5878788,251.9459459,532,55.3014553,1064,-253440,18944,-234496,70
402,35,22,8,0.0800915332,0.919908467,124.5558128,127.1399229,224.5024876,155.8,437,7.809149392,874,-205824,17920,-187904,70
504,41,23,7,0.0752293578,0.924770642,153.3786512,199.5702849,273.202381,270.5121951,545,128.8416076,1090,-258048,20992,-237056,70
509,49,22,8,0.0878136201,0.91218638,156.5376097,201.5656337,281.1100196,262.7755102,558,80.40345821,1116,-260608,25088,-235520,70
531,50,23,7,0.0860585198,0.91394148,164.9301799,185.3797443,296.4161959,233.48,581,63.01518438,1162,-271872,25600,-246272,70
367,40,23,7,0.0982800983,0.901719902,113.1946659,150.8228908,205.2615804,192.425,407,6.424625099,814,-187904,20480,-167424,70
476,44,23,7,0.0846153846,0.915384615,145.2273262,194.4766273,262.0693277,243.5227273,520,98.29867675,1040,-243712,22528,-221184,70
475,46,23,7,0.0882917466,0.911708253,145.4256981,194.1571382,261.9978947,250.6956522,521,84.71544715,1042,-243200,23552,-219648,70
476,44,23,7,0.0846153846,0.915384615,145.2374494,195.13927,260.9411765,255.7272727,520,101.7612524,1040,-243712,22528,-221184,70
478,42,23,7,0.0807692308,0.919230769,145.4470983,195.4805478,260.7384937,257.7857143,520,91.06830123,1040,-244736,21504,-223232,70
473,43,23,7,0.0833333333,0.916666667,146.3277725,170.3729088,262.0866808,219.0465116,516,214.1078838,1032,-242176,22016,-220160,70
475,45,23,7,0.0865384615,0.913461538,145.6994877,189.8866667,261.9326316,245.3777778,520,106.7761807,1040,-243200,23040,-220160,70
477,46,22,8,0.0879541109,0.912045889,145.9438142,194.2858086,264.1467505,239.7391304,523,117.264574,1046,-244224,23552,-220672,70
63,18,24,6,0.222222222,0.777777778,23.61976232,21.49282108,42.6984127,35.05555556,81,2.873359347,162,-32256,9216,-23040,70
474,43,23,7,0.083172147,0.916827853,146.7275837,162.6332627,264.5189873,198.1627907,517,96.8164794,1034,-242688,22016,-220672,70
471,38,23,7,0.0746561886,0.925343811,144.6908306,171.1850581,256.5498938,235.7894737,509,60.5952381,1018,-241152,19456,-221696,70
480,39,23,7,0.0751445087,0.924855491,146.4398853,186.4218245,259.6,264.9230769,519,125.060241,1038,-245760,19968,-225792,70
484,40,23,7,0.0763358779,0.923664122,147.8593192,186.9410853,263.7871901,246.925,524,90.50086356,1048,-247808,20480,-227328,70
472,39,23,7,0.0763209393,0.923679061,143.3640233,190.2360138,254.9491525,268.7179487,511,47.1402214,1022,-241664,19968,-221696,70
468,43,22,8,0.084148728,0.915851272,142.7962651,191.2558366,256.8034188,247.255814,511,82.28663446,1022,-239616,22016,-217600,70
477,41,23,7,0.0791505792,0.920849421,145.251276,191.5213242,257.9224319,277.8536585,518,99.61538462,1036,-244224,20992,-223232,70
463,42,22,8,0.0831683168,0.916831683,141.5317953,184.3839424,255.3174946,227.452381,505,85.59322034,1010,-237056,21504,-215552,70
474,45,22,8,0.0867052023,0.913294798,146.5676343,174.2385111,264.3016878,214.6888889,519,19.02492669,1038,-242688,23040,-219648,70
474,39,23,7,0.0760233918,0.923976608,144.4249835,185.1186659,259.0801688,231.7179487,513,69.79591837,1026,-242688,19968,-222720,70
458,41,23,7,0.0821643287,0.917835671,141.782805,155.6682587,255.2532751,191.3170732,499,61.60493827,998,-234496,20992,-213504,70
472,40,23,7,0.078125,0.921875,143.5071391,191.2739119,256.1292373,260.875,512,85.19134775,1024,-241664,20480,-221184,70
495,43,24,6,0.0799256506,0.920074349,150.9064218,199.0773146,269.4464646,270.1162791,538,66.74937965,1076,-253440,22016,-231424,70
493,46,23,7,0.0853432282,0.914656772,151.4345059,194.4032663,270.9350913,259.9782609,539,84.08736349,1078,-252416,23552,-228864,70
490,43,23,7,0.0806754221,0.919324578,150.155629,188.4864511,269.6510204,236.7906977,533,84.87261146,1066,-250880,22016,-228864,70
486,44,22,8,0.0830188679,0.916981132,150.8310439,169.3564798,269.3744856,222.7045455,530,125.8907363,1060,-248832,22528,-226304,70
494,41,23,7,0.076635514,0.923364486,150.4152764,196.4170374,267.3866397,275.3902439,535,126.1792453,1070,-252928,20992,-231936,70
496,45,23,7,0.0831792976,0.916820702,153.867846,176.5082812,273.8971774,239.0666667,541,9.831001272,1082,-253952,23040,-230912,70
518,57,24,6,0.0991304348,0.900869565,159.3836831,215.3292453,285.2104247,313.3508772,575,89.84375,1150,-265216,29184,-236032,70
530,46,24,6,0.0798611111,0.920138889,161.8598638,210.5403885,288.1358491,292.6956522,576,100.8756567,1152,-271360,23552,-247808,70
494,42,22,8,0.078358209,0.921641791,150.800542,194.9292389,267.8502024,276.1428571,536,91.78082192,1072,-252928,21504,-231424,70
493,39,23,7,0.0733082707,0.926691729,151.7001809,171.2394811,269.4462475,229.2564103,532,111.5303983,1064,-252416,19968,-232448,70
502,46,22,8,0.0839416058,0.916058394,153.6546657,199.2793787,276.9183267,248.1086957,548,125.1141553,1096,-257024,23552,-233472,70
511,54,23,7,0.0955752212,0.904424779,156.4673642,212.922013,279.3385519,317.6481481,565,45.41800643,1130,-261632,27648,-233984,70
485,44,24,6,0.0831758034,0.916824197,149.1753085,186.4930482,266.5010309,248.4545455,529,150.2840909,1058,-248320,22528,-225792,70
543,55,23,7,0.0919732441,0.908026756,167.3148557,217.6004527,297.8839779,315.4545455,598,100.1675042,1196,-278016,28160,-249856,70
519,47,24,6,0.0830388693,0.916961131,158.9533807,206.0303502,284.044316,277.4893617,566,105.0092764,1132,-265728,24064,-241664,70
512,43,23,7,0.0774774775,0.922522523,156.181388,201.6663009,276.8789063,291.3488372,555,49.6866607,1110,-262144,22016,-240128,70
488,42,23,7,0.079245283,0.920754717,148.9990366,193.4906995,265.4856557,265.6666667,530,103.7181996,1060,-249856,21504,-228352,70
498,42,22,8,0.0777777778,0.922222222,153.4955619,174.38722,274.6706827,221.047619,540,99.44751381,1080,-254976,21504,-233472,70
363,42,23,7,0.103703704,0.896296296,112.5867938,149.1507402,203.2203857,201.0952381,405,6.471716203,810,-185856,21504,-164352,70
343,38,23,7,0.0997375328,0.900262467,105.1296795,146.4227671,191.9650146,182.2894737,381,6.165048544,762,-175616,19456,-156160,70
4265,363,22,8,0.0784356093,0.921564391,1329.537379,1392.846746,2332.190621,2106.647383,4628,247.486631,9256,-2183680,185856,-1997824,71
4258,405,22,8,0.0868539567,0.913146043,1331.206372,1493.552739,2333.488492,2316.350617,4663,81.73531989,9326,-2180096,207360,-1972736,71
4304,386,22,8,0.0823027719,0.917697228,1346.25575,1421.54631,2363.096887,2149.290155,4690,206.7901235,9380,-2203648,197632,-2006016,71
4225,367,22,8,0.0799216028,0.920078397,1318.806903,1389.066853,2311.950296,2118.632153,4592,306.5420561,9184,-2163200,187904,-1975296,71
4255,379,22,8,0.0817867933,0.918213207,1328.953678,1412.629594,2337.777203,2089.849604,4634,257.730812,9268,-2178560,194048,-1984512,71
4208,386,22,8,0.0840226382,0.915977362,1313.388641,1455.227434,2305.80038,2207.012953,4594,80.28661307,9188,-2154496,197632,-1956864,71
4209,349,22,8,0.0765686705,0.92343133,1310.300723,1360.365426,2298.060347,2055.659026,4558,157.3895028,9116,-2155008,178688,-1976320,71
4312,397,22,8,0.0843066468,0.915693353,1349.878612,1442.975699,2373.698284,2151.90932,4709,270.9436133,9418,-2207744,203264,-2004480,71
4745,363,22,8,0.0710649961,0.928935004,1468.486601,1503.016584,2582.923709,2182.955923,5108,232.1818182,10216,-2429440,185856,-2243584,71
4291,388,22,8,0.0829237016,0.917076298,1340.005708,1462.350336,2345.815661,2275.68299,4679,217.83054,9358,-2196992,198656,-1998336,71
4678,366,22,8,0.0725614592,0.927438541,1451.283037,1468.834953,2550.776828,2161.081967,5044,336.0426382,10088,-2395136,187392,-2207744,71
4207,347,22,8,0.0761967501,0.92380325,1304.79098,1414.660453,2293.222486,2086.881844,4554,116.889117,9108,-2153984,177664,-1976320,71
4726,352,22,8,0.0693186294,0.930681371,1462.028836,1477.126538,2564.267457,2206.96875,5078,245.5512573,10156,-2419712,180224,-2239488,71
4227,355,22,8,0.0774770842,0.922522916,1318.375724,1357.323476,2308.327419,2091.135211,4582,296.761658,9164,-2164224,181760,-1982464,71
4290,367,22,8,0.0788060983,0.921193902,1333.508829,1462.053893,2336.949883,2236.070845,4657,273.6192714,9314,-2196480,187904,-2008576,71
4296,367,22,8,0.0787046965,0.921295303,1335.441821,1446.044165,2351.269553,2106.435967,4663,306.1720289,9326,-2199552,187904,-2011648,71
4290,395,22,8,0.0843116329,0.915688367,1338.653372,1481.634426,2359.923776,2159.194937,4685,297.4603175,9370,-2196480,202240,-1994240,71
4309,359,22,8,0.0769065981,0.923093402,1337.567404,1435.097223,2356.799257,2066.846797,4668,248.8272921,9336,-2206208,183808,-2022400,71
4234,362,22,8,0.0787641427,0.921235857,1320.600488,1364.134721,2323.097308,2010.80663,4596,154.539341,9192,-2167808,185344,-1982464,71
4217,377,22,8,0.0820635612,0.917936439,1317.606316,1386.176474,2323.282191,2009.108753,4594,242.0442571,9188,-2159104,193024,-1966080,71
7330,905,22,8,0.109896782,0.890103218,2388.603355,2279.652624,4132.645566,3999.379006,8235,145.9847545,16470,-3752960,463360,-3289600,71
8966,938,22,8,0.0947092084,0.905290792,2816.886025,3232.434813,4941.410439,5058.501066,9904,672.3693143,19808,-4590592,480256,-4110336,71
6384,767,22,8,0.107257726,0.892742274,2066.307231,2047.111571,3581.408521,3530.983051,7151,164.9976927,14302,-3268608,392704,-2875904,71
4004,468,22,8,0.104651163,0.895348837,1276.560048,1406.133337,2244.7505,2165.912393,4472,84.9382716,8944,-2050048,239616,-1810432,71
6723,778,22,8,0.103719504,0.896280496,2181.780437,2010.844567,3769.372155,3592.239075,7501,140.1270316,15002,-3442176,398336,-3043840,71
7235,875,22,8,0.107891492,0.892108508,2351.709434,2246.612577,4073.272149,3908.549714,8110,154.5939764,16220,-3704320,448000,-3256320,71
9156,760,22,8,0.076643808,0.923356192,2847.492296,2924.994547,5023.83104,4171.432895,9916,965.5306719,19832,-4687872,389120,-4298752,71
7481,958,22,8,0.113520559,0.886479441,2420.748152,2546.365171,4197.728379,4393.91858,8439,146.2058212,16878,-3830272,490496,-3339776,71
7204,847,22,8,0.105204322,0.894795678,2317.600141,2378.643799,4029.756802,3994.047226,8051,157.6463677,16102,-3688448,433664,-3254784,71
8055,841,22,8,0.0945368705,0.905463129,2527.770915,2924.325688,4438.906269,4540.387634,8896,211.1058377,17792,-4124160,430592,-3693568,71
6089,718,22,8,0.105479653,0.894520347,1960.81361,2000.252747,3404.54426,3399.384401,6807,180.3656598,13614,-3117568,367616,-2749952,71
4944,667,22,8,0.118873641,0.881126359,1596.762493,1769.714036,2780.69377,2993.577211,5611,120.5629566,11222,-2531328,341504,-2189824,71
5422,703,22,8,0.11477551,0.88522449,1753.52344,1865.094572,3037.237735,3261.69559,6125,142.8071812,12250,-2776064,359936,-2416128,71
8323,919,22,8,0.0994373512,0.900562649,2660.964843,2729.635822,4627.598702,4566.266594,9242,169.9834468,18484,-4261376,470528,-3790848,71
7460,888,22,8,0.106372784,0.893627216,2416.448588,2352.561047,4183.029357,4102.845721,8348,194.2298744,16696,-3819520,454656,-3364864,71
6812,789,22,8,0.103802131,0.896197869,2195.593913,2178.369764,3815.389166,3676.768061,7601,135.3936587,15202,-3487744,403968,-3083776,71
6421,729,22,8,0.101958042,0.898041958,2064.344611,2061.163148,3577.276281,3559.854595,7150,168.4334511,14300,-3287552,373248,-2914304,71
5401,700,22,8,0.114735289,0.885264711,1746.424042,1863.940565,3030.719496,3207.478571,6101,131.6005177,12202,-2765312,358400,-2406912,71
7401,850,22,8,0.103017816,0.896982184,2385.063067,2350.953734,4138.524929,4016.944706,8251,148.6398847,16502,-3789312,435200,-3354112,71
8289,833,22,8,0.0913176935,0.908682307,2602.360152,2923.253229,4563.594402,4540.659064,9122,195.4993571,18244,-4243968,426496,-3817472,71
9210,723,22,8,0.0727876774,0.927212323,2840.036816,3173.774447,4938.780673,5326.474412,9933,740.1639344,19866,-4715520,370176,-4345344,71
9332,610,22,8,0.061355864,0.938644136,2841.810806,3271.134517,4972.989606,4948.711475,9942,684.2395045,19884,-4777984,312320,-4465664,71
9249,692,22,8,0.0696107031,0.930389297,2839.823089,3234.979454,4954.600605,5190.187861,9941,726.1504748,19882,-4735488,354304,-4381184,71
9338,609,22,8,0.0612244898,0.93877551,2857.849811,3067.060504,4985.526987,4797.252874,9947,499.8492462,19894,-4781056,311808,-4469248,71
9236,701,22,8,0.0705444299,0.92945557,2840.377644,3202.592134,4946.775769,5261.814551,9937,551.4428413,19874,-4728832,358912,-4369920,71
9232,704,22,8,0.0708534622,0.929146538,2838.734654,3209.210835,4941.110269,5327.678977,9936,683.8265657,19872,-4726784,360448,-4366336,71
9336,610,22,8,0.0613311884,0.938668812,2855.572749,3099.250079,4977.819623,4907.388525,9946,579.2661619,19892,-4780032,312320,-4467712,71
8776,712,22,8,0.0750421585,0.924957841,2686.320611,3236.411086,4686.799795,5455.703652,9488,310.2681491,18976,-4493312,364544,-4128768,71
9202,729,22,8,0.0734065049,0.926593495,2838.54984,3182.151343,4938.555966,5312.419753,9931,860.5719237,19862,-4711424,373248,-4338176,71
9209,726,22,8,0.0730749874,0.926925013,2836.001732,3219.732862,4936.43729,5368.359504,9935,521.7962185,19870,-4715008,371712,-4343296,71
7322,507,22,8,0.0647592285,0.935240771,2227.205433,2689.086891,3919.358235,3852.059172,7829,255.6825604,15658,-3748864,259584,-3489280,71
9320,623,22,8,0.0626571457,0.937342854,2841.663971,3267.462412,4965.867704,5063.738363,9943,785.3870458,19886,-4771840,318976,-4452864,71
9328,615,22,8,0.0618525596,0.93814744,2842.976169,3253.022991,4981.881647,4822.120325,9943,897.3826715,19886,-4775936,314880,-4461056,71
9223,707,22,8,0.0711983887,0.928801611,2843.132398,3112.411791,4926.845495,5469.758133,9930,612.5848242,19860,-4722176,361984,-4360192,71
9242,693,22,8,0.0697533971,0.930246603,2835.690682,3251.487595,4944.03008,5287.66811,9935,406.1733442,19870,-4731904,354816,-4377088,71
9218,715,22,8,0.0719822813,0.928017719,2838.678147,3193.203414,4939.126817,5326.34965,9933,522.5144661,19866,-4719616,366080,-4353536,71
9246,693,22,8,0.0697253245,0.930274676,2841.617066,3191.653971,4942.707117,5334.141414,9939,700.9167842,19878,-4733952,354816,-4379136,71
9384,566,22,8,0.0568844221,0.943115578,2855.081158,3136.514683,4962.506181,5190.931095,9950,645.6846204,19900,-4804608,289792,-4514816,71
7524,525,22,8,0.0652254939,0.934774506,2291.779828,2738.384215,4022.589846,4059.540952,8049,512.6751592,16098,-3852288,268800,-3583488,71
9328,614,22,8,0.0617581975,0.938241802,2849.840544,3159.504807,4966.172277,5052.439739,9942,398.6367281,19884,-4775936,314368,-4461568,71
3826,375,22,8,0.0892644608,0.910735539,1207.819099,1261.047826,2097.264506,2139.112,4201,198.4411904,8402,-1958912,192000,-1766912,71
3823,381,22,8,0.0906279734,0.909372027,1212.660503,1222.472938,2099.501177,2132.590551,4204,293.986014,8408,-1957376,195072,-1762304,71
3858,375,22,8,0.0885896527,0.911410347,1217.465171,1265.487985,2110.718507,2181.624,4233,170.2735318,8466,-1975296,192000,-1783296,71
3832,379,22,8,0.0900023747,0.909997625,1211.76785,1253.759256,2107.026096,2095.62533,4211,265.0094399,8422,-1961984,194048,-1767936,71
3811,373,22,8,0.0891491396,0.91085086,1201.830328,1267.292755,2093.732091,2079.911528,4184,148.5795455,8368,-1951232,190976,-1760256,71
3819,374,22,8,0.0891962795,0.91080372,1206.98745,1244.702352,2095.077507,2116.631016,4193,252.4382902,8386,-1955328,191488,-1763840,71
3830,367,22,8,0.087443412,0.912556588,1205.336697,1274.59806,2101.065274,2077.446866,4197,267.3248408,8394,-1960960,187904,-1773056,71
3839,370,22,8,0.0879068662,0.912093134,1211.916353,1246.7671,2103.218026,2123.489189,4209,217.6318511,8418,-1965568,189440,-1776128,71
3821,372,22,8,0.0887192941,0.911280706,1203.624463,1277.42282,2093.205444,2135.975806,4193,160.651341,8386,-1956352,190464,-1765888,71
3800,369,22,8,0.0885104342,0.911489566,1196.632824,1271.819535,2083.511842,2100.325203,4169,227.1934605,8338,-1945600,188928,-1756672,71
3757,371,22,8,0.089874031,0.910125969,1187.857008,1229.195775,2062.331648,2086.458221,4128,240.5594406,8256,-1923584,189952,-1733632,71
3181,337,22,8,0.0957930642,0.904206936,1002.234298,1132.96328,1755.543854,1796.84273,3518,61.75179919,7036,-1628672,172544,-1456128,71
3773,371,22,8,0.089527027,0.910472973,1193.721813,1221.474212,2069.546515,2102.536388,4144,237.3424971,8288,-1931776,189952,-1741824,71
3759,375,22,8,0.0907111756,0.909288824,1185.022916,1271.393421,2059.521149,2147.48,4134,212.3266564,8268,-1924608,192000,-1732608,71
3839,372,22,8,0.0883400617,0.911659938,1213.401631,1238.10003,2107.307893,2092.502688,4211,260.0988264,8422,-1965568,190464,-1775104,71
3856,372,22,8,0.0879848628,0.912015137,1216.233204,1263.834139,2112.193983,2138.403226,4228,246.6744457,8456,-1974272,190464,-1783808,71
3752,331,22,8,0.0810678423,0.918932158,1181.798825,1132.91712,2029.522388,2183.438066,4083,261.0613811,8166,-1921024,169472,-1751552,71
711,111,22,8,0.135036496,0.864963504,230.2008258,225.2684063,435.2658228,259.2702703,822,14.93730692,1644,-364032,56832,-307200,71
3848,377,22,8,0.0892307692,0.910769231,1215.274733,1263.326992,2114.762994,2095.005305,4225,190.6588448,8450,-1970176,193024,-1777152,71
3842,372,22,8,0.0882771713,0.911722829,1212.514978,1256.633568,2108.33342,2098.892473,4214,251.2820513,8428,-1967104,190464,-1776640,71
2944,228,22,8,0.0718789407,0.928121059,898.8414097,1109.203946,1582.700068,1635.565789,3172,146.5804067,6344,-1507328,116736,-1390592,71
2904,221,22,8,0.07072,0.92928,883.7678374,1115.447346,1562.801309,1565.61086,3125,138.9506447,6250,-1486848,113152,-1373696,71
2881,212,22,8,0.0685418687,0.931458131,875.9819161,1095.813041,1550.495661,1499.495283,3093,292.8977273,6186,-1475072,108544,-1366528,71
2907,217,22,8,0.0694622279,0.930537772,885.9653189,1091.873465,1564.580667,1534.626728,3124,243.4918161,6248,-1488384,111104,-1377280,71
3069,231,22,8,0.07,0.93,936.4889311,1144.996856,1647.649397,1688.372294,3300,191.8604651,6600,-1571328,118272,-1453056,71
2868,208,22,8,0.0676202861,0.932379714,872.375084,1078.098167,1543.240237,1473.139423,3076,231.626506,6152,-1468416,106496,-1361920,71
2882,225,22,8,0.0724171226,0.927582877,874.855692,1140.145291,1548.623178,1622.871111,3107,54.43237561,6214,-1475584,115200,-1360384,71
2908,211,22,8,0.0676498878,0.932350112,886.5027634,1072.727118,1562.82978,1521,3119,283.2879201,6238,-1488896,108032,-1380864,71
1815,115,22,8,0.0595854922,0.940414508,548.821145,639.7078049,978.7410468,756.5217391,1930,198.3556012,3860,-929280,58880,-870400,71
2882,210,22,8,0.0679172057,0.932082794,876.3700396,1089.11903,1551.023595,1484.419048,3092,282.1167883,6184,-1475584,107520,-1368064,71
2881,209,22,8,0.0676375405,0.93236246,876.2011924,1084.837884,1549.948976,1484.172249,3090,306.8520357,6180,-1475072,107008,-1368064,71
2912,211,22,8,0.0675632405,0.93243676,886.7457733,1085.116569,1563.027473,1547.819905,3123,291.5966387,6246,-1490944,108032,-1382912,71
2873,212,22,8,0.068719611,0.931280389,875.4037275,1072.994507,1547.815524,1477.740566,3085,195.5006337,6170,-1470976,108544,-1362432,71
1760,121,22,8,0.0643274854,0.935672515,532.2125576,613.9418191,960.5698864,656.3471074,1881,34.95632782,3762,-901120,61952,-839168,71
2881,211,22,8,0.068240621,0.931759379,875.3839771,1100.396614,1548.764665,1515.578199,3092,246.374502,6184,-1475072,108032,-1367040,71
2877,209,22,8,0.0677252106,0.932274789,874.4958071,1090.603759,1546.355231,1504.196172,3086,277.0197487,6172,-1473024,107008,-1366016,71
2882,209,22,8,0.0676156584,0.932384342,878.251454,1067.217539,1546.712353,1536.177033,3091,184.9790545,6182,-1475584,107008,-1368576,71
1732,121,22,8,0.0652995143,0.934700486,524.6425739,610.6099131,944.7528868,672.8842975,1853,33.59927471,3706,-886784,61952,-824832,71
2897,219,22,8,0.0702824134,0.929717587,881.4420465,1111.217627,1558.818778,1554.283105,3116,138.365897,6232,-1483264,112128,-1371136,71
3035,229,22,8,0.0701593137,0.929840686,928.515503,1105.362271,1638.206919,1556.864629,3264,153.3834586,6528,-1553920,117248,-1436672,71
3021,285,22,8,0.0862068966,0.913793103,936.0881797,1130.015262,1653.81099,1650.203509,3306,109.4701987,6612,-1546752,145920,-1400832,71
3043,280,22,8,0.0842612098,0.91573879,939.957007,1148.144001,1664.038778,1639.842857,3323,232.3776224,6646,-1558016,143360,-1414656,71
3020,279,22,8,0.0845710821,0.915428918,935.0091163,1122.645297,1647.728146,1674.591398,3299,153.2280539,6598,-1546240,142848,-1403392,71
3023,277,22,8,0.0839393939,0.916060606,934.220169,1134.161059,1651.823685,1636.054152,3300,262.7388535,6600,-1547776,141824,-1405952,71
3023,286,22,8,0.0864309459,0.913569054,934.6549751,1149.840823,1651.806484,1688.755245,3309,103.6654135,6618,-1547776,146432,-1401344,71
2987,259,22,8,0.0797905114,0.920209489,923.3814149,1078.558762,1630.845665,1538.783784,3246,237.4542794,6492,-1529344,132608,-1396736,71
2991,276,22,8,0.0844811754,0.915518825,922.4710058,1142.836413,1635.888332,1613.536232,3267,253.0596437,6534,-1531392,141312,-1390080,71
3150,284,22,8,0.0827023879,0.917297612,974.7221188,1159.115368,1720.057143,1689.137324,3434,175.7420676,6868,-1612800,145408,-1467392,71
3016,272,22,8,0.0827250608,0.917274939,933.1657958,1111.073256,1646.078249,1627,3288,155.0212164,6576,-1544192,139264,-1404928,71
2984,272,22,8,0.0835380835,0.916461916,921.6266141,1120.193178,1632.728887,1582.106618,3256,163.6180905,6512,-1527808,139264,-1388544,71
3027,280,22,8,0.0846688842,0.915331116,938.6567232,1111.862087,1658.370334,1606.753571,3307,266.0498793,6614,-1549824,143360,-1406464,71
3038,275,22,8,0.0830063387,0.916993661,938.618799,1133.648094,1660.17709,1621.901818,3313,157.7619048,6626,-1555456,140800,-1414656,71
2915,236,22,8,0.0748968581,0.925103142,900.6801039,988.6119209,1593.38422,1361.275424,3151,63.70804691,6302,-1492480,120832,-1371648,71
3008,271,22,8,0.0826471485,0.917352851,928.4690769,1128.103521,1639.989694,1640.114391,3279,178.4975504,6558,-1540096,138752,-1401344,71
3010,270,22,8,0.0823170732,0.917682927,934.2065538,1077.832479,1639.956146,1646.562963,3280,183.5478456,6560,-1541120,138240,-1402880,71
3019,276,22,8,0.0837632777,0.916236722,933.0684532,1130.267532,1650.20106,1623.923913,3295,183.1573096,6590,-1545728,141312,-1404416,71
3019,277,22,8,0.0840412621,0.915958738,932.0085955,1142.267604,1649.349785,1639.238267,3296,157.5525813,6592,-1545728,141824,-1403904,71
3027,307,22,8,0.0920815837,0.907918416,937.126969,1177.376345,1655.968616,1781.198697,3334,58.64555849,6668,-1549824,157184,-1392640,71
3034,281,22,8,0.0847662142,0.915233786,936.0173901,1157.48861,1652.403757,1718.423488,3315,211.8210863,6630,-1553408,143872,-1409536,71
3043,271,22,8,0.0817742909,0.918225709,942.9715662,1098.47106,1655.146895,1683.922509,3314,203.5626536,6628,-1558016,138752,-1419264,71
9271,669,22,8,0.0673038229,0.932696177,2845.278858,3174.686293,4952.367059,5221.786248,9940,631.5120712,19880,-4746752,342528,-4404224,71
9286,657,22,8,0.0660766368,0.933923363,2844.746008,3203.380937,4958.180379,5167.325723,9943,609.6259963,19886,-4754432,336384,-4418048,71
9292,650,22,8,0.0653791994,0.934620801,2843.340001,3220.689591,4957.605037,5170.133846,9942,592.8443649,19884,-4757504,332800,-4424704,71
9302,643,22,8,0.0646556058,0.935344394,2843.787762,3227.395633,4955.94098,5219.785381,9945,770.9302326,19890,-4762624,329216,-4433408,71
9281,660,22,8,0.0663917111,0.933608289,2849.332859,3129.245465,4951.246417,5248.777273,9941,489.4633186,19882,-4751872,337920,-4413952,71
9232,707,22,8,0.0711339169,0.928866083,2836.006428,3247.376094,4940.936092,5349.516266,9939,579.1958042,19878,-4726784,361984,-4364800,71
9289,655,22,8,0.0658688656,0.934131134,2845.556621,3194.270494,4955.011088,5220.522137,9944,800,19888,-4755968,335360,-4420608,71
9304,638,22,8,0.0641721988,0.935827801,2839.412881,3283.65119,4968.553203,5014.473354,9942,773.6964981,19884,-4763648,326656,-4436992,71
8796,684,22,8,0.0721518987,0.927848101,2684.967212,3259.650729,4689.338336,5398.421053,9480,288.8482633,18960,-4503552,350208,-4153344,71
7936,449,22,8,0.0535480024,0.946451998,2398.823569,2712.428258,4225.641003,3616.075724,8385,540.2706186,16770,-4063232,229888,-3833344,71
9315,627,22,8,0.0630657815,0.936934218,2842.67395,3243.943082,4959.549651,5149.039872,9942,728.8856305,19884,-4769280,321024,-4448256,71
9256,683,22,8,0.068719187,0.931280813,2844.15456,3178.183304,4951.729797,5217.597365,9939,809.3648208,19878,-4739072,349696,-4389376,71
9277,663,22,8,0.0667002012,0.933299799,2840.968051,3230.094152,4951.67123,5233.960784,9940,594.4976077,19880,-4749824,339456,-4410368,71
9316,625,22,8,0.0628709385,0.937129061,2835.682095,3332.755277,4961.224453,5116.7104,9941,498.7957852,19882,-4769792,320000,-4449792,71
3152,220,22,8,0.0652431791,0.934756821,954.5241744,938.7486694,1738.24651,945.1136364,3372,60.86642599,6744,-1613824,112640,-1501184,71
9243,692,22,8,0.0696527428,0.930347257,2846.36294,3125.523291,4944.381478,5283.471098,9935,377.9003423,19870,-4732416,354304,-4378112,71
9276,662,22,8,0.0666130006,0.933386999,2844.596404,3166.31911,4943.091527,5339.537764,9938,402.1853501,19876,-4749312,338944,-4410368,71
9276,665,22,8,0.0668946786,0.933105321,2847.886539,3157.607366,4965.602415,5046.290226,9941,957.7071291,19882,-4749312,340480,-4408832,71
9265,673,22,8,0.0677198632,0.932280137,2840.287011,3225.003032,4950.306638,5233.729569,9938,713.9367816,19876,-4743680,344576,-4399104,71
6461,410,22,8,0.0596710814,0.940328919,1943.423689,2527.413357,3445.846309,3280.836585,6871,84.92151774,13742,-3308032,209920,-3098112,71
2879,234,22,8,0.0751686476,0.924831352,882.0076912,1069.674278,1543.951719,1717.538462,3113,134.9956635,6226,-1474048,119808,-1354240,71
2880,237,22,8,0.0760346487,0.923965351,884.1896633,1067.64469,1551.838194,1646.029536,3117,128.6952931,6234,-1474560,121344,-1353216,71
2856,222,22,8,0.0721247563,0.927875244,871.5802351,1080.864178,1534.039916,1609.743243,3078,219.2307692,6156,-1462272,113664,-1348608,71
2886,229,22,8,0.0735152488,0.926484751,881.7965037,1093.770599,1553.537076,1614.244541,3115,142.5629291,6230,-1477632,117248,-1360384,71
2872,223,22,8,0.0720516963,0.927948304,875.9711727,1092.454335,1543.83844,1601.596413,3095,304.6259843,6190,-1470464,114176,-1356288,71
2877,224,22,8,0.072234763,0.927765237,877.963802,1091.153841,1546.998262,1602.397321,3101,243.2156863,6202,-1473024,114688,-1358336,71
2862,227,22,8,0.0734865652,0.926513435,876.9841094,1059.865549,1543.485674,1564.092511,3089,54.62422635,6178,-1465344,116224,-1349120,71
2884,233,22,8,0.0747513635,0.925248637,880.5919714,1104.150847,1549.87448,1671.95279,3117,164.5723337,6234,-1476608,119296,-1357312,71
2902,237,22,8,0.0755017522,0.924498248,886.4364575,1113.933401,1561.048243,1679.611814,3139,185.5200946,6278,-1485824,121344,-1364480,71
2881,225,22,8,0.0724404379,0.927559562,879.2509003,1093.304235,1548.929885,1612.017778,3106,253.1377343,6212,-1475072,115200,-1359872,71
2890,223,22,8,0.0716350787,0.928364921,878.9415888,1117.783796,1548.84083,1662.73991,3113,213.3653187,6226,-1479680,114176,-1365504,71
2871,234,22,8,0.0753623188,0.924637681,877.6642722,1093.477239,1543.682689,1667.316239,3105,177.3272416,6210,-1469952,119808,-1350144,71
2887,223,22,8,0.0717041801,0.92829582,880.8056943,1093.262244,1552.499134,1594.349776,3110,289.3023256,6220,-1478144,114176,-1363968,71
1242,92,22,8,0.0689655172,0.931034483,378.2172612,396.2065018,685.3204509,426.923913,1334,23.80442541,2668,-635904,47104,-588800,71
2981,237,22,8,0.0736482287,0.926351771,911.8035433,1121.132028,1605.191882,1663.687764,3218,197.6658477,6436,-1526272,121344,-1404928,71
2890,233,22,8,0.074607749,0.925392251,883.0226411,1099.705688,1553.118339,1672.16309,3123,152.9382958,6246,-1479680,119296,-1360384,71
2896,245,22,8,0.0780006367,0.921999363,887.6416196,1099.014171,1559.75518,1703.918367,3141,152.1802326,6282,-1482752,125440,-1357312,71
2891,246,22,8,0.0784188715,0.921581128,886.302315,1099.172662,1558.130059,1696.743902,3137,171.3271436,6274,-1480192,125952,-1354240,71
2878,221,22,8,0.0713133269,0.928686673,876.2633598,1105.313331,1547.07401,1588.104072,3099,290.7129456,6198,-1473536,113152,-1360384,71
2923,238,22,8,0.0752926289,0.924707371,893.9130103,1112.001214,1573.772494,1669.764706,3161,187.8193702,6322,-1496576,121856,-1374720,71
9431,519,22,8,0.052160804,0.947839196,2828.677207,3571.5207,4968.852296,5096.298651,9950,262.1870883,19900,-4828672,265728,-4562944,71
9445,506,22,8,0.0508491609,0.949150839,2831.721334,3549.397392,4971.649127,5057.213439,9951,857.8448276,19902,-4835840,259072,-4576768,71
9445,506,22,8,0.0508491609,0.949150839,2833.150379,3523.098314,4965.323769,5175.282609,9951,792.2770701,19902,-4835840,259072,-4576768,71
9454,496,22,8,0.0498492462,0.950150754,2837.50533,3469.531155,4973.693675,5009.929435,9950,520.9424084,19900,-4840448,253952,-4586496,71
9442,510,22,8,0.0512459807,0.948754019,2832.692678,3532.087293,4968.262338,5129.009804,9952,928.358209,19904,-4834304,261120,-4573184,71
9133,484,22,8,0.050327545,0.949672455,2736.401391,3441.7482,4809.953794,4791.002066,9617,169.1347168,19234,-4676096,247808,-4428288,71
9439,512,22,8,0.0514521154,0.948547885,2831.262495,3546.762336,4968.565844,5113.052734,9951,930.8699719,19902,-4832768,262144,-4570624,71
9436,513,22,8,0.0515629712,0.948437029,2828.526082,3572.906855,4963.848665,5180.11501,9949,893.0879713,19898,-4831232,262656,-4568576,71
9431,518,22,8,0.0520655342,0.947934466,2827.759483,3556.196266,4951.32425,5406.054054,9949,1058.404255,19898,-4828672,265216,-4563456,71
9454,497,22,8,0.0499447292,0.950055271,2832.951772,3533.31533,4962.315316,5236.311871,9951,636.2531969,19902,-4840448,254464,-4585984,71
9452,500,22,8,0.0502411576,0.949758842,2832.954139,3543.230748,4972.128967,5059.13,9952,1120.720721,19904,-4839424,256000,-4583424,71
4639,235,22,8,0.0482150185,0.951784982,1388.967736,1510.505397,2478.654451,1625.093617,4874,86.51047213,9748,-2375168,120320,-2254848,71
3040,183,22,8,0.0567793981,0.943220602,913.5892133,998.6123615,1648.198684,1010.666667,3223,60.68536999,6446,-1556480,93696,-1462784,71
9446,505,22,8,0.0507486685,0.949251332,2834.490305,3509.560597,4972.804044,5035.780198,9951,663.8425617,19902,-4836352,258560,-4577792,71
9444,504,22,8,0.0506634499,0.94933655,2832.609763,3524.770028,4978.352922,4902.303571,9948,416.4085391,19896,-4835328,258048,-4577280,71
9459,493,22,8,0.0495377814,0.950462219,2837.654364,3480.404288,4974.543926,5014.030426,9952,821.1221122,19904,-4843008,252416,-4590592,71
9448,504,22,8,0.0506430868,0.949356913,2831.606574,3553.918311,4966.310436,5167.513889,9952,980.4926108,19904,-4837376,258048,-4579328,71
9438,514,22,8,0.05164791,0.94835209,2830.00436,3567.352161,4969.219008,5110.192607,9952,852.0547945,19904,-4832256,263168,-4569088,71
8947,454,22,8,0.0482927348,0.951707265,2673.982838,3405.008933,4703.336873,4654.947137,9401,571.836983,18802,-4580864,232448,-4348416,71
9113,498,22,8,0.0518156279,0.948184372,2730.931525,3475.556876,4808.925711,4752.461847,9611,130.4424539,19222,-4665856,254976,-4410880,71
9306,625,22,8,0.0629342463,0.937065754,2841.941576,3148.285132,5008.274339,4336.552,9931,558.2349635,19862,-4764672,320000,-4444672,71
9373,566,22,8,0.056947379,0.943052621,2845.388775,3068.101253,5030.562467,3967.081272,9939,976.3261297,19878,-4798976,289792,-4509184,71
1449,126,22,8,0.08,0.92,446.0605598,495.4589645,806.7149758,572.7777778,1575,81.10195675,3150,-741888,64512,-677376,71
9307,623,22,8,0.0627391742,0.937260826,2841.371229,3156.074862,5006.627914,4351.089888,9930,628.0834915,19860,-4765184,318976,-4446208,71
9337,594,22,8,0.0598127077,0.940187292,2841.415506,3145.889546,5013.890115,4213.222222,9931,810.0326264,19862,-4780544,304128,-4476416,71
9267,661,22,8,0.0665793715,0.933420629,2848.853484,2965.061297,5025.878494,4103.993949,9928,1157.109557,19856,-4744704,338432,-4406272,71
9353,582,22,8,0.058580775,0.941419225,2843.327638,3130.99818,5017.990484,4164.630584,9935,780.4399057,19870,-4788736,297984,-4490752,71
9259,668,22,8,0.0672912259,0.932708774,2839.319091,3141.142635,5009.673183,4330.934132,9927,1111.646137,19854,-4740608,342016,-4398592,71
1438,121,22,8,0.077613855,0.922386145,441.6505609,488.9075605,798.5097357,560.0247934,1559,30.4730258,3118,-736256,61952,-674304,71
7215,656,22,8,0.0833439207,0.916656079,2245.223347,2545.307753,3949.073874,3792.207317,7871,143.9992682,15742,-3694080,335872,-3358208,71
9349,585,22,8,0.0588886652,0.941111335,2842.359967,3120.681914,5021.702749,4101.275214,9934,1525.960061,19868,-4786688,299520,-4487168,71
9355,584,22,8,0.0587584264,0.941241574,2844.078275,3087.728562,5030.313843,4003.842466,9939,1382.336579,19878,-4789760,299008,-4490752,71
9394,550,22,8,0.0553097345,0.944690265,2845.715199,3051.77951,5038.743453,3841.061818,9944,1352.92517,19888,-4809728,281600,-4528128,71
9317,615,22,8,0.0619210632,0.938078937,2840.737093,3155.901206,5013.574648,4253.338211,9932,1067.956989,19864,-4770304,314880,-4455424,71
9219,703,22,8,0.0708526507,0.929147349,2836.549209,3180.958779,4990.445927,4581.908962,9922,686.6435986,19844,-4720128,359936,-4360192,71
9251,678,22,8,0.0682848222,0.931715178,2848.526055,3045.831473,5005.067344,4418.29941,9929,501.9716886,19858,-4736512,347136,-4389376,71
9344,593,22,8,0.0596759585,0.940324041,2844.830462,3055.925854,5031.356914,3986.431703,9937,945.4804948,19874,-4784128,303616,-4480512,71
9427,527,22,8,0.0529435403,0.94705646,2850.874554,2940.297416,5052.990135,3627.129032,9954,1346.955345,19908,-4826624,269824,-4556800,71
4215,386,22,8,0.0838948055,0.916105195,1326.547124,1258.767812,2342.793832,1844.624352,4601,83.7154294,9202,-2158080,197632,-1960448,71
1392,143,22,8,0.0931596091,0.906840391,431.9678534,487.9942557,790.5596264,548.3986014,1535,23.7358899,3070,-712704,73216,-639488,71
9409,556,19,11,0.0557952835,0.944204717,2853.893538,2997.746922,5053.212988,3794.809353,9965,1108.453838,19930,-4817408,284672,-4532736,72
9375,586,20,10,0.0588294348,0.941170565,2852.806966,3045.834597,5043.737493,3977.307167,9961,899.0072202,19922,-4800000,300032,-4499968,72
9311,638,20,10,0.0641270479,0.935872952,2849.124627,3077.59742,5030.035979,4171.802508,9949,754.2835481,19898,-4767232,326656,-4440576,72
9461,506,20,10,0.0507675329,0.949232467,2857.223771,3108.447228,5029.442025,4134.341897,9967,1245.875,19934,-4844032,259072,-4584960,72
9415,549,20,10,0.0550983541,0.944901646,2859.093251,3056.687018,5027.431227,4211.958106,9964,1179.171598,19928,-4820480,281088,-4539392,72
9305,643,21,9,0.0646361078,0.935363892,2854.044383,3027.564476,5023.928963,4259.202177,9948,326.8068331,19896,-4764160,329216,-4434944,72
9467,505,20,10,0.050641797,0.949358203,2859.65219,3057.991333,5037.980564,4021.417822,9972,954.2583732,19944,-4847104,258560,-4588544,72
9406,556,20,10,0.0558120859,0.944187914,2857.642656,3026.914932,5034.990751,4076.582734,9962,843.5224386,19924,-4815872,284672,-4531200,72
9256,693,20,10,0.0696552417,0.930344758,2852.737126,2989.588814,5039.024201,4119.865801,9949,586.269888,19898,-4739072,354816,-4384256,72
9383,581,20,10,0.0583099157,0.941690084,2855.823415,3014.702297,5045.120324,3971.197935,9964,896.0431655,19928,-4804096,297472,-4506624,72
9356,606,18,12,0.0608311584,0.939168842,2852.083264,3066.044499,5043.168234,4029.407591,9962,595.8133971,19924,-4790272,310272,-4480000,72
9359,601,20,10,0.0603413655,0.939658635,2852.993756,3091.471974,5032.23838,4174.810316,9960,567.1981777,19920,-4791808,307712,-4484096,72
9409,556,21,9,0.0557952835,0.944204717,2855.774056,3025.760041,5044.436497,3943.330935,9965,1084.330794,19930,-4817408,284672,-4532736,72
9413,550,19,11,0.0552042557,0.944795744,2862.627559,3011.126935,5023.158398,4277.592727,9963,817.9802956,19926,-4819456,281600,-4537856,72
9391,571,20,10,0.0573178077,0.942682192,2859.241869,3004.480247,5034.410286,4111.30648,9962,899.9096658,19924,-4808192,292352,-4515840,72
9291,658,19,11,0.0661373002,0.9338627,2849.250144,3043.474942,5037.200194,4096.729483,9949,417.849643,19898,-4756992,336896,-4420096,72
9478,490,20,10,0.0491573034,0.950842697,2858.873735,3138.445498,5020.093269,4296.02449,9968,1440.462428,19936,-4852736,250880,-4601856,72
9408,553,20,10,0.0555165144,0.944483486,2862.482146,2974.835295,5028.414009,4174.361664,9961,765.641814,19922,-4816896,283136,-4533760,72
9477,491,19,11,0.0492576244,0.950742376,2861.34012,3031.540275,5031.926454,4069.101833,9968,1205.320435,19936,-4852224,251392,-4600832,72
9300,656,21,9,0.0658899156,0.934110084,2859.134703,2950.555736,5038.192043,4132.256098,9956,406.5332789,19912,-4761600,335872,-4425728,72
4052,400,18,12,0.0898472597,0.91015274,1254.112076,1527.826149,2194.33539,2552.3275,4452,150.3038488,8904,-2074624,204800,-1869824,72
4060,387,20,10,0.0870249606,0.912975039,1252.136015,1558.611019,2201.792118,2456.981912,4447,82.67335936,8894,-2078720,198144,-1880576,72
4026,396,20,10,0.0895522388,0.910447761,1245.090906,1521.429816,2178.917536,2542.755051,4422,151.1794872,8844,-2061312,202752,-1858560,72
2968,191,20,10,0.0604621716,0.939537828,897.5247594,990.862418,1611.479784,1090.827225,3159,80.29994916,6318,-1519616,97792,-1421824,72
4106,414,21,9,0.0915929204,0.90840708,1272.374582,1546.563725,2224.572333,2616.826087,4520,152.857626,9040,-2102272,211968,-1890304,72
4104,391,20,10,0.0869855395,0.913014461,1268.029392,1540.350903,2218.188109,2560.910486,4495,121.8487395,8990,-2101248,200192,-1901056,72
4082,389,19,11,0.0870051443,0.912994856,1259.775898,1535.584615,2202.601666,2586.467866,4471,154.6523694,8942,-2089984,199168,-1890816,72
4133,414,19,11,0.0910490433,0.908950957,1278.275232,1588.487358,2245.734091,2556.181159,4547,155.6125941,9094,-2116096,211968,-1904128,72
4098,376,20,10,0.0840411265,0.915958873,1260.22893,1567.551287,2212.440703,2510.619681,4474,147.122657,8948,-2098176,192512,-1905664,72
4098,387,19,11,0.0862876254,0.913712375,1261.860123,1577.902614,2218.156174,2506.074935,4485,150.7056452,8970,-2098176,198144,-1900032,72
4028,381,19,11,0.0864141529,0.913585847,1243.198453,1517.561979,2175.915591,2512.485564,4409,148.0523842,8818,-2062336,195072,-1867264,72
4010,381,19,11,0.0867683899,0.91323161,1235.182486,1525.084634,2162.756359,2545.887139,4391,138.2556675,8782,-2053120,195072,-1858048,72
4075,388,19,11,0.0869370379,0.913062962,1258.04819,1529.005543,2198.871902,2579.930412,4463,152.685597,8926,-2086400,198656,-1887744,72
4045,370,20,10,0.0838052095,0.91619479,1245.40335,1533.357268,2184.060569,2469.716216,4415,95.02798106,8830,-2071040,189440,-1881600,72
4124,404,19,11,0.0892226148,0.910777385,1276.22192,1559.585565,2236.284433,2552.522277,4528,97.7336499,9056,-2111488,206848,-1904640,72
3505,290,20,10,0.0764163373,0.923583663,1077.3741,1286.257122,1909.878174,1754.437931,3795,67.14437367,7590,-1794560,148480,-1646080,72
4004,388,19,11,0.0883424408,0.911657559,1237.36146,1513.997315,2166.692308,2504.103093,4392,146.7423989,8784,-2050048,198656,-1851392,72
4087,396,20,10,0.0883337051,0.911666295,1263.648971,1550.952946,2216.837534,2501.694444,4483,137.2627067,8966,-2092544,202752,-1889792,72
4074,399,19,11,0.0892018779,0.910798122,1258.659702,1560.68859,2210.576829,2506.794486,4473,139.8249453,8946,-2085888,204288,-1881600,72
4074,406,21,9,0.090625,0.909375,1261.179758,1535.853174,2205.440108,2592.307882,4480,130.994152,8960,-2085888,207872,-1878016,72
2709,300,19,11,0.0997008973,0.900299103,848.003543,1030.878447,1493.767073,1606.433333,3009,80.00531773,6018,-1387008,153600,-1233408,72
2733,328,19,11,0.107154525,0.892845475,857.839622,1050.97609,1505.501647,1743.460366,3061,95.38797133,6122,-1399296,167936,-1231360,72
2794,332,21,9,0.106206014,0.893793986,878.4481508,1059.233718,1538.058339,1777.608434,3126,96.42196175,6252,-1430528,169984,-1260544,72
2753,328,20,10,0.106458942,0.893541058,864.5145037,1049.380993,1514.275336,1765.307927,3081,93.47694175,6162,-1409536,167936,-1241600,72
2707,324,19,11,0.106895414,0.893104586,849.8519891,1038.812657,1491.09457,1724.083333,3031,93.14689613,6062,-1385984,165888,-1220096,72
2756,313,21,9,0.101987618,0.898012382,863.3136769,1050.026271,1516.080914,1701.584665,3069,89.42307692,6138,-1411072,160256,-1250816,72
2746,321,20,10,0.104662537,0.895337463,860.3401698,1030.665641,1499.846686,1826.165109,3067,97.02625751,6134,-1405952,164352,-1241600,72
2773,337,20,10,0.108360129,0.891639871,870.97767,1069.164123,1529.086909,1772.839763,3110,111.8302769,6220,-1419776,172544,-1247232,72
2769,356,19,11,0.11392,0.88608,866.6513567,1086.902696,1521.030336,1889.44382,3125,55.29016277,6250,-1417728,182272,-1235456,72
2799,342,19,11,0.108882521,0.891117479,877.0657794,1087.146097,1539.768846,1826.602339,3141,104.0410732,6282,-1433088,175104,-1257984,72
2693,313,18,12,0.104125083,0.895874917,842.7700589,1032.616352,1477.830301,1724.357827,3006,92.06738132,6012,-1378816,160256,-1218560,72
2787,321,21,9,0.103281853,0.896718147,873.5983774,1059.165991,1531.097955,1757.682243,3108,87.54929577,6216,-1426944,164352,-1262592,72
2720,315,19,11,0.103789127,0.896210873,857.3076409,1001.67085,1494.491912,1720.990476,3035,84.14194622,6070,-1392640,161280,-1231360,72
2748,331,19,11,0.107502436,0.892497564,863.3034065,1050.394522,1512.589884,1767.561934,3079,98.21371611,6158,-1406976,169472,-1237504,72
2750,342,18,12,0.110608021,0.889391979,864.1803692,1073.698558,1521.592727,1746.777778,3092,85.06189821,6184,-1408000,175104,-1232896,72
2746,325,20,10,0.10582872,0.89417128,859.0010838,1066.616166,1509.962491,1755.996923,3071,106.9662139,6142,-1405952,166400,-1239552,72
2765,326,20,10,0.105467486,0.894532514,866.0007372,1068.069908,1521.685353,1752.226994,3091,94.67075038,6182,-1415680,166912,-1248768,72
2713,318,19,11,0.104915869,0.895084131,848.6720922,1054.360938,1493.632879,1706.823899,3031,107.8647687,6062,-1389056,162816,-1226240,72
1359,112,21,9,0.0761386812,0.923861319,414.6350456,428.0319744,760.9249448,433.5625,1471,22.61685117,2942,-695808,57344,-638464,72
1453,115,19,11,0.0733418367,0.926658163,441.8830475,487.2757693,807.2360633,497.2347826,1568,23.70728757,3136,-743936,58880,-685056,72
2714,328,19,11,0.1078238,0.8921762,854.6085674,1023.697651,1493.372881,1754.234756,3042,99.21722114,6084,-1389568,167936,-1221632,72
2686,322,19,11,0.107047872,0.892952128,843.230277,1032.642318,1480.183172,1707.341615,3008,83.53235212,6016,-1375232,164864,-1210368,72
2720,339,19,11,0.11082053,0.88917947,857.4829877,1044.719203,1504.929779,1731.153392,3059,107.0328901,6118,-1392640,173568,-1219072,72
2752,347,20,10,0.111971604,0.888028396,866.3040419,1071.037723,1523.853924,1757.360231,3099,98.41219435,6198,-1409024,177664,-1231360,72
2738,352,21,9,0.113915858,0.886084142,859.4486556,1068.350312,1507.644631,1839.954545,3090,54.69026549,6180,-1401856,180224,-1221632,72
2748,326,20,10,0.106050748,0.893949252,860.973189,1068.820022,1516.707424,1712.769939,3074,104.1327913,6148,-1406976,166912,-1240064,72
2701,333,19,11,0.109756098,0.890243902,850.2185683,1047.184996,1497.61866,1678.75976,3034,53.98576512,6068,-1382912,170496,-1212416,72
2683,320,19,11,0.106560107,0.893439893,843.8000679,1033.988323,1488.867685,1612.10625,3003,52.68421053,6006,-1373696,163840,-1209856,72
2648,345,19,11,0.115268961,0.884731039,834.7976451,1042.607744,1472.398414,1685.826087,2993,82.29309871,5986,-1355776,176640,-1179136,72
2744,330,19,11,0.107351984,0.892648016,858.7756142,1070.060707,1510.169461,1764.757576,3074,88.92102979,6148,-1404928,168960,-1235968,72
2751,352,20,10,0.113438608,0.886561392,867.6462401,1069.43345,1526.122864,1754.238636,3103,105.5801293,6206,-1408512,180224,-1228288,72
2704,317,19,11,0.104932142,0.895067858,849.979796,1024.062998,1489.788092,1691.936909,3021,92.35707735,6042,-1384448,162304,-1222144,72
2777,354,19,11,0.113062919,0.886937081,870.1604543,1102.406612,1534.157004,1815.79661,3131,54.87206449,6262,-1421824,181248,-1240576,72
2738,337,20,10,0.109593496,0.890406504,860.4988493,1060.55469,1512.239226,1747.296736,3075,104.6986721,6150,-1401856,172544,-1229312,72
2735,326,20,10,0.106501143,0.893498857,857.7552813,1049.873364,1504.180987,1756,3061,80.40451799,6122,-1400320,166912,-1233408,72
2864,343,19,11,0.106953539,0.893046461,899.3144259,1102.867093,1580.236034,1802.425656,3207,88.88580931,6414,-1466368,175616,-1290752,72
2732,339,19,11,0.110387496,0.889612504,859.3035538,1063.927428,1513.511713,1717.233038,3071,74.93899463,6142,-1398784,173568,-1225216,72
2728,328,19,11,0.107329843,0.892670157,855.8493476,1056.705753,1505.104106,1723.085366,3056,97.35584581,6112,-1396736,167936,-1228800,72
2750,341,20,10,0.110320285,0.889679715,862.9939129,1081.399567,1522.163273,1738.231672,3091,100.5857468,6182,-1408000,174592,-1233408,72
2686,307,19,11,0.10257267,0.89742733,843.5963821,1004.042954,1474.468354,1694.13355,2993,89.47683109,5986,-1375232,157184,-1218048,72
8607,518,23,7,0.0567671233,0.943232877,2603.984068,3092.292889,4566.187522,4510.03668,9125,228.1820455,18250,-4406784,265216,-4141568,72
8571,508,23,7,0.0559532988,0.944046701,2591.060072,3080.789291,4540.683468,4528.468504,9079,241.9131362,18158,-4388352,260096,-4128256,72
8582,520,22,8,0.057130301,0.942869699,2580.753138,3262.833169,4520.489863,5063.286538,9102,158.9036313,18204,-4393984,266240,-4127744,72
8549,505,23,7,0.0557764524,0.944223548,2581.575043,3102.427052,4517.821734,4691.340594,9054,287.9770992,18108,-4377088,258560,-4118528,72
8616,476,23,7,0.0523537176,0.947646282,2600.243093,3031.233796,4551.037372,4464.369748,9092,284.4806008,18184,-4411392,243712,-4167680,72
8558,502,23,7,0.0554083885,0.944591611,2583.068469,3112.311631,4522.678313,4663.842629,9060,292.0696325,18120,-4381696,257024,-4124672,72
8566,518,23,7,0.0570233377,0.942976662,2594.084169,3051.012669,4546.22064,4480.972973,9084,225.2417555,18168,-4385792,265216,-4120576,72
8562,505,23,7,0.0556964817,0.944303518,2589.651829,3049.932012,4533.744569,4538.330693,9067,249.2303463,18134,-4383744,258560,-4125184,72
8576,502,23,7,0.0552985239,0.944701476,2573.789433,3288.090339,4513.473764,4984.123506,9078,325.2597635,18156,-4390912,257024,-4133888,72
8593,508,22,8,0.055818042,0.944181958,2599.910988,3050.558594,4557.337717,4443.795276,9101,187.8819158,18202,-4399616,260096,-4139520,72
8587,502,23,7,0.0552315986,0.944768401,2571.886209,3363.805996,4520.893909,4957.348606,9089,203.5610302,18178,-4396544,257024,-4139520,72
8549,485,22,8,0.0536860748,0.946313925,2571.402386,3181.924288,4512.665575,4602.715464,9034,303.2561262,18068,-4377088,248320,-4128768,72
8563,497,23,7,0.0548565121,0.945143488,2583.150111,3111.546239,4518.288801,4740.891348,9060,291.8814433,18120,-4384256,254464,-4129792,72
8527,495,23,7,0.0548658834,0.945134117,2571.754464,3103.884662,4497.42125,4754.024242,9022,295.9002952,18044,-4365824,253440,-4112384,72
8679,508,23,7,0.0552955263,0.944704474,2616.169328,3194.962673,4580.554442,4823.712598,9187,302.7018122,18374,-4443648,260096,-4183552,72
8596,526,22,8,0.0576627932,0.942337207,2601.400536,3083.948203,4584.652978,4183.129278,9122,199.4315697,18244,-4401152,269312,-4131840,72
8655,501,23,7,0.0547182176,0.945281782,2614.211989,3098.930189,4573.721895,4661.043912,9156,265.0072359,18312,-4431360,256512,-4174848,72
8669,532,23,7,0.0578198022,0.942180198,2606.730402,3294.706756,4561.774714,5240.180451,9201,288.9761307,18402,-4438528,272384,-4166144,72
8433,431,23,7,0.0486236462,0.951376354,2545.965656,2624.902186,4480.85699,3486.341067,8864,199.1015274,17728,-4317696,220672,-4097024,72
4646,220,23,7,0.0452116728,0.954788327,1386.280809,1587.560971,2467.439518,1716.759091,4866,74.5518615,9732,-2378752,112640,-2266112,72
2410,335,22,8,0.122040073,0.877959927,784.2478951,846.4261246,1364.663485,1432.973134,2745,149.1847826,5490,-1233920,171520,-1062400,72
2388,324,23,7,0.119469027,0.880530973,774.060149,836.1585644,1340.886097,1471.580247,2712,110.7843137,5424,-1222656,165888,-1056768,72
4609,458,22,8,0.0903887902,0.90961121,1443.323209,1639.564553,2546.899327,2404.189956,5067,169.5215791,10134,-2359808,234496,-2125312,72
2571,338,22,8,0.116191131,0.883808869,829.0784657,915.0816012,1447.840918,1509.455621,2909,143.5834156,5818,-1316352,173056,-1143296,72
7207,548,22,8,0.0706640877,0.929335912,2206.540802,2556.274579,3921.721521,3302.998175,7755,299.3052875,15510,-3689984,280576,-3409408,72
2519,351,23,7,0.122299652,0.877700348,818.0524061,897.2003657,1426.392616,1500.860399,2870,142.149579,5740,-1289728,179712,-1110016,72
2287,315,23,7,0.121060723,0.878939277,743.2974918,803.5952552,1293.919108,1356.539683,2602,97.19835637,5204,-1170944,161280,-1009664,72
2605,323,23,7,0.110314208,0.889685792,833.965963,926.9431144,1454.104415,1548.340557,2928,133.8820302,5856,-1333760,165376,-1168384,72
2415,335,23,7,0.121818182,0.878181818,784.6879726,855.072198,1367.925466,1430.104478,2750,111.2009705,5500,-1236480,171520,-1064960,72
2398,328,22,8,0.120322817,0.879677183,781.0674433,822.9639932,1351.212677,1453.332317,2726,120.619469,5452,-1227776,167936,-1059840,72
2570,341,22,8,0.117141876,0.882858124,831.2987174,905.2522937,1453.211673,1477.014663,2911,149.6658098,5822,-1315840,174592,-1141248,72
2604,342,23,7,0.116089613,0.883910387,841.1478815,915.486767,1464.97427,1538.415205,2946,110.6271123,5892,-1333248,175104,-1158144,72
82,13,24,6,0.136842105,0.863157895,25.7519167,36.22056038,47.90243902,48.61538462,95,12.13282248,190,-41984,6656,-35328,72
2363,347,23,7,0.12804428,0.87195572,773.9160888,829.7181146,1340.152772,1460.011527,2710,140.8523909,5420,-1209856,177664,-1032192,72
2596,347,23,7,0.117906898,0.882093102,836.1178527,936.6856911,1457.12057,1583.317003,2943,131.091314,5886,-1329152,177664,-1151488,72
2389,322,23,7,0.11877536,0.88122464,769.8082501,860.5203024,1338.433236,1486.332298,2711,125.9758364,5422,-1223168,164864,-1058304,72
2646,370,23,7,0.122679045,0.877320955,851.1419236,973.2557513,1478.942555,1719.875676,3016,53.06122449,6032,-1354752,189440,-1165312,72
2389,330,23,7,0.12136815,0.87863185,775.1326937,841.5561631,1342.503977,1486.660606,2719,141.6145833,5438,-1223168,168960,-1054208,72
2681,364,23,7,0.11954023,0.88045977,864.8022266,975.6309014,1515.604625,1577.46978,3045,103.3955857,6090,-1372672,186368,-1186304,72
2386,328,23,7,0.120854827,0.879145173,772.6392846,857.5796457,1353.613998,1385.768293,2714,107.6130056,5428,-1221632,167936,-1053696,72
2635,322,20,10,0.108894149,0.891105851,829.4523606,999.9879746,1450.408729,1712.968944,2957,84.84935438,5914,-1349120,164864,-1184256,72
2642,327,19,11,0.110138094,0.889861906,832.9275176,992.6696974,1452.199092,1750.015291,2969,101.0551396,5938,-1352704,167424,-1185280,72
2612,301,21,9,0.1033299,0.8966701,819.4260911,981.5238247,1431.809724,1675.594684,2913,91.83480454,5826,-1337344,154112,-1183232,72
1937,176,20,10,0.0832938949,0.916706105,595.1987214,751.7435298,1061.663913,1005.670455,2113,54.96878252,4226,-991744,90112,-901632,72
2632,320,19,11,0.108401084,0.891598916,827.6144613,1010.961419,1452.583967,1673.209375,2952,84.90077653,5904,-1347584,163840,-1183744,72
2631,316,19,11,0.107227689,0.892772311,827.0943497,1001.472839,1448.396427,1687.174051,2947,83.50807594,5894,-1347072,161792,-1185280,72
2602,311,20,10,0.106762788,0.893237212,818.4038213,981.4336366,1430.178709,1681.401929,2913,81.48251748,5826,-1332224,159232,-1172992,72
2583,289,20,10,0.100626741,0.899373259,810.630645,969.2826892,1422.200542,1564.304498,2872,86.66264333,5744,-1322496,147968,-1174528,72
2610,308,20,10,0.105551748,0.894448252,821.1944067,970.5358276,1430.848276,1702.295455,2918,96.94352159,5836,-1336320,157696,-1178624,72
2628,324,19,11,0.109756098,0.890243902,827.8386902,1006.876682,1452.11796,1674.265432,2952,64.7510419,5904,-1345536,165888,-1179648,72
2579,280,20,10,0.0979363414,0.902063659,809.5405952,944.8246729,1413.339279,1583.457143,2859,94.20098847,5718,-1320448,143360,-1177088,72
2562,285,20,10,0.100105374,0.899894626,803.2461528,965.8056963,1411.263076,1538.498246,2847,97.2668261,5694,-1311744,145920,-1165824,72
2633,314,20,10,0.106549033,0.893450967,827.5262556,1001.945923,1449.7406,1677.423567,2947,105.4382826,5894,-1348096,160768,-1187328,72
2636,322,20,10,0.108857336,0.891142664,828.7662413,1010.886885,1452.831942,1697.813665,2958,97.14285714,5916,-1349632,164864,-1184768,72
2610,311,20,10,0.106470387,0.893529613,821.2490322,974.3908002,1431.522989,1708.379421,2921,99.5229983,5842,-1336320,159232,-1177088,72
2630,310,20,10,0.105442177,0.894557823,824.2334386,996.8520587,1440.192015,1727.629032,2940,90.88098918,5880,-1346560,158720,-1187840,72
2541,299,19,11,0.10528169,0.89471831,797.2001149,954.1597149,1390.4695,1675.70903,2840,51.45859757,5680,-1300992,153088,-1147904,72
2641,315,19,11,0.106562923,0.893437077,830.5132003,1001.068212,1453.787202,1685.695238,2956,97.36495389,5912,-1352192,161280,-1190912,72
2635,309,20,10,0.104959239,0.895040761,827.1708007,1000.473043,1448.76129,1674.932039,2944,100.5807995,5888,-1349120,158208,-1190912,72
1294,110,20,10,0.0783475783,0.921652422,396.9558784,427.2095204,722.5741886,466.3545455,1404,21.47445702,2808,-662528,56320,-606208,72
8302,404,23,7,0.0464047783,0.953595222,2490.450775,2930.225248,4366.046254,4095.680693,8706,694.2583732,17412,-4250624,206848,-4043776,72
8352,402,22,8,0.0459218643,0.954078136,2509.897479,2853.85141,4386.643918,4187.524876,8754,632.5144509,17508,-4276224,205824,-4070400,72
8306,397,23,7,0.0456164541,0.954383546,2500.137859,2607.484155,4393.567782,3482.322418,8703,190.4793171,17406,-4252672,203264,-4049408,72
8360,418,23,7,0.0476190476,0.952380952,2510.918019,2916.418884,4413.58122,3907.875598,8778,607.0539419,17556,-4280320,214016,-4066304,72
8345,411,23,7,0.0469392417,0.953060758,2513.118475,2744.326378,4406.693469,3806.055961,8756,453.2091097,17512,-4272640,210432,-4062208,72
8368,410,23,7,0.0467076783,0.953292322,2509.31571,2993.362373,4390.775574,4363.465854,8778,617.7339901,17556,-4284416,209920,-4074496,72
8529,375,24,6,0.042115903,0.957884097,2548.935691,3015.815814,4455.974792,4373.469333,8904,766.2650602,17808,-4366848,192000,-4174848,72
9584,394,23,7,0.0394868711,0.960513129,2861.509139,3167.268587,5027.801127,4057.829949,9978,985.9683794,19956,-4907008,201728,-4705280,72
8327,402,23,7,0.0460533853,0.953946615,2499.948619,2857.301873,4388.777351,3872.477612,8729,529.6723301,17458,-4263424,205824,-4057600,72
9600,379,23,7,0.0379797575,0.962020243,2868.602121,3080.1249,5019.270938,4248.572559,9979,1274.457216,19958,-4915200,194048,-4721152,72
9568,405,22,8,0.040609646,0.959390354,2864.255343,3123.039414,5017.177153,4274.074074,9973,286.4981327,19946,-4898816,207360,-4691456,72
8289,390,23,7,0.0449360525,0.955063947,2494.74235,2606.495762,4376.120762,3572.294872,8679,192.8238169,17358,-4243968,199680,-4044288,72
9545,429,23,7,0.0430118308,0.956988169,2868.695766,2995.531877,5023.383447,4189.114219,9974,217.3931997,19948,-4887040,219648,-4667392,72
8324,401,23,7,0.0459598854,0.954040115,2497.274933,2921.387425,4372.308025,4169.783042,8725,794.6265938,17450,-4261888,205312,-4056576,72
9548,427,23,7,0.0428070175,0.957192982,2864.453049,3056.580304,5029.186217,4067.04918,9975,959.1346154,19950,-4888576,218624,-4669952,72
9570,406,23,7,0.0406976744,0.959302326,2864.37978,3145.892416,5017.519749,4304.463054,9976,1506.94864,19952,-4899840,207872,-4691968,72
8356,408,23,7,0.0465540849,0.953445915,2506.965165,2958.951085,4388.568573,4258.213235,8764,915.7784744,17528,-4278272,208896,-4069376,72
8377,412,22,8,0.0468767778,0.953123222,2517.107257,2893.687675,4411.983884,4049.674757,8789,574.4444444,17578,-4289024,210944,-4078080,72
5256,244,23,7,0.0443636364,0.955636364,1577.746163,1666.401659,2780.035198,2114.282787,5500,98.00427655,11000,-2691072,124928,-2566144,72
4661,230,23,7,0.0470251482,0.952974852,1402.421607,1458.056828,2476.796396,1821.904348,4891,69.34637743,9782,-2386432,117760,-2268672,72
2932,336,21,9,0.102815177,0.897184823,915.2282461,1121.243542,1602.017735,1917.946429,3268,98.97032102,6536,-1501184,172032,-1329152,72
2947,339,20,10,0.103164942,0.896835058,921.9804087,1133.378634,1619.653885,1850.79941,3286,99.00572462,6572,-1508864,173568,-1335296,72
3030,352,20,10,0.104080426,0.895919574,947.909875,1166.606838,1664.028383,1927.974432,3382,102.8276072,6764,-1551360,180224,-1371136,72
2510,258,20,10,0.0932080925,0.906791908,772.1248717,1009.475855,1367.25259,1552.294574,2768,53.44661131,5536,-1285120,132096,-1153024,72
2931,330,19,11,0.101195952,0.898804048,915.3286645,1121.44949,1605.301262,1859.251515,3261,83.72272144,6522,-1500672,168960,-1331712,72
2947,320,20,10,0.0979491889,0.902050811,915.5563262,1146.978399,1612.031558,1836.315625,3267,104.0777318,6534,-1508864,163840,-1345024,72
3029,448,20,10,0.128846707,0.871153293,958.2058255,1177.127756,1673.428854,2182.337054,3477,77.7852349,6954,-1550848,229376,-1321472,72
2878,310,21,9,0.0972396487,0.902760351,891.7875185,1128.557848,1570.958999,1813.051613,3188,55.87101297,6376,-1473536,158720,-1314816,72
2949,341,18,12,0.103647416,0.896352584,921.0969125,1145.856746,1620.425229,1862.348974,3290,97.85841761,6580,-1509888,174592,-1335296,72
2865,310,19,11,0.0976377953,0.902362205,894.8362315,1081.545594,1569.129843,1762.396774,3175,97.4524248,6350,-1466880,158720,-1308160,72
2933,324,19,11,0.0994780473,0.900521953,914.9350721,1117.871032,1603.556768,1859.324074,3257,109.5526404,6514,-1501696,165888,-1335808,72
2927,320,20,10,0.09855251,0.90144749,910.5059282,1129.69169,1599.496413,1848.13125,3247,100,6494,-1498624,163840,-1334784,72
2414,258,20,10,0.0965568862,0.903443114,750.514807,943.3827053,1340.474316,1299.313953,2672,47.37588652,5344,-1235968,132096,-1103872,72
2931,324,20,10,0.0995391705,0.900460829,912.1582449,1134.243984,1603.013647,1854.033951,3255,90.66852368,6510,-1500672,165888,-1334784,72
2953,339,20,10,0.102976914,0.897023086,923.6154837,1127.790947,1618.338977,1891.80826,3292,100.0607903,6584,-1511936,173568,-1338368,72
2454,268,18,12,0.0984570169,0.901542983,758.7915608,995.5036229,1352.211084,1446.55597,2722,51.011994,5444,-1256448,137216,-1119232,72
2939,340,20,10,0.103690149,0.896309851,918.850416,1120.022261,1607.428377,1921.552941,3279,93.68571429,6558,-1504768,174080,-1330688,72
2901,303,19,11,0.0945692884,0.905430712,901.9984123,1116.259608,1592.425371,1698.957096,3204,108.4263959,6408,-1485312,155136,-1330176,72
2946,338,19,11,0.102923264,0.897076736,922.6047945,1110.231361,1611.705703,1910.902367,3284,103.628905,6568,-1508352,173056,-1335296,72
2936,342,20,10,0.10433191,0.89566809,920.540845,1118.591339,1613.26158,1864.751462,3278,104.9631764,6556,-1503232,175104,-1328128,72
3280,346,23,7,0.0954219526,0.904578047,1015.970617,1260.419861,1780.439634,2126.904624,3626,114.4932112,7252,-1679360,177152,-1502208,72
3240,333,23,7,0.0931989924,0.906801008,1001.278345,1255.786712,1758.75,2061.864865,3573,119.4983278,7146,-1658880,170496,-1488384,72
3266,358,23,7,0.098785872,0.901214128,1013.059866,1274.946485,1781.151562,2098.488827,3624,117.3955296,7248,-1672192,183296,-1488896,72
3236,320,23,7,0.0899887514,0.910011249,998.86177,1237.665999,1750.419036,2062.46875,3556,121.0759278,7112,-1656832,163840,-1492992,72
3260,342,23,7,0.0949472515,0.905052748,1011.499846,1249.799044,1774.586503,2058.04386,3602,112.3868955,7204,-1669120,175104,-1494016,72
3305,346,23,7,0.0947685566,0.905231443,1023.425563,1274.198544,1795.625416,2116.138728,3651,131.1422414,7302,-1692160,177152,-1515008,72
3293,335,23,7,0.092337376,0.907662624,1018.561411,1257.321546,1783.86942,2115.59403,3628,130.0824668,7256,-1686016,171520,-1514496,72
3265,347,24,6,0.09606866,0.90393134,1014.421551,1247.304694,1778.154977,2073.204611,3612,97.80666125,7224,-1671680,177664,-1494016,72
427,97,23,7,0.185114504,0.814885496,152.8879333,134.0571901,273.2295082,215.2680412,524,19.25762587,1048,-218624,49664,-168960,72
3254,354,23,7,0.0981152993,0.901884701,1009.106891,1273.557083,1776.355562,2063.206215,3608,133.0874216,7216,-1666048,181248,-1484800,72
3209,289,23,7,0.0826186392,0.917381361,985.6236659,1189.509582,1717.215644,2107.979239,3498,104.1071429,6996,-1643008,147968,-1495040,72
3349,353,23,7,0.0953538628,0.904646137,1036.633762,1295.842316,1819.349358,2156.521246,3702,104.8428207,7404,-1714688,180736,-1533952,72
3259,336,23,7,0.0934631433,0.906536857,1008.872972,1249.068766,1768.418226,2084.925595,3595,117.2920065,7190,-1668608,172032,-1496576,72
3272,346,23,7,0.0956329464,0.904367054,1012.515559,1272.074744,1778.770171,2100.101156,3618,133.7028825,7236,-1675264,177152,-1498112,72
3186,328,23,7,0.093340922,0.906659078,985.0537989,1232.370166,1729.719083,2027.347561,3514,118.077957,7028,-1631232,167936,-1463296,72
3236,354,22,8,0.0986072423,0.901392758,1000.767663,1252.254025,1752.884734,2185.056497,3590,63.1264287,7180,-1656832,181248,-1475584,72
3288,331,23,7,0.0914617298,0.90853827,1024.190056,1176.821731,1775.623783,2151.477341,3619,130.5084746,7238,-1683456,169472,-1513984,72
2731,220,22,8,0.0745509997,0.925449,830.8871442,1075.936809,1482.291468,1397.9,2951,75.99793974,5902,-1398272,112640,-1285632,72
3222,325,23,7,0.0916267268,0.908373273,996.5740193,1243.864037,1752.672253,1985.44,3547,90.27742428,7094,-1649664,166400,-1483264,72
3346,340,23,7,0.0922409116,0.907759088,1036.520751,1269.653524,1814.549611,2128.405882,3686,105.7675753,7372,-1713152,174080,-1539072,72
9579,405,23,7,0.0405649038,0.959435096,2858.127811,3166.503364,5043.876396,3777.353086,9984,1175.971731,19968,-4904448,207360,-4697088,73
9614,370,23,7,0.0370592949,0.962940705,2865.162019,3223.376115,5017.857916,4333.605405,9984,1492.376682,19968,-4922368,189440,-4732928,73
9610,374,22,8,0.0374599359,0.962540064,2867.851409,3122.262562,5023.710198,4190.548128,9984,574.7841105,19968,-4920320,191488,-4728832,73
9595,389,23,7,0.0389623397,0.96103766,2861.534767,3153.696607,5037.448254,3883.81491,9984,952.6717557,19968,-4912640,199168,-4713472,73
9574,410,23,7,0.0410657051,0.958934295,2854.963353,3277.222434,5038.55891,3916.968293,9984,1234.116193,19968,-4901888,209920,-4691968,73
9617,367,22,8,0.0367588141,0.963241186,2867.840127,3155.25576,5019.103879,4295.362398,9984,541.1382114,19968,-4923904,187904,-4736000,73
9619,365,23,7,0.0365584936,0.963441506,2869.8443,3104.617631,5019.634162,4277.421918,9984,748.4257871,19968,-4924928,186880,-4738048,73
9591,393,22,8,0.0393629808,0.960637019,2859.420656,3256.809174,5030.223334,4071.877863,9984,1008.484848,19968,-4910592,201216,-4709376,73
9575,409,22,8,0.0409655449,0.959034455,2855.980309,3191.939579,5045.92846,3741.699267,9984,870.4446382,19968,-4902400,209408,-4692992,73
9615,369,22,8,0.0369591346,0.963040865,2867.543211,3134.73845,5023.231929,4191.720867,9984,867.4196351,19968,-4922880,188928,-4733952,73
9608,376,22,8,0.0376602564,0.962339744,2862.466515,3179.895836,5032.429017,3972.18617,9984,1234.116193,19968,-4919296,192512,-4726784,73
9631,353,22,8,0.0353565705,0.964643429,2868.883624,3183.722915,5010.479078,4501.971671,9984,474.9762131,19968,-4931072,180736,-4750336,73
7655,352,22,8,0.0439615337,0.956038466,2283.728042,2569.953001,4059.166297,2804.289773,8007,140.6464079,16014,-3919360,180224,-3739136,73
9599,385,22,8,0.0385616987,0.961438301,2863.75333,3142.949975,5033.019481,3982.249351,9984,1104.424779,19968,-4914688,197120,-4717568,73
9572,412,22,8,0.0412660256,0.958733974,2852.744097,3223.340601,5049.550251,3667.050971,9984,1097.142857,19968,-4900864,210944,-4689920,73
7383,315,22,8,0.0409197194,0.959080281,2204.976288,2412.759715,3889.277259,2917.196825,7698,136.5377794,15396,-3780096,161280,-3618816,73
9573,411,22,8,0.0411658654,0.958834135,2857.153291,3208.92483,5041.322783,3855.321168,9984,889.047195,19968,-4901376,210432,-4690944,73
9588,396,22,8,0.0396634615,0.960336538,2860.447113,3165.784461,5038.641322,3875.320707,9984,1059.872611,19968,-4909056,202752,-4706304,73
9590,390,23,7,0.0390781563,0.960921844,2861.217526,3245.802302,5020.196976,4260.258974,9980,711.8402282,19960,-4910080,199680,-4710400,73
9567,415,22,8,0.0415748347,0.958425165,2853.747639,3274.441098,5039.13118,3893.457831,9982,835.3138075,19964,-4898304,212480,-4685824,73
9566,414,22,8,0.0414829659,0.958517034,2854.651618,3157.36659,5047.662659,3669.683575,9980,909.7538742,19960,-4897792,211968,-4685824,73
9543,437,22,8,0.0437875752,0.956212425,2851.683676,3136.111635,5055.884732,3562.659039,9980,1032.057911,19960,-4886016,223744,-4662272,73
9552,428,22,8,0.0428857715,0.957114228,2851.759346,3157.300445,5053.565327,3583.023364,9980,734.3635026,19960,-4890624,219136,-4671488,73
9576,404,23,7,0.0404809619,0.959519038,2860.513989,3133.00406,5037.058375,3886.928218,9980,541.8023887,19960,-4902912,206848,-4696064,73
9602,378,22,8,0.0378757515,0.962124248,2866.061147,3163.490075,5016.97261,4318.039683,9980,770.0617284,19960,-4916224,193536,-4722688,73
9566,414,23,7,0.0414829659,0.958517034,2859.019533,3104.195719,5043.697784,3761.297101,9980,200.2809552,19960,-4897792,211968,-4685824,73
9536,444,23,7,0.044488978,0.955511022,2851.08425,3119.282786,5058.774119,3524.144144,9980,1014.227642,19960,-4882432,227328,-4655104,73
9544,436,22,8,0.0436873747,0.956312625,2854.505942,3114.084686,5052.499476,3633.337156,9980,1374.655647,19960,-4886528,223232,-4663296,73
9574,406,22,8,0.0406813627,0.959318637,2860.654982,3103.223498,5040.023397,3822.674877,9980,1096.703297,19960,-4901888,207872,-4694016,73
9583,397,22,8,0.0397795591,0.960220441,2861.498102,3146.98548,5033.012627,3964.307305,9980,795.2191235,19960,-4906496,203264,-4703232,73
9560,420,22,8,0.0420841683,0.957915832,2855.343758,3243.420294,5036.153347,3951.342857,9980,837.9513014,19960,-4894720,215040,-4679680,73
9574,406,22,8,0.0406813627,0.959318637,2863.02348,3077.798711,5037.106643,3891.455665,9980,934.4569288,19960,-4901888,207872,-4694016,73
9582,398,22,8,0.0398797595,0.96012024,2863.511711,3087.747538,5034.737737,3925.459799,9980,1106.430155,19960,-4905984,203776,-4702208,73
9557,423,22,8,0.0423847695,0.95761523,2853.277659,3162.276195,5050.025636,3645.614657,9980,888.6910062,19960,-4893184,216576,-4676608,73
9585,395,22,8,0.0395791583,0.960420842,2862.410755,3108.724328,5035.172666,3906.481013,9980,939.7363465,19960,-4907520,202240,-4705280,73
9543,437,22,8,0.0437875752,0.956212425,2851.246242,3159.889827,5054.407838,3594.910755,9980,696.9273743,19960,-4886016,223744,-4662272,73
9545,435,22,8,0.0435871743,0.956412826,2854.85738,3118.865411,5051.28769,3656.664368,9980,1255.345912,19960,-4887040,222720,-4664320,73
9549,431,22,8,0.0431863727,0.956813627,2853.214321,3133.614327,5053.057493,3604.510441,9980,914.7571036,19960,-4889088,220672,-4668416,73
9578,402,22,8,0.0402805611,0.959719439,2856.364378,3266.551675,5031.49906,4013.661692,9980,907.2727273,19960,-4903936,205824,-4698112,73
9539,441,23,7,0.0441883768,0.955811623,2850.456728,3163.16298,5055.65814,3581.104308,9980,527.7630883,19960,-4883968,225792,-4658176,73
9553,431,23,7,0.0431690705,0.956830929,2852.373637,3158.189803,5056.681461,3569.935035,9984,727.696793,19968,-4891136,220672,-4670464,73
9623,363,22,8,0.0363508912,0.963649109,2865.43672,3187.943371,5026.186117,4127.002755,9986,693.4722222,19972,-4926976,185856,-4741120,73
9564,420,22,8,0.0420673077,0.957932692,2853.963587,3175.49737,5051.781263,3642.580952,9984,828.5477178,19968,-4896768,215040,-4681728,73
9629,357,22,8,0.0357500501,0.96424995,2867.135045,3171.470277,5023.238135,4191.403361,9986,1036.967809,19972,-4930048,182784,-4747264,73
9592,392,22,8,0.0392628205,0.960737179,2861.483713,3144.830637,5038.500626,3866.892857,9984,1095.938529,19968,-4911104,200704,-4710400,73
9587,397,22,8,0.0397636218,0.960236378,2862.045039,3127.286975,5039.000626,3869.574307,9984,697.6939203,19968,-4908544,203264,-4705280,73
9616,368,22,8,0.0368589744,0.963141026,2869.108505,3110.004887,5021.393511,4237.5,9984,541.7254476,19968,-4923392,188416,-4734976,73
9613,371,22,8,0.0371594551,0.962840545,2868.434594,3131.357923,5020.388224,4269.886792,9984,622.8321896,19968,-4921856,189952,-4731904,73
1112,153,23,7,0.120948617,0.879051383,357.2087824,268.5641175,674.4100719,332.0326797,1265,23.51738241,2530,-569344,78336,-491008,73
9548,436,23,7,0.0436698718,0.956330128,2852.495183,3159.987952,5056.329912,3594.683486,9984,724.5283019,19968,-4888576,223232,-4665344,73
9564,420,22,8,0.0420673077,0.957932692,2851.703671,3212.8117,5052.635926,3623.119048,9984,358.491921,19968,-4896768,215040,-4681728,73
9598,386,22,8,0.038661859,0.961338141,2865.258636,3119.586516,5031.661075,4018.748705,9984,513.8445703,19968,-4914176,197632,-4716544,73
9546,438,22,8,0.0438701923,0.956129808,2848.352912,3196.271545,5060.680285,3506.543379,9984,451.3562387,19968,-4887552,224256,-4663296,73
9584,401,22,8,0.0401602404,0.95983976,2859.718122,3178.792483,5040.084725,3867.663342,9985,760.4722011,19970,-4907008,205312,-4701696,73
9568,416,23,7,0.0416666667,0.958333333,2854.658515,3176.98752,5050.211957,3665.125,9984,950.8571429,19968,-4898816,212992,-4685824,73
9545,438,22,8,0.0438745868,0.956125413,2852.478879,3252.57872,5045.001886,3836.97032,9983,176.9721681,19966,-4887040,224256,-4662784,73
9564,420,23,7,0.0420673077,0.957932692,2852.818922,3186.933626,5052.95368,3615.883333,9984,460.5166052,19968,-4896768,215040,-4681728,73
9553,431,23,7,0.0431690705,0.956830929,2851.952052,3177.199605,5055.654663,3592.693735,9984,990.4761905,19968,-4891136,220672,-4670464,73
9561,423,22,8,0.0423677885,0.957632212,2855.080642,3190.533287,5047.863299,3741.132388,9984,705.0847458,19968,-4895232,216576,-4678656,73
9558,426,23,7,0.0426682692,0.957331731,2852.813786,3182.445684,5053.415882,3625.753521,9984,949.9524263,19968,-4893696,218112,-4675584,73
9525,452,23,7,0.0453041997,0.9546958,2847.600464,3442.433685,5017.158635,4395.612832,9977,775.8164852,19954,-4876800,231424,-4645376,73
9539,440,22,8,0.0440925944,0.955907406,2849.789932,3427.744707,5018.079673,4381.245455,9979,772.9666925,19958,-4883968,225280,-4658688,73
9534,444,23,7,0.0444978954,0.955502105,2849.645964,3456.099973,5006.297042,4628.817568,9978,762.8440367,19956,-4881408,227328,-4654080,73
9554,424,23,7,0.0424934857,0.957506514,2857.117989,3359.785968,4995.420871,4856.084906,9978,558.6786114,19956,-4891648,217088,-4674560,73
9525,453,23,7,0.0453998797,0.95460012,2849.136037,3450.153909,5008.065617,4599.130243,9978,761.6793893,19956,-4876800,231936,-4644864,73
9584,393,22,8,0.0393905984,0.960609402,2863.969145,3244.078753,4981.782137,5165.020356,9977,712.1341899,19954,-4907008,201216,-4705792,73
9572,409,23,7,0.0409778579,0.959022142,2859.835605,3329.886178,5003.763581,4692.288509,9981,439.8854121,19962,-4900864,209408,-4691456,73
9528,450,23,7,0.0450992183,0.954900782,2847.880901,3449.539424,5016.473447,4418.382222,9978,844.1624365,19956,-4878336,230400,-4647936,73
9609,370,23,7,0.0370778635,0.962922136,2861.906359,3325.368275,4997.697471,4790.094595,9979,442.5277162,19958,-4919808,189440,-4730368,73
9546,436,23,7,0.0436786215,0.956321378,2852.045361,3392.951777,5022.947832,4302.965596,9982,927.6951673,19964,-4887552,223232,-4664320,73
9542,439,23,7,0.0439835688,0.956016431,2849.672828,3411.09532,5025.891847,4232.599089,9981,471.46906,19962,-4885504,224768,-4660736,73
9550,428,23,7,0.0428943676,0.957105632,2854.950042,3392.804588,4998.545445,4787.668224,9978,732.5991189,19956,-4889600,219136,-4670464,73
9531,447,23,7,0.0447985568,0.955201443,2848.423669,3448.743101,5014.974504,4446.328859,9978,665.2,19956,-4879872,228864,-4651008,73
9600,382,23,7,0.038268884,0.961731116,2862.180411,3287.536167,5012.591146,4461.460733,9982,204.9271197,19964,-4915200,195584,-4719616,73
9532,446,23,7,0.0446983363,0.955301664,2847.462674,3471.49125,5013.595363,4474.529148,9978,369.0088757,19956,-4880384,228352,-4652032,73
9560,418,22,8,0.0418921628,0.958107837,2855.727177,3392.991963,4995.73159,4846.978469,9978,614.7874307,19956,-4894720,214016,-4680704,73
9565,413,23,7,0.0413910603,0.95860894,2855.993565,3396.944509,4989.713539,4984.554479,9978,674.1891892,19956,-4897280,211456,-4685824,73
9565,413,23,7,0.0413910603,0.95860894,2857.730075,3362.803264,4990.851228,4958.205811,9978,384.0646651,19956,-4897280,211456,-4685824,73
9602,383,23,7,0.0383575363,0.961642464,2863.105063,3145.98367,5035.732139,3921.684073,9985,851.2361466,19970,-4916224,196096,-4720128,73
9176,379,23,7,0.0396650968,0.960334903,2742.913114,3059.501945,4800.013296,4245.034301,9555,120.1131364,19110,-4698112,194048,-4504064,73
9560,417,22,8,0.0417961311,0.958203869,2847.666071,3479.094616,5017.690167,4331.258993,9977,595.9976105,19954,-4894720,213504,-4681216,73
9538,440,22,8,0.0440970134,0.955902987,2844.002452,3497.263536,5023.922101,4243.322727,9978,587.2866392,19956,-4883456,225280,-4658176,73
9585,398,23,7,0.0398677752,0.960132225,2854.77401,3224.702498,5044.202295,3734.816583,9983,1107.991121,19966,-4907520,203776,-4703744,73
9545,432,23,7,0.0432995891,0.956700411,2843.025888,3501.317555,5026.704138,4155.930556,9977,913.6446886,19954,-4887040,221184,-4665856,73
9561,416,22,8,0.0416959006,0.958304099,2849.919117,3444.989902,5016.049053,4367.326923,9977,742.3363095,19954,-4895232,212992,-4682240,73
9543,434,22,8,0.0435000501,0.95649995,2849.691827,3414.437928,5019.468721,4319.039171,9977,674.1216216,19954,-4886016,222208,-4663808,73
9542,435,22,8,0.0436002806,0.956399719,2845.259419,3454.223402,5027.364284,4147.455172,9977,222.6511939,19954,-4885504,222720,-4662784,73
9527,450,22,8,0.0451037386,0.954896261,2849.611279,3372.899188,5025.29831,4220.524444,9977,559.8765432,19954,-4877824,230400,-4647424,73
9532,445,22,8,0.0446025859,0.955397414,2841.01565,3486.313565,5033.048573,4045.469663,9977,667.3578595,19954,-4880384,227840,-4652544,73
9560,420,22,8,0.0420841683,0.957915832,2850.091324,3427.448786,5023.296862,4243.980952,9980,877.7484609,19960,-4894720,215040,-4679680,73
9553,428,22,8,0.0428814748,0.957118525,2848.72287,3374.047097,5036.54339,3974.46729,9981,938.9463782,19962,-4891136,219136,-4672000,73
9553,425,22,8,0.0425937062,0.957406294,2846.42094,3441.344922,5029.107924,4099.207059,9978,881.4487633,19956,-4891136,217600,-4673536,73
9555,422,22,8,0.0422972838,0.957702716,2849.502805,3419.073429,5021.800209,4246.331754,9977,656.8136932,19954,-4892160,216064,-4676096,73
9560,417,22,8,0.0417961311,0.958203869,2849.148806,3458.842579,5015.948849,4371.179856,9977,622.78402,19954,-4894720,213504,-4681216,73
9540,440,23,7,0.0440881764,0.955911824,2845.042108,3458.691585,5030.80566,4116.6,9980,242.4095215,19960,-4884480,225280,-4659200,73
9530,450,22,8,0.0450901804,0.95490982,2841.41948,3436.830725,5042.749318,3883.975556,9980,626.097867,19960,-4879360,230400,-4648960,73
9589,394,22,8,0.0394670941,0.960532906,2857.568177,3206.823163,5039.855251,3827.319797,9983,393.8067061,19966,-4909568,201728,-4707840,73
9521,456,22,8,0.0457051218,0.954294878,2840.168135,3488.455092,5033.297868,4064.087719,9977,661.6047745,19954,-4874752,233472,-4641280,73
9528,449,22,8,0.0450035081,0.954996492,2840.211041,3495.690233,5033.139274,4052.342984,9977,552.7423823,19954,-4878336,229888,-4648448,73
9077,449,22,8,0.0471341591,0.952865841,2717.021813,3145.06998,4818.690096,3647.775056,9526,135.6786783,19052,-4647424,229888,-4417536,73
9562,422,22,8,0.0422676282,0.957732372,2853.193967,3181.481015,5052.743673,3627.452607,9984,1432.424677,19968,-4895744,216064,-4679680,73
547,117,22,8,0.176204819,0.823795181,197.3440642,118.636507,354.0877514,231.5726496,664,24.11038489,1328,-280064,59904,-220160,73
3146,206,22,8,0.0614558473,0.938544153,952.4207793,1033.686095,1712.050223,1133.582524,3352,58.47871598,6704,-1610752,105472,-1505280,73
9625,359,23,7,0.0359575321,0.964042468,2865.546509,3201.017453,5021.244364,4221.846797,9984,734.1176471,19968,-4928000,183808,-4744192,73
9602,382,22,8,0.0382612179,0.961738782,2864.618227,3140.522681,5030.999688,4024.767016,9984,1318.890357,19968,-4916224,195584,-4720640,73
1950,191,23,7,0.0892106492,0.910789351,604.9714535,581.1727349,1113.588718,636.1937173,2141,37.76680191,4282,-998400,97792,-900608,73
8349,339,22,8,0.039019337,0.960980663,2491.49268,2726.437205,4382.05833,3419.501475,8688,152.6889279,17376,-4274688,173568,-4101120,73
9591,393,22,8,0.0393629808,0.960637019,2860.139731,3177.321434,5038.173496,3877.857506,9984,516.5028453,19968,-4910592,201216,-4709376,73
9597,387,22,8,0.0387620192,0.961237981,2863.266864,3140.394668,5034.574242,3949.124031,9984,943.6672968,19968,-4913664,198144,-4715520,73
9614,370,22,8,0.0370592949,0.962940705,2867.902849,3126.401134,5023.142084,4196.302703,9984,1194.258373,19968,-4922368,189440,-4732928,73
9567,417,22,8,0.0417668269,0.958233173,2854.232065,3195.746363,5049.197345,3691.724221,9984,494.9925632,19968,-4898304,213504,-4684800,73
9598,386,22,8,0.038661859,0.961338141,2861.651784,3230.991433,5027.602105,4119.676166,9984,894.6236559,19968,-4914176,197632,-4716544,73
5681,259,22,8,0.0436026936,0.956397306,1700.333634,1831.986477,3006.791058,2174.478764,5940,104.6880508,11880,-2908672,132608,-2776064,73
9602,382,22,8,0.0382612179,0.961738782,2862.664343,3168.737929,5032.98969,3974.746073,9984,299.3703148,19968,-4916224,195584,-4720640,73
9586,398,22,8,0.0398637821,0.960136218,2860.201954,3148.036035,5041.144586,3820.874372,9984,1380.912863,19968,-4908032,203776,-4704256,73
9580,404,22,8,0.0404647436,0.959535256,2857.712678,3186.766898,5042.668894,3802.851485,9984,473.3997155,19968,-4904960,206848,-4698112,73
9588,396,22,8,0.0396634615,0.960336538,2861.101773,3158.8462,5037.802774,3895.623737,9984,893.8227395,19968,-4909056,202752,-4706304,73
9579,405,22,8,0.0405649038,0.959435096,2859.664581,3142.276132,5042.950308,3799.25679,9984,1197.122302,19968,-4904448,207360,-4697088,73
9590,394,22,8,0.039463141,0.960536859,2860.735594,3215.826024,5031.871011,4034.205584,9984,1123.059618,19968,-4910080,201728,-4708352,73
857,130,22,8,0.131712259,0.868287741,280.2913913,232.3806845,523.7957993,297.5769231,987,25.5500906,1974,-438784,66560,-372224,73
9607,377,23,7,0.0377604167,0.962239583,2862.598243,3305.848737,5011.26793,4514.241379,9984,636.7346939,19968,-4918784,193024,-4725760,73
9520,459,22,8,0.0459965928,0.954003407,2845.140873,3492.292955,5016.801366,4434.119826,9979,496.9621514,19958,-4874240,235008,-4639232,73
9546,430,22,8,0.0431034483,0.956896552,2848.297775,3507.449428,4988.109051,4997.17907,9976,233.1930809,19952,-4887552,220160,-4667392,73
9561,416,22,8,0.0416959006,0.958304099,2856.406825,3377.665484,4993.619914,4882.819712,9977,570.1142857,19954,-4895232,212992,-4682240,73
9510,467,22,8,0.0468076576,0.953192342,2841.363424,3559.362018,5006.980126,4622.852248,9977,508.2526745,19954,-4869120,239104,-4630016,73
9585,394,22,8,0.0394829141,0.960517086,2855.258383,3440.516221,4993.997705,4892.746193,9979,706.2278839,19958,-4907520,201728,-4705792,73
9553,426,23,7,0.0426896483,0.957310352,2851.54242,3424.857018,5014.502669,4440.530516,9979,733.2108744,19958,-4891136,218112,-4673024,73
9586,396,22,8,0.0396714085,0.960328591,2860.215692,3336.521469,5006.483518,4628.792929,9982,659.3130779,19964,-4908032,202752,-4705280,73
9530,449,22,8,0.0449944884,0.955005512,2847.547086,3470.600208,5014.483316,4470.342984,9979,816.6121113,19958,-4879360,229888,-4649472,73
9558,420,22,8,0.0420926037,0.957907396,2851.119248,3479.784659,4993.109751,4907.352381,9978,828.0497925,19956,-4893696,215040,-4678656,73
9577,407,22,8,0.0407652244,0.959234776,2852.032809,3392.984238,5031.001775,4086.525799,9984,659.8810311,19968,-4903424,208384,-4695040,73
9562,415,22,8,0.04159567,0.95840433,2856.129978,3381.926832,4996.01485,4827.371084,9977,351.3028169,19954,-4895744,212480,-4683264,73
9590,396,22,8,0.0396555177,0.960344482,2857.094381,3213.255009,5043.808342,3775.174242,9986,706.7232838,19972,-4910080,202752,-4707328,73
9550,428,22,8,0.0428943676,0.957105632,2851.781868,3445.323458,5002.421257,4701.186916,9978,757.6309795,19956,-4889600,219136,-4670464,73
9550,433,22,8,0.0433737354,0.956626265,2849.619657,3441.163384,5024.493194,4275.34873,9983,831.9166667,19966,-4889600,221696,-4667904,73
9557,426,22,8,0.0426725433,0.957327457,2850.059961,3395.521707,5032.505912,4083.279343,9983,665.08994,19966,-4893184,218112,-4675072,73
9580,404,22,8,0.0404647436,0.959535256,2852.990207,3394.112714,5028.273173,4144.215347,9984,500.2004008,19968,-4904960,206848,-4698112,73
9579,403,22,8,0.0403726708,0.959627329,2858.084383,3371.717527,5006.750391,4629.009926,9982,902.5316456,19964,-4904448,206336,-4698112,73
9531,448,22,8,0.044894278,0.955105722,2849.493128,3456.928273,5007.852586,4610.194196,9979,601.8697226,19958,-4879872,229376,-4650496,73
9575,410,22,8,0.0410615924,0.958938408,2858.367553,3368.705818,5011.035822,4571.797561,9985,850.5110733,19970,-4902400,209920,-4692480,73
9554,423,22,8,0.0423975143,0.957602486,2856.744693,3363.56079,4993.173645,4894.732861,9977,234.3118835,19954,-4891648,216576,-4675072,73
9550,427,22,8,0.0427984364,0.957201564,2855.413,3375.114057,5000.732775,4726.592506,9977,642.020592,19954,-4889600,218624,-4670976,73
9559,418,22,8,0.0418963616,0.958103638,2854.950952,3404.322418,4992.1814,4916.246411,9977,475.3215817,19954,-4894208,214016,-4680192,73
9524,451,23,7,0.0452130326,0.954786967,2847.468801,3440.97552,5014.557749,4427.166297,9975,373.3158683,19950,-4876288,230912,-4645376,73
9561,416,22,8,0.0416959006,0.958304099,2854.915278,3404.804957,4995.526514,4839,9977,450.8359693,19954,-4895232,212992,-4682240,73
9555,422,22,8,0.0422972838,0.957702716,2856.54313,3366.820862,4995.249189,4847.504739,9977,492.9347826,19954,-4892160,216064,-4676096,73
9591,389,22,8,0.0389779559,0.961022044,2864.87869,3247.665079,4997.769054,4811.277635,9980,750.9405568,19960,-4910592,199168,-4711424,73
9529,448,22,8,0.0449032775,0.955096722,2848.573737,3454.805688,5009.663973,4549.475446,9977,209.9978952,19954,-4878848,229376,-4649472,73
9549,429,22,8,0.0429945881,0.957005412,2849.252503,3410.38585,5024.616609,4207.848485,9978,879.1189427,19956,-4889088,219648,-4669440,73
844,83,22,8,0.0895361381,0.910463862,262.7091677,273.0398097,478.3672986,317.9036145,927,20.90663058,1854,-432128,42496,-389632,73
9546,431,23,7,0.0431993585,0.956800641,2854.155346,3396.761432,4999.230882,4762.401392,9977,208.2011686,19954,-4887552,220672,-4666880,73
8654,391,22,8,0.0432283029,0.956771697,2581.074625,3123.942186,4554.413797,3827.71867,9045,159.1029024,18090,-4430848,200192,-4230656,73
9575,403,23,7,0.0403888555,0.959611145,2855.849909,3370.85667,5011.317389,4471.133995,9978,529.6178344,19956,-4902400,206336,-4696064,73
9572,408,22,8,0.0408817635,0.959118236,2860.706311,3302.101545,5005.365859,4641.735294,9980,442.1798848,19960,-4900864,208896,-4691968,73
9524,453,22,8,0.0454044302,0.95459557,2847.690614,3451.088242,5013.995065,4463.496689,9977,632.2560203,19954,-4876288,231936,-4644352,73
9562,418,22,8,0.0418837675,0.958116232,2857.633065,3310.870354,5017.654779,4369.318182,9980,705.7991513,19960,-4895744,214016,-4681728,73
9037,437,22,8,0.0461262402,0.95387376,2698.279097,3329.633733,4771.18723,4040.860412,9474,251.8341308,18948,-4626944,223744,-4403200,73
9548,432,23,7,0.0432865731,0.956713427,2848.342035,3376.09918,5035.514349,3995.599537,9980,745.3323376,19960,-4888576,221184,-4667392,73
8048,359,21,9,0.0427025098,0.95729749,2401.056601,2678.018475,4257.706262,3000.022284,8407,156.3802083,16814,-4120576,183808,-3936768,73
9584,400,22,8,0.0400641026,0.959935897,2860.00531,3168.591264,5039.320743,3870.675,9984,756.9370735,19968,-4907008,204800,-4702208,73
9530,450,22,8,0.0450901804,0.95490982,2847.617576,3429.714282,5025.771773,4243.522222,9980,594.4014294,19960,-4879360,230400,-4648960,73
9621,362,23,7,0.0362616448,0.963738355,2864.938376,3217.579016,5018.998649,4274.447514,9983,545.5191257,19966,-4925952,185344,-4740608,73
9581,403,22,8,0.0403645833,0.959635417,2858.958608,3162.683399,5042.409247,3805.947891,9984,386.0788863,19968,-4905472,206336,-4699136,73
9572,408,22,8,0.0408817635,0.959118236,2857.084495,3364.86411,5008.8972,4558.887255,9980,221.975089,19960,-4900864,208896,-4691968,73
9550,427,22,8,0.0427984364,0.957201564,2854.352721,3404.62154,4985.267016,5072.489461,9977,847.6635514,19954,-4889600,218624,-4670976,73
9514,465,22,8,0.0465978555,0.953402145,2846.234071,3462.038573,5018.229346,4412.421505,9979,656.5131579,19958,-4871168,238080,-4633088,73
9601,382,22,8,0.0382650506,0.961734949,2862.675277,3295.946358,5009.851682,4543.324607,9983,502.6686808,19966,-4915712,195584,-4720128,73
9552,425,22,8,0.0425979753,0.957402025,2853.570805,3417.86537,4996.965662,4809.969412,9977,305.6678922,19954,-4890624,217600,-4673024,73
9554,423,22,8,0.0423975143,0.957602486,2853.913478,3407.539947,5000.996651,4718.040189,9977,407.2244898,19954,-4891648,216576,-4675072,73
9545,432,23,7,0.0432995891,0.956700411,2853.834855,3399.694517,5000.387847,4737.386574,9977,530.1275239,19954,-4887040,221184,-4665856,73
9522,455,22,8,0.0456048912,0.954395109,2845.534232,3476.178273,5016.79143,4407.395604,9977,546.3855422,19954,-4875264,232960,-4642304,73
9523,454,22,8,0.0455046607,0.954495339,2846.514675,3468.281256,5014.586265,4452.30837,9977,816.4484452,19954,-4875776,232448,-4643328,73
9568,412,22,8,0.0412825651,0.958717435,2855.666946,3398.713664,5005.153428,4650.199029,9980,543.5729847,19960,-4898816,210944,-4687872,73
9534,446,22,8,0.0446893788,0.955310621,2849.052446,3415.936911,5024.1588,4270.986547,9980,179.8522256,19960,-4881408,228352,-4653056,73
9563,419,22,8,0.041975556,0.958024444,2856.31849,3380.874093,5009.592806,4578.560859,9982,598.80024,19964,-4896256,214528,-4681728,73
9531,450,22,8,0.0450856628,0.954914337,2848.314788,3411.828283,5028.479593,4197.182222,9981,587.8091873,19962,-4879872,230400,-4649472,73
9533,445,23,7,0.0445981159,0.955401884,2849.384101,3429.943417,5016.078989,4420.11236,9978,772.8892332,19956,-4880896,227840,-4653056,73
9530,447,22,8,0.044803047,0.955196953,2847.726677,3465.64544,5011.416579,4511.080537,9977,307.4576271,19954,-4879360,228864,-4650496,73
9537,444,22,8,0.0444845206,0.955515479,2848.24589,3442.444113,5023.66048,4289.461712,9981,581.9825073,19962,-4882944,227328,-4655616,73
9321,423,23,7,0.04341133,0.95658867,2788.348352,3173.859167,4913.731252,3963.950355,9744,147.6587362,19488,-4772352,216576,-4555776,73
9546,434,22,8,0.0434869739,0.956513026,2851.318842,3403.982336,5020.409281,4332.633641,9980,703.8081805,19960,-4887552,222208,-4665344,73
39,13,22,8,0.25,0.75,14.59098278,16.18860729,26.64102564,26.07692308,52,1.008533747,104,-19968,6656,-13312,73
9528,449,22,8,0.0450035081,0.954996492,2848.65018,3457.059181,5007.902813,4587.873051,9977,581.4102564,19954,-4878336,229888,-4648448,73
2847,196,22,8,0.0644101216,0.935589878,859.688801,884.4854542,1567.296804,864.0408163,3043,53.2831378,6086,-1457664,100352,-1357312,73
9582,396,22,8,0.0396873121,0.960312688,2857.514879,3377.674124,4999.862137,4738.767677,9978,738.0177515,19956,-4905984,202752,-4703232,73
9549,431,22,8,0.0431863727,0.956813627,2854.155212,3373.593489,5015.750759,4431.058005,9980,211.5751537,19960,-4889088,220672,-4668416,73
9532,445,23,7,0.0446025859,0.955397414,2850.095781,3444.258107,5004.566198,4655.568539,9977,411.9322874,19954,-4880384,227840,-4652544,73
9566,411,22,8,0.0411947479,0.958805252,2855.186965,3408.705966,4986.713987,5042.206813,9977,620.0745805,19954,-4897792,210432,-4687360,73
9552,425,22,8,0.0425979753,0.957402025,2854.304702,3394.266905,5002.772927,4679.449412,9977,627.4842767,19954,-4890624,217600,-4673024,73
9178,387,22,8,0.0404600105,0.95953999,2739.967933,3171.305333,4806.871759,4216.863049,9565,310.1491569,19130,-4699136,198144,-4500992,73
9552,426,22,8,0.0426939266,0.957306073,2856.667307,3366.974782,4994.515913,4877.030516,9978,608.4146341,19956,-4890624,218112,-4672512,73
9558,419,22,8,0.0419965922,0.958003408,2855.182376,3387.675207,5001.153275,4711.76611,9977,529.2838196,19954,-4893696,214528,-4679168,73
9518,459,22,8,0.0460058134,0.953994187,2844.101314,3485.473272,5019.559992,4355.296296,9977,458.2912265,19954,-4873216,235008,-4638208,73
9570,410,22,8,0.0410821643,0.958917836,2860.88646,3303.17536,5002.497492,4710.460976,9980,631.6455696,19960,-4899840,209920,-4689920,73
9541,437,22,8,0.043796352,0.956203648,2847.250209,3438.883498,5024.660203,4221.84897,9978,625.5799373,19956,-4884992,223744,-4661248,73
9530,447,22,8,0.044803047,0.955196953,2851.283424,3417.674682,5005.977859,4627.033557,9977,406.5607172,19954,-4879360,228864,-4650496,73
9543,435,22,8,0.043595911,0.956404089,2847.621031,3443.099376,5022.885361,4257.094253,9978,394.3873518,19956,-4886016,222720,-4663296,73
9525,452,22,8,0.0453041997,0.9546958,2849.753365,3430.875826,5009.199055,4563.345133,9977,420.4382638,19954,-4876800,231424,-4645376,73
9552,426,22,8,0.0426939266,0.957306073,2846.036527,3536.672314,5009.064594,4550.812207,9978,778.3151326,19956,-4890624,218112,-4672512,73
9547,434,22,8,0.043482617,0.956517383,2849.206659,3365.526715,5035.820886,4005.043779,9981,535.1742627,19962,-4888064,222208,-4665856,73
6358,944,21,9,0.129279649,0.870720351,2041.490328,2090.591426,3459.086977,4947.434322,7302,155.7593857,14604,-3255296,483328,-2771968,74
8643,1206,21,9,0.12244898,0.87755102,2852.487501,2676.263326,4828.901423,5613.706468,9849,328.5190127,19698,-4425216,617472,-3807744,74
6646,1040,22,8,0.135310955,0.864689045,2175.820295,2170.406457,3670.222088,4950.8125,7686,135.9872611,15372,-3402752,532480,-2870272,74
6750,1044,20,10,0.133949192,0.866050808,2182.411455,2226.567059,3691.937778,5226.566092,7794,142.7734017,15588,-3456000,534528,-2921472,74
8652,1212,22,8,0.122871046,0.877128954,2845.82906,2711.659381,4813.50393,5781.966997,9864,625.4914394,19728,-4429824,620544,-3809280,74
5838,956,21,9,0.140712393,0.859287607,1892.048158,2067.169512,3231.080336,4413.774059,6794,120.9327163,13588,-2989056,489472,-2499584,74
7410,1137,20,10,0.133029133,0.866970867,2418.502863,2422.662497,4083.799595,5513.564644,8547,150.2373001,17094,-3793920,582144,-3211776,74
8854,1023,20,10,0.10357396,0.89642604,2902.809185,2357.722628,4933.25672,4988.707722,9877,334.3601896,19754,-4533248,523776,-4009472,74
6121,922,20,10,0.130910124,0.869089876,1975.765167,2128.683558,3372.771606,4512.701735,7043,131.5710816,14086,-3133952,472064,-2661888,74
8768,1110,20,10,0.112370925,0.887629075,2850.393666,2793.949142,4866.324703,5517.518919,9878,281.8259629,19756,-4489216,568320,-3920896,74
6059,1023,21,9,0.14445072,0.85554928,1970.867601,2091.033576,3346.707542,4695.212121,7082,127.3282992,14164,-3102208,523776,-2578432,74
6147,1095,20,10,0.151201326,0.848798674,2012.189211,2082.725584,3398.977875,4870.672146,7242,140.3488372,14484,-3147264,560640,-2586624,74
6583,1103,20,10,0.143507676,0.856492324,2165.790203,2208.177404,3657.882728,4951.31369,7686,154.0280561,15372,-3370496,564736,-2805760,74
6133,999,20,10,0.140072911,0.859927089,1993.137766,2022.086736,3364.740421,4805.13013,7132,125.7848325,14264,-3140096,511488,-2628608,74
8910,984,21,9,0.0994542147,0.900545785,2899.826456,2408.999274,4918.227609,5212.557927,9894,427.3866091,19788,-4561920,503808,-4058112,74
8634,1233,20,10,0.124961995,0.875038005,2844.914186,2731.901368,4815.481005,5763.92133,9867,180.2521008,19734,-4420608,631296,-3789312,74
8719,1147,21,9,0.116257855,0.883742145,2903.08924,2370.919511,4897.473219,5207.36007,9866,509.0815273,19732,-4464128,587264,-3876864,74
8839,1050,21,9,0.106178582,0.893821418,2894.246924,2487.274529,4920.051363,5155.02,9889,456.7667436,19778,-4525568,537600,-3987968,74
8571,1279,21,9,0.129847716,0.870152284,2862.539865,2595.705084,4816.109205,5658.563722,9850,344.7672384,19700,-4388352,654848,-3733504,74
8714,1155,20,10,0.117033134,0.882966866,2870.99365,2596.656032,4854.103971,5545.327273,9869,397.9435484,19738,-4461568,591360,-3870208,74
5129,595,20,10,0.103948288,0.896051712,1638.466069,1683.276967,2803.208423,3373.603361,5724,111.971831,11448,-2626048,304640,-2321408,74
7057,873,21,9,0.110088272,0.889911728,2295.204376,2165.303012,3898.550092,4506.697595,7930,158.15716,15860,-3613184,446976,-3166208,74
8600,1266,20,10,0.128319481,0.871680519,2855.757791,2659.497829,4815.217558,5736.99842,9866,491.3346614,19732,-4403200,648192,-3755008,74
708,61,22,8,0.0793237971,0.920676203,219.1478175,215.5112544,395.9025424,258.4590164,769,27.58249641,1538,-362496,31232,-331264,74
7590,1202,21,9,0.136715196,0.863284804,2536.920665,2340.518955,4249.417128,5325.251248,8792,157.2808587,17584,-3886080,615424,-3270656,74
8002,1249,20,10,0.135012431,0.864987569,2615.522276,2629.0163,4416.483004,5968.317854,9251,167.1666064,18502,-4097024,639488,-3457536,74
8147,1241,21,9,0.13219003,0.86780997,2708.857063,2482.896318,4537.54965,5724.858179,9388,165.6316161,18776,-4171264,635392,-3535872,74
7284,1263,21,9,0.147771148,0.852228852,2431.13335,2252.716337,4045.666667,5590.848773,8547,151.6770186,17094,-3729408,646656,-3082752,74
8140,1235,21,9,0.131733333,0.868266667,2705.504195,2428.501213,4517.409459,5812.378138,9375,166.5778252,18750,-4167680,632320,-3535360,74
847,77,21,9,0.0833333333,0.916666667,263.6621861,273.9740112,472.8051948,349.1428571,924,16.09475701,1848,-433664,39424,-394240,74
7692,1330,19,11,0.147417424,0.852582576,2575.435283,2476.535029,4314.772751,5649.26391,9022,178.8659794,18044,-3938304,680960,-3257344,74
7457,1319,21,9,0.150296263,0.849703737,2521.853489,2325.340646,4199.664208,5456.087945,8776,177.1140262,17552,-3817984,675328,-3142656,74
7454,1251,20,10,0.143710511,0.856289489,2500.790022,2276.185187,4163.047089,5484.821743,8705,157.3571945,17410,-3816448,640512,-3175936,74
6471,977,21,9,0.131176155,0.868823845,2103.669465,2085.949668,3547.698037,4895.518936,7448,134.4404332,14896,-3313152,500224,-2812928,74
7419,1169,20,10,0.136120168,0.863879832,2446.949455,2377.664139,4115.175226,5432.575706,8588,156.6295823,17176,-3798528,598528,-3200000,74
7474,1172,21,9,0.135554013,0.864445987,2488.150156,2318.867095,4170.71742,5297.814846,8646,155.7276657,17292,-3826688,600064,-3226624,74
8968,919,21,9,0.0929503388,0.907049661,2872.811749,2656.614585,4923.418153,5144.846572,9887,368.7803059,19774,-4591616,470528,-4121088,74
7751,1219,20,10,0.135897436,0.864102564,2590.990455,2381.426114,4340.6265,5406.676784,8970,159.9500713,17940,-3968512,624128,-3344384,74
6667,1203,20,10,0.152858958,0.847141042,2214.11211,2222.236463,3721.581821,5121.029925,7870,149.7336377,15740,-3413504,615936,-2797568,74
6879,1244,20,10,0.15314539,0.84685461,2298.028401,2184.264997,3830.734409,5340.839228,8123,141.4910294,16246,-3522048,636928,-2885120,74
1361,156,23,7,0.102834542,0.897165458,430.5417358,476.0054277,743.2307127,896.5769231,1517,53.00489168,3034,-696832,79872,-616960,74
1356,155,23,7,0.102581072,0.897418928,426.8032306,499.2375712,744.1998525,859.2322581,1511,53.84889522,3022,-694272,79360,-614912,74
1399,177,23,7,0.112309645,0.887690355,445.3532294,522.5612908,782.8899214,832.8418079,1576,53.89876881,3152,-716288,90624,-625664,74
1283,126,23,7,0.0894251242,0.910574876,401.0446923,460.2033835,702.8534684,726.8571429,1409,42.61947973,2818,-656896,64512,-592384,74
1374,154,23,7,0.10078534,0.89921466,431.239314,506.9511244,751.8005822,877.8051948,1528,47.13140037,3056,-703488,78848,-624640,74
1341,176,21,9,0.116018457,0.883981543,427.9669009,503.9835188,751.7621178,814.1477273,1517,50.41542041,3034,-686592,90112,-596480,74
1382,168,22,8,0.108387097,0.891612903,437.2061999,523.1554037,771.8024602,805.9166667,1550,50.17805115,3100,-707584,86016,-621568,74
1365,157,23,7,0.103153745,0.896846255,432.8994709,486.1591399,753.2688645,833.0636943,1522,53.74293785,3044,-698880,80384,-618496,74
1365,173,21,9,0.112483745,0.887516255,429.9628989,520.4492761,751.421978,912.1387283,1538,28.13757775,3076,-698880,88576,-610304,74
1356,157,23,7,0.10376735,0.89623265,427.8580577,488.1299759,741.8871681,887.5286624,1513,53.31219168,3026,-694272,80384,-613888,74
1409,169,23,7,0.107097592,0.892902408,446.9045215,518.7966088,783.0404542,843.3550296,1578,45.71263036,3156,-721408,86528,-634880,74
1413,166,23,7,0.105129829,0.894870171,446.3570915,514.1114219,775.8931352,910.0783133,1579,49.46741855,3158,-723456,84992,-638464,74
1383,165,23,7,0.106589147,0.893410853,435.0259897,530.4667855,765.8828633,846.7272727,1548,38.83592574,3096,-708096,84480,-623616,74
1395,166,23,7,0.106342088,0.893657912,440.177233,529.3007924,777.2896057,812.1807229,1561,50.50145584,3122,-714240,84992,-629248,74
1368,169,21,9,0.109954457,0.890045543,433.7914172,510.6619687,759.6593567,844.6094675,1537,48.98024219,3074,-700416,86528,-613888,74
1353,168,23,7,0.110453649,0.889546351,429.1053601,498.676876,747.2357724,871.8511905,1521,52.07120849,3042,-692736,86016,-606720,74
1427,173,23,7,0.108125,0.891875,453.5265278,521.0993954,792.5143658,866.3699422,1600,53.63727791,3200,-730624,88576,-642048,74
1433,181,23,7,0.112143742,0.887856258,456.34801,527.2887221,796.2386602,896.6574586,1614,46.11428571,3228,-733696,92672,-641024,74
1390,173,23,7,0.110684581,0.889315419,442.1601823,511.2518358,772.1223022,861.3641618,1563,51.68650794,3126,-711680,88576,-623104,74
880,81,23,7,0.0842872008,0.915712799,273.7809027,281.3078558,493.3306818,347.037037,961,15.22979398,1922,-450560,41472,-409088,74
7839,1191,20,10,0.131893688,0.868106312,2529.992792,2542.07901,4273.291109,6109.685978,9030,164.5108399,18060,-4013568,609792,-3403776,74
7740,1032,22,8,0.117647059,0.882352941,2483.548785,2466.843923,4202.454264,5766.843023,8772,155.229163,17544,-3962880,528384,-3434496,74
7303,925,21,9,0.112421001,0.887578999,2346.859172,2235.075802,3958.759414,5344.092973,8228,166.3566518,16456,-3739136,473600,-3265536,74
8903,975,21,9,0.0987041911,0.901295809,2855.776628,2652.611153,4842.316635,5826.908718,9878,648.1627297,19756,-4558336,499200,-4059136,74
7590,981,20,10,0.114455723,0.885544277,2439.693276,2428.161898,4135.108432,5453.448522,8571,160.235558,17142,-3886080,502272,-3383808,74
7695,1074,20,10,0.122476907,0.877523093,2462.791565,2498.517047,4173.368681,5901.29702,8769,154.9567061,17538,-3939840,549888,-3389952,74
8815,1067,22,8,0.107974094,0.892025906,2876.589061,2466.806535,4831.763471,5848.086223,9882,584.3879361,19764,-4513280,546304,-3966976,74
8810,1066,22,8,0.107938437,0.892061563,2853.223547,2709.280403,4844.202838,5717.822702,9876,435.8340688,19752,-4510720,545792,-3964928,74
6684,1004,20,10,0.130593132,0.869406868,2148.099745,2243.151349,3648.17295,5151.521912,7688,136.457224,15376,-3422208,514048,-2908160,74
8687,1120,20,10,0.11420414,0.88579586,2803.230924,2804.063049,4762.119374,6004.461607,9807,176.511879,19614,-4447744,573440,-3874304,74
7643,1069,20,10,0.122704316,0.877295684,2450.120982,2447.048188,4143.732566,5877.717493,8712,152.2810697,17424,-3913216,547328,-3365888,74
8670,1149,21,9,0.117018026,0.882981974,2797.818902,2727.257857,4727.170819,6289.572672,9819,180.297466,19638,-4439040,588288,-3850752,74
7548,958,21,9,0.112626381,0.887373619,2417.408526,2386.766251,4093.360493,5515.22547,8506,153.4271284,17012,-3864576,490496,-3374080,74
8212,1067,21,9,0.11499084,0.88500916,2630.111156,2670.117629,4465.961033,5979.463918,9279,175.8052293,18558,-4204544,546304,-3658240,74
8023,1156,21,9,0.125939645,0.874060355,2585.38804,2642.977263,4382.432382,6030.58391,9179,175.339064,18358,-4107776,591872,-3515904,74
6927,998,20,10,0.125930599,0.874069401,2216.339494,2173.535933,3739.954526,5511.132265,7925,147.1407352,15850,-3546624,510976,-3035648,74
8283,1004,21,9,0.108108108,0.891891892,2653.896444,2633.465384,4506.544247,5778.00996,9287,169.6255708,18574,-4240896,514048,-3726848,74
8792,1085,20,10,0.109851169,0.890148831,2847.57997,2718.04429,4827.867038,5839.535484,9877,379.3010753,19754,-4501504,555520,-3945984,74
8359,1109,20,10,0.11713139,0.88286861,2688.85956,2691.632611,4556.603302,6075.382326,9468,174.493181,18936,-4279808,567808,-3712000,74
1970,130,21,9,0.0619047619,0.938095238,594.8652361,676.3743552,1072.328934,719.7076923,2100,31.80372558,4200,-1008640,66560,-942080,74
4888,806,21,9,0.141552511,0.858447489,1642.750455,1601.002846,2786.802578,3215.600496,5694,107.2922555,11388,-2502656,412672,-2089984,74
4782,792,20,10,0.142088267,0.857911733,1611.986252,1553.54814,2734.582183,3107.011364,5574,99.16384985,11148,-2448384,405504,-2042880,74
5233,812,21,9,0.134325889,0.865674111,1745.362684,1703.213042,2969.562584,3367.381773,6045,105.276907,12090,-2679296,415744,-2263552,74
5238,872,20,10,0.142716858,0.857283142,1760.546055,1742.989427,2997.417908,3404.392202,6110,108.912656,12220,-2681856,446464,-2235392,74
4992,864,20,10,0.147540984,0.852459016,1686.348838,1654.752669,2857.008013,3341.564815,5856,108.3040503,11712,-2555904,442368,-2113536,74
5045,893,21,9,0.150387336,0.849612664,1697.091588,1732.928741,2885.656492,3443.173572,5938,113.3206107,11876,-2583040,457216,-2125824,74
3556,479,20,10,0.118711276,0.881288724,1173.298247,1096.064836,2006.708661,2101.824635,4035,78.15223707,8070,-1820672,245248,-1575424,74
4611,744,20,10,0.138935574,0.861064426,1530.493184,1556.459626,2601.655389,3151.151882,5355,100.4313578,10710,-2360832,380928,-1979904,74
5291,860,21,9,0.139814664,0.860185336,1762.503322,1807.092597,3013.245889,3462.083721,6151,113.111438,12302,-2708992,440320,-2268672,74
3526,479,20,10,0.119600499,0.880399501,1167.588999,1066.941722,1996.587635,2050.202505,4005,78.39107457,8010,-1805312,245248,-1560064,74
4603,748,20,10,0.139786956,0.860213044,1531.653052,1546.801834,2602.085596,3130.850267,5351,101.4023119,10702,-2356736,382976,-1973760,74
5029,846,21,9,0.144,0.856,1671.007964,1725.21887,2839.630145,3522.754137,5875,108.635355,11750,-2574848,433152,-2141696,74
5442,842,21,9,0.133991088,0.866008912,1802.525584,1820.437802,3071.123484,3603.819477,6284,117.9208107,12568,-2786304,431104,-2355200,74
4839,838,20,10,0.147613176,0.852386824,1632.214635,1619.467894,2769.755115,3238.852029,5677,102.3251622,11354,-2477568,429056,-2048512,74
5413,829,21,9,0.132809997,0.867190003,1796.284012,1801.723593,3069.516534,3460.92883,6242,109.8943662,12484,-2771456,424448,-2347008,74
2333,281,20,10,0.107498087,0.892501913,750.4254308,783.0180144,1297.057865,1394.19573,2614,52.7016129,5228,-1194496,143872,-1050624,74
4943,870,20,10,0.149664545,0.850335455,1668.518107,1660.89342,2827.664576,3357.752874,5813,103.4709861,11626,-2530816,445440,-2085376,74
4784,821,20,10,0.14647636,0.85352364,1606.541924,1612.292201,2726.261915,3250.155907,5605,98.69695369,11210,-2449408,420352,-2029056,74
5082,769,21,9,0.131430525,0.868569475,1672.996388,1751.587759,2873.005706,3276.217165,5851,111.9380142,11702,-2601984,393728,-2208256,74
4857,822,20,10,0.144743793,0.855256207,1631.481801,1644.968524,2782.614989,3179.074209,5679,101.4650706,11358,-2486784,420864,-2065920,74
1360,230,21,9,0.144654088,0.855345912,466.6312587,358.2230013,826.9948529,609.2695652,1590,28.21650399,3180,-696320,117760,-578560,74
9292,673,21,9,0.0675363773,0.932463623,2847.152609,3085.505188,5055.874193,3976.838039,9965,1299.217731,19930,-4757504,344576,-4412928,74
9172,792,20,10,0.0794861501,0.92051385,2850.963377,2963.719992,5072.274204,3942.842172,9964,383.6734694,19928,-4696064,405504,-4290560,74
9191,762,20,10,0.0765598312,0.923440169,2843.045739,3123.388649,5037.546948,4246.7021,9953,1081.847826,19906,-4705792,390144,-4315648,74
9224,731,20,10,0.073430437,0.926569563,2857.152174,2949.152656,5044.593343,4137.703146,9955,712.5984252,19910,-4722688,374272,-4348416,74
9239,710,20,10,0.0713639562,0.928636044,2856.233661,3041.086943,5006.21918,4568.75493,9949,879.6640141,19898,-4730368,363520,-4366848,74
9209,740,19,11,0.0743793346,0.925620665,2851.59011,3074.095883,5013.986101,4489.833784,9949,1000.905433,19898,-4715008,378880,-4336128,74
9156,792,20,10,0.0796139928,0.920386007,2848.063299,2964.530192,5058.478921,4003.652778,9948,735.7988166,19896,-4687872,405504,-4282368,74
9252,711,21,9,0.071364047,0.928635953,2837.851361,3158.606892,5060.954712,3954.589311,9963,1346.351351,19926,-4737024,364032,-4372992,74
9316,646,20,10,0.0648464164,0.935153584,2854.119533,3055.611098,5038.531237,4159.049536,9962,1174.764151,19924,-4769792,330752,-4439040,74
9168,784,21,9,0.078778135,0.921221865,2851.0815,3074.807382,5018.285122,4487.869898,9952,657.331572,19904,-4694016,401408,-4292608,74
9187,760,20,10,0.0764049462,0.923595054,2838.032374,3083.108857,5055.317078,3991.026316,9947,255.4442732,19894,-4703744,389120,-4314624,74
9255,694,21,9,0.0697557543,0.930244246,2847.2674,3133.765398,5015.697785,4432.26513,9949,612.2461538,19898,-4738560,355328,-4383232,74
9260,702,21,9,0.0704677776,0.929532222,2846.216623,3076.433493,5055.936933,3999.611111,9962,1413.049645,19924,-4741120,359424,-4381696,74
9379,596,20,10,0.0597493734,0.940250627,2849.900821,3071.409299,5064.217507,3788.597315,9975,1063.432836,19950,-4802048,305152,-4496896,74
9215,741,20,10,0.0744274809,0.925572519,2843.874886,3116.742446,5042.842214,4178.346829,9956,1218.604651,19912,-4718080,379392,-4338688,74
9276,676,20,10,0.067926045,0.932073955,2852.646851,3110.482842,5005.442324,4579.356509,9952,788.5895404,19904,-4749312,346112,-4403200,74
9216,737,20,10,0.0740480257,0.925951974,2845.760654,3111.414877,5033.306749,4272.898236,9953,873.0701754,19906,-4718592,377344,-4341248,74
9313,649,21,9,0.0651475607,0.934852439,2853.267539,3085.272437,5033.783636,4231.241911,9962,1342.587601,19924,-4768256,332288,-4435968,74
9226,753,21,9,0.0754584628,0.924541537,2853.000664,2961.755782,5085.197919,3823.60425,9979,655.2199606,19958,-4723712,385536,-4338176,74
7209,1321,21,9,0.154865182,0.845134818,2448.18082,2293.235911,4082.082536,5266.451173,8530,179.9198481,17060,-3691008,676352,-3014656,74
7407,1285,21,9,0.147837092,0.852162908,2509.817011,2315.963861,4193.4489,5228.71751,8692,154.4420753,17384,-3792384,657920,-3134464,74
3831,457,20,10,0.106576493,0.893423507,1240.224044,1214.882733,2135.230488,2222.205689,4288,74.99125568,8576,-1961472,233984,-1727488,74
6377,1310,21,9,0.170417588,0.829582412,2180.72411,1983.809108,3592.315979,5069.182443,7687,139.7890526,15374,-3265024,670720,-2594304,74
3492,336,20,10,0.0877742947,0.912225705,1097.746939,1171.581763,1902.991409,2034.107143,3828,95.77182887,7656,-1787904,172032,-1615872,74
8472,1380,21,9,0.140073082,0.859926918,2882.916758,2529.1956,4840.470845,5454.644203,9852,478.4847013,19704,-4337664,706560,-3631104,74
7479,1216,20,10,0.139850489,0.860149511,2477.173265,2472.316588,4183.108838,5362.162007,8695,159.9227515,17390,-3829248,622592,-3206656,74
8596,1272,20,10,0.1289015,0.8710985,2868.549823,2627.094868,4842.456142,5556.519654,9868,260.3693931,19736,-4401152,651264,-3749888,74
7776,1193,21,9,0.133013714,0.866986286,2598.171169,2395.521478,4369.009259,5241.030176,8969,168.9395366,17938,-3981312,610816,-3370496,74
7703,1332,21,9,0.147426674,0.852573326,2607.615578,2406.692009,4356.157861,5453.938438,9035,159.5162429,18070,-3943936,681984,-3261952,74
8117,1361,21,9,0.143595695,0.856404305,2723.810297,2606.027251,4577.229641,5707.279941,9478,165.3812598,18956,-4155904,696832,-3459072,74
7456,1297,19,11,0.148177768,0.851822232,2527.058956,2339.452557,4224.4147,5254.159599,8753,170.52406,17506,-3817472,664064,-3153408,74
6030,940,21,9,0.134863702,0.865136298,1973.216534,1994.118534,3335.861028,4445.418085,6970,128.9785344,13940,-3087360,481280,-2606080,74
8200,1390,20,10,0.144942649,0.855057351,2721.636546,2817.449044,4620.929512,5825.340288,9590,171.9870875,19180,-4198400,711680,-3486720,74
7010,1343,21,9,0.160780558,0.839219442,2383.859832,2194.267017,3949.07903,5366.669397,8353,145.598745,16706,-3589120,687616,-2901504,74
6333,1053,21,9,0.142567019,0.857432981,2072.534395,2128.919229,3503.589294,4835.669516,7386,149.8174442,14772,-3242496,539136,-2703360,74
8640,1242,21,9,0.12568306,0.87431694,2866.834802,2622.364563,4829.190856,5722.780998,9882,343.8413361,19764,-4423680,635904,-3787776,74
8057,1289,21,9,0.137919966,0.862080034,2681.318066,2603.379783,4520.501924,5629.826998,9346,166.6250669,18692,-4125184,659968,-3465216,74
6622,1043,21,9,0.136073059,0.863926941,2219.445778,2026.213221,3719.552703,4553.276127,7665,147.2622478,15330,-3390464,534016,-2856448,74
657,66,20,10,0.0912863071,0.908713693,201.6318287,267.5743248,364.8493151,333.6363636,723,11.01630352,1446,-336384,33792,-302592,74
8528,1325,21,9,0.134476809,0.865523191,2884.816748,2475.096641,4827.839587,5565.218868,9853,529.4465341,19706,-4366336,678400,-3687936,74
6202,1154,20,10,0.156878738,0.843121262,2089.241663,2028.199249,3493.605772,4672.186308,7356,138.7400981,14712,-3175424,590848,-2584576,74
8045,1356,21,9,0.144239974,0.855760026,2712.725637,2510.428869,4537.588689,5670.501475,9401,165.1036178,18802,-4119040,694272,-3424768,74
6214,1011,21,9,0.139930796,0.860069204,2040.936463,2053.03059,3442.965883,4658.095945,7225,130.5801554,14450,-3181568,517632,-2663936,74
6346,1159,20,10,0.15443038,0.84556962,2142.714161,2023.266398,3572.002364,4744.036238,7505,133.1618169,15010,-3249152,593408,-2655744,74
5743,1054,20,10,0.155068413,0.844931587,1936.110631,1818.451608,3222.411109,4361.191651,6797,138.2628153,13594,-2940416,539648,-2400768,74
1642,117,20,10,0.0665150654,0.933484935,499.1563006,612.3879417,884.7095006,813.9059829,1759,38.01599308,3518,-840704,59904,-780800,74
7328,1254,21,9,0.146119786,0.853880214,2439.660768,2450.750663,4117.123226,5310.505582,8582,154.8817903,17164,-3751936,642048,-3109888,74
5799,1118,20,10,0.161630765,0.838369235,1966.80398,1859.246905,3270.00638,4439.298748,6917,142.6773927,13834,-2969088,572416,-2396672,74
6584,1107,21,9,0.143934469,0.856065531,2153.091121,2213.001422,3638.598269,5079.543812,7691,138.4269258,15382,-3371008,566784,-2804224,74
8233,1475,21,9,0.151936547,0.848063453,2779.836229,2658.649887,4653.093405,5978.690169,9708,172.1276596,19416,-4215296,755200,-3460096,74
7505,1172,21,9,0.135069725,0.864930275,2509.898516,2360.158711,4232.155363,5023.188567,8677,160.7149472,17354,-3842560,600064,-3242496,74
5799,1125,20,10,0.162478336,0.837521664,1935.586795,1940.849014,3244.336782,4587.058667,6924,126.1202186,13848,-2969088,576000,-2393088,74
8053,1232,20,10,0.13268713,0.86731287,2701.250874,2440.151931,4542.794983,5297.992695,9285,173.1629989,18570,-4123136,630784,-3492352,74
8195,1428,21,9,0.148394472,0.851605528,2780.641291,2602.545331,4663.151922,5666.208683,9623,169.9276002,19246,-4195840,731136,-3464704,74
7475,1234,20,10,0.141692502,0.858307498,2507.852856,2396.330058,4221.026355,5166.550243,8709,163.0288282,17418,-3827200,631808,-3195392,74
7579,1229,21,9,0.139532243,0.860467757,2537.706606,2401.363179,4265.540441,5261.436127,8808,158.8744589,17616,-3880448,629248,-3251200,74
7134,1248,21,9,0.14889048,0.85110952,2390.119919,2291.316248,3999.365854,5289.805288,8382,150.4847397,16764,-3652608,638976,-3013632,74
7586,1268,21,9,0.143212108,0.856787892,2557.182893,2373.782369,4284.053388,5285.690852,8854,157.0415041,17708,-3884032,649216,-3234816,74
1936,232,21,9,0.10701107,0.89298893,620.0490968,664.501162,1072.946281,1180.913793,2168,38.67975022,4336,-991232,118784,-872448,74
6095,682,20,10,0.100634499,0.899365501,1926.738861,1994.160778,3289.55242,4277.758065,6777,123.1286337,13554,-3120640,349184,-2771456,74
5759,668,21,9,0.103936518,0.896063482,1809.924597,1932.235992,3096.615037,4226.005988,6427,118.1868334,12854,-2948608,342016,-2606592,74
7076,936,21,9,0.116824763,0.883175237,2292.988546,2179.899023,3865.337761,5073.662393,8012,140.6107406,16024,-3622912,479232,-3143680,74
5779,694,21,9,0.107214584,0.892785416,1831.334437,1870.736854,3115.85032,4245.824207,6473,113.7609842,12946,-2958848,355328,-2603520,74
5680,643,19,11,0.101692235,0.898307765,1791.857815,1834.696895,3052.901937,4125.727838,6323,110.9492893,12646,-2908160,329216,-2578944,74
5774,692,21,9,0.107021342,0.892978658,1831.509719,1878.437834,3118.142362,4196.036127,6466,115.11483,12932,-2956288,354304,-2601984,74
4928,391,20,10,0.0735100583,0.926489942,1518.401784,1660.400469,2621.253856,3148.340153,5319,129.6052632,10638,-2523136,200192,-2322944,74
5873,594,21,9,0.0918509355,0.908149064,1829.716969,1974.846945,3140.41495,4159.294613,6467,153.646947,12934,-3006976,304128,-2702848,74
4940,411,19,11,0.0768080733,0.923191927,1530.067786,1645.924835,2638.691498,3124.428224,5351,142.6933333,10702,-2529280,210432,-2318848,74
33,19,20,10,0.365384615,0.634615385,15.61661896,13.84580699,26,27.36842105,52,1.591187271,104,-16896,9728,-7168,74
5712,707,20,10,0.110141767,0.889858233,1819.830186,1807.1973,3084.67507,4222.526167,6419,120.7032719,12838,-2924544,361984,-2562560,74
5609,629,21,9,0.100833601,0.899166399,1758.062783,1913.395654,3016.59458,4037.141494,6238,114.7534952,12476,-2871808,322048,-2549760,74
6112,737,21,9,0.10760695,0.89239305,1947.783211,1974.49464,3313.051211,4353.400271,6849,138.2240161,13698,-3129344,377344,-2752000,74
6835,897,20,10,0.116011381,0.883988619,2213.084835,2103.904241,3731.476225,4895.360089,7732,140.6073832,15464,-3499520,459264,-3040256,74
5625,588,20,10,0.0946402704,0.90535973,1758.434501,1890.631595,3016.105778,3976.52381,6213,134.1321244,12426,-2880000,301056,-2578944,74
7843,827,21,9,0.0953863899,0.90461361,2514.026651,2303.949147,4270.320541,4953.640871,8670,181.8372483,17340,-4015616,423424,-3592192,74
5697,680,21,9,0.106633213,0.893366787,1806.031691,1843.377885,3073.08917,4160.094118,6377,113.6517555,12754,-2916864,348160,-2568704,74
3633,218,21,9,0.0566086731,0.943391327,1102.891803,1234.657361,1937.074043,1741.449541,3851,72.81149556,7702,-1860096,111616,-1748480,74
5358,600,20,10,0.100704935,0.899295065,1678.510704,1823.203803,2879.262785,3874.618333,5958,111.5939314,11916,-2743296,307200,-2436096,74
6314,811,20,10,0.113824561,0.886175439,2033.360132,1935.132792,3428.765283,4608.077682,7125,147.6072094,14250,-3232768,415232,-2817536,74
8728,1138,21,9,0.115345631,0.884654369,2910.501739,2312.724904,4942.507676,4864.414763,9866,224.5334547,19732,-4468736,582656,-3886080,74
7413,1287,20,10,0.147931034,0.852068966,2514.492239,2326.241452,4206.381492,5180.609169,8700,156.3904368,17400,-3795456,658944,-3136512,74
8720,1166,20,10,0.117944568,0.882055432,2895.371633,2476.913667,4884.099312,5387.731561,9886,462.8277154,19772,-4464640,596992,-3867648,74
8660,1207,20,10,0.122326948,0.877673052,2909.228251,2343.762245,4891.613972,5238.111848,9867,327.1551724,19734,-4433920,617984,-3815936,74
8476,1383,21,9,0.140277919,0.859722081,2885.236079,2483.639531,4817.28799,5620.778742,9859,375.4379284,19718,-4339712,708096,-3631616,74
6638,1160,20,10,0.148756091,0.851243909,2246.083308,2023.136127,3730.159235,4868.537931,7798,146.1668229,15596,-3398656,593920,-2804736,74
8487,1373,20,10,0.139249493,0.860750507,2858.90796,2637.09074,4804.562036,5708.967225,9860,428.1372123,19720,-4345344,702976,-3642368,74
8521,1342,20,10,0.136064078,0.863935922,2849.313566,2715.674467,4813.495951,5684.438897,9863,251.5429737,19726,-4362752,687104,-3675648,74
8651,1215,20,10,0.123150213,0.876849787,2925.422543,2220.717509,4932.681193,4939.330041,9866,428.7701,19732,-4429312,622080,-3807232,74
481,51,20,10,0.0958646617,0.904135338,149.5208971,164.2242561,275.6320166,180.372549,532,10.9849267,1064,-246272,26112,-220160,74
6167,1244,21,9,0.167858589,0.832141411,2086.870717,2011.91929,3471.138965,4870.299035,7411,131.2145892,14822,-3157504,636928,-2520576,74
8546,1318,21,9,0.133617194,0.866382806,2881.782213,2546.855705,4847.832787,5481.48786,9864,229.769392,19728,-4375552,674816,-3700736,74
8483,1388,20,10,0.14061392,0.85938608,2899.205558,2455.316231,4846.880703,5480.667867,9871,264.2130621,19742,-4343296,710656,-3632640,74
8489,1371,20,10,0.139046653,0.860953347,2882.049749,2532.261293,4833.085522,5533.673961,9860,313.713013,19720,-4346368,701952,-3644416,74
8595,1263,21,9,0.128119294,0.871880706,2904.087425,2357.192817,4859.580221,5405.319873,9858,444.4544635,19716,-4400640,646656,-3753984,74
8849,1042,20,10,0.105348296,0.894651704,2923.836425,2179.389855,4967.875127,4760.229367,9891,420.7145895,19782,-4530688,533504,-3997184,74
5839,876,19,11,0.130454207,0.869545793,1923.284382,1960.215666,3280.660558,3873.507991,6715,117.2311453,13430,-2989568,448512,-2541056,74
8767,1126,20,10,0.113817851,0.886182149,2913.668774,2354.512677,4931.941257,5064.246892,9893,381.0862866,19786,-4488704,576512,-3912192,74
6254,1112,20,10,0.150963888,0.849036112,2077.866234,2109.280105,3502.568756,4701.07554,7366,129.4096978,14732,-3202048,569344,-2632704,74
577,60,21,9,0.0941915228,0.905808477,177.2761352,236.664152,321.729636,292.75,637,9.672031582,1274,-295424,30720,-264704,74
256,38,20,10,0.129251701,0.870748299,82.86700732,77.94178878,155.5664063,93.15789474,294,38.33116037,588,-131072,19456,-111616,75
257,37,20,10,0.12585034,0.87414966,83.34913309,69.01278187,156.2412451,86.78378378,294,62.02531646,588,-131584,18944,-112640,75
251,37,20,10,0.128472222,0.871527778,80.77305182,77.46174154,152.689243,88.94594595,288,70.41564792,576,-128512,18944,-109568,75
248,35,20,10,0.123674912,0.876325088,79.87838691,72.01125762,149.891129,86.08571429,283,77.11171662,566,-126976,17920,-109056,75
254,37,19,11,0.127147766,0.872852234,82.07814794,74.15010539,154.3385827,88.75675676,291,51.59574468,582,-130048,18944,-111104,75
254,38,19,11,0.130136986,0.869863014,82.28024106,76.10096807,154.8188976,90.89473684,292,29.11266201,584,-130048,19456,-110592,75
249,38,19,11,0.132404181,0.867595819,81.05588175,64.42200399,153.6827309,80.55263158,287,17.54278729,574,-127488,19456,-108032,75
249,37,19,11,0.129370629,0.870629371,80.75323193,72.60554143,151.7389558,88.05405405,286,74.86910995,572,-127488,18944,-108544,75
252,36,19,11,0.125,0.875,81.24219132,66.23988392,153.6666667,80.33333333,288,45.56962025,576,-129024,18432,-110592,75
251,38,19,11,0.131487889,0.868512111,80.60853339,83.00931513,152.8844622,92.92105263,289,48.98305085,578,-128512,19456,-109056,75
258,39,20,10,0.131313131,0.868686869,83.51785017,83.19182462,156.6046512,98.69230769,297,46.55172414,594,-132096,19968,-112128,75
248,39,19,11,0.135888502,0.864111498,80.39068883,77.27002101,152.5806452,89.43589744,287,51.15864528,574,-126976,19968,-107008,75
253,39,20,10,0.133561644,0.866438356,81.46956874,81.93211699,154.9011858,92,292,55.72519084,584,-129536,19968,-109568,75
250,39,19,11,0.134948097,0.865051903,81.11973018,70.66539205,154.624,83.30769231,289,32.84090909,578,-128000,19968,-108032,75
253,35,20,10,0.121527778,0.878472222,80.95535306,72.40992152,152.9604743,83.34285714,288,39.07734057,576,-129536,17920,-111616,75
251,41,19,11,0.140410959,0.859589041,81.47690349,77.72404242,155.9840637,88.43902439,292,60.70686071,584,-128512,20992,-107520,75
255,40,20,10,0.13559322,0.86440678,82.25923932,82.66976473,156.6431373,92.9,295,48.8410596,590,-130560,20480,-110080,75
254,40,20,10,0.136054422,0.863945578,82.25378859,81.9493136,155.8622047,94.4,294,51.66959578,588,-130048,20480,-109568,75
251,39,19,11,0.134482759,0.865517241,80.86215523,83.51704405,153.4900398,94.07692308,290,41.31054131,580,-128512,19968,-108544,75
250,40,19,11,0.137931034,0.862068966,80.99261438,77.32479793,154.696,88.025,290,51.14638448,580,-128000,20480,-107520,75
400,102,23,7,0.203187251,0.796812749,138.5542172,167.228289,249.1625,260.6666667,502,85.51959114,1004,-204800,52224,-152576,75
409,102,23,7,0.199608611,0.800391389,141.5228105,168.8922203,253.0268949,267.9215686,511,102.8169014,1022,-209408,52224,-157184,75
396,113,23,7,0.222003929,0.777996071,140.0781495,168.0426915,251.030303,268.9115044,509,67.15039578,1018,-202752,57856,-144896,75
396,102,23,7,0.204819277,0.795180723,138.2750684,163.1903998,248.020202,255.245098,498,63.92811297,996,-202752,52224,-150528,75
403,112,23,7,0.217475728,0.782524272,141.8738525,170.8407481,256.9677419,261.7142857,515,46.5641953,1030,-206336,57344,-148992,75
400,106,23,7,0.209486166,0.790513834,140.2578427,166.0581891,254.9925,247.8679245,506,70.27777778,1012,-204800,54272,-150528,75
397,109,22,8,0.21541502,0.78458498,140.0086288,165.8500768,250.5717884,264.1651376,506,39.37743191,1012,-203264,55808,-147456,75
398,105,23,7,0.208747515,0.791252485,138.7623409,167.2467521,250.419598,257.9904762,503,93.84328358,1006,-203776,53760,-150016,75
402,107,23,7,0.21021611,0.78978389,141.2246552,166.6465116,255.2860697,253.9252336,509,142.9775281,1018,-205824,54784,-151040,75
413,109,23,7,0.208812261,0.791187739,143.9075351,173.718273,259.1815981,270.2844037,522,101.5564202,1044,-211456,55808,-155648,75
421,110,23,7,0.207156309,0.792843691,146.9954469,175.0474118,263.8574822,274.2,531,85.78352181,1062,-215552,56320,-159232,75
392,96,23,7,0.196721311,0.803278689,134.7025434,162.8540584,240.9107143,259.15625,488,55.01691094,976,-200704,49152,-151552,75
407,110,22,8,0.212765957,0.787234043,143.6879806,168.0434969,260.8280098,252.2363636,517,46.91470054,1034,-208384,56320,-152064,75
419,109,23,7,0.206439394,0.793560606,146.8986677,171.8970302,263.1026253,269.8715596,528,88.44221106,1056,-214528,55808,-158720,75
411,115,23,7,0.218631179,0.781368821,144.2105536,175.4808346,258.9513382,279.7565217,526,9.203849519,1052,-210432,58880,-151552,75
404,107,23,7,0.209393346,0.790606654,141.9575564,166.7175549,254.5717822,261.3925234,511,49.0403071,1022,-206848,54784,-152064,75
406,108,23,7,0.210116732,0.789883268,142.3467183,168.6382346,260.5812808,245.9166667,514,72.49647391,1028,-207872,55296,-152576,75
407,112,23,7,0.215799615,0.784200385,143.7074516,170.183461,260.6240786,257.7321429,519,55.80645161,1038,-208384,57344,-151040,75
414,104,22,8,0.200772201,0.799227799,142.36292,174.959323,257.47343,267.5673077,518,41.30781499,1036,-211968,53248,-158720,75
394,106,23,7,0.212,0.788,138.5244755,164.1168662,249.7284264,253.3679245,500,78.36990596,1000,-201728,54272,-147456,75
164,33,20,10,0.16751269,0.83248731,54.28403033,56.68214017,105.9878049,64.27272727,197,30.73322933,394,-83968,16896,-67072,75
176,30,21,9,0.145631068,0.854368932,56.96361388,62.81140201,109.1818182,70.16666667,206,23.14606742,412,-90112,15360,-74752,75
162,34,19,11,0.173469388,0.826530612,53.72396985,58.25704436,105.4012346,65.61764706,196,36.63551402,392,-82944,17408,-65536,75
162,32,19,11,0.164948454,0.835051546,53.04711723,60.76285069,103.4197531,67.53125,194,11.66566446,388,-82944,16384,-66560,75
168,34,20,10,0.168316832,0.831683168,54.84590316,67.52643978,106.6488095,76.05882353,202,3.679417122,404,-86016,17408,-68608,75
166,33,20,10,0.165829146,0.834170854,54.78506943,58.32118724,106.7951807,65.81818182,199,44.81981982,398,-84992,16896,-68096,75
164,33,20,10,0.16751269,0.83248731,53.89465924,61.34641734,105.1097561,68.63636364,197,46.35294118,394,-83968,16896,-67072,75
161,31,19,11,0.161458333,0.838541667,52.89308177,57.84954831,102.4782609,65.4516129,192,38.32335329,384,-82432,15872,-66560,75
168,32,19,11,0.16,0.84,54.91915698,57.70341059,107.6309524,63.0625,200,28.49002849,400,-86016,16384,-69632,75
163,32,19,11,0.164102564,0.835897436,53.77529804,56.35323859,104.7239264,63.75,195,42.85714286,390,-83456,16384,-67072,75
163,31,19,11,0.159793814,0.840206186,53.21496865,59.07389683,103.6564417,65.12903226,194,40.58577406,388,-83456,15872,-67584,75
164,33,19,11,0.16751269,0.83248731,53.80302436,59.85630175,105.7134146,65.63636364,197,40.87136929,394,-83968,16896,-67072,75
161,33,19,11,0.170103093,0.829896907,53.30371816,55.7965279,104.6397516,62.66666667,194,16.26152557,388,-82432,16896,-65536,75
162,31,20,10,0.160621762,0.839378238,53.37215951,52.58165445,104.1728395,59.51612903,193,38.83299799,386,-82944,15872,-67072,75
162,30,19,11,0.15625,0.84375,52.85356806,55.88843053,102.9814815,61.5,192,26.70375522,384,-82944,15360,-67584,75
166,33,19,11,0.165829146,0.834170854,54.50698183,59.72131483,106.7650602,65.96969697,199,28.22695035,398,-84992,16896,-68096,75
162,31,20,10,0.160621762,0.839378238,52.75787221,59.41199912,103.1975309,64.61290323,193,28.7202381,386,-82944,15872,-67072,75
167,32,19,11,0.16080402,0.83919598,55.03577602,56.8447636,106.760479,64.71875,199,30.75734158,398,-85504,16384,-69120,75
169,33,20,10,0.163366337,0.836633663,55.52235187,61.23449936,107.8816568,68.81818182,202,30.28485757,404,-86528,16896,-69632,75
167,36,19,11,0.177339901,0.822660099,55.63586774,59.59137475,109.4550898,67.41666667,203,34.06040268,406,-85504,18432,-67072,75
168,33,20,10,0.164179104,0.835820896,55.1651352,60.51643373,107.6011905,67.39393939,201,47.5177305,402,-86016,16896,-69120,75
166,35,19,11,0.174129353,0.825870647,55.0566254,60.36173947,107.9457831,68.05714286,201,38.06818182,402,-84992,17920,-67072,75
164,30,19,11,0.154639175,0.845360825,53.36491449,57.97939289,103.6829268,63.7,194,34.39716312,388,-83968,15360,-68608,75
164,33,20,10,0.16751269,0.83248731,54.40324512,56.13376062,105.9817073,64.3030303,197,43.10722101,394,-83968,16896,-67072,75
164,35,19,11,0.175879397,0.824120603,54.41896697,58.92326383,107.2865854,65.85714286,199,22.97921478,398,-83968,17920,-66048,75
164,35,19,11,0.175879397,0.824120603,54.76784158,54.96418129,107.9573171,62.71428571,199,43.64035088,398,-83968,17920,-66048,75
173,32,21,9,0.156097561,0.843902439,56.94532368,58.05519161,109.6531792,67.03125,205,35.04273504,410,-88576,16384,-72192,75
166,34,20,10,0.17,0.83,54.61404619,62.45079032,106.813253,69.67647059,200,42.64392324,400,-84992,17408,-67584,75
167,33,19,11,0.165,0.835,55.03580924,57.29770179,107.7005988,64.06060606,200,41.66666667,400,-85504,16896,-68608,75
167,32,20,10,0.16080402,0.83919598,54.38881908,62.81588144,105.9221557,69.09375,199,23.32942556,398,-85504,16384,-69120,75
161,31,19,11,0.161458333,0.838541667,52.94394199,54.37940481,103.3540373,60.90322581,192,31.57894737,384,-82432,15872,-66560,75
167,32,19,11,0.16080402,0.83919598,54.83229446,56.85823929,107.0179641,63.375,199,25.12626263,398,-85504,16384,-69120,75
171,33,20,10,0.161764706,0.838235294,56.13512037,61.22599603,109.0175439,68.72727273,204,39.61165049,408,-87552,16896,-70656,75
171,35,19,11,0.169902913,0.830097087,56.52748525,59.82632006,111.0116959,66.8,206,29.55523673,412,-87552,17920,-69632,75
169,34,20,10,0.167487685,0.832512315,55.9368476,60.56242311,108.5739645,69.32352941,203,35.42757417,406,-86528,17408,-69120,75
164,33,19,11,0.16751269,0.83248731,54.39057886,56.87787571,105.7926829,65.24242424,197,44.17040359,394,-83968,16896,-67072,75
165,35,19,11,0.175,0.825,54.71464132,59.76118459,107.6121212,66.97142857,200,27.02702703,400,-84480,17920,-66560,75
45,25,20,10,0.357142857,0.642857143,19.78696416,20.92447371,35.17777778,36.08,70,2.966101695,140,-23040,12800,-10240,75
167,35,19,11,0.173267327,0.826732673,55.29934187,61.41046909,108.2694611,69.2,202,24.19161677,404,-85504,17920,-67584,75
165,34,20,10,0.170854271,0.829145729,54.71371824,61.50568235,105.9454545,71.14705882,199,41.80672269,398,-84480,17408,-67072,75
166,33,19,11,0.165829146,0.834170854,54.68521805,60.9238788,106.1445783,69.09090909,199,35.85585586,398,-84992,16896,-68096,75
165,34,19,11,0.170854271,0.829145729,54.76168454,55.79452076,107.6181818,63.02941176,199,28.71572872,398,-84480,17408,-67072,75
164,36,20,10,0.18,0.82,54.28458648,65.44701466,106.1585366,74.72222222,200,3.538570418,400,-83968,18432,-65536,75
167,31,19,11,0.156565657,0.843434343,54.23032197,63.05077814,105.0179641,69.77419355,198,32.30016313,396,-85504,15872,-69632,75
164,30,19,11,0.154639175,0.845360825,53.58989339,56.99703696,103.6402439,63.93333333,194,22.27324914,388,-83968,15360,-68608,75
167,37,20,10,0.181372549,0.818627451,55.26523297,68.09510815,107.7964072,78.59459459,204,3.541666667,408,-85504,18944,-66560,75
164,33,19,11,0.16751269,0.83248731,54.01050171,58.31161343,105.8902439,64.75757576,197,38.10444874,394,-83968,16896,-67072,75
163,33,20,10,0.168367347,0.831632653,53.89790841,59.11287859,104.8159509,67.3030303,196,33.27674024,392,-83456,16896,-66560,75
165,31,19,11,0.158163265,0.841836735,54.08102482,58.4227836,104.6181818,65.93548387,196,24.04907975,392,-84480,15872,-68608,75
163,32,20,10,0.164102564,0.835897436,53.62138953,58.0754409,104.4478528,65.15625,195,33.91304348,390,-83456,16384,-67072,75
163,32,20,10,0.164102564,0.835897436,53.74090538,56.15380664,104.8220859,63.25,195,39.63414634,390,-83456,16384,-67072,75
172,35,20,10,0.169082126,0.830917874,57.1344862,60.77911833,110.8953488,70.11428571,207,49.5215311,414,-88064,17920,-70144,75
162,31,20,10,0.160621762,0.839378238,52.65297966,62.10832737,102.4876543,68.32258065,193,26.40218878,386,-82944,15872,-67072,75
162,30,19,11,0.15625,0.84375,53.13618146,52.77542568,103.3641975,59.43333333,192,38.70967742,384,-82944,15360,-67584,75
167,32,19,11,0.16080402,0.83919598,54.75082696,60.55717856,106.1077844,68.125,199,37.97709924,398,-85504,16384,-69120,75
168,31,20,10,0.155778894,0.844221106,54.80186818,59.40117406,106.297619,65.87096774,199,34.13379074,398,-86016,15872,-70144,75
165,36,19,11,0.179104478,0.820895522,54.32586911,68.15097619,105.9454545,78.33333333,201,3.55626327,402,-84480,18432,-66048,75
162,30,20,10,0.15625,0.84375,52.45294195,59.57151631,102.5246914,63.96666667,192,34.40860215,384,-82944,15360,-67584,75
163,30,20,10,0.155440415,0.844559585,53.02582925,58.375756,103.0613497,64.06666667,193,28.34067548,386,-83456,15360,-68096,75
168,36,20,10,0.176470588,0.823529412,55.21009367,69.53151763,107.2321429,80.41666667,204,3.248924988,408,-86016,18432,-67584,75
280,55,20,10,0.164179104,0.835820896,94.14214008,78.59102214,181.5178571,99.18181818,335,54.20711974,670,-143360,28160,-115200,75
287,54,20,10,0.158357771,0.841642229,96.03353048,82.85493959,183.5783972,104.1481481,341,45.40612517,682,-146944,27648,-119296,75
280,55,20,10,0.164179104,0.835820896,94.26729366,78.5286093,181.3857143,99.85454545,335,75.45045045,670,-143360,28160,-115200,75
277,49,19,11,0.150306748,0.849693252,91.7114234,78.39929196,175.2888087,96.85714286,326,40.80100125,652,-141824,25088,-116736,75
307,57,19,11,0.156593407,0.843406593,102.5755769,85.81065645,196.2214984,108.5964912,364,52.83018868,728,-157184,29184,-128000,75
286,54,19,11,0.158823529,0.841176471,95.96090496,79.4778916,183.4195804,102.0740741,340,26.52106084,680,-146432,27648,-118784,75
278,52,19,11,0.157575758,0.842424242,92.88237844,72.83738829,178.9784173,93.44230769,330,66.53225806,660,-142336,26624,-115712,75
285,53,20,10,0.156804734,0.843195266,95.93159921,83.24176766,180.6947368,109.3018868,338,44.53227931,676,-145920,27136,-118784,75
286,59,19,11,0.171014493,0.828985507,96.70216635,80.66237565,187.7447552,101.5254237,345,43.78172589,690,-146432,30208,-116224,75
279,55,19,11,0.164670659,0.835329341,94.38690377,82.52687817,179.5197133,106.5272727,334,69.58333333,668,-142848,28160,-114688,75
276,54,19,11,0.163636364,0.836363636,92.77502831,75.83883894,179.0253623,96.37037037,330,45.64315353,660,-141312,27648,-113664,75
290,58,20,10,0.166666667,0.833333333,98.20610374,85.50017905,187.4344828,109.8275862,348,79.81651376,696,-148480,29696,-118784,75
286,55,20,10,0.161290323,0.838709677,96.36389016,76.47164656,184.5769231,100.4,341,45.16556291,682,-146432,28160,-118272,75
279,55,19,11,0.164670659,0.835329341,94.50710415,80.83828158,179.734767,105.4363636,334,55.38971808,668,-142848,28160,-114688,75
290,57,20,10,0.16426513,0.83573487,97.58780089,85.91188483,187.0206897,107.754386,347,6.138333628,694,-148480,29184,-119296,75
285,56,20,10,0.164222874,0.835777126,96.12794798,80.67453983,184.2842105,103.3928571,341,39.78996499,682,-145920,28672,-117248,75
280,53,19,11,0.159159159,0.840840841,93.563931,79.13556196,179.9285714,98.69811321,333,65.29411765,666,-143360,27136,-116224,75
284,60,20,10,0.174418605,0.825581395,96.30603337,95.14352316,183.9929577,118.1,344,6.038265754,688,-145408,30720,-114688,75
291,54,20,10,0.156521739,0.843478261,97.12732917,85.0672392,185.4020619,106.1666667,345,46.55870445,690,-148992,27648,-121344,75
285,52,20,10,0.154302671,0.845697329,95.07394928,76.19973365,181.9824561,97.84615385,337,53.92,674,-145920,26624,-119296,75
279,58,19,11,0.172106825,0.827893175,94.87692536,76.75504995,183.4014337,99.72413793,337,71.39830508,674,-142848,29696,-113152,75
292,57,19,11,0.163323782,0.836676218,98.18613604,82.01228429,188.869863,103.9473684,349,42.25181598,698,-149504,29184,-120320,75
285,56,19,11,0.164222874,0.835777126,95.92733412,79.06020052,184.8245614,100.6428571,341,67.39130435,682,-145920,28672,-117248,75
280,55,20,10,0.164179104,0.835820896,94.98415275,79.85088168,180.2535714,105.6181818,335,37.55605381,670,-143360,28160,-115200,75
279,54,20,10,0.162162162,0.837837838,94.18363818,78.46032959,179.5232975,102.2962963,333,71.0021322,666,-142848,27648,-115200,75
280,57,20,10,0.169139466,0.830860534,94.90712942,76.76007798,183.15,99.49122807,337,52.49221184,674,-143360,29184,-114176,75
282,54,19,11,0.160714286,0.839285714,94.17866555,83.64688337,181.177305,102.2962963,336,64.24474187,672,-144384,27648,-116736,75
278,55,19,11,0.165165165,0.834834835,93.50747148,76.34420965,180.9136691,96.67272727,333,80.24096386,666,-142336,28160,-114176,75
297,59,19,11,0.165730337,0.834269663,99.98446002,85.64585393,192.6329966,107.3559322,356,46.17380026,712,-152064,30208,-121856,75
279,54,20,10,0.162162162,0.837837838,93.67092799,77.1146444,180.3799283,97.87037037,333,75.16930023,666,-142848,27648,-115200,75
298,59,20,10,0.165266106,0.834733894,100.3916824,80.47692156,194.0067114,103.2033898,357,51.81422351,714,-152576,30208,-122368,75
277,53,19,11,0.160606061,0.839393939,92.75244818,81.27290104,177.8158845,101.1320755,330,72.05240175,660,-141824,27136,-114688,75
284,56,20,10,0.164705882,0.835294118,96.51841561,77.93122295,183.4577465,104.7857143,340,55.82922824,680,-145408,28672,-116736,75
285,59,20,10,0.171511628,0.828488372,97.08375356,79.13014237,186.7333333,103.7457627,344,81.13207547,688,-145920,30208,-115712,75
282,56,20,10,0.165680473,0.834319527,95.40839004,81.53063779,182.2943262,105.0714286,338,57.38539898,676,-144384,28672,-115712,75
284,53,19,11,0.15727003,0.84272997,94.57193439,80.07293756,182.0915493,98.8490566,337,48.91146589,674,-145408,27136,-118272,75
291,58,20,10,0.166189112,0.833810888,98.52002342,82.90450683,188.5017182,107.2586207,349,95.35519126,698,-148992,29696,-119296,75
281,60,19,11,0.175953079,0.824046921,96.32297244,76.19100815,185.7793594,101.7833333,341,51.27819549,682,-143872,30720,-113152,75
278,55,19,11,0.165165165,0.834834835,93.24091415,80.29868622,180.4748201,98.89090909,333,41.7816813,666,-142336,28160,-114176,75
286,56,19,11,0.16374269,0.83625731,95.77968709,84.11213968,184.8986014,103.0714286,342,54.54545455,684,-146432,28672,-117760,75
165,32,19,11,0.162436548,0.837563452,53.93729107,58.94574273,105.7212121,64.34375,197,28.84333821,394,-84480,16384,-68096,75
165,32,19,11,0.162436548,0.837563452,53.87802229,60.84546736,105.2484848,66.78125,197,38.4765625,394,-84480,16384,-68096,75
172,32,18,12,0.156862745,0.843137255,55.87635411,62.13222261,109.0406977,67.34375,204,20.29850746,408,-88064,16384,-71680,75
173,32,20,10,0.156097561,0.843902439,56.89276458,57.5399233,109.849711,65.96875,205,45.55555556,410,-88576,16384,-72192,75
165,32,19,11,0.162436548,0.837563452,54.24101708,55.84303301,106.1454545,62.15625,197,46.24413146,394,-84480,16384,-68096,75
166,36,19,11,0.178217822,0.821782178,55.25613041,60.15665634,108.8072289,67.80555556,202,42.08333333,404,-84992,18432,-66560,75
164,33,19,11,0.16751269,0.83248731,54.3694002,53.1515497,106.7682927,60.39393939,197,41.73728814,394,-83968,16896,-67072,75
162,35,19,11,0.177664975,0.822335025,53.45850545,65.00438918,104.3641975,74.17142857,197,3.524150268,394,-82944,17920,-65024,75
169,31,20,10,0.155,0.845,54.77506451,63.67424903,106.0769231,70.09677419,200,26.80965147,400,-86528,15872,-70656,75
175,34,19,11,0.162679426,0.837320574,57.35294124,62.44596973,111.9885714,69.02941176,209,46.96629213,418,-89600,17408,-72192,75
171,34,19,11,0.165853659,0.834146341,56.09279297,62.46763176,109.7660819,68.97058824,205,39.80582524,410,-87552,17408,-70144,75
176,32,20,10,0.153846154,0.846153846,57.50353222,59.62361601,111.3806818,66.65625,208,30.63328424,416,-90112,16384,-73728,75
167,34,20,10,0.169154229,0.830845771,55.58872245,55.54455956,108.5149701,64.08823529,201,20.87227414,402,-85504,17408,-68096,75
162,31,19,11,0.160621762,0.839378238,53.00140372,57.00238234,103.5493827,62.77419355,193,31.84818482,386,-82944,15872,-67072,75
162,33,20,10,0.169230769,0.830769231,53.76601926,55.20911079,105.154321,62.87878788,195,42.20779221,390,-82944,16896,-66048,75
168,34,20,10,0.168316832,0.831683168,55.41925343,62.52457648,107.6666667,71.02941176,202,30.69908815,404,-86016,17408,-68608,75
165,33,20,10,0.166666667,0.833333333,54.33759249,60.4737647,105.7757576,68.12121212,198,25.84856397,396,-84480,16896,-67584,75
164,31,20,10,0.158974359,0.841025641,53.53056525,60.80849659,103.6829268,67.93548387,195,41.57782516,390,-83968,15872,-68096,75
162,31,19,11,0.160621762,0.839378238,52.57105715,62.59281558,102.4444444,68.5483871,193,33.44887348,386,-82944,15872,-67072,75
175,34,19,11,0.162679426,0.837320574,57.46608185,61.51625098,112.0971429,68.47058824,209,34.66003317,418,-89600,17408,-72192,75
277,57,19,11,0.170658683,0.829341317,94.05835783,79.34354784,180.9927798,101.9298246,334,59.85663082,668,-141824,29184,-112640,75
280,54,20,10,0.161676647,0.838323353,94.07393939,75.06673985,181.15,96.72222222,334,38.88242142,668,-143360,27648,-115712,75
279,56,20,10,0.167164179,0.832835821,94.40868053,77.1112948,181.6989247,99.75,335,51.85758514,670,-142848,28672,-114176,75
283,53,20,10,0.157738095,0.842261905,94.67799249,80.55700095,181,101.754717,336,75,672,-144896,27136,-117760,75
286,55,20,10,0.161290323,0.838709677,96.05827291,80.9923494,184.1048951,102.8545455,341,60.03521127,682,-146432,28160,-118272,75
281,55,19,11,0.163690476,0.836309524,94.55678921,76.36769253,182.3202847,97.89090909,336,68.99383984,672,-143872,28160,-115712,75
275,56,19,11,0.16918429,0.83081571,93.15462308,76.68855772,179.7272727,98.58928571,331,59.31899642,662,-140800,28672,-112128,75
284,52,20,10,0.154761905,0.845238095,95.18160218,84.32853476,179.4084507,108.9230769,336,57.53424658,672,-145408,26624,-118784,75
279,51,20,10,0.154545455,0.845454545,92.85129694,78.49040426,177.8458781,97.96078431,330,55.93220339,660,-142848,26112,-116736,75
280,56,19,11,0.166666667,0.833333333,94.02223135,91.16507615,179.9535714,111.2321429,336,5.895771188,672,-143360,28672,-114688,75
283,61,20,10,0.177325581,0.822674419,96.72523445,94.31661728,183.7491166,120.3114754,344,6.024518389,688,-144896,31232,-113664,75
276,54,19,11,0.163636364,0.836363636,93.08246311,76.0026374,178.6449275,98.31481481,330,66.80161943,660,-141312,27648,-113664,75
280,55,19,11,0.164179104,0.835820896,94.07168558,75.28079886,182.1892857,95.76363636,335,77.7262181,670,-143360,28160,-115200,75
285,56,20,10,0.164222874,0.835777126,96.21894981,73.88430136,185.4035088,97.69642857,341,46.90508941,682,-145920,28672,-117248,75
277,52,19,11,0.158054711,0.841945289,92.32922501,77.8078349,177.8953069,96.30769231,329,50.4601227,658,-141824,26624,-115200,75
282,54,20,10,0.160714286,0.839285714,94.13405079,82.93826724,181.3723404,101.2777778,336,62.92134831,672,-144384,27648,-116736,75
297,61,19,11,0.170391061,0.829608939,99.50285611,99.29772486,192.2087542,117.6229508,358,6.281803825,716,-152064,31232,-120832,75
286,52,20,10,0.153846154,0.846153846,95.48770838,80.7773897,181.5699301,103.1153846,338,54.78119935,676,-146432,26624,-119808,75
293,59,19,11,0.167613636,0.832386364,98.75542362,86.1539045,190.4266212,107.3389831,352,65.54934823,704,-150016,30208,-119808,75
279,54,19,11,0.162162162,0.837837838,94.030718,73.40335462,180.6236559,96.61111111,333,23.0449827,666,-142848,27648,-115200,75
66,18,20,10,0.214285714,0.785714286,23.93486724,22.55254496,45.3030303,32.22222222,84,4.296675192,168,-33792,9216,-24576,75
68,21,19,11,0.235955056,0.764044944,25.3866425,22.74346733,48.75,32.85714286,89,16.27056673,178,-34816,10752,-24064,75
67,22,19,11,0.247191011,0.752808989,25.50125685,22.44920805,48.88059701,33.18181818,89,17.8,178,-34304,11264,-23040,75
68,20,20,10,0.227272727,0.772727273,25.13548065,22.92945704,47.82352941,33.2,88,25.14285714,176,-34816,10240,-24576,75
69,20,19,11,0.224719101,0.775280899,25.57561654,22.83396593,48.2173913,33.9,89,22.47474747,178,-35328,10240,-25088,75
68,20,19,11,0.227272727,0.772727273,25.33800485,22.80981149,47.51470588,34.25,88,16.82600382,176,-34816,10240,-24576,75
67,20,20,10,0.229885057,0.770114943,24.83382957,22.90256536,47.23880597,33.15,87,17.09233792,174,-34304,10240,-24064,75
67,22,19,11,0.247191011,0.752808989,25.55272701,22.73222673,48.65671642,33.86363636,89,12.2085048,178,-34304,11264,-23040,75
67,20,19,11,0.229885057,0.770114943,25.01070388,22.64420456,47.04477612,33.8,87,14.54849498,174,-34304,10240,-24064,75
68,21,20,10,0.235955056,0.764044944,25.56195405,23.07406983,48.29411765,34.33333333,89,22.47474747,178,-34816,10752,-24064,75
65,19,19,11,0.226190476,0.773809524,24.08070258,21.84457817,45.52307692,32.15789474,84,8.43373494,168,-33280,9728,-23552,75
68,23,19,11,0.252747253,0.747252747,26.16478589,23.07217245,49.85294118,34.60869565,91,9.46930281,182,-34816,11776,-23040,75
69,22,20,10,0.241758242,0.758241758,26.19459276,23.14761291,49.57971014,34.77272727,91,22.4137931,182,-35328,11264,-24064,75
67,20,19,11,0.229885057,0.770114943,25.01070388,22.64420456,47.04477612,33.8,87,17.22772277,174,-34304,10240,-24064,75
66,19,20,10,0.223529412,0.776470588,24.27112411,22.22586151,46.13636364,32.10526316,85,12.02263083,170,-33792,9728,-24064,75
68,20,20,10,0.227272727,0.772727273,25.15314254,22.70126648,47.89705882,32.95,88,21.25603865,176,-34816,10240,-24576,75
68,21,19,11,0.235955056,0.764044944,25.3625954,22.38389038,48.94117647,32.23809524,89,11.38107417,178,-34816,10752,-24064,75
68,21,20,10,0.235955056,0.764044944,25.56195405,23.07406983,48.29411765,34.33333333,89,15.94982079,178,-34816,10752,-24064,75
72,25,20,10,0.257731959,0.742268041,26.93646789,30.26284851,50.80555556,43.8,97,1.549520767,194,-36864,12800,-24064,75
72,27,20,10,0.272727273,0.727272727,27.7173231,30.11090611,52,44.66666667,99,1.57693533,198,-36864,13824,-23040,75
561,62,19,11,0.0995184591,0.900481541,173.2107306,195.9399529,324.9055258,195.2258065,623,24.07264297,1246,-287232,31744,-255488,76
548,58,19,11,0.095709571,0.904290429,168.4922738,198.1476557,314.6405109,198.2413793,606,23.05058958,1212,-280576,29696,-250880,76
567,71,19,11,0.111285266,0.888714734,177.8296495,191.5086597,334.2380952,201.8028169,638,11.32410366,1276,-290304,36352,-253952,76
569,64,19,11,0.101105845,0.898894155,176.1310887,195.7652147,330.5413005,196.609375,633,23.33210468,1266,-291328,32768,-258560,76
550,63,19,11,0.102773246,0.897226754,170.0571913,193.8359887,320.1309091,192.3650794,613,22.33151184,1226,-281600,32256,-249344,76
35,22,19,11,0.385964912,0.614035088,15.03546827,17.96374908,26.85714286,32.40909091,57,1.007779349,114,-17920,11264,-6656,76
557,64,19,11,0.103059581,0.896940419,172.1761823,201.5363815,323.5062837,202.15625,621,22.94900222,1242,-285184,32768,-252416,76
551,70,19,11,0.112721417,0.887278583,170.8750495,214.5037657,322.5117967,220.3857143,621,10.8282476,1242,-282112,35840,-246272,76
539,65,19,11,0.107615894,0.892384106,167.535381,190.5080905,315.7142857,192.9230769,604,10.85745102,1208,-275968,33280,-242688,76
555,62,19,11,0.100486224,0.899513776,171.0608417,207.4824924,319.9675676,210.8225806,617,23.03098171,1234,-284160,31744,-252416,76
550,63,19,11,0.102773246,0.897226754,171.1156767,186.6507214,319.9418182,194.015873,613,21.15251898,1226,-281600,32256,-249344,76
544,65,19,11,0.106732348,0.893267652,167.6759133,216.438726,314.7297794,223.5692308,609,23.24427481,1218,-278528,33280,-245248,76
561,62,19,11,0.0995184591,0.900481541,173.0263901,200.1354978,324.4349376,199.483871,623,19.31184129,1246,-287232,31744,-255488,76
567,60,19,11,0.0956937799,0.90430622,174.9668466,177.5603645,328.7636684,174.4833333,627,21.48732008,1254,-290304,30720,-259584,76
556,63,19,11,0.10177706,0.89822294,171.716978,201.7266298,322.1492806,202.7777778,619,24.32220039,1238,-284672,32256,-252416,76
9379,568,19,11,0.057102644,0.942897356,2836.975743,3329.818085,5011.526282,4354.353873,9947,631.956798,19894,-4802048,290816,-4511232,76
551,62,19,11,0.101141925,0.898858075,170.2282581,187.7154648,320.8439201,183.9677419,613,18.45273931,1226,-282112,31744,-250368,76
561,67,19,11,0.106687898,0.893312102,174.2683096,192.675363,329.0606061,192.5820896,628,20.85685819,1256,-287232,34304,-252928,76
558,63,19,11,0.101449275,0.898550725,172.7433296,181.6361115,325.9390681,178.6825397,621,20.41420118,1242,-285696,32256,-253440,76
554,68,19,11,0.109324759,0.890675241,172.0174936,202.9326725,324.5288809,205.3529412,622,9.451451147,1244,-283648,34816,-248832,76
557,65,19,11,0.104501608,0.895498392,172.6637379,187.1124688,326.3285458,184.4307692,622,18.32106038,1244,-285184,33280,-251904,76
549,60,19,11,0.0985221675,0.901477833,169.7217114,182.3084649,318.4881603,181.5833333,609,20.36108325,1218,-281088,30720,-250368,76
560,65,19,11,0.104,0.896,173.6623656,195.2694173,326.475,196.9076923,625,22.54689755,1250,-286720,33280,-253440,76
559,71,19,11,0.112698413,0.887301587,173.5553345,221.0731818,325.8300537,234.1690141,630,21.44315861,1260,-286208,36352,-249856,76
551,68,19,11,0.109854604,0.890145396,171.2074864,206.4027975,321.9546279,213.1323529,619,22.3707987,1238,-282112,34816,-247296,76
2619,365,19,11,0.122319035,0.877680965,849.5129987,935.3604065,1507.46239,1385.139726,2984,53.29523129,5968,-1340928,186880,-1154048,76
552,66,19,11,0.106796117,0.893203883,170.6740076,209.5424352,321.067029,212.7575758,618,22.84658041,1236,-282624,33792,-248832,76
549,60,19,11,0.0985221675,0.901477833,169.3259215,185.2384919,318.5482696,181.0333333,609,20.75664622,1218,-281088,30720,-250368,76
555,68,19,11,0.109149278,0.890850722,172.658361,197.0536144,325.7747748,199.5735294,623,20.89201878,1246,-284160,34816,-249344,76
547,65,19,11,0.10620915,0.89379085,169.7938428,197.4648713,318.9414991,201.8,612,23.55658199,1224,-280064,33280,-246784,76
555,67,19,11,0.107717042,0.892282958,171.483862,218.7733264,321.6036036,227.8059701,622,10.96421646,1244,-284160,34304,-249856,76
561,64,19,11,0.1024,0.8976,174.1843845,182.8804441,327.6987522,184.15625,625,19.0432663,1250,-287232,32768,-254464,76
568,61,19,11,0.0969793323,0.903020668,175.6927006,186.0084913,328.6707746,187.704918,629,20.91090426,1258,-290816,31232,-259584,76
560,63,19,11,0.101123596,0.898876404,172.1600575,213.9769628,322.9821429,214.3809524,623,23.70624049,1246,-286720,32256,-254464,76
548,63,19,11,0.103109656,0.896890344,170.1167321,186.0467354,319.5,188.5714286,611,25,1222,-280576,32256,-248320,76
553,64,19,11,0.103727715,0.896272285,171.4638003,193.74159,322.0886076,195.90625,617,16.65766739,1234,-283136,32768,-250368,76
569,63,19,11,0.0996835443,0.900316456,175.8735263,197.9285178,329.5237258,198.8730159,632,23.71482176,1264,-291328,32256,-259072,76
556,65,19,11,0.104669887,0.895330113,172.5379273,198.1092222,323.6798561,202.5384615,621,21.4137931,1242,-284672,33280,-251392,76
553,63,19,11,0.102272727,0.897727273,171.5441572,174.4043803,323.9403255,172.968254,616,19.86455982,1232,-283136,32256,-250880,76
558,62,19,11,0.1,0.9,172.6567506,184.7481003,324.6057348,183.5483871,620,19.27860697,1240,-285696,31744,-253952,76
544,61,19,11,0.100826446,0.899173554,168.0219798,189.1062417,316.0183824,186.9016393,605,17.94187426,1210,-278528,31232,-247296,76
547,67,19,11,0.109120521,0.890879479,169.3229577,211.5214518,318.5246801,217.4925373,614,10.89425124,1228,-280064,34304,-245760,76
5530,665,19,11,0.107344633,0.892655367,1746.211366,2103.043846,3084.693309,3208.655639,6195,125.2021019,12390,-2831360,340480,-2490880,76
552,65,19,11,0.10534846,0.89465154,170.7564832,203.9225424,321.1666667,205.6769231,617,23.63984674,1234,-282624,33280,-249344,76
558,67,19,11,0.1072,0.8928,172.2005133,223.5214991,322.3100358,235.4626866,625,23.32089552,1250,-285696,34304,-251392,76
552,66,19,11,0.106796117,0.893203883,171.2934119,199.2813788,322.3351449,202.1515152,618,10.80797482,1236,-282624,33792,-248832,76
549,61,19,11,0.1,0.9,169.7656459,190.0297902,318.2313297,190.9180328,610,18.71165644,1220,-281088,31232,-249856,76
5553,636,19,11,0.102762967,0.897237033,1755.305498,2034.38774,3079.150009,3233.388365,6189,109.6757044,12378,-2843136,325632,-2517504,76
550,65,19,11,0.105691057,0.894308943,170.2799473,198.6394575,320.9436364,198.4769231,615,21.6168717,1230,-281600,33280,-248320,76
553,73,19,11,0.116613419,0.883386581,171.7200272,222.8965606,323.8625678,235,626,10.90022636,1252,-283136,37376,-245760,76
6070,666,19,11,0.098871734,0.901128266,1920.12573,2142.493601,3345.223229,3580.647147,6736,117.0663886,13472,-3107840,340992,-2766848,76
560,66,19,11,0.10543131,0.89456869,173.2389216,206.046816,326.0321429,207.1666667,626,22.43727599,1252,-286720,33792,-252928,76
568,66,19,11,0.104100946,0.895899054,176.0393685,201.8818696,330.6566901,204.2727273,634,23.63026463,1268,-290816,33792,-257024,76
550,66,19,11,0.107142857,0.892857143,169.8067708,213.9260125,319.3054545,218.4545455,616,22.15030565,1232,-281600,33792,-247808,76
558,67,19,11,0.1072,0.8928,173.54943,186.3227127,328.2616487,185.8955224,625,18.18975553,1250,-285696,34304,-251392,76
561,62,19,11,0.0995184591,0.900481541,173.2257016,201.5170359,323.9019608,204.3064516,623,23.09117865,1246,-287232,31744,-255488,76
567,62,19,11,0.0985691574,0.901430843,175.2891471,197.5425506,327.4867725,200.8064516,629,23.44390608,1258,-290304,31744,-258560,76
557,65,19,11,0.104501608,0.895498392,172.7366176,200.2450251,323.9587074,204.7384615,622,22.65938069,1244,-285184,33280,-251904,76
562,61,19,11,0.0979133226,0.902086677,173.5060057,185.2933466,326.0765125,182.3114754,623,20.52042161,1246,-287744,31232,-256512,76
551,65,19,11,0.105519481,0.894480519,170.9924722,186.7025695,323.030853,185.3230769,616,21.24870645,1232,-282112,33280,-248832,76
9695,297,22,8,0.029723779,0.970276221,2882.688894,2938.610306,5000.145642,4877.494949,9992,929.4883721,19984,-4963840,152064,-4811776,76
9695,297,22,8,0.029723779,0.970276221,2882.663477,2939.380368,5000.177617,4876.451178,9992,735.7879234,19984,-4963840,152064,-4811776,76
9698,295,24,6,0.0295206645,0.970479336,2883.571635,2921.038799,4999.839555,4903.650847,9993,538.7061995,19986,-4965376,151040,-4814336,76
9696,296,23,7,0.029623699,0.970376301,2882.967414,2930.379466,4999.717822,4891.094595,9992,1084.907709,19984,-4964352,151552,-4812800,76
9695,297,22,8,0.029723779,0.970276221,2882.679091,2938.89969,5000.163589,4876.909091,9992,1106.533776,19984,-4963840,152064,-4811776,76
9695,297,22,8,0.029723779,0.970276221,2882.676507,2938.893543,5000.227953,4874.808081,9992,794.9085123,19984,-4963840,152064,-4811776,76
9695,297,22,8,0.029723779,0.970276221,2882.653367,2939.671291,5000.201341,4875.676768,9992,776.9828927,19984,-4963840,152064,-4811776,76
9696,296,23,7,0.029623699,0.970376301,2882.968518,2930.397748,4999.673164,4892.557432,9992,696.7921897,19984,-4964352,151552,-4812800,76
9696,296,23,7,0.029623699,0.970376301,2882.970409,2930.281063,4999.719369,4891.043919,9992,615.270936,19984,-4964352,151552,-4812800,76
9695,297,22,8,0.029723779,0.970276221,2882.679723,2938.827368,5000.201444,4875.673401,9992,796.1752988,19984,-4963840,152064,-4811776,76
9696,296,23,7,0.029623699,0.970376301,2882.992207,2929.678796,4999.635726,4893.783784,9992,1427.428571,19984,-4964352,151552,-4812800,76
9695,297,22,8,0.029723779,0.970276221,2882.675824,2938.944499,5000.207014,4875.491582,9992,1010.313448,19984,-4963840,152064,-4811776,76
9695,297,22,8,0.029723779,0.970276221,2882.698728,2938.257302,5000.173491,4876.585859,9992,1232.059186,19984,-4963840,152064,-4811776,76
9696,296,23,7,0.029623699,0.970376301,2882.988454,2929.690557,4999.726691,4890.804054,9992,1156.481481,19984,-4964352,151552,-4812800,76
9695,297,22,8,0.029723779,0.970276221,2882.703239,2938.161868,5000.137597,4877.757576,9992,878.8038698,19984,-4963840,152064,-4811776,76
9696,296,23,7,0.029623699,0.970376301,2883.000103,2929.343056,4999.703589,4891.560811,9992,505.156724,19984,-4964352,151552,-4812800,76
9695,297,22,8,0.029723779,0.970276221,2882.673992,2939.026129,5000.190407,4876.03367,9992,1163.213038,19984,-4963840,152064,-4811776,76
9695,297,22,8,0.029723779,0.970276221,2882.686075,2938.634086,5000.194121,4875.912458,9992,496.1271102,19984,-4963840,152064,-4811776,76
9696,296,23,7,0.029623699,0.970376301,2882.960966,2930.658847,4999.658313,4893.043919,9992,727.7494538,19984,-4964352,151552,-4812800,76
9695,297,22,8,0.029723779,0.970276221,2882.699314,2938.288008,5000.137287,4877.767677,9992,1765.371025,19984,-4963840,152064,-4811776,76
535,58,21,9,0.0978077572,0.902192243,165.1266455,186.7630305,308.8373832,187.8103448,593,22.53895857,1186,-273920,29696,-244224,76
553,55,21,9,0.0904605263,0.909539474,169.7906383,192.8250901,315.5189873,193.7090909,608,23.15308454,1216,-283136,28160,-254976,76
9358,598,22,8,0.0600642828,0.939935717,2849.371171,3145.168891,5025.617226,4241.170569,9956,750.8295626,19912,-4791296,306176,-4485120,76
9378,578,21,9,0.058055444,0.941944556,2852.634477,3150.761439,5012.477927,4427.211073,9956,645.6549935,19912,-4801536,295936,-4505600,76
542,54,21,9,0.0906040268,0.909395973,166.4894539,189.7879412,309.1125461,191.9814815,596,22.63577668,1192,-277504,27648,-249856,76
555,61,21,9,0.099025974,0.900974026,170.908441,206.308493,319.4414414,208.9508197,616,16.83980317,1232,-284160,31232,-252928,76
544,55,22,8,0.0918196995,0.908180301,167.448247,176.0191894,312.6819853,174.5636364,599,15.50608335,1198,-278528,28160,-250368,76
544,58,22,8,0.096345515,0.903654485,168.1856901,181.5664311,313.9889706,184.362069,602,21.97080292,1204,-278528,29696,-248832,76
529,54,20,10,0.0926243568,0.907375643,162.6773552,183.2868142,303.0661626,183.5925926,583,22.59689922,1166,-270848,27648,-243200,76
539,55,21,9,0.0925925926,0.907407407,165.638296,189.5744988,308.471243,189.9818182,594,24.51506397,1188,-275968,28160,-247808,76
538,55,22,8,0.0927487352,0.907251265,165.7065572,183.8258914,308.3401487,186.0727273,593,20.86558761,1186,-275456,28160,-247296,76
544,56,21,9,0.0933333333,0.906666667,167.7378425,182.2504085,312.4613971,184.3035714,600,22.2057735,1200,-278528,28672,-249856,76
553,56,21,9,0.091954023,0.908045977,170.3124422,184.1299305,317.1175407,185.3392857,609,22.25877193,1218,-283136,28672,-254464,76
9321,630,21,9,0.0633102201,0.93668978,2843.242044,3220.819879,5015.327218,4394.144444,9951,455.8405863,19902,-4772352,322560,-4449792,76
544,54,21,9,0.0903010033,0.909698997,166.8982658,191.3370264,310.2058824,191.6481481,598,24.18115649,1196,-278528,27648,-250880,76
532,53,22,8,0.0905982906,0.909401709,163.2156461,190.3921699,303.0244361,192.3773585,585,20.53352053,1170,-272384,27136,-245248,76
546,54,21,9,0.09,0.91,167.2263111,198.8079643,310.4194139,200.2037037,600,22.65005663,1200,-279552,27648,-251904,76
9325,624,21,9,0.0627198713,0.937280129,2849.648768,3163.301379,5000.560751,4593.022436,9949,547.5509081,19898,-4774400,319488,-4454912,76
553,59,21,9,0.0964052288,0.903594771,170.5042478,202.8102618,316.7124774,210.779661,612,24.84774665,1224,-283136,30208,-252928,76
534,58,20,10,0.097972973,0.902027027,164.2062967,193.4292018,308,190.6206897,592,9.336066866,1184,-273408,29696,-243712,76
1348,195,19,11,0.126377187,0.873622813,442.1267479,460.8428844,782.7047478,698,1543,28.3379247,3086,-690176,99840,-590336,76
545,64,19,11,0.105090312,0.894909688,167.9505167,213.4669087,315.1357798,218.6875,609,22.86036036,1218,-279040,32768,-246272,76
555,64,19,11,0.103392569,0.896607431,170.9865508,207.4249764,322.0918919,205.140625,619,24.33176101,1238,-284160,32768,-251392,76
549,64,19,11,0.104404568,0.895595432,168.8572852,219.9548937,316.2058288,228.03125,613,22.40497076,1226,-281088,32768,-248320,76
557,64,19,11,0.103059581,0.896940419,172.3266744,194.7406503,324.5260323,193.28125,621,23.6121673,1242,-285184,32768,-252416,76
550,62,19,11,0.10130719,0.89869281,169.4114349,206.5297634,317.6254545,207.8064516,612,22.77633048,1224,-281600,31744,-249856,76
548,64,19,11,0.104575163,0.895424837,169.6853532,192.1448606,320.0364964,190.59375,612,21.95121951,1224,-280576,32768,-247808,76
550,63,19,11,0.102773246,0.897226754,168.9788925,224.3085622,314.7454545,239.3809524,613,22.0028715,1226,-281600,32256,-249344,76
552,63,19,11,0.102439024,0.897560976,170.825814,192.8771888,321.1521739,192.7619048,615,20.52736983,1230,-282624,32256,-250368,76
553,64,19,11,0.103727715,0.896272285,170.0331452,217.2255087,319.3019892,219.984375,617,22.42005814,1234,-283136,32768,-250368,76
547,62,19,11,0.10180624,0.89819376,169.0407049,198.8062141,316.7458867,201.3709677,609,23.07692308,1218,-280064,31744,-248320,76
553,63,19,11,0.102272727,0.897727273,171.2834987,194.000526,321.283906,196.2857143,616,23.25405814,1232,-283136,32256,-250880,76
550,60,19,11,0.0983606557,0.901639344,169.3751758,196.3962548,317.6272727,194.3333333,610,17.57925072,1220,-281600,30720,-250880,76
561,65,19,11,0.103833866,0.896166134,174.6244966,184.9188339,327.8538324,189.6153846,626,23.099631,1252,-287232,33280,-253952,76
553,66,19,11,0.106623586,0.893376414,171.0317424,214.1674679,320.4014467,222.8484848,619,21.69645987,1238,-283136,33792,-249344,76
553,62,19,11,0.100813008,0.899186992,170.3643867,195.0871473,321.3254973,189.1451613,615,22.41253644,1230,-283136,31744,-251392,76
552,65,19,11,0.10534846,0.89465154,170.6352492,209.6041329,320.1014493,214.7230769,617,22.26632984,1234,-282624,33280,-249344,76
549,62,19,11,0.101472995,0.898527005,169.6984957,194.7240831,318.5154827,195.1774194,611,21.12724758,1222,-281088,31744,-249344,76
546,65,19,11,0.106382979,0.893617021,168.4491625,212.7411717,316.5714286,217.2,611,10.81990437,1222,-279552,33280,-246272,76
392,54,19,11,0.121076233,0.878923767,125.3019937,99.16902511,238.2806122,116.2037037,446,15.03708699,892,-200704,27648,-173056,76
4150,508,19,11,0.109059682,0.890940318,1318.836752,1538.224044,2336.417831,2272.98622,4658,96.45889418,9316,-2124800,260096,-1864704,76
549,66,19,11,0.107317073,0.892682927,170.4893185,197.3522445,320.9344262,200.4090909,615,21.87833511,1230,-281088,33792,-247296,76
569,61,19,11,0.0968253968,0.903174603,175.3977309,199.9668516,327.827768,200.5081967,630,21.9972067,1260,-291328,31232,-260096,76
566,67,19,11,0.105845182,0.894154818,176.7378225,184.2971585,331.860424,191.4626866,633,23.24641939,1266,-289792,34304,-255488,76
567,73,19,11,0.1140625,0.8859375,175.6442495,232.779414,329.4391534,251.0684932,640,11.13043478,1280,-290304,37376,-252928,76
546,65,19,11,0.106382979,0.893617021,169.5019201,191.7659236,319.467033,192.8769231,611,22.85821175,1222,-279552,33280,-246272,76
555,61,19,11,0.099025974,0.900974026,170.8453579,201.7237195,320.4252252,200,616,21.86723465,1232,-284160,31232,-252928,76
552,65,19,11,0.10534846,0.89465154,170.7687906,206.0040179,320.7047101,209.6,617,23.10861423,1234,-282624,33280,-249344,76
563,65,19,11,0.103503185,0.896496815,174.1150351,196.9935955,328.3872114,194.2153846,628,11.11898017,1256,-288256,33280,-254976,76
555,65,19,11,0.10483871,0.89516129,170.5070365,228.3180435,318.4774775,242.3846154,620,22.78574054,1240,-284160,33280,-250880,76
1567,150,19,11,0.0873616773,0.912638323,482.9431912,499.4495101,891.4837269,519.6533333,1717,30.43247076,3434,-802304,76800,-725504,76
4082,472,19,11,0.103645147,0.896354853,1289.717178,1509.576835,2288.695247,2180.680085,4554,95.93427428,9108,-2089984,241664,-1848320,76
566,63,19,11,0.100158983,0.899841017,174.1570719,208.5518376,327.1254417,206.0634921,629,23.53161242,1258,-289792,32256,-257536,76
555,67,19,11,0.107717042,0.892282958,171.6316368,213.2502371,322.7981982,217.9104478,622,21.19250426,1244,-284160,34304,-249856,76
551,67,19,11,0.108414239,0.891585761,170.6403838,211.8657174,320.522686,218.8507463,618,21.15713797,1236,-282112,34304,-247808,76
562,65,19,11,0.103668262,0.896331738,174.5555499,187.7685129,328.4074733,189.4307692,627,20.58437295,1254,-287744,33280,-254464,76
557,67,19,11,0.107371795,0.892628205,172.9236292,203.450336,325.0610413,208.0746269,624,19.9488491,1248,-285184,34304,-250880,76
554,65,19,11,0.105008078,0.894991922,171.8875663,192.4471334,323.6931408,193.2923077,619,21.59804606,1238,-283648,33280,-250368,76
559,65,19,11,0.104166667,0.895833333,173.0157236,195.3143205,326.3846154,193.0923077,624,24.01847575,1248,-286208,33280,-252928,76
556,68,19,11,0.108974359,0.891025641,172.3070824,216.8795829,322.8021583,228.2647059,624,24.10196987,1248,-284672,34816,-249856,76
544,64,19,11,0.105263158,0.894736842,168.5608457,191.9441339,317.8069853,191.390625,608,22.14936248,1216,-278528,32768,-245760,76
555,62,19,11,0.100486224,0.899513776,170.9460646,207.7318051,320.0936937,209.6935484,617,22.70051508,1234,-284160,31744,-252416,76
555,66,19,11,0.106280193,0.893719807,172.2241665,192.6877133,325.1423423,192.0757576,621,23.43396226,1242,-284160,33792,-250368,76
551,66,19,11,0.106969206,0.893030794,170.400292,209.5416332,320.4627949,213.3030303,617,22.27436823,1234,-282112,33792,-248320,76
569,66,19,11,0.103937008,0.896062992,176.4416388,205.7372468,330.3110721,211.8636364,635,22.31201687,1270,-291328,33792,-257536,76
569,62,19,11,0.0982567353,0.901743265,175.5775234,199.1393527,328.7205624,199.2580645,631,23.3271719,1262,-291328,31744,-259584,76
556,67,19,11,0.107544141,0.892455859,172.2562113,208.9718224,323.8561151,213.6119403,623,24.49862367,1246,-284672,34304,-250368,76
551,66,19,11,0.106969206,0.893030794,170.4657202,209.3908564,320.3938294,213.8787879,617,25.06092608,1234,-282112,33792,-248320,76
570,66,19,11,0.103773585,0.896226415,176.5733828,208.989427,330.4473684,215.3181818,636,23.60801782,1272,-291840,33792,-258048,76
555,67,19,11,0.107717042,0.892282958,172.0852847,203.0123303,324.3945946,204.6865672,622,23.17436662,1244,-284160,34304,-249856,76
561,61,19,11,0.0980707395,0.90192926,172.7956389,198.2120823,324.087344,195.7377049,622,23.65019011,1244,-287232,31232,-256000,76
548,62,19,11,0.101639344,0.898360656,169.0344723,200.6293065,317.3850365,200.4516129,610,22.1576462,1220,-280576,31744,-248832,76
555,98,19,11,0.15007657,0.84992343,186.7182917,161.3331434,345.7747748,220.6734694,653,18.17928731,1306,-284160,50176,-233984,76
554,69,19,11,0.110754414,0.889245586,171.5891459,216.2981627,323.0505415,223.2753623,623,23.67920943,1246,-283648,35328,-248320,76
553,66,19,11,0.106623586,0.893376414,171.5425217,191.6662906,324.3435805,189.8181818,619,17.74655963,1238,-283136,33792,-249344,76
547,63,19,11,0.103278689,0.896721311,168.7994645,204.846782,316.8775137,206.7142857,610,23.158694,1220,-280064,32256,-247808,76
553,66,19,11,0.106623586,0.893376414,171.24307,205.0150597,322.2188065,207.6212121,619,22.78248068,1238,-283136,33792,-249344,76
555,64,19,11,0.103392569,0.896607431,172.3101036,180.9139281,324.8990991,180.796875,619,20.93337842,1238,-284160,32768,-251392,76
565,63,19,11,0.100318471,0.899681529,175.1978338,182.3303106,329.1132743,183.4444444,628,20.46936115,1256,-289280,32256,-257024,76
565,65,19,11,0.103174603,0.896825397,174.3489159,208.967563,327.7681416,208.8615385,630,9.810028029,1260,-289280,33280,-256000,76
541,53,21,9,0.0892255892,0.910774411,166.0834698,190.8401335,307.5489834,194.9245283,594,24.38423645,1188,-276992,27136,-249856,76
536,58,21,9,0.0976430976,0.902356902,164.7796181,203.7190162,307.0876866,208.8965517,594,23.78854626,1188,-274432,29696,-244736,76
533,57,21,9,0.0966101695,0.903389831,163.6706632,204.9838781,304.4484053,211.8245614,590,21.69117647,1180,-272896,29184,-243712,76
544,58,20,10,0.096345515,0.903654485,167.3609743,189.355463,313.8676471,185.5,602,18.74805357,1204,-278528,29696,-248832,76
551,56,21,9,0.0922570016,0.907742998,169.0014908,208.6344083,312.7985481,217.4285714,607,24.74520995,1214,-282112,28672,-253440,76
531,54,21,9,0.0923076923,0.907692308,162.9188032,195.0155423,302.6497175,198.1111111,585,21.24954595,1170,-271872,27648,-244224,76
541,56,21,9,0.0938023451,0.906197655,167.000996,181.1194076,310.8225508,184.7857143,597,23.87045182,1194,-276992,28672,-248320,76
533,51,21,9,0.0873287671,0.912671233,163.0809613,188.9892946,302.424015,188.7843137,584,23.97372742,1168,-272896,26112,-246784,76
540,55,22,8,0.0924369748,0.907563025,166.0911328,185.8098166,309.3925926,186.1454545,595,24.19682798,1190,-276480,28160,-248320,76
533,54,22,8,0.0919931857,0.908006814,163.8436321,188.4295395,304.424015,191.1111111,587,23.34924423,1174,-272896,27648,-245248,76
553,58,22,8,0.0949263502,0.90507365,169.9328934,207.4015597,315.6654611,213.8448276,611,22.91822956,1222,-283136,29696,-253440,76
539,54,21,9,0.0910623946,0.908937605,165.4340902,193.4778586,307.1038961,196.1481481,593,23.00232739,1186,-275968,27648,-248320,76
534,52,21,9,0.0887372014,0.911262799,163.4402235,191.1870841,303.5168539,190.6346154,586,20.72135785,1172,-273408,26624,-246784,76
533,57,20,10,0.0966101695,0.903389831,164.0861612,193.7628289,306.1369606,196.0350877,590,24.73794549,1180,-272896,29184,-243712,76
535,56,22,8,0.0947546531,0.905245347,163.9348556,210.2847976,303.8485981,221.0178571,591,24.34102142,1182,-273920,28672,-245248,76
536,51,20,10,0.0868824532,0.913117547,163.617688,194.8141811,303.6156716,192.9411765,587,22.19281664,1174,-274432,26112,-248320,76
544,54,21,9,0.0903010033,0.909698997,167.2408325,186.2897724,310.5165441,188.5185185,598,23.45098039,1196,-278528,27648,-250880,76
541,58,21,9,0.0968280467,0.903171953,166.4974912,200.097191,310.2809612,204.1034483,599,20.78417765,1198,-276992,29696,-247296,76
537,59,21,9,0.0989932886,0.901006711,164.47765,218.2758244,305.9851024,230.3728814,596,19.94645248,1192,-274944,30208,-244736,76
1903,221,21,9,0.104048964,0.895951036,610.8422757,595.8301909,1085.873883,861.2307692,2124,33.31242158,4248,-974336,113152,-861184,76
545,54,21,9,0.0901502504,0.90984975,167.5097138,183.0208635,311.5669725,183.2592593,599,23.50863422,1198,-279040,27648,-251392,76
535,55,20,10,0.093220339,0.906779661,164.1052964,194.7781361,305.8971963,194.3636364,590,23.29253849,1180,-273920,28160,-245760,76
545,52,21,9,0.0871021776,0.912897822,167.0458589,186.398531,309.7027523,186.8269231,597,23.293016,1194,-279040,26624,-252416,76
535,52,20,10,0.0885860307,0.911413969,163.7647586,187.0966777,304.6635514,184.2884615,587,23.42378292,1174,-273920,26624,-247296,76
553,53,21,9,0.0874587459,0.912541254,169.2191558,201.0092053,312.9837251,204.5471698,606,22.90249433,1212,-283136,27136,-256000,76
531,56,20,10,0.0954003407,0.904599659,164.2133728,165.3267241,307.440678,166.5535714,587,21.71661117,1174,-271872,28672,-243200,76
552,58,21,9,0.0950819672,0.904918033,170.3202634,195.8145409,316.307971,202.637931,610,22.95822356,1220,-282624,29696,-252928,76
550,59,22,8,0.0968801314,0.903119869,169.0681664,212.8010469,313.6945455,223.9491525,609,14.53113815,1218,-281600,30208,-251392,76
4240,484,21,9,0.102455546,0.897544454,1340.37451,1553.127884,2363.295519,2355.530992,4724,104.1675854,9448,-2170880,247808,-1923072,76
538,56,21,9,0.0942760943,0.905723906,165.4535544,194.3975354,307.9349442,197.25,594,24.51506397,1188,-275456,28672,-246784,76
4193,460,21,9,0.0988609499,0.90113905,1318.165951,1552.870571,2328.559981,2312.780435,4653,90.71943849,9306,-2146816,235520,-1911296,76
4236,453,21,9,0.0966090851,0.903390915,1334.250523,1519.777885,2354.52101,2255.969095,4689,106.1099796,9378,-2168832,231936,-1936896,76
548,57,21,9,0.094214876,0.905785124,169.244857,181.8191969,315.2481752,185.245614,605,16.31607335,1210,-280576,29184,-251392,76
540,57,21,9,0.0954773869,0.904522613,165.4233396,211.6310459,307.4240741,219.1929825,597,22.92626728,1194,-276480,29184,-247296,76
542,54,21,9,0.0906040268,0.909395973,166.576976,176.6050906,310.8929889,174.1111111,596,22.62718299,1192,-277504,27648,-249856,76
548,59,22,8,0.097199341,0.902800659,169.0484228,194.6664573,315.4653285,197.5084746,607,18.29966838,1214,-280576,30208,-250368,76
551,56,22,8,0.0922570016,0.907742998,169.5606678,184.25417,316.2377495,183.5892857,607,20.74504443,1214,-282112,28672,-253440,76
531,54,21,9,0.0923076923,0.907692308,163.1263896,187.4651069,303.6760829,188.0185185,585,20.54073034,1170,-271872,27648,-244224,76
541,55,20,10,0.0922818792,0.907718121,166.5026905,175.1519614,311.2754159,172.8363636,596,21.44656351,1192,-276992,28160,-248832,76
543,59,21,9,0.0980066445,0.901993355,167.6913045,187.8214494,313.7384899,188.8644068,602,23.00343905,1204,-278016,30208,-247808,76
5270,723,20,10,0.120640748,0.879359252,1719.995948,1800.094849,2987.9074,3063.276625,5993,110.5515588,11986,-2698240,370176,-2328064,77
4667,733,21,9,0.135740741,0.864259259,1551.259138,1606.110403,2704.188987,2677.012278,5400,127.0289344,10800,-2389504,375296,-2014208,77
4725,669,21,9,0.124026696,0.875973304,1550.25422,1603.098167,2687.925079,2765.125561,5394,118.0823117,10788,-2419200,342528,-2076672,77
5162,732,21,9,0.124194096,0.875805904,1695.504467,1737.749719,2929.885897,3071.713115,5894,121.7768595,11788,-2642944,374784,-2268160,77
4659,703,21,9,0.131107796,0.868892204,1540.675325,1594.729587,2683.210131,2670.16643,5362,133.349913,10724,-2385408,359936,-2025472,77
4835,779,20,10,0.138760242,0.861239758,1607.174663,1701.426651,2812.155946,2778.602054,5614,106.0245515,11228,-2475520,398848,-2076672,77
5066,759,21,9,0.130300429,0.869699571,1665.498302,1778.300872,2891.624556,3055.671937,5825,126.6855154,11650,-2593792,388608,-2205184,77
3440,457,21,9,0.117269695,0.882730305,1122.46736,1130.467942,1970.575291,1786.595186,3897,86.94779116,7794,-1761280,233984,-1527296,77
5483,802,21,9,0.12760541,0.87239459,1801.374184,1900.269832,3139.055444,3169.967581,6285,152.8453307,12570,-2807296,410624,-2396672,77
4741,701,21,9,0.128812936,0.871187064,1561.023765,1636.536634,2718.809956,2739.693295,5442,135.3394678,10884,-2427392,358912,-2068480,77
4754,678,20,10,0.124815906,0.875184094,1567.318519,1573.365103,2718.484224,2702.587021,5432,109.3397746,10864,-2434048,347136,-2086912,77
3412,441,20,10,0.114456268,0.885543732,1114.632625,1078.813704,1948.929074,1757.335601,3853,92.39808153,7706,-1746944,225792,-1521152,77
5670,885,20,10,0.135011442,0.864988558,1878.085352,1979.343579,3267.332275,3346.345763,6555,117.1791205,13110,-2903040,453120,-2449920,77
8088,1257,21,9,0.134510433,0.865489567,2692.868885,2723.777929,4650.163205,4819.940334,9345,163.4312697,18690,-4141056,643584,-3497472,77
4706,688,21,9,0.127549129,0.872450871,1544.677175,1638.514976,2689.158521,2754.556686,5394,113.7254902,10788,-2409472,352256,-2057216,77
4721,724,20,10,0.132966024,0.867033976,1566.10103,1606.869051,2734.050837,2650.940608,5445,174.9116608,10890,-2417152,370688,-2046464,77
3698,493,21,9,0.117633023,0.882366977,1208.51138,1208.363032,2116.812331,1939.88641,4191,92.72123894,8382,-1893376,252416,-1640960,77
4690,702,21,9,0.130192878,0.869807122,1545.341582,1629.333287,2695.327292,2704.334758,5392,120.0089027,10784,-2401280,359424,-2041856,77
7582,1021,21,9,0.11867953,0.88132047,2490.565313,2417.215619,4333.654972,4066.928501,8603,167.8961749,17206,-3881984,522752,-3359232,77
6630,1039,20,10,0.135480506,0.864519494,2192.13298,2345.846867,3821.410106,3921.718961,7669,142.5464684,15338,-3394560,531968,-2862592,77
9600,379,22,8,0.0379797575,0.962020243,2862.340911,3164.331877,5027.830833,4031.751979,9979,887.0222222,19958,-4915200,194048,-4721152,77
9599,379,22,8,0.0379835638,0.962016436,2861.120172,3177.891255,5028.253047,4007.994723,9978,881.4487633,19956,-4914688,194048,-4720640,77
9609,370,22,8,0.0370778635,0.962922136,2864.593315,3150.278388,5023.279113,4125.732432,9979,1287.612903,19958,-4919808,189440,-4730368,77
9599,380,22,8,0.0380799679,0.961920032,2858.46784,3214.254982,5032.327013,3920.797368,9979,380.152381,19958,-4914688,194560,-4720128,77
860,129,22,8,0.130434783,0.869565217,275.8420339,342.7254281,496.9302326,482.1317829,989,31.95476575,1978,-440320,66048,-374272,77
9609,370,22,8,0.0370778635,0.962922136,2861.731938,3189.141463,5026.922677,4031.108108,9979,385.8855375,19958,-4919808,189440,-4730368,77
931,146,22,8,0.135561746,0.864438254,303.5856491,352.6996283,543.4607948,510.5547945,1077,24.96522949,2154,-476672,74752,-401920,77
9592,386,22,8,0.0386851072,0.961314893,2857.490103,3211.333034,5033.62573,3892.987047,9978,387.9471229,19956,-4911104,197632,-4713472,77
9602,376,22,8,0.0376829024,0.962317098,2859.880089,3201.794109,5028.924495,3982.707447,9978,375.2538548,19956,-4916224,192512,-4723712,77
9601,377,22,8,0.0377831229,0.962216877,2864.629468,3122.899503,5025.04562,4084.265252,9978,811.8795769,19956,-4915712,193024,-4722688,77
9599,380,22,8,0.0380799679,0.961920032,2858.326932,3225.573828,5031.380769,3944.7,9979,447.2882116,19958,-4914688,194560,-4720128,77
9591,387,22,8,0.0387853277,0.961214672,2857.201233,3211.85675,5034.248254,3880.50646,9978,406.7672238,19956,-4910592,198144,-4712448,77
9600,378,22,8,0.0378833434,0.962116657,2861.37813,3174.423058,5027.998958,4011.748677,9978,227.1340769,19956,-4915200,193536,-4721664,77
9591,387,22,8,0.0387853277,0.961214672,2857.362995,3212.078736,5033.820665,3891.103359,9978,333.3778817,19956,-4910592,198144,-4712448,77
9597,382,22,8,0.0382803888,0.961719611,2860.307696,3192.573206,5029.912785,3987.269634,9979,214.9256946,19958,-4913664,195584,-4718080,77
9605,374,22,8,0.0374787053,0.962521295,2861.701089,3177.596958,5028.230297,4008.176471,9979,195.2455488,19958,-4917760,191488,-4726272,77
9606,373,22,8,0.0373784948,0.962621505,2860.182209,3205.153032,5029.1726,3981.174263,9979,405.9804719,19958,-4918272,190976,-4727296,77
9598,381,22,8,0.0381801784,0.961819822,2861.211148,3180.303261,5028.959575,4008.545932,9979,203.9444104,19958,-4914176,195072,-4719104,77
864,134,22,8,0.134268537,0.865731463,278.3551804,343.8179103,502.2847222,481.5447761,998,35.66833452,1996,-442368,68608,-373760,77
557,85,22,8,0.132398754,0.867601246,177.7676439,213.1736937,333.3034111,244.1529412,642,10.42207792,1284,-285184,43520,-241664,77
9323,629,23,7,0.0632033762,0.936796624,2856.924769,2939.905918,5040.706747,4024.831479,9952,540.2823018,19904,-4773376,322048,-4451328,77
9271,664,23,7,0.0668344238,0.933165576,2876.302234,2698.131255,5004.51591,4458.152108,9935,815.0123052,19870,-4746752,339968,-4406784,77
9268,666,23,7,0.0670424804,0.93295752,2872.703099,2741.374327,5006.070889,4430.750751,9934,613.588635,19868,-4745216,340992,-4404224,77
3054,290,23,7,0.086722488,0.913277512,965.10393,967.6320092,1673.563851,1661.296552,3344,128.8135593,6688,-1563648,148480,-1415168,77
407,38,23,7,0.0853932584,0.914606742,126.8255401,141.0448864,220.0687961,254.3947368,445,13.67547634,890,-208384,19456,-188928,77
9213,720,23,7,0.0724856539,0.927514346,2865.904092,2846.879284,5002.922935,4507.336111,9933,593.3691756,19866,-4717056,368640,-4348416,77
3389,331,23,7,0.0889784946,0.911021505,1071.840223,1093.535022,1856.324875,1903.247734,3720,144.4099379,7440,-1735168,169472,-1565696,77
9285,654,23,7,0.0658013885,0.934198612,2873.990878,2693.932982,5021.81874,4234.316514,9939,793.2162809,19878,-4753920,334848,-4419072,77
9234,698,23,7,0.0702778896,0.92972211,2875.294586,2636.804114,5025.115335,4191.06447,9932,1108.482143,19864,-4727808,357376,-4370432,77
9289,647,23,7,0.0651167472,0.934883253,2862.640552,2947.714219,4971.258478,4928.896445,9936,504.6216353,19872,-4755968,331264,-4424704,77
9214,720,23,7,0.0724783572,0.927521643,2869.255107,2740.793087,5025.671587,4223.065278,9934,1140.528129,19868,-4717568,368640,-4348928,77
9227,706,23,7,0.0710762106,0.928923789,2875.076099,2632.281062,5029.479137,4150.434844,9933,401.9830028,19866,-4724224,361472,-4362752,77
9219,711,22,8,0.0716012085,0.928398792,2868.398958,2730.772987,5024.107929,4205.575246,9930,692.9518493,19860,-4720128,364032,-4356096,77
9227,706,23,7,0.0710762106,0.928923789,2873.442582,2617.744305,5037.612442,4044.137394,9933,654.7791694,19866,-4724224,361472,-4362752,77
9182,749,23,7,0.0754204008,0.924579599,2881.717231,2532.678012,5034.169135,4130.313752,9931,360.8648256,19862,-4701184,383488,-4317696,77
9221,714,22,8,0.0718671364,0.928132864,2879.092678,2588.216793,5030.512851,4160.673669,9935,749.2458522,19870,-4721152,365568,-4355584,77
9216,717,23,7,0.0721836303,0.92781637,2876.694854,2648.560218,5021.125217,4271.298466,9933,777.2300469,19866,-4718592,367104,-4351488,77
9206,728,22,8,0.0732836722,0.926716328,2869.086234,2653.628139,5046.660222,3966.471154,9934,456.5257353,19868,-4713472,372736,-4340736,77
9249,686,23,7,0.0690488173,0.930951183,2869.882185,2770.582512,5013.410315,4355.755102,9935,967.3807205,19870,-4735488,351232,-4384256,77
9199,731,23,7,0.0736153072,0.926384693,2876.524951,2688.716617,5004.987281,4468.586867,9930,498.2438535,19860,-4709888,374272,-4335616,77
2700,298,23,7,0.0993995997,0.9006004,854.687455,944.1984916,1482.874815,1650.130872,2998,310.0310238,5996,-1382400,152576,-1229824,77
2655,301,22,8,0.101826793,0.898173207,841.1055738,934.7565854,1457.832392,1660.800664,2956,107.8045222,5912,-1359360,154112,-1205248,77
5130,580,23,7,0.101576182,0.898423818,1669.621268,1446.196109,2852.390253,2883.005172,5710,144.9974606,11420,-2626560,296960,-2329600,77
6601,854,23,7,0.114553991,0.885446009,2146.350025,2175.764334,3691.965308,4006.530445,7455,150,14910,-3379712,437248,-2942464,77
2279,252,23,7,0.0995653892,0.900434611,722.8711593,781.2438295,1249.222905,1417.72619,2531,89.27689594,5062,-1166848,129024,-1037824,77
2298,270,23,7,0.105140187,0.894859813,729.238061,820.2389073,1265.918625,1442.648148,2568,84.19672131,5136,-1176576,138240,-1038336,77
2214,236,23,7,0.0963265306,0.903673469,700.758428,765.4562383,1226.438121,1216.699153,2450,85.87451805,4900,-1133568,120832,-1012736,77
3155,403,22,8,0.11326588,0.88673412,1024.159508,1032.686536,1756.733756,1957.73201,3558,376.5079365,7116,-1615360,206336,-1409024,77
8247,1154,23,7,0.122752899,0.877247101,2690.570216,2814.216197,4624.173275,5250.038128,9401,168.2054035,18802,-4222464,590848,-3631616,77
2311,279,23,7,0.107722008,0.892277992,736.2942242,807.7867489,1270.961489,1498.756272,2590,45.35901926,5180,-1183232,142848,-1040384,77
6457,834,23,7,0.114387601,0.885612399,2095.197865,2151.428451,3605.464767,3959.832134,7291,170.6295343,14582,-3305984,427008,-2878976,77
8682,1198,23,7,0.121255061,0.878744939,2821.750977,2976.677998,4847.021078,5617.949082,9880,196.5386911,19760,-4445184,613376,-3831808,77
8717,1157,22,8,0.117176423,0.882823577,2851.745221,2822.006473,4897.629574,5237.889369,9874,432.3117338,19748,-4463104,592384,-3870720,77
8675,1093,23,7,0.111895987,0.888104013,2817.922362,2820.382246,4850.988012,5150.480329,9768,172.8237792,19536,-4441600,559616,-3881984,77
2146,217,23,7,0.0918324164,0.908167584,674.7601089,750.1770945,1185.816869,1144.253456,2363,78.81921281,4726,-1098752,111104,-987648,77
2798,213,23,7,0.0707406177,0.929259382,865.7871113,908.6640952,1512.414582,1421.737089,3011,81.84289209,6022,-1432576,109056,-1323520,77
8715,1172,23,7,0.118539496,0.881460504,2843.289569,2878.107505,4872.368675,5476.651024,9887,190.9793317,19774,-4462080,600064,-3862016,77
5832,679,23,7,0.104285056,0.895714944,1903.244957,1656.198422,3271.716221,3121.011782,6511,192.2917897,13022,-2985984,347648,-2638336,77
5003,516,23,7,0.0934951984,0.906504802,1602.173984,1503.298303,2761.661203,2743.893411,5519,189.786795,11038,-2561536,264192,-2297344,77
2186,222,23,7,0.092192691,0.907807309,689.5094187,748.1416341,1203.450595,1214.833333,2408,90.22105658,4816,-1119232,113664,-1005568,77
3210,315,22,8,0.0893617021,0.910638298,997.6136929,1195.790706,1751.314019,1882.085714,3525,97.32192159,7050,-1643520,161280,-1482240,77
2240,289,22,8,0.114274417,0.885725583,716.4861106,820.9614396,1252.154464,1364.564014,2529,80.10769718,5058,-1146880,147968,-998912,77
2466,288,22,8,0.104575163,0.895424837,779.7901961,910.1742769,1367.091646,1466.621528,2754,85.58110628,5508,-1262592,147456,-1115136,77
3047,321,22,8,0.0953087886,0.904691211,952.7245114,1138.69794,1677.020676,1755.495327,3368,68.4413737,6736,-1560064,164352,-1395712,77
3188,316,22,8,0.0901826484,0.909817352,992.4700159,1185.183015,1746.824655,1809.756329,3504,117.5050302,7008,-1632256,161792,-1470464,77
2263,310,22,8,0.120481928,0.879518072,724.3113555,859.2555086,1273.548387,1385.196774,2573,45.30727241,5146,-1158656,158720,-999936,77
2253,300,22,8,0.117508813,0.882491187,724.7435468,819.6356852,1267.508211,1348.283333,2553,77.90662191,5106,-1153536,153600,-999936,77
2738,288,22,8,0.0951751487,0.904824851,858.9769999,1000.121631,1508.468955,1561.329861,3026,85.5527283,6052,-1401856,147456,-1254400,77
2445,279,22,8,0.102422907,0.897577093,773.5058505,882.9910298,1349.588139,1475.65233,2724,87.36369468,5448,-1251840,142848,-1108992,77
2687,304,22,8,0.101638248,0.898361752,847.1374408,985.3991289,1480.539263,1632.654605,2991,96.14271938,5982,-1375744,155648,-1220096,77
2985,315,22,8,0.0954545455,0.904545455,933.9338677,1113.258881,1645.628811,1696.660317,3300,99.39759036,6600,-1528320,161280,-1367040,77
2702,288,22,8,0.0963210702,0.90367893,849.377365,981.6549051,1490.474463,1542.649306,2990,92.1133703,5980,-1383424,147456,-1235968,77
2474,291,22,8,0.105244123,0.894755877,782.6041945,915.5852582,1372.909054,1468.790378,2765,97.1197752,5530,-1266688,148992,-1117696,77
2249,291,22,8,0.114566929,0.885433071,720.3038865,814.421062,1253.448644,1402.281787,2540,82.89817232,5080,-1151488,148992,-1002496,77
3053,322,22,8,0.0954074074,0.904592593,956.3317025,1121.037967,1673.461186,1825.847826,3375,105.9987437,6750,-1563136,164864,-1398272,77
1886,187,22,8,0.0902074288,0.909792571,592.8734895,621.431081,1055.584836,849.5614973,2073,39.96529786,4146,-965632,95744,-869888,77
2507,302,22,8,0.10751157,0.89248843,795.0147266,920.8496318,1388.433985,1542.519868,2809,77.44692583,5618,-1283584,154624,-1128960,77
2458,288,22,8,0.104879825,0.895120175,778.3531413,901.383084,1363.412937,1459.590278,2746,90.32894737,5492,-1258496,147456,-1111040,77
2416,302,22,8,0.111111111,0.888888889,766.7903567,909.3155129,1347.686672,1454.006623,2718,93.27385038,5436,-1236992,154624,-1082368,77
3033,305,22,8,0.0913720791,0.908627921,944.965597,1131.183543,1664.645565,1717.77377,3338,109.442623,6676,-1552896,156160,-1396736,77
3393,269,23,7,0.0734571273,0.926542873,1061.613564,981.6225487,1845.586207,1653.825279,3662,127.8631285,7324,-1737216,137728,-1599488,77
5000,380,23,7,0.0706319703,0.92936803,1547.474078,1622.012369,2697.6388,2596.568421,5380,652.9126214,10760,-2560000,194560,-2365440,77
2779,266,23,7,0.0873563218,0.912643678,879.292811,876.1151733,1523.096438,1521.992481,3045,107.6352068,6090,-1422848,136192,-1286656,77
2913,289,22,8,0.0902560899,0.90974391,917.463553,990.1795019,1597.761071,1639.186851,3202,120.5118555,6404,-1491456,147968,-1343488,77
6281,643,23,7,0.0928653957,0.907134604,1986.088024,2107.074608,3440.767235,3674.791602,6924,190.9542195,13848,-3215872,329216,-2886656,77
4821,418,23,7,0.0797862187,0.920213781,1509.201145,1542.094698,2631.64468,2485.696172,5239,886.463621,10478,-2468352,214016,-2254336,77
2787,266,23,7,0.0871274157,0.912872584,874.9481294,944.385138,1531.292429,1482.026316,3053,82.55813953,6106,-1426944,136192,-1290752,77
5073,417,23,7,0.0759562842,0.924043716,1580.920168,1619.033392,2761.469939,2551.218225,5490,207.8758046,10980,-2597376,213504,-2383872,77
4071,372,23,7,0.0837272113,0.916272789,1286.288465,1231.602983,2235.55662,2073.642473,4443,667.1171171,8886,-2084352,190464,-1893888,77
5018,406,23,7,0.0748525074,0.925147493,1558.48697,1642.809028,2726.893583,2534.600985,5424,205.3767512,10848,-2569216,207872,-2361344,77
2768,243,23,7,0.080704085,0.919295915,865.7481865,907.5736063,1506.611633,1499.032922,3011,107.1911712,6022,-1417216,124416,-1292800,77
2898,275,22,8,0.0866687677,0.913331232,912.0224069,951.4876649,1578.097654,1680.814545,3173,125.9126984,6346,-1483776,140800,-1342976,77
2800,280,23,7,0.0909090909,0.909090909,884.0784741,936.2554803,1534.986429,1595.635714,3080,103.3210332,6160,-1433600,143360,-1290240,77
5101,360,23,7,0.0659219923,0.934078008,1565.254444,1724.727122,2737.516761,2638.661111,5461,204.5318352,10922,-2611712,184320,-2427392,77
2868,265,23,7,0.0845834663,0.915416534,898.24633,966.1568662,1560.783821,1634.275472,3133,97.44945568,6266,-1468416,135680,-1332736,77
2890,274,22,8,0.0865992415,0.913400759,904.1970176,999.331679,1572.828374,1684.510949,3164,113.4050179,6328,-1479680,140288,-1339392,77
8939,965,22,8,0.0974353796,0.90256462,2852.345707,2866.313623,4895.173174,5483.53057,9904,497.4384731,19808,-4576768,494080,-4082688,77
3240,288,23,7,0.0816326531,0.918367347,1021.855455,979.0583238,1766.233951,1744.993056,3528,120.9047293,7056,-1658880,147456,-1511424,77
8910,995,22,8,0.100454316,0.899545684,2848.612975,2906.070014,4897.140741,5453.207035,9905,534.2502697,19810,-4561920,509440,-4052480,77
1063,127,23,7,0.106722689,0.893277311,335.8354933,401.7749594,597.4562559,579.1259843,1190,24.03069467,2380,-544256,65024,-479232,77
2973,314,23,7,0.0955278369,0.904472163,940.8726891,1006.867105,1626.670367,1808.079618,3287,116.3951841,6574,-1522176,160768,-1361408,77
5464,453,23,7,0.0765590671,0.923440933,1721.159559,1503.823598,2986.078697,2632.381898,5917,163.9966741,11834,-2797568,231936,-2565632,77
5234,468,23,7,0.0820764644,0.917923536,1659.161304,1446.771794,2882.470577,2505.132479,5702,202.4139155,11404,-2679808,239616,-2440192,77
5382,460,23,7,0.0787401575,0.921259843,1703.415968,1419.116035,2953.995541,2541.302174,5842,187.8456592,11684,-2755584,235520,-2520064,77
689,111,23,7,0.13875,0.86125,223.3655995,271.1774588,405.5820029,368.954955,800,17.14530647,1600,-352768,56832,-295936,77
5485,477,23,7,0.0800067092,0.919993291,1739.215853,1462.728187,3008.005105,2676.719078,5962,192.3225806,11924,-2808320,244224,-2564096,77
3057,312,23,7,0.0926090828,0.907390917,959.0967188,1067.373694,1660.965653,1920.490385,3369,104.3034056,6738,-1565184,159744,-1405440,77
5272,473,23,7,0.082332463,0.917667537,1674.694135,1411.279264,2906.816009,2496.090909,5745,209.3658892,11490,-2699264,242176,-2457088,77
3043,311,23,7,0.0927251044,0.907274896,961.5789064,1013.294311,1659.027604,1858.244373,3354,129.8490128,6708,-1558016,159232,-1398784,77
5528,558,23,7,0.0916858363,0.908314164,1780.157378,1480.085362,3070.743488,2773.603943,6086,120.6582078,12172,-2830336,285696,-2544640,77
2972,275,23,7,0.0846935633,0.915306437,934.3729792,941.0970555,1603.678331,1843.621818,3247,112.0041394,6494,-1521664,140800,-1380864,77
2650,312,23,7,0.105334234,0.894665766,847.6798275,901.2748124,1463.718113,1632.532051,2962,410.8183079,5924,-1356800,159744,-1197056,77
2784,317,23,7,0.102225089,0.897774911,885.19837,964.2338573,1533.044181,1708.694006,3101,391.540404,6202,-1425408,162304,-1263104,77
5562,497,22,8,0.0820267371,0.917973263,1769.388146,1467.961092,3057.720065,2719.780684,6059,198.2657068,12118,-2847744,254464,-2593280,77
5349,541,23,7,0.0918505942,0.908149406,1722.713257,1420.132384,2978.264348,2621.550832,5890,176.930009,11780,-2738688,276992,-2461696,77
5631,526,23,7,0.0854312165,0.914568783,1804.087956,1430.60239,3105.523175,2795.060837,6157,203.8066865,12314,-2883072,269312,-2613760,77
2738,342,22,8,0.111038961,0.888961039,885.0551807,909.4606503,1523.376187,1677.590643,3080,87.62446657,6160,-1401856,175104,-1226752,77
5634,597,23,7,0.0958112662,0.904188734,1823.180409,1516.026432,3148.107561,2812.994975,6231,210.2936213,12462,-2884608,305664,-2578944,77
5329,541,23,7,0.0921635434,0.907836457,1713.910418,1462.190904,2963.282042,2661.839187,5870,136.5751512,11740,-2728448,276992,-2451456,77
5367,445,23,7,0.0765657261,0.923434274,1690.44788,1495.914581,2926.430408,2666.125843,5812,179.382716,11624,-2747904,227840,-2520064,77
5913,837,23,7,0.124,0.876,1946.291112,1874.923721,3297.807881,3924.357228,6750,139.9543852,13500,-3027456,428544,-2598912,77
4723,646,23,7,0.120320358,0.879679642,1534.424151,1567.635161,2615.488037,3193.212074,5369,95.85788252,10738,-2418176,330752,-2087424,77
4716,636,23,7,0.118834081,0.881165919,1522.095653,1564.155524,2590.539864,3313.902516,5352,106.1694108,10704,-2414592,325632,-2088960,77
3791,464,23,7,0.109048179,0.890951821,1215.896607,1285.393322,2090.660248,2433.075431,4255,140.6146728,8510,-1940992,237568,-1703424,77
4777,677,22,8,0.12412908,0.87587092,1559.334479,1586.632414,2655.421394,3236.096012,5454,131.1057692,10908,-2445824,346624,-2099200,77
2477,166,23,7,0.0628074158,0.937192584,759.1342306,791.563443,1335.395236,1122.120482,2643,48.90821614,5286,-1268224,84992,-1183232,77
8871,1037,23,7,0.104662899,0.895337101,2903.879381,2415.999279,5002.656747,4542.543877,9908,413.0054189,19816,-4541952,530944,-4011008,77
7263,1089,23,7,0.130387931,0.869612069,2398.581549,2377.470088,4071.918491,4873.998163,8352,155.4438861,16704,-3718656,557568,-3161088,77
7159,1032,22,8,0.125991942,0.874008058,2352.206237,2359.596794,4007.952368,4706.787791,8191,155.4859529,16382,-3665408,528384,-3137024,77
5504,686,23,7,0.11082391,0.88917609,1786.491289,1692.766657,3027.046875,3644.721574,6190,113.7658519,12380,-2818048,351232,-2466816,77
5912,869,23,7,0.12815219,0.87184781,1947.823833,1925.985743,3306.433187,3966.326812,6781,135.5115907,13562,-3026944,444928,-2582016,77
2761,214,23,7,0.0719327731,0.928067227,857.6420238,862.5430374,1498.400942,1353.808411,2975,99.13362213,5950,-1413632,109568,-1304064,77
4855,718,23,7,0.128835457,0.871164543,1593.737882,1623.908678,2714.352832,3278.228412,5573,124.8152296,11146,-2485760,367616,-2118144,77
3360,401,23,7,0.10662058,0.89337942,1066.04283,1186.925442,1841.196429,2214.516209,3761,109.9064874,7522,-1720320,205312,-1515008,77
5441,775,23,7,0.12467825,0.87532175,1781.681708,1810.149063,3040.200698,3588.005161,6216,138.2869855,12432,-2785792,396800,-2388992,77
4025,429,23,7,0.0963179165,0.903682084,1271.485736,1360.47857,2188.954037,2589.149184,4454,148.4171943,8908,-2060800,219648,-1841152,77
5941,751,23,7,0.112223551,0.887776449,1934.308991,1882.550988,3306.710991,3661.262317,6692,133.2006369,13384,-3041792,384512,-2657280,77
7388,1135,22,8,0.133169072,0.866830928,2444.997746,2392.567951,4132.46386,5105.18326,8523,151.4661454,17046,-3782656,581120,-3201536,77
5177,668,23,7,0.114285714,0.885714286,1682.478537,1671.696863,2871.693259,3320.627246,5845,126.1873921,11690,-2650624,342016,-2308608,77
5563,800,23,7,0.125726858,0.874273142,1824.809314,1809.875884,3096.464498,3776.7925,6363,120.785877,12726,-2848256,409600,-2438656,77
9310,633,23,7,0.0636628784,0.936337122,2865.227309,2871.647401,5014.632438,4344.973144,9943,1092.637363,19886,-4766720,324096,-4442624,77
9266,670,23,7,0.067431562,0.932568438,2860.699629,2911.908677,5009.697172,4398.749254,9936,495.0672646,19872,-4744192,343040,-4401152,77
9301,640,23,7,0.0643798411,0.935620159,2869.862981,2750.702386,5024.94721,4186.995313,9941,1031.224066,19882,-4762112,327680,-4434432,77
3070,281,23,7,0.0838555655,0.916144434,966.3542928,977.8491136,1678.182085,1652.160142,3351,123.0176211,6702,-1571840,143872,-1427968,77
2976,260,22,8,0.0803461063,0.919653894,929.4703938,960.4021899,1637.262097,1403.746154,3236,116.2773985,6472,-1523712,133120,-1390592,77
3072,304,23,7,0.0900473934,0.909952607,971.110795,1008.632191,1686.609701,1707.601974,3376,136.3489499,6752,-1572864,155648,-1417216,77
3297,320,23,7,0.0884711087,0.911528891,1048.101446,999.9520488,1815.473157,1742.30625,3617,116.1901703,7234,-1688064,163840,-1524224,77
3218,285,23,7,0.0813588353,0.918641165,1015.132826,959.2929817,1761.68583,1642.635088,3503,125.9166068,7006,-1647616,145920,-1501696,77
2995,258,23,7,0.0793114049,0.920688595,938.391769,932.8638561,1640.370618,1471.786822,3253,105.8574683,6506,-1533440,132096,-1401344,77
9297,645,23,7,0.0648762824,0.935123718,2865.054405,2848.702355,5020.403463,4266.607752,9942,640.5927835,19884,-4760064,330240,-4429824,77
9300,641,22,8,0.0644804346,0.935519565,2867.170617,2809.876811,5020.531935,4252.361934,9941,614.0210006,19882,-4761600,328192,-4433408,77
3433,276,23,7,0.0744135886,0.925586411,1068.820856,1093.420848,1857.080396,1829.123188,3709,96.28764278,7418,-1757696,141312,-1616384,77
3053,294,22,8,0.0878398566,0.912160143,965.2970257,974.8048575,1677.332787,1639.391156,3347,125.3558052,6694,-1563136,150528,-1412608,77
9258,680,23,7,0.0684242302,0.93157577,2864.045619,2801.047577,5031.2911,4128.232353,9938,778.8401254,19876,-4740096,348160,-4391936,77
9285,654,23,7,0.0658013885,0.934198612,2856.57767,3016.979003,4996.470005,4594.198777,9939,658.6481113,19878,-4753920,334848,-4419072,77
3647,320,22,8,0.0806654903,0.91933451,1139.98418,1201.680097,1979.746093,2032.48125,3967,141.5774447,7934,-1867264,163840,-1703424,77
3222,319,22,8,0.0900875459,0.909912454,1026.654109,966.3078268,1783.996276,1639.733542,3541,87.62682504,7082,-1649664,163328,-1486336,77
3201,288,23,7,0.0825451419,0.917454858,1006.720948,1005.700162,1754.989691,1633.96875,3489,122.1638655,6978,-1638912,147456,-1491456,77
9333,614,23,7,0.0617271539,0.938272846,2850.75535,3095.805842,5017.284582,4316.060261,9947,1055.944798,19894,-4778496,314368,-4464128,77
1769,139,23,7,0.072851153,0.927148847,545.481431,611.6716392,958.8615037,898.9928058,1908,29.02342562,3816,-905728,71168,-834560,77
6952,837,23,7,0.107459237,0.892540763,2238.907141,2319.679289,3874.65607,4063.973716,7789,151.3014763,15578,-3559424,428544,-3130880,77
7512,998,23,7,0.117273796,0.882726204,2436.466384,2554.318418,4192.724441,4728.01503,8510,156.6642121,17020,-3846144,510976,-3335168,77
6592,834,23,7,0.112308107,0.887691893,2117.059546,2278.699922,3648.1875,4229.735012,7426,178.939759,14852,-3375104,427008,-2948096,77
2977,298,23,7,0.0909923664,0.909007634,947.1105759,927.4794084,1641.636547,1601.671141,3275,119.0909091,6550,-1524224,152576,-1371648,77
6752,891,23,7,0.11657726,0.88342274,2192.396501,2291.79903,3786.801985,4088.73064,7643,137.7613554,15286,-3457024,456192,-3000832,77
5658,583,23,7,0.0934145169,0.906585483,1794.84082,1863.817018,3111.851184,3209.789022,6241,178.3652472,12482,-2896896,298496,-2598400,77
6419,797,23,7,0.110449002,0.889550998,2063.134089,2189.925148,3554.899205,4040.198243,7216,170.8737864,14432,-3286528,408064,-2878464,77
6469,825,23,7,0.113106663,0.886893337,2084.639395,2221.277442,3595.419539,4055.873939,7294,161.2290009,14588,-3312128,422400,-2889728,77
6990,944,23,7,0.118981598,0.881018402,2267.726969,2378.82295,3892.464378,4523.113347,7934,146.4648329,15868,-3578880,483328,-3095552,77
1852,139,23,7,0.0698141637,0.930185836,572.8067161,556.2172503,1012.300216,778.8201439,1991,53.95663957,3982,-948224,71168,-877056,77
7307,798,23,7,0.0984577421,0.901542258,2327.897278,2413.513207,4012.286027,4425.803258,8105,170.8473862,16210,-3741184,408576,-3332608,77
2793,242,23,7,0.0797364086,0.920263591,862.6151004,999.5012706,1534.579663,1326.64876,3035,101.4710799,6070,-1430016,123904,-1306112,77
7243,830,22,8,0.102811842,0.897188158,2322.840001,2380.86668,4007.755074,4292.206024,8073,195.9466019,16146,-3708416,424960,-3283456,77
6632,831,23,7,0.111349323,0.888650677,2145.24921,2186.864775,3682.957027,4123.399519,7463,144.8282554,14926,-3395584,425472,-2970112,77
7425,1017,23,7,0.120469083,0.879530917,2403.104142,2570.337615,4127.989764,4904.207473,8442,169.5180723,16884,-3801600,520704,-3280896,77
5817,582,23,7,0.0909517112,0.909048289,1838.733612,1926.477221,3188.695032,3312.991409,6399,178.2451253,12798,-2978304,297984,-2680320,77
5386,484,23,7,0.0824531516,0.917546848,1698.203261,1644.094165,2950.263461,2771.210744,5870,105.2348512,11740,-2757632,247808,-2509824,77
6590,819,23,7,0.110541234,0.889458766,2105.822996,2305.486961,3632.249165,4290.382173,7409,175.319451,14818,-3374080,419328,-2954752,77
7438,1009,23,7,0.119450693,0.880549307,2417.358816,2541.704401,4161.600968,4683.984143,8447,149.0033516,16894,-3808256,516608,-3291648,77
5715,569,23,7,0.090547422,0.909452578,1805.777967,1887.955399,3127.034646,3297.83304,6284,188.2000599,12568,-2926080,291328,-2634752,77
9344,615,22,8,0.0617531881,0.938246812,2862.214416,2784.738377,5061.081764,3748.084553,9959,1017.262513,19918,-4784128,314880,-4469248,78
9310,635,22,8,0.0638511815,0.936148819,2868.407709,2724.157024,5039.924382,3991.793701,9945,1385.097493,19890,-4766720,325120,-4441600,78
9406,559,22,8,0.0560963372,0.943903663,2868.324658,2762.870676,5052.436424,3814.629696,9965,1526.033691,19930,-4815872,286208,-4529664,78
9364,592,22,8,0.0594616312,0.940538369,2873.815911,2713.815431,5037.200555,4050,9956,1629.459902,19912,-4794368,303104,-4491264,78
9331,616,22,8,0.0619282196,0.93807178,2866.10319,2730.581152,5045.600793,3889.410714,9947,313.4888118,19894,-4777472,315392,-4462080,78
9355,591,22,8,0.0594208727,0.940579127,2865.355216,2865.677434,5019.30155,4248.502538,9946,742.7931292,19892,-4789760,302592,-4487168,78
9402,560,22,8,0.0562136117,0.943786388,2866.495821,2769.060135,5052.312806,3792.603571,9962,1330.040053,19924,-4813824,286720,-4527104,78
9351,606,22,8,0.0608617053,0.939138295,2873.796744,2660.998684,5048.621752,3904.688119,9957,906.8306011,19914,-4787712,310272,-4477440,78
3391,184,21,9,0.0514685315,0.948531469,1017.656652,1086.583824,1822.52079,1151.804348,3575,68.92230576,7150,-1736192,94208,-1641984,78
9297,652,22,8,0.0655342245,0.934465775,2871.696161,2629.43664,5054.114015,3846.897239,9949,305.7467732,19898,-4760064,333824,-4426240,78
9375,575,22,8,0.0577889447,0.942211055,2863.229716,2885.293147,5027.91552,4120.89913,9950,979.3307087,19900,-4800000,294400,-4505600,78
9295,649,22,8,0.0652654867,0.934734513,2867.294491,2796.93024,5028.48865,4170.628659,9944,1084.405671,19888,-4759040,332288,-4426752,78
9292,654,22,8,0.0657550774,0.934244923,2864.99064,2856.20203,5025.697805,4231.876147,9946,798.2343499,19892,-4757504,334848,-4422656,78
9384,576,22,8,0.0578313253,0.942168675,2863.318312,2875.869015,5043.197677,3959.050347,9960,1583.465819,19920,-4804608,294912,-4509696,78
9285,662,22,8,0.0665527295,0.933447271,2868.435096,2634.084386,5059.751427,3771.277946,9947,259.7806216,19894,-4753920,338944,-4414976,78
9281,661,22,8,0.0664856166,0.933514383,2868.388058,2730.762311,5037.158065,4049.605144,9942,460.0647848,19884,-4751872,338432,-4413440,78
9342,607,22,8,0.0610111569,0.938988843,2867.37734,2789.390583,5034.021088,4066.639209,9949,1303.931848,19898,-4783104,310784,-4472320,78
9265,676,22,8,0.0680012071,0.931998793,2870.859363,2734.49497,5028.576363,4181.880178,9941,432.7818894,19882,-4743680,346112,-4397568,78
9328,621,22,8,0.0624183335,0.937581666,2874.168243,2713.535327,5028.957226,4164.512077,9949,1666.499162,19898,-4775936,317952,-4457984,78
9335,617,22,8,0.0619975884,0.938002412,2866.472697,2698.52046,5055.659454,3778.844408,9952,221.1555556,19904,-4779520,315904,-4463616,78
3326,272,22,8,0.0755975542,0.924402446,1025.225156,1164.330674,1819.080577,1560.069853,3598,336.5762395,7196,-1702912,139264,-1563648,78
5313,425,22,8,0.0740676194,0.925932381,1641.793587,1805.507739,2892.183512,2585.929412,5738,262.84929,11476,-2720256,217600,-2502656,78
3753,333,22,8,0.0814977974,0.918502203,1165.520763,1317.955482,2056.794031,1893.672673,4086,282.5726141,8172,-1921536,170496,-1751040,78
3272,242,22,8,0.0688673876,0.931132612,1006.532951,1095.015894,1772.646088,1552.714876,3514,346.5483235,7028,-1675264,123904,-1551360,78
3833,309,22,8,0.0746016417,0.925398358,1179.162214,1361.553092,2090.936342,1830.401294,4142,224.742268,8284,-1962496,158208,-1804288,78
3316,264,22,8,0.0737430168,0.926256983,1018.844092,1182.907048,1806.836248,1585.306818,3580,271.4177407,7160,-1697792,135168,-1562624,78
3285,261,22,8,0.0736040609,0.926395939,1012.790053,1131.682324,1789.773212,1568.681992,3546,398.4269663,7092,-1681920,133632,-1548288,78
3837,347,22,8,0.0829349904,0.91706501,1201.212183,1251.186808,2115.296065,1840.429395,4184,256.2155542,8368,-1964544,177664,-1786880,78
3730,322,22,8,0.0794669299,0.92053307,1160.766434,1266.285853,2033.036729,1950.779503,4052,232.0733104,8104,-1909760,164864,-1744896,78
3736,305,22,8,0.0754763672,0.924523633,1158.080824,1264.642365,2024.723233,1975.393443,4041,279.2674499,8082,-1912832,156160,-1756672,78
5284,427,22,8,0.0747679916,0.925232008,1635.040494,1787.142748,2877.432248,2590.782201,5711,299.1618649,11422,-2705408,218624,-2486784,78
5445,413,22,8,0.0705018778,0.929498122,1682.61254,1754.55436,2958.466116,2547.610169,5858,218.0938198,11716,-2787840,211456,-2576384,78
3290,273,22,8,0.0766208251,0.923379175,1017.690241,1119.52966,1803.448024,1523.52381,3563,470.0527704,7126,-1684480,139776,-1544704,78
5498,426,22,8,0.071910871,0.928089129,1697.663806,1844.010767,2982.46908,2704.776995,5924,270.3788225,11848,-2814976,218112,-2596864,78
3807,324,22,8,0.0784313725,0.921568627,1183.282904,1290.804387,2075.561072,1953.657407,4131,166.9765562,8262,-1949184,165888,-1783296,78
3268,254,22,8,0.0721181147,0.927881885,1007.107145,1100.470505,1781.702876,1501.566929,3522,251.5714286,7044,-1673216,130048,-1543168,78
5258,408,22,8,0.0720084716,0.927991528,1624.665648,1765.863188,2843.484975,2704.821078,5666,257.1947345,11332,-2692096,208896,-2483200,78
5291,420,22,8,0.0735422868,0.926457713,1635.737305,1789.052477,2873.157437,2639.857143,5711,370.8441558,11422,-2708992,215040,-2493952,78
89,11,21,9,0.11,0.89,27.7679893,21.80416216,53.92134831,22.81818182,100,20.5338809,200,-45568,5632,-39936,78
2377,223,22,8,0.0857692308,0.914230769,738.3969626,862.8523365,1310.237695,1196.704036,2600,38.94547633,5200,-1217024,114176,-1102848,78
3541,264,22,8,0.0693823916,0.930617608,1088.76245,1210.597075,1914.129624,1753.719697,3805,231.3069909,7610,-1812992,135168,-1677824,78
5076,396,22,8,0.0723684211,0.927631579,1564.244256,1764.985137,2737.244681,2726.954545,5472,291.2187334,10944,-2598912,202752,-2396160,78
3279,204,22,8,0.0585701981,0.941429802,998.0639044,1074.072653,1760.639219,1442.401961,3483,283.6319218,6966,-1678848,104448,-1574400,78
3532,293,22,8,0.0766013072,0.923398693,1090.149965,1259.949687,1908.686863,1964.993174,3825,201.9535375,7650,-1808384,150016,-1658368,78
90,10,21,9,0.1,0.9,27.80283536,19.71826564,53.81111111,20.7,100,30.39513678,200,-46080,5120,-40960,78
3757,294,22,8,0.0725746729,0.927425327,1157.778845,1305.754833,2033.085174,1935.459184,4051,123.6946565,8102,-1923584,150528,-1773056,78
2583,263,22,8,0.0924104006,0.907589599,813.1510734,896.2506631,1415.461479,1502.448669,2846,131.9425127,5692,-1322496,134656,-1187840,78
2563,256,22,8,0.0908123448,0.909187655,804.6149304,896.3164834,1401.880218,1491.292969,2819,189.3216924,5638,-1312256,131072,-1181184,78
3062,203,22,8,0.0621745789,0.937825421,935.8269034,995.9789399,1651.84226,1348.788177,3265,258.9214909,6530,-1567744,103936,-1463808,78
3994,310,22,8,0.0720260223,0.927973978,1224.645905,1452.524191,2152.967702,2146.474194,4304,274.6649649,8608,-2044928,158720,-1886208,78
3992,315,22,8,0.0731367541,0.926863246,1229.064766,1410.35133,2158.516784,2096.75873,4307,259.6142254,8614,-2043904,161280,-1882624,78
2912,269,22,8,0.0845646023,0.915435398,907.0197453,1025.723914,1580.720124,1702.282528,3181,181.4603537,6362,-1490944,137728,-1353216,78
2699,223,22,8,0.0763175907,0.923682409,834.9143469,922.4134048,1446.591701,1641.93722,2922,175.284943,5844,-1381888,114176,-1267712,78
5611,401,22,8,0.0666999335,0.933300067,1714.511127,2005.860045,3009.941365,2958.346633,6012,265.5477032,12024,-2872832,205312,-2667520,78
4393,361,22,8,0.0759360538,0.924063946,1357.412786,1542.57083,2379.134532,2357.609418,4754,263.0879911,9508,-2249216,184832,-2064384,78
2245,182,22,8,0.0749896992,0.925010301,694.1451118,754.6928452,1228.078396,1040.340659,2427,314.7859922,4854,-1149440,93184,-1056256,78
3607,254,22,8,0.0657860658,0.934213934,1103.906908,1235.212725,1915.389243,2152.685039,3861,207.2463768,7722,-1846784,130048,-1716736,78
2597,265,22,8,0.0925925926,0.907407407,817.7402054,901.6637556,1424.167501,1503.358491,2862,167.7608441,5724,-1329664,135680,-1193984,78
3570,296,22,8,0.076564925,0.923435075,1100.839346,1283.410345,1928.343697,1995.689189,3866,244.9936629,7732,-1827840,151552,-1676288,78
3187,235,22,8,0.0686732905,0.93132671,985.4229964,939.4476573,1739.796988,1327.744681,3422,72.90157648,6844,-1631744,120320,-1511424,78
3601,417,22,8,0.103782977,0.896217023,1150.017954,1241.681246,2006.724799,2033.465228,4018,253.5015773,8036,-1843712,213504,-1630208,78
2714,357,22,8,0.116248779,0.883751221,888.8055701,785.1743972,1582.035372,1186.028011,3071,61.71623794,6142,-1389568,182784,-1206784,78
3539,424,22,8,0.106989654,0.893010346,1141.867493,1157.845541,1971.120373,2072.808962,3963,234.2198582,7926,-1811968,217088,-1594880,78
3497,410,22,8,0.104939852,0.895060148,1118.776189,1201.680086,1958.91507,1912.078049,3907,104.8577563,7814,-1790464,209920,-1580544,78
3684,369,22,8,0.0910436714,0.908956329,1159.534437,1244.921224,2050.869978,1788.688347,4053,71.25527426,8106,-1886208,188928,-1697280,78
3544,410,22,8,0.103692463,0.896307537,1132.502086,1211.615572,1966.467833,2072.860976,3954,193.0664063,7908,-1814528,209920,-1604608,78
3475,384,22,8,0.0995076445,0.900492356,1110.025617,1149.313181,1930.220719,1928.002604,3859,264.1341547,7718,-1779200,196608,-1582592,78
3481,389,22,8,0.100516796,0.899483204,1121.087376,1080.797258,1939.665613,1898.22365,3870,195.4545455,7740,-1782272,199168,-1583104,78
3242,340,22,8,0.0949190396,0.90508096,1037.396962,993.02125,1804.400062,1668.494118,3582,183.8809035,7164,-1659904,174080,-1485824,78
5130,511,22,8,0.0905867754,0.909413225,1620.924975,1692.969623,2837.444444,2655.911937,5641,263.4750117,11282,-2626560,261632,-2364928,78
3649,414,22,8,0.101895151,0.898104849,1166.234912,1229.314738,2027.704029,2069.864734,4063,163.501006,8126,-1868288,211968,-1656320,78
3199,306,22,8,0.0873038516,0.912696148,1006.175651,1052.789241,1769.893404,1576.392157,3505,162.1184089,7010,-1637888,156672,-1481216,78
3578,437,22,8,0.108841843,0.891158157,1161.560563,1137.148419,2013.378703,1963.961098,4015,488.4428224,8030,-1831936,223744,-1608192,78
3227,342,22,8,0.0958251611,0.904174839,1024.431155,1081.762146,1791.905175,1719.845029,3569,247.6752255,7138,-1652224,175104,-1477120,78
3445,345,22,8,0.0910290237,0.908970976,1088.9706,1139.549392,1904.945428,1801.182609,3790,229.2800968,7580,-1763840,176640,-1587200,78
3615,390,22,8,0.0973782772,0.902621723,1144.620165,1256.971671,2008.072476,1955.982051,4005,166.5973378,8010,-1850880,199680,-1651200,78
3540,424,22,8,0.106962664,0.893037336,1142.295656,1160.762749,1979.988136,2003.471698,3964,194.1234084,7928,-1812480,217088,-1595392,78
5174,531,22,8,0.0930762489,0.906923751,1638.886369,1710.228205,2873.424043,2653.990584,5705,302.6525199,11410,-2649088,271872,-2377216,78
4006,440,22,8,0.0989653621,0.901034638,1281.290696,1301.845642,2229.069146,2172.795455,4446,241.1062907,8892,-2051072,225280,-1825792,78
3217,327,22,8,0.092268623,0.907731377,1018.835418,1055.407917,1785.396021,1645.629969,3544,212.5974805,7088,-1647104,167424,-1479680,78
2404,217,22,8,0.0827928272,0.917207173,750.6521212,814.9741636,1318.682196,1225.894009,2621,140.6870639,5242,-1230848,111104,-1119744,78
3976,316,22,8,0.0736253495,0.926374651,1227.763841,1362.530918,2159.106388,1987.882911,4292,286.5153538,8584,-2035712,161792,-1873920,78
2388,217,22,8,0.0833013436,0.916698656,746.2581531,810.0121829,1308.523451,1242.21659,2605,179.5313577,5210,-1222656,111104,-1111552,78
2382,223,22,8,0.0856046065,0.914395393,745.9905707,810.4183001,1309.240554,1236.340807,2605,159.1325596,5210,-1219584,114176,-1105408,78
2437,230,22,8,0.0862392201,0.91376078,763.6897672,819.4120594,1347.430037,1191.7,2667,119.0093708,5334,-1247744,117760,-1129984,78
2136,166,22,8,0.0721112076,0.927888792,656.8096982,740.5466225,1163.206929,1000.861446,2302,159.5287595,4604,-1093632,84992,-1008640,78
2122,165,22,8,0.0721469174,0.927853083,652.5253373,729.3832662,1157.694628,967.8787879,2287,326.2482168,4574,-1086464,84480,-1001984,78
2365,223,22,8,0.0861669243,0.913833076,740.4973657,810.7233005,1300.809725,1227.58296,2588,166.0038486,5176,-1210880,114176,-1096704,78
1739,160,22,8,0.084254871,0.915745129,542.3238833,591.2481242,962.6118459,812.925,1899,46.19314036,3798,-890368,81920,-808448,78
2174,175,22,8,0.0744997871,0.925500213,670.9974688,740.222129,1188.609936,1005.925714,2349,266.3265306,4698,-1113088,89600,-1023488,78
2159,162,22,8,0.0697975011,0.930202499,663.0629387,737.2411783,1173.303844,997.0246914,2321,345.3869048,4642,-1105408,82944,-1022464,78
2147,172,22,8,0.0741699008,0.925830099,661.6779358,742.6652494,1172.315789,1006.267442,2319,174.8868778,4638,-1099264,88064,-1011200,78
4018,327,22,8,0.0752589183,0.924741082,1242.43872,1379.989617,2187.122947,1999.464832,4345,264.9390244,8690,-2057216,167424,-1889792,78
2430,228,21,9,0.085778781,0.914221219,758.9018666,844.9534374,1339.07037,1227.5,2658,173.046875,5316,-1244160,116736,-1127424,78
2383,223,22,8,0.0855717575,0.914428243,746.120221,809.2409162,1312.365086,1208.766816,2606,180.9722222,5212,-1220096,114176,-1105920,78
1986,134,14,16,0.0632075472,0.936792453,604.6741312,694.2595239,1070.717523,909.0671642,2120,123.1126597,4240,-1016832,68608,-948224,78
2397,223,22,8,0.0851145038,0.914885496,750.6927478,810.8400471,1317.317063,1237.224215,2620,195.5223881,5240,-1227264,114176,-1113088,78
2141,167,22,8,0.0723570191,0.927642981,656.8903624,765.4672004,1164.278375,1029.137725,2308,162.4208304,4616,-1096192,85504,-1010688,78
2434,226,22,8,0.084962406,0.915037594,760.1342436,843.9530194,1336.638044,1264.393805,2660,155.3738318,5320,-1246208,115712,-1130496,78
2182,149,22,8,0.0639210639,0.936078936,664.9995333,779.2174004,1164.613199,1186.308725,2331,41.24203822,4662,-1117184,76288,-1040896,78
88,10,21,9,0.102040816,0.897959184,27.16797829,21.62960934,52.69318182,21.4,98,22.1719457,196,-45056,5120,-39936,78
5258,499,22,8,0.0866770888,0.913322911,1651.602509,1749.439155,2856.597375,3115.058116,5757,189.9373144,11514,-2692096,255488,-2436608,78
6803,654,22,8,0.0877028296,0.91229717,2116.224244,2473.009913,3695.181685,4080.782875,7457,156.7255149,14914,-3483136,334848,-3148288,78
3084,214,22,8,0.0648878108,0.935112189,936.1400309,1128.426236,1666.738327,1401.074766,3298,294.4642857,6596,-1579008,109568,-1469440,78
5259,506,22,8,0.0877710321,0.912228968,1652.145205,1773.423045,2864.507701,3075.195652,5765,181.8611987,11530,-2692608,259072,-2433536,78
5294,521,22,8,0.0895958727,0.910404127,1669.47673,1764.259103,2895.690026,3033.084453,5815,189.8465557,11630,-2710528,266752,-2443776,78
5375,517,22,8,0.0877460964,0.912253904,1694.265401,1767.23052,2941.35907,2999.947776,5892,175.5661502,11784,-2752000,264704,-2487296,78
5256,535,22,8,0.0923847349,0.907615265,1660.683747,1771.82312,2883.5371,3018.439252,5791,171.3313609,11582,-2691072,273920,-2417152,78
5256,508,22,8,0.0881332408,0.911866759,1652.707788,1768.96346,2868.118912,3031.293307,5764,188.9836066,11528,-2691072,260096,-2430976,78
3511,229,22,8,0.0612299465,0.938770053,1071.406359,1130.606775,1895.704358,1484.069869,3740,154.9295775,7480,-1797632,117248,-1680384,78
5263,505,22,8,0.0875520111,0.912447989,1657.286013,1733.723594,2866.99145,3066.970297,5768,208.9098153,11536,-2694656,258560,-2436096,78
3042,214,22,8,0.0657248157,0.934275184,925.0932051,1074.159009,1652.336292,1289.668224,3256,176.4769648,6512,-1557504,109568,-1447936,78
7023,664,22,8,0.0863796019,0.913620398,2178.355544,2551.922298,3794.142105,4371.337349,7687,278.9187228,15374,-3595776,339968,-3255808,78
5224,496,22,8,0.0867132867,0.913286713,1642.586331,1728.770016,2842.93817,3045.465726,5720,175.8376883,11440,-2674688,253952,-2420736,78
61,21,22,8,0.256097561,0.743902439,22.75660212,26.03590753,40.80327869,43.52380952,82,1.711899791,164,-31232,10752,-20480,78
3356,292,22,8,0.0800438596,0.91995614,1052.624713,1005.474648,1852.077175,1507.55137,3648,69.5784856,7296,-1718272,149504,-1568768,78
4826,440,22,8,0.0835548804,0.91644512,1511.373843,1604.920807,2619.058641,2791.895455,5266,158.1381381,10532,-2470912,225280,-2245632,78
5317,550,22,8,0.0937446736,0.906255326,1683.106421,1782.321817,2915.259733,3115.167273,5867,220.2327327,11734,-2722304,281600,-2440704,78
5426,524,22,8,0.0880672269,0.911932773,1709.264147,1800.194291,2968.408773,3048.929389,5950,198.7307949,11900,-2778112,268288,-2509824,78
5218,489,22,8,0.0856842474,0.914315753,1639.990932,1723.158595,2846.393446,2935.167689,5707,196.454389,11414,-2671616,250368,-2421248,78
2341,252,22,8,0.0971847281,0.902815272,731.6930901,889.7879278,1298.317813,1284.757937,2593,111.4789338,5186,-1198592,129024,-1069568,78
5214,464,22,8,0.0817189151,0.918281085,1621.264922,1822.746682,2850.800921,2712.510776,5678,283.4747878,11356,-2669568,237568,-2432000,78
4276,382,22,8,0.0820094461,0.917990554,1323.01111,1566.527627,2328.309167,2342.829843,4658,222.8708134,9316,-2189312,195584,-1993728,78
3659,355,22,8,0.0884404584,0.911559542,1144.178417,1298.974214,2004.522274,2038.191549,4014,199.7014925,8028,-1873408,181760,-1691648,78
4152,373,22,8,0.0824309392,0.917569061,1292.855123,1438.753471,2276.322977,2114.697051,4525,253.6434978,9050,-2125824,190976,-1934848,78
3885,384,22,8,0.0899508082,0.910049192,1223.630187,1313.88539,2144.029858,2043.643229,4269,213.6636637,8538,-1989120,196608,-1792512,78
2173,251,22,8,0.103547855,0.896452145,703.3989703,658.1006417,1224.583065,1107.89243,2424,43.69142033,4848,-1112576,128512,-984064,78
3325,277,22,8,0.0769017213,0.923098279,1034.441219,1062.464417,1824.971128,1519.761733,3602,188.3891213,7204,-1702400,141824,-1560576,78
4148,377,22,8,0.0833149171,0.916685083,1290.751911,1463.134997,2271.032787,2174.618037,4525,241.7200855,9050,-2123776,193024,-1930752,78
3198,267,22,8,0.0770562771,0.922943723,995.171803,1030.282329,1752.749844,1496.445693,3465,236.3574352,6930,-1637376,136704,-1500672,78
3062,340,22,8,0.0999412111,0.900058789,970.0451934,1082.029711,1693.954931,1769.45,3402,178.5826772,6804,-1567744,174080,-1393664,78
2930,307,22,8,0.0948409021,0.905159098,925.2400187,1018.059485,1618.309556,1625.589577,3237,193.6004785,6474,-1500160,157184,-1342976,78
3625,363,22,8,0.0910230692,0.908976931,1138.470378,1270.161845,2000.489655,1934.68595,3988,214.1783029,7976,-1856000,185856,-1670144,78
2687,254,22,8,0.0863651819,0.913634818,839.3453937,941.0352064,1478.857834,1387.874016,2941,144.0960314,5882,-1375744,130048,-1245696,78
5192,453,22,8,0.0802480071,0.919751993,1614.903369,1785.026757,2833.116718,2707.048565,5645,318.2074408,11290,-2658304,231936,-2426368,78
3925,286,22,8,0.0679173593,0.932082641,1201.970996,1368.268305,2122.957197,1873.283217,4211,205.6152344,8422,-2009600,146432,-1863168,78
3472,247,22,8,0.0664157031,0.933584297,1061.000325,1213.972942,1876.322581,1630.558704,3719,215.2199074,7438,-1777664,126464,-1651200,78
3966,302,22,8,0.0707591378,0.929240862,1219.45594,1349.815166,2157.93646,1826.721854,4268,232.9694323,8536,-2030592,154624,-1875968,78
3806,356,22,8,0.0855358001,0.9144642,1188.7253,1329.433065,2085.182606,2042.129213,4162,227.805145,8324,-1948672,182272,-1766400,78
4681,453,22,8,0.0882352941,0.911764706,1467.171642,1625.179455,2576.246315,2477.121413,5134,261.5384615,10268,-2396672,231936,-2164736,78
4806,493,22,8,0.093036422,0.906963578,1530.014892,1523.664958,2659.106742,2561.223124,5299,95.25435916,10598,-2460672,252416,-2208256,78
6226,651,22,8,0.0946633707,0.905336629,1961.695763,2197.269452,3442.200771,3408.388633,6877,216.7349512,13754,-3187712,333312,-2854400,78
4793,512,22,8,0.0965127238,0.903487276,1526.729223,1574.508611,2655.289798,2631.564453,5305,178.3792872,10610,-2454016,262144,-2191872,78
88,10,21,9,0.102040816,0.897959184,27.27242424,18.64430208,52.81818182,20.3,98,23.61445783,196,-45056,5120,-39936,78
157,40,22,8,0.203045685,0.796954315,54.10106346,64.83640952,95.50955414,112.7,197,11.59505592,394,-80384,20480,-59904,78
4832,507,22,8,0.0949616033,0.905038397,1537.598621,1575.297978,2672.431291,2646.828402,5339,98.10731349,10678,-2473984,259584,-2214400,78
8874,648,22,8,0.0680529301,0.93194707,2728.834783,2904.693357,4816.713094,4005.387346,9522,218.0444241,19044,-4543488,331776,-4211712,78
90,10,21,9,0.1,0.9,27.81815954,19.17941605,53.83333333,20.5,100,33.11258278,200,-46080,5120,-40960,78
6377,577,22,8,0.082973828,0.917026172,1970.238397,2354.76454,3447.402227,3810.140381,6954,228.1496063,13908,-3265024,295424,-2969600,78
4928,512,22,8,0.0941176471,0.905882353,1565.021564,1620.840112,2723.783888,2688.892578,5440,180.0728236,10880,-2523136,262144,-2260992,78
6137,617,22,8,0.0913532721,0.908646728,1925.831144,2172.697707,3374.021509,3412.098865,6754,228.7940379,13508,-3142144,315904,-2826240,78
4906,514,22,8,0.0948339483,0.905166052,1562.678698,1582.568351,2714.273746,2674.480545,5420,202.6925954,10840,-2511872,263168,-2248704,78
4853,474,22,8,0.0889806645,0.911019335,1534.214999,1573.333859,2667.300227,2630.21097,5327,177.8037383,10654,-2484736,242688,-2242048,78
2788,243,22,8,0.0801715605,0.919828439,863.0069786,988.0659444,1529.972023,1355.695473,3031,285.4048964,6062,-1427456,124416,-1303040,78
4847,514,22,8,0.0958776348,0.904122365,1546.787146,1553.752809,2687.557458,2619.163424,5361,192.0816912,10722,-2481664,263168,-2218496,78
6400,607,22,8,0.0866276581,0.913372342,1996.790359,2278.28885,3501.209844,3533.418451,7007,256.384925,14014,-3276800,310784,-2966016,78
4928,534,22,8,0.0977663859,0.902233614,1572.590185,1613.591678,2725.719765,2784.842697,5462,169.5746663,10924,-2523136,273408,-2249728,78
4854,525,22,8,0.0976017847,0.902398215,1548.325408,1593.218149,2687.450968,2713.567619,5379,201.9902366,10758,-2485248,268800,-2216448,78
2754,240,22,8,0.0801603206,0.919839679,854.7296152,942.9583507,1515.519971,1290.720833,2994,373.3167082,5988,-1410048,122880,-1287168,78
166,41,22,8,0.198067633,0.801932367,57.56347611,66.39259149,100.8433735,116.7804878,207,10.7253886,414,-84992,20992,-64000,78
2491,205,22,8,0.0760385757,0.923961424,768.9347604,826.6718746,1373.236853,1047.917073,2696,58.22894168,5392,-1275392,104960,-1170432,78
5297,509,22,8,0.0876679297,0.91233207,1671.647834,1718.706105,2911.948839,2815.575639,5806,188.139987,11612,-2712064,260608,-2451456,78
4894,465,22,8,0.0867699198,0.91323008,1542.229138,1596.410889,2678.869432,2691.898925,5359,174.8450245,10718,-2505728,238080,-2267648,78
6343,576,22,8,0.0832490244,0.916750976,1959.212583,2349.785365,3428.741605,3804.222222,6919,192.9447853,13838,-3247616,294912,-2952704,78
6393,569,22,8,0.0817293881,0.918270612,1983.666007,2274.155514,3464.883466,3668.195079,6962,234.0954943,13924,-3273216,291328,-2981888,78
4921,487,22,8,0.0900517751,0.909948225,1555.933535,1612.601807,2701.248933,2737.351129,5408,188.4977344,10816,-2519552,249344,-2270208,78
4903,477,22,8,0.08866171,0.91133829,1545.63562,1627.53574,2690.048134,2695.144654,5380,174.1663969,10760,-2510336,244224,-2266112,78
4997,499,22,8,0.0907933042,0.909206696,1578.789337,1662.030208,2751.643586,2717.02004,5496,216.6338195,10992,-2558464,255488,-2302976,78
6382,564,22,8,0.0811978117,0.918802188,1975.262505,2303.78274,3452.968035,3705.83156,6946,210.0393106,13892,-3267584,288768,-2978816,78
2855,223,22,8,0.0724496426,0.927550357,875.5830075,1015.567264,1556.457793,1322.394619,3078,291.4772727,6156,-1461760,114176,-1347584,78
5019,460,22,8,0.0839569264,0.916043074,1581.005496,1583.517307,2728.777047,2862.452174,5479,209.842972,10958,-2569728,235520,-2334208,78
2824,234,22,8,0.0765206017,0.923479398,867.0506572,1047.508512,1538.897309,1416.089744,3058,53.83802817,6116,-1445888,119808,-1326080,78
4894,484,22,8,0.0899962811,0.910003719,1548.850486,1588.873876,2689.282795,2691.696281,5378,204.7981721,10756,-2505728,247808,-2257920,78
2831,222,22,8,0.0727153619,0.927284638,868.6992193,1013.496509,1540.365595,1356.558559,3053,283.4726091,6106,-1449472,113664,-1335808,78
5069,486,22,8,0.0874887489,0.912511251,1598.443811,1656.087316,2775.479384,2804.290123,5555,197.0556935,11110,-2595328,248832,-2346496,78
2836,220,22,8,0.0719895288,0.928010471,871.8092644,982.6813823,1544.75952,1318.9,3056,308.3753784,6112,-1452032,112640,-1339392,78
4853,476,22,8,0.0893225746,0.910677425,1533.018325,1591.56924,2666.812075,2646.52521,5329,170.9108403,10658,-2484736,243712,-2241024,78
4950,479,22,8,0.0882298766,0.911770123,1558.586227,1650.276958,2705.066465,2817.653445,5429,216.5536498,10858,-2534400,245248,-2289152,78
4882,461,22,8,0.0862811155,0.913718885,1542.001437,1544.422747,2664.744777,2748.832972,5343,121.625313,10686,-2499584,236032,-2263552,78
4955,480,22,8,0.0883164673,0.911683533,1564.326153,1614.751034,2712.361857,2776.202083,5435,185.4948805,10870,-2536960,245760,-2291200,78
2527,238,22,8,0.0860759494,0.913924051,791.9971826,853.2661147,1393.478037,1271.747899,2765,154.5556177,5530,-1293824,121856,-1171968,78
4049,319,22,8,0.0730311355,0.926968864,1247.33316,1406.878503,2200.342307,1983.416928,4368,224.691358,8736,-2073088,163328,-1909760,78
2452,239,22,8,0.0888145671,0.911185433,767.1789533,858.1041999,1359.128059,1211.313808,2691,175.1953125,5382,-1255424,122368,-1133056,78
4074,359,22,8,0.0809835326,0.919016467,1260.461338,1477.08606,2225.584683,2119.579387,4433,81.29470017,8866,-2085888,183808,-1902080,78
2472,238,22,8,0.0878228782,0.912177122,774.3783847,857.8181829,1361.594256,1292.201681,2710,186.6391185,5420,-1265664,121856,-1143808,78
4078,336,22,8,0.0761214318,0.923878568,1259.922837,1420.18017,2224.520598,2000.922619,4414,229.5371815,8828,-2087936,172032,-1915904,78
2488,238,22,8,0.0873074101,0.91269259,778.0864598,864.1898193,1375.446543,1238.613445,2726,176.7833982,5452,-1273856,121856,-1152000,78
2441,232,22,8,0.0867938646,0.913206135,763.3056677,851.9339754,1342.768128,1276.310345,2673,159.2019059,5346,-1249792,118784,-1131008,78
2473,237,22,8,0.0874538745,0.912546125,773.7628861,857.4143506,1366.942175,1236.105485,2710,200.443787,5420,-1266176,121344,-1144832,78
2209,190,23,7,0.0791996665,0.920800333,686.3527184,738.3984184,1215.089181,1024.568421,2399,127.2679045,4798,-1131008,97280,-1033728,78
2171,186,22,8,0.0789138736,0.921086126,670.2703105,760.9238287,1196.200368,978.2365591,2357,167.6386913,4714,-1111552,95232,-1016320,78
2510,242,22,8,0.0879360465,0.912063953,786.6637212,867.0550196,1384.072908,1297.954545,2752,178.4695201,5504,-1285120,123904,-1161216,78
4088,327,22,8,0.0740656852,0.925934315,1262.048373,1406.279204,2223.699609,2011.730887,4415,276.9761606,8830,-2093056,167424,-1925632,78
2462,237,22,8,0.0878103001,0.9121897,770.2839872,859.3538001,1359.647035,1249.78481,2699,169.1102757,5398,-1260544,121344,-1139200,78
1729,180,22,8,0.0942902043,0.905709796,534.5437207,682.9399378,964.7738577,861.1166667,1909,376.5285996,3818,-885248,92160,-793088,78
2231,193,22,8,0.079620462,0.920379538,690.5187356,778.9667362,1227.15688,1043.072539,2424,130.5331179,4848,-1142272,98816,-1043456,78
2217,188,22,8,0.0781704782,0.921829522,686.6623249,754.5851045,1218.530898,1019.851064,2405,532.079646,4810,-1135104,96256,-1038848,78
2942,270,21,9,0.0840597758,0.915940224,927.6642167,893.2625144,1626.709041,1386.296296,3212,200.3742982,6424,-1506304,138240,-1368064,78
2418,211,22,8,0.0802586535,0.919741347,748.2762061,822.2977466,1339.219603,1037.450237,2629,201.3016845,5258,-1238016,108032,-1129984,78
1256,141,22,8,0.100930565,0.899069435,392.2982432,473.038445,712.7507962,576.5106383,1397,19.01974132,2794,-643072,72192,-570880,78
9419,516,22,8,0.0519375944,0.948062406,2852.017898,3135.304591,4981.349612,4724.317829,9935,743.0815258,19870,-4822528,264192,-4558336,79
9423,515,22,8,0.051821292,0.948178708,2859.204378,2993.470794,4997.697973,4453.559223,9938,832.3283082,19876,-4824576,263680,-4560896,79
9546,424,22,8,0.0425275827,0.957472417,2868.378376,2953.11765,5024.8348,4099.910377,9970,1884.688091,19940,-4887552,217088,-4670464,79
4059,277,22,8,0.0638837638,0.936116236,1246.197271,1214.145018,2204.291451,1644.032491,4336,75.88379419,8672,-2078208,141824,-1936384,79
3131,169,22,8,0.0512121212,0.948787879,949.2366165,996.3131734,1660.24465,1469.964497,3300,237.5809935,6600,-1603072,86528,-1516544,79
9337,595,23,7,0.0599073701,0.94009263,2845.770125,3183.202727,4963.928457,5006.853782,9932,546.0142936,19864,-4780544,304640,-4475904,79
9414,529,22,8,0.0532032586,0.946796741,2849.329929,3220.559783,4973.475887,4945.73535,9943,754.400607,19886,-4819968,270848,-4549120,79
9555,415,23,7,0.0416248746,0.958375125,2866.2816,3018.83127,5021.877551,4147.939759,9970,1515.197568,19940,-4892160,212480,-4679680,79
9487,472,22,8,0.0473943167,0.952605683,2859.627831,3121.133814,5005.958259,4458.25,9959,1177.186761,19918,-4857344,241664,-4615680,79
9511,450,22,8,0.0451761871,0.954823813,2861.466556,3081.639431,5012.786983,4309.164444,9961,1353.396739,19922,-4869632,230400,-4639232,79
2377,168,23,7,0.0660117878,0.933988212,729.5829268,676.5204365,1302.587295,854.375,2545,44.7826852,5090,-1217024,86016,-1131008,79
9492,453,22,8,0.0455505279,0.954449472,2856.423113,3147.483166,4985.292562,4715.426049,9945,1149.710983,19890,-4859904,231936,-4627968,79
9465,477,22,8,0.047978274,0.952021726,2858.877992,3046.366102,4994.660433,4511.932914,9942,854.8581255,19884,-4846080,244224,-4601856,79
9412,524,22,8,0.0527375201,0.94726248,2844.265148,3269.651059,4969.044411,4958.721374,9936,943.5897436,19872,-4818944,268288,-4550656,79
9491,468,22,8,0.0469926699,0.95300733,2862.913482,3061.086783,5005.989358,4452.938034,9959,996.8968969,19918,-4859392,239616,-4619776,79
9487,465,22,8,0.0467242765,0.953275723,2858.855473,3069.369754,5009.456836,4304.109677,9952,1675.420875,19904,-4857344,238080,-4619264,79
9380,554,23,7,0.0557680693,0.944231931,2847.626792,3188.421464,4967.4629,4968.128159,9934,733.6779911,19868,-4802560,283648,-4518912,79
9484,474,22,8,0.0475999197,0.95240008,2867.657073,2954.364167,5007.773197,4413.797468,9958,924.6053853,19916,-4855808,242688,-4613120,79
9489,469,23,7,0.0470978108,0.952902189,2860.399369,3098.814847,5006.436927,4434.501066,9958,1002.819738,19916,-4858368,240128,-4618240,79
3452,301,22,8,0.0802025047,0.919797495,1070.837167,1205.183229,1891.866165,1706.508306,3753,65.80746975,7506,-1767424,154112,-1613312,79
8565,1274,23,7,0.129484704,0.870515296,2801.80414,2879.642411,4765.83094,5956.466248,9839,489.5024876,19678,-4385280,652288,-3732992,79
6357,714,23,7,0.100975817,0.899024183,2029.97251,2092.271383,3488.762781,3956.570028,7071,257.2208076,14142,-3254784,365568,-2889216,79
6284,700,23,7,0.100229095,0.899770905,2001.009435,2092.76713,3441.883673,3946.89,6984,300.2579536,13968,-3217408,358400,-2859008,79
2575,230,23,7,0.0819964349,0.918003565,802.6270821,740.5058612,1444.539806,937.9347826,2805,49.27969079,5610,-1318400,117760,-1200640,79
5809,664,23,7,0.102579947,0.897420053,1853.986131,1922.764759,3180.696678,3729.569277,6473,263.5586319,12946,-2974208,339968,-2634240,79
2260,212,24,6,0.0857605178,0.914239482,712.3957154,668.9989874,1261.877434,965.9669811,2472,44.02493321,4944,-1157120,108544,-1048576,79
7433,1030,24,6,0.121706251,0.878293749,2420.91927,2497.931689,4139.627068,4898.609709,8463,224.9003455,16926,-3805696,527360,-3278336,79
5828,718,24,6,0.109685304,0.890314696,1855.459902,1999.997577,3182.65477,4010.889972,6546,116.997319,13092,-2983936,367616,-2616320,79
6280,702,23,7,0.100544257,0.899455743,1999.418306,2121.284566,3451.66449,3847.863248,6982,269.1595991,13964,-3215360,359424,-2855936,79
5940,683,23,7,0.103125472,0.896874528,1893.02722,2020.336522,3263.551347,3733.354319,6623,247.7740367,13246,-3041280,349696,-2691584,79
7346,1126,23,7,0.132908404,0.867091596,2426.318178,2393.486896,4103.591751,5103.590586,8472,227.8644432,16944,-3761152,576512,-3184640,79
7101,732,23,7,0.0934507851,0.906549215,2255.265817,2307.786162,3895.773131,4122.918033,7833,283.4961998,15666,-3635712,374784,-3260928,79
8650,1197,23,7,0.121559866,0.878440134,2876.624434,2530.688825,4856.72763,5410.137009,9847,499.8477157,19694,-4428800,612864,-3815936,79
7355,1157,24,6,0.135925752,0.864074248,2436.563681,2424.537071,4125.585588,5088.717373,8512,198.7392015,17024,-3765760,592384,-3173376,79
3768,271,22,8,0.0670958158,0.932904184,1162.476242,1189.764504,2036.536624,1790.073801,4039,164.8571429,8078,-1929216,138752,-1790464,79
6196,699,23,7,0.10137781,0.89862219,1979.040779,2058.896482,3410.507586,3780.336195,6895,280.398536,13790,-3172352,357888,-2814464,79
7209,999,23,7,0.121710526,0.878289474,2364.818605,2305.063991,4016.511444,4739.444444,8208,254.5116279,16416,-3691008,511488,-3179520,79
6024,670,24,6,0.100089633,0.899910367,1921.105049,1976.942861,3298.365372,3789.271642,6694,159.6470308,13388,-3084288,343040,-2741248,79
6242,709,24,6,0.101999712,0.898000288,1992.639725,2078.914314,3428.428228,3894.819464,6951,183.0173776,13902,-3195904,363008,-2832896,79
6120,711,22,8,0.104084321,0.895915679,1947.696558,2122.326846,3366.551471,3841.632911,6831,205.8150045,13662,-3133440,364032,-2769408,79
9211,711,22,8,0.0716589397,0.92834106,2883.294232,2594.468341,4978.68885,4738.818565,9922,673.1343284,19844,-4716032,364032,-4352000,79
9214,708,23,7,0.0713565813,0.928643419,2887.942552,2501.992688,4991.950619,4565.211864,9922,803.4008097,19844,-4717568,362496,-4355072,79
9223,700,22,8,0.0705431825,0.929456817,2884.593136,2560.949207,4988.052694,4618.737143,9923,754.6007605,19846,-4722176,358400,-4363776,79
9138,776,22,8,0.0782731491,0.921726851,2892.703546,2469.556218,4963.925914,4881.829897,9914,865.8515284,19828,-4678656,397312,-4281344,79
9119,792,22,8,0.0799112098,0.92008879,2888.786067,2518.727812,4949.509815,5030.727273,9911,754.261796,19822,-4668928,405504,-4263424,79
9142,762,22,8,0.0769386107,0.923061389,2878.909238,2604.505357,4964.577773,4807.598425,9904,476.3828764,19808,-4680704,390144,-4290560,79
9220,704,22,8,0.0709391374,0.929060863,2881.503171,2610.479964,4989.682755,4606.49858,9924,559.4137542,19848,-4720640,360448,-4360192,79
9244,683,21,9,0.0688022565,0.931197744,2881.434371,2618.755946,4989.572479,4617.891654,9927,734.2455621,19854,-4732928,349696,-4383232,79
9143,771,22,8,0.0777688118,0.922231188,2895.972457,2419.058249,4967.083889,4843.848249,9914,658.7375415,19828,-4681216,394752,-4286464,79
9160,752,22,8,0.0758676352,0.924132365,2882.931185,2575.765869,4972.780677,4758.1875,9912,734.7664937,19824,-4689920,385024,-4304896,79
8811,1049,22,8,0.106389452,0.893610548,2845.615016,2734.432962,4839.13642,5697.901811,9860,799.0275527,19720,-4511232,537088,-3974144,79
46,13,22,8,0.220338983,0.779661017,17.15061711,15.91248254,31.17391304,25.84615385,59,1.550591327,118,-23552,6656,-16896,79
9162,749,22,8,0.0755725961,0.924427404,2882.674862,2578.145954,4967.151604,4819.59012,9911,691.1436541,19822,-4690944,383488,-4307456,79
9152,760,22,8,0.0766747377,0.923325262,2884.010902,2562.096508,4975.214816,4731.134211,9912,817.147568,19824,-4685824,389120,-4296704,79
9162,749,22,8,0.0755725961,0.924427404,2883.073784,2567.883023,4972.637961,4752.479306,9911,715.0793651,19822,-4690944,383488,-4307456,79
9211,708,23,7,0.0713781631,0.928621837,2882.396298,2575.905163,4987.837368,4597.838983,9919,496.9438878,19838,-4716032,362496,-4353536,79
9285,643,22,8,0.0647663175,0.935233683,2884.227815,2556.325085,4991.512332,4574.438569,9928,586.068477,19856,-4753920,329216,-4424704,79
9273,653,22,8,0.0657868225,0.934213178,2881.371382,2607.434162,4985.81527,4646.609495,9926,561.7430673,19852,-4747776,334336,-4413440,79
8779,1083,22,8,0.109815453,0.890184547,2849.952802,2697.961451,4835.12621,5712.723915,9862,681.0773481,19724,-4494848,554496,-3940352,79
2550,149,22,8,0.0552056317,0.944794368,774.2981389,803.0969316,1367.100392,1057.342282,2699,39.93785144,5398,-1305600,76288,-1229312,79
3893,269,22,8,0.0646323883,0.935367612,1192.826453,1249.961279,2109.890316,1670.63197,4162,119.5633439,8324,-1993216,137728,-1855488,79
9177,739,21,9,0.0745260186,0.925473981,2887.162671,2510.96128,4986.244633,4613.963464,9916,772.8760717,19832,-4698624,378368,-4320256,79
9055,841,23,7,0.0849838319,0.915016168,2870.061859,2708.980969,4947.16444,4962.879905,9896,531.7571198,19792,-4636160,430592,-4205568,79
8861,1016,22,8,0.102865242,0.897134758,2878.544994,2591.071238,4914.313509,5154.302165,9877,466.5564478,19754,-4536832,520192,-4016640,79
9068,829,22,8,0.0837627564,0.916237244,2873.550466,2667.757801,4957.434274,4856.741858,9897,720.3056769,19794,-4642816,424448,-4218368,79
9200,720,23,7,0.0725806452,0.927419355,2877.57058,2664.280592,4982.011196,4685.634722,9920,709.5851216,19840,-4710400,368640,-4341760,79
9147,766,23,7,0.0772722687,0.922727731,2880.752903,2609.708593,4977.908057,4707.331593,9913,793.04,19826,-4683264,392192,-4291072,79
9180,736,22,8,0.0742234772,0.925776523,2876.264364,2667.434041,4982.109586,4664.021739,9916,647.6812541,19832,-4700160,376832,-4323328,79
4219,267,22,8,0.059518502,0.940481498,1287.200121,1391.091283,2258.533065,2005.955056,4486,115.9173127,8972,-2160128,136704,-2023424,79
9007,881,23,7,0.0890978964,0.910902104,2870.388103,2674.829037,4921.939936,5175.145289,9888,891.6140667,19776,-4611584,451072,-4160512,79
9130,777,22,8,0.0784293934,0.921570607,2875.200705,2666.555067,4969.871413,4767.505792,9907,365.3023599,19814,-4674560,397824,-4276736,79
9219,699,22,8,0.0704779189,0.929522081,2884.487107,2535.953889,4987.184293,4594.376252,9918,593.5368043,19836,-4720128,357888,-4362240,79
8867,1002,22,8,0.101530044,0.898469956,2849.561856,2777.703007,4869.917898,5510.931138,9869,540.4709748,19738,-4539904,513024,-4026880,79
9105,802,21,9,0.0809528616,0.919047138,2871.423908,2725.497062,4951.088083,4987.058603,9907,555.6365676,19814,-4661760,410624,-4251136,79
9170,744,23,7,0.0750453904,0.92495461,2866.444919,2804.279677,4964.27012,4874.056452,9914,418.3122363,19828,-4695040,380928,-4314112,79
9050,844,23,7,0.0853042248,0.914695775,2858.410941,2804.708856,4912.637127,5321.325829,9894,597.1031986,19788,-4633600,432128,-4201472,79
9156,759,22,8,0.0765506808,0.923449319,2880.934898,2611.456845,4979.896571,4693.85639,9915,812.704918,19830,-4687872,388608,-4299264,79
9231,688,22,8,0.0693618308,0.930638169,2881.707027,2582.440386,4984.521287,4630.994186,9919,610.7758621,19838,-4726272,352256,-4374016,79
9035,861,22,8,0.0870048504,0.91299515,2864.825814,2736.701201,4909.309463,5359.75029,9896,464.3829188,19792,-4625920,440832,-4185088,79
2505,194,22,8,0.0718784735,0.928121526,772.0402369,860.4211796,1357.003593,1259.56701,2699,41.73496212,5398,-1282560,99328,-1183232,79
6061,689,22,8,0.102074074,0.897925926,1934.16138,2020.199799,3326.447616,3807.004354,6750,257.6335878,13500,-3103232,352768,-2750464,79
7454,1134,22,8,0.132044714,0.867955286,2469.701852,2394.827688,4174.399651,5083.942681,8588,241.6432189,17176,-3816448,580608,-3235840,79
6415,722,22,8,0.101162954,0.898837046,2037.375251,2222.073537,3528.957132,3924.782548,7137,261.0460863,14274,-3284480,369664,-2914816,79
8576,1258,23,7,0.127923531,0.872076469,2788.606157,2926.316425,4754.123834,6031.263116,9834,621.2255212,19668,-4390912,644096,-3746816,79
6435,699,22,8,0.0979814971,0.902018503,2051.423734,2099.292727,3529.411344,3918.144492,7134,211.6285969,14268,-3294720,357888,-2936832,79
8562,1272,23,7,0.129347163,0.870652837,2793.394076,2927.533477,4764.946274,5944.359277,9834,601.8359853,19668,-4383744,651264,-3732480,79
8683,1179,23,7,0.119549787,0.880450213,2875.795155,2583.178025,4872.438558,5366.470738,9862,530.7857912,19724,-4445696,603648,-3842048,79
5885,693,22,8,0.105351171,0.894648829,1881.373882,1992.526551,3239.879694,3710.878788,6578,206.8553459,13156,-3013120,354816,-2658304,79
6406,698,22,8,0.0982545045,0.901745495,2041.636886,2103.251869,3516.049485,3887.030086,7104,253.8049303,14208,-3279872,357376,-2922496,79
6354,676,22,8,0.0961593172,0.903840683,2022.161617,2071.215124,3482.943972,3821.507396,7030,200.7424329,14060,-3253248,346112,-2907136,79
7373,1085,22,8,0.128280917,0.871719083,2420.234241,2456.145223,4119.997287,4973.613825,8458,262.0198265,16916,-3774976,555520,-3219456,79
8666,1180,22,8,0.119845623,0.880154377,2850.818866,2769.508457,4894.343757,5137.625424,9846,477.0348837,19692,-4436992,604160,-3832832,79
6399,698,23,7,0.0983514161,0.901648584,2044.652982,2057.653193,3513.685576,3872.749284,7097,228.3462033,14194,-3276288,357376,-2918912,79
6324,770,22,8,0.10854243,0.89145757,2007.910625,2253.727713,3470.793801,4177.487013,7094,123.7181723,14188,-3237888,394240,-2843648,79
62,15,22,8,0.194805195,0.805194805,22.50008672,19.07528943,40.93548387,31,77,18.68932039,154,-31744,7680,-24064,79
7357,1025,23,7,0.122285851,0.877714149,2407.783301,2391.464707,4094.895881,4884.881951,8382,235.053281,16764,-3766784,524800,-3241984,79
6386,722,22,8,0.101575689,0.898424311,2036.790138,2149.900326,3515.159098,3902.465374,7108,241.3582343,14216,-3269632,369664,-2899968,79
7366,1091,23,7,0.129005558,0.870994442,2426.768728,2423.350373,4125.015884,4931.059578,8457,251.3971463,16914,-3771392,558592,-3212800,79
8599,1233,22,8,0.125406835,0.874593165,2862.057188,2629.05037,4856.906384,5332.108678,9832,681.3582814,19664,-4402688,631296,-3771392,79
2637,263,22,8,0.0906896552,0.909310345,833.3080814,845.1727911,1471.976868,1235.159696,2900,43.71419958,5800,-1350144,134656,-1215488,79
6103,573,24,6,0.0858298382,0.914170162,1919.484147,2003.611053,3327.305424,3457.732984,6676,223.6515913,13352,-3124736,293376,-2831360,79
8502,1203,24,6,0.123956723,0.876043277,2777.940014,2795.115569,4722.638673,5774.306733,9705,177.5196634,19410,-4353024,615936,-3737088,79
6403,591,23,7,0.0845010009,0.915498999,2001.507257,2197.692027,3505.488677,3410.949239,6994,244.6309899,13988,-3278336,302592,-2975744,79
6502,615,22,8,0.0864128144,0.913587186,2046.109641,2140.556876,3554.234851,3609.378862,7117,251.6619519,14234,-3329024,314880,-3014144,79
6461,591,23,7,0.0838060125,0.916193988,2026.032539,2138.269044,3531.258938,3474.473773,7052,251.5875847,14104,-3308032,302592,-3005440,79
8419,1151,23,7,0.120271682,0.879728318,2744.381654,2783.500035,4684.621095,5523.37967,9570,184.2865396,19140,-4310528,589312,-3721216,79
3170,290,23,7,0.0838150289,0.916184971,996.4863596,958.0314538,1762.147003,1384.565517,3460,61.02292769,6920,-1623040,148480,-1474560,79
8236,1149,24,6,0.122429409,0.877570591,2678.870989,2741.830503,4562.689048,5627.065274,9385,185.035489,18770,-4216832,588288,-3628544,79
6449,595,23,7,0.0844690517,0.915530948,2025.885002,2113.174668,3525.529074,3489.668908,7044,278.3089688,14088,-3301888,304640,-2997248,79
5385,552,24,6,0.0929762506,0.907023749,1692.759229,1886.961552,2941.718663,3235.141304,5937,104.2676502,11874,-2757120,282624,-2474496,79
8074,1119,24,6,0.12172305,0.87827695,2617.903478,2745.999567,4476.051647,5469.687221,9193,179.2007797,18386,-4133888,572928,-3560960,79
5057,491,23,7,0.0885003605,0.91149964,1580.415927,1802.792453,2766.093534,2861.081466,5548,215.7076205,11096,-2589184,251392,-2337792,79
8390,1166,24,6,0.122017581,0.877982419,2720.665687,2868.377734,4656.55292,5655.975129,9556,165.0146779,19112,-4295680,596992,-3698688,79
6651,615,23,7,0.0846407927,0.915359207,2087.722876,2200.614531,3633.542174,3633.043902,7266,283.3853354,14532,-3405312,314880,-3090432,79
5556,552,24,6,0.0903732809,0.909626719,1744.769594,1938.7372,3050.259539,3097.181159,6108,156.4950038,12216,-2844672,282624,-2562048,79
6182,587,23,7,0.0867188654,0.913281135,1940.052696,2095.551611,3387.319638,3360.570698,6769,210.0217189,13538,-3165184,300544,-2864640,79
4141,344,24,6,0.0767001115,0.923299889,1285.398784,1364.001168,2268.853176,1931.784884,4485,151.2137559,8970,-2120192,176128,-1944064,79
5953,567,23,7,0.0869631902,0.91303681,1874.268239,1960.730085,3251.681505,3353.08642,6520,233.1069003,13040,-3047936,290304,-2757632,79
5639,561,22,8,0.090483871,0.909516129,1770.008346,1976.987934,3095.729207,3148.454545,6200,192.3673596,12400,-2887168,287232,-2599936,79
6437,599,23,7,0.0851335986,0.914866401,2022.679729,2119.015606,3523.22759,3467.69616,7036,236.2659503,14072,-3295744,306688,-2989056,79
9226,697,22,8,0.0702408546,0.929759145,2889.932722,2468.663376,4992.539562,4557.756098,9923,917.0979667,19846,-4723712,356864,-4366848,79
2645,136,22,8,0.0489032722,0.951096728,795.5583279,861.1234774,1408.957656,1041.75,2781,63.6967476,5562,-1354240,69632,-1284608,79
9215,708,22,8,0.0713493903,0.92865061,2886.981266,2533.033002,4986.338904,4645.216102,9923,835.2693603,19846,-4718080,362496,-4355584,79
9160,756,23,7,0.0762404195,0.92375958,2888.831961,2517.022928,4970.723144,4810.399471,9916,802.2653722,19832,-4689920,387072,-4302848,79
9248,678,23,7,0.0683054604,0.93169454,2889.810756,2490.378119,4984.888733,4671.755162,9926,500.8072654,19852,-4734976,347136,-4387840,79
9251,674,23,7,0.0679093199,0.93209068,2893.526716,2437.465824,4973.136093,4823.876855,9925,605.9218559,19850,-4736512,345088,-4391424,79
9173,741,23,7,0.074742788,0.925257212,2888.907392,2496.169674,4972.820342,4767.846154,9914,869.6491228,19828,-4696576,379392,-4317184,79
4144,200,23,7,0.0460405157,0.953959484,1252.933888,1229.544267,2188.580598,1839.31,4344,120.0331583,8688,-2121728,102400,-2019328,79
9130,781,22,8,0.0788013319,0.921198668,2887.210038,2532.877079,4965.328916,4846.943662,9911,1092.723264,19822,-4674560,399872,-4274688,79
9234,690,23,7,0.069528416,0.930471584,2890.443354,2472.251463,4987.571475,4626.978261,9924,701.3427562,19848,-4727808,353280,-4374528,79
8934,948,22,8,0.0959319976,0.904068002,2859.95694,2708.558733,4876.882024,5550.46308,9882,335.0966429,19764,-4574208,485376,-4088832,79
9261,665,22,8,0.0669957687,0.933004231,2882.179699,2582.029649,4994.490552,4531.915789,9926,777.2905247,19852,-4741632,340480,-4401152,79
9265,663,22,8,0.0667808219,0.933219178,2891.337053,2443.290095,4995.641662,4529.315234,9928,509.1282051,19856,-4743680,339456,-4404224,79
9259,667,23,7,0.0671972597,0.93280274,2886.0601,2532.589162,4990.095367,4594.314843,9926,743.5205993,19852,-4740608,341504,-4399104,79
9023,871,23,7,0.0880331514,0.911966849,2868.055631,2699.811975,4910.313089,5332.732491,9894,428.8686606,19788,-4619776,445952,-4173824,79
51,9,22,8,0.15,0.85,17.10568277,9.695359715,33.05882353,16,60,1.65334803,120,-26112,4608,-21504,79
2548,107,22,8,0.0403013183,0.959698682,762.480187,853.4136006,1330.252355,1274.364486,2655,159.939759,5310,-1304576,54784,-1249792,79
9217,706,23,7,0.0711478384,0.928852162,2882.283921,2584.981442,4994.251275,4540.951841,9923,555.9103641,19846,-4719104,361472,-4357632,79
8905,966,23,7,0.0978624253,0.902137575,2861.583913,2691.133629,4885.316339,5403.223602,9871,877.4222222,19742,-4559360,494592,-4064768,79
2698,190,23,7,0.0657894737,0.934210526,827.9357483,905.6255398,1451.556709,1344.294737,2888,43.59245283,5776,-1381376,97280,-1284096,79
2311,93,22,8,0.0386855241,0.961314476,691.608673,731.5443696,1209.092601,1038.677419,2404,300.1248439,4808,-1183232,47616,-1135616,79
2834,192,22,8,0.0634500991,0.936549901,872.064097,801.3452164,1539.61856,1127.979167,3026,53.35919591,6052,-1451008,98304,-1352704,79
9007,889,23,7,0.0898342765,0.910165724,2864.194273,2749.042396,4909.564783,5342.976378,9896,346.1350122,19792,-4611584,455168,-4156416,79
8861,1002,23,7,0.101591808,0.898408192,2839.770947,2752.408396,4830.060151,5833.486028,9863,1053.739316,19726,-4536832,513024,-4023808,79
8999,884,23,7,0.0894465243,0.910553476,2861.514217,2687.582213,4881.272919,5560.193439,9883,773.9232576,19766,-4607488,452608,-4154880,79
8729,1131,22,8,0.114705882,0.885294118,2804.74286,2783.916796,4751.098522,6315.111406,9860,845.626072,19720,-4469248,579072,-3890176,79
9165,750,22,8,0.0756429652,0.924357035,2883.56975,2586.381969,4953.391053,5014.321333,9915,996.4824121,19830,-4692480,384000,-4308480,79
9233,693,23,7,0.0698166432,0.930183357,2883.088668,2613.51636,4974.814362,4812.756133,9926,731.4664702,19852,-4727296,354816,-4372480,79
9243,684,23,7,0.0689029918,0.931097008,2883.937061,2597.111149,4979.722817,4751.535088,9927,614.6749226,19854,-4732416,350208,-4382208,79
9093,813,23,7,0.0820714718,0.917928528,2878.638189,2620.735188,4928.04432,5238.209102,9906,773.3021077,19812,-4655616,416256,-4239360,79
9356,580,22,8,0.058373591,0.941626409,2884.032695,2524.808226,5006.081124,4362.277586,9936,600,19872,-4790272,296960,-4493312,79
4650,279,22,8,0.0566037736,0.943396226,1414.367623,1513.945195,2486.418065,2108.032258,4929,126.4494613,9858,-2380800,142848,-2237952,79
7614,1229,21,9,0.138979984,0.861020016,2506.757874,2374.194119,4193.7917,5835.814483,8843,179.2621123,17686,-3898368,629248,-3269120,79
9248,680,22,8,0.0684931507,0.931506849,2887.032881,2562.25362,4963.100995,4983.526471,9928,910.8256881,19856,-4734976,348160,-4386816,79
9261,665,23,7,0.0669957687,0.933004231,2883.370074,2601.110426,4968.483749,4894.094737,9926,803.0744337,19852,-4741632,340480,-4401152,79
9093,812,22,8,0.0819787986,0.918021201,2878.172474,2625.834327,4930.373254,5206.380542,9905,561.1898017,19810,-4655616,415744,-4239872,79
8952,939,23,7,0.0949347892,0.905065211,2853.244424,2786.377259,4875.448503,5618.605964,9891,386.5181712,19782,-4583424,480768,-4102656,79
9232,694,23,7,0.0699173887,0.930082611,2883.846927,2601.434586,4976.339471,4792.701729,9926,757.7099237,19852,-4726784,355328,-4371456,79
9134,780,23,7,0.0786766189,0.921323381,2879.087829,2613.410126,4920.217429,5394.088462,9914,511.5583075,19828,-4676608,399360,-4277248,79
9115,795,24,6,0.080221998,0.919778002,2878.792349,2597.245409,4913.478113,5437.298113,9910,742.8785607,19820,-4666880,407040,-4259840,79
6474,622,23,7,0.0876550169,0.912344983,2051.840021,1986.130206,3518.589589,3859.818328,7096,230.2401038,14192,-3314688,318464,-2996224,79
7034,645,22,8,0.0839953119,0.916004688,2201.612796,2345.805769,3807.182684,4197.886822,7679,288.1425891,15358,-3601408,330240,-3271168,79
6932,661,22,8,0.0870538654,0.912946135,2185.444967,2235.477842,3767.631275,4104.993949,7593,314.800995,15186,-3549184,338432,-3210752,79
5432,460,22,8,0.078071962,0.921928038,1701.714365,1689.293246,2952.524116,2875.363043,5892,318.3144246,11784,-2781184,235520,-2545664,79
6814,614,22,8,0.0826602046,0.917339795,2139.261018,2184.459054,3692.563252,3957.947883,7428,135.0545455,14856,-3488768,314368,-3174400,79
6298,622,22,8,0.0898843931,0.910115607,1999.77399,1945.141226,3427.82677,3791.329582,6920,275.1491054,13840,-3224576,318464,-2906112,79
6535,636,22,8,0.0886905592,0.911309441,2071.222739,2030.779111,3554.77215,3906.871069,7171,280.445835,14342,-3345920,325632,-3020288,79
6800,627,22,8,0.0844217046,0.915578295,2141.570328,2158.449838,3694.220441,3928.515152,7427,273.2523915,14854,-3481600,321024,-3160576,79
8967,923,22,8,0.0933265925,0.906673407,2882.792943,2567.764712,4936.642021,5031.555796,9890,451.3920584,19780,-4591104,472576,-4118528,79
6815,653,22,8,0.0874397429,0.912560257,2165.273656,2048.411498,3719.874688,3887.136294,7468,280.4355989,14936,-3489280,334336,-3154944,79
3310,204,22,8,0.0580535003,0.9419465,1008.986076,1006.97438,1783.771601,1331.230392,3514,98.34872656,7028,-1694720,104448,-1590272,79
6854,647,22,8,0.086255166,0.913744834,2163.763389,2165.547456,3726.784797,4007.523957,7501,251.6269708,15002,-3509248,331264,-3177984,79
7096,761,22,8,0.0968563065,0.903143694,2264.724738,2271.820045,3892.717728,4267.316689,7857,273.096976,15714,-3633152,389632,-3243520,79
8764,1085,23,7,0.110163468,0.889836532,2852.776433,2715.759669,4864.786399,5411.370507,9849,940.6876791,19698,-4487168,555520,-3931648,79
8815,1044,22,8,0.105893093,0.894106907,2841.167055,2788.362822,4846.239592,5637.229885,9859,687.5174338,19718,-4513280,534528,-3978752,79
8859,1005,22,8,0.101885645,0.898114355,2867.660336,2654.006188,4908.852466,5140.951244,9864,536.3784666,19728,-4535808,514560,-4021248,79
6461,632,22,8,0.0891019315,0.910898069,2044.641454,2053.606845,3517.791828,3845.598101,7093,257.5526507,14186,-3308032,323584,-2984448,79
8702,1143,23,7,0.116099543,0.883900457,2816.317023,2861.57747,4799.816939,5860.829396,9845,770.3442879,19690,-4455424,585216,-3870208,79
8733,1102,23,7,0.112048805,0.887951195,2875.654334,2483.100471,4859.716363,5379.87931,9835,427.6086957,19670,-4471296,564224,-3907072,79
7178,760,23,7,0.0957420005,0.904257999,2275.576432,2376.800476,3915.39231,4480.532895,7938,272.1288996,15876,-3675136,389120,-3286016,79
9253,674,22,8,0.0678956382,0.932104362,2889.276432,2488.556111,4991.666054,4584.186944,9927,935.6267672,19854,-4737536,345088,-4392448,79
9228,695,22,8,0.0700393026,0.929960697,2886.75674,2524.646407,4988.569571,4609.217266,9923,515.4805195,19846,-4724736,355840,-4368896,79
9205,719,22,8,0.0724506247,0.927549375,2889.12002,2523.615621,4978.959044,4751.783032,9924,890.044843,19848,-4712960,368128,-4344832,79
8915,944,23,7,0.0957500761,0.904249924,2858.525333,2675.482615,4877.718003,5423.743644,9859,659.0240642,19718,-4564480,483328,-4081152,79
9231,694,22,8,0.0699244332,0.930075567,2887.832372,2514.361923,4990.831438,4592.809798,9925,754.1793313,19850,-4726272,355328,-4370944,79
9039,859,23,7,0.0867852091,0.913214791,2878.809122,2613.253716,4931.980086,5133.85681,9898,608.7330873,19796,-4627968,439808,-4188160,79
9000,896,22,8,0.090541633,0.909458367,2884.87449,2553.692061,4936.360778,5070.434152,9896,695.9212377,19792,-4608000,458752,-4149248,79
9215,708,22,8,0.0713493903,0.92865061,2892.905171,2437.548226,4989.407813,4605.272599,9923,514.1450777,19846,-4718080,362496,-4355584,79
9217,706,21,9,0.0711478384,0.928852162,2888.329986,2489.880141,4996.467723,4512.015581,9923,800.8878128,19846,-4719104,361472,-4357632,79
8826,1033,22,8,0.104777361,0.895222639,2854.711152,2693.478149,4857.958872,5545.522749,9859,532.6310103,19718,-4518912,528896,-3990016,79
8901,969,22,8,0.0981762918,0.901823708,2869.406056,2588.573082,4873.714189,5503.049536,9870,726.2693157,19740,-4557312,496128,-4061184,79
9252,672,22,8,0.0677146312,0.932285369,2885.765111,2512.846056,4996.412451,4495.598214,9924,838.1756757,19848,-4737024,344064,-4392960,79
9098,810,23,7,0.0817521195,0.918247881,2885.712189,2556.078058,4953.257199,4968.459259,9908,872.1830986,19816,-4658176,414720,-4243456,79
8968,921,22,8,0.093133785,0.906866215,2870.672251,2685.68725,4923.91793,5150.281216,9889,195.8217822,19778,-4591616,471552,-4120064,79
8755,1104,22,8,0.111978903,0.888021097,2841.965268,2691.440824,4808.799429,5891.151268,9859,749.1641337,19718,-4482560,565248,-3917312,79
9255,671,22,8,0.0676002418,0.932399758,2889.584833,2445.928669,5002.309562,4428.205663,9926,656.0475876,19852,-4738560,343552,-4395008,79
9243,682,22,8,0.0687153652,0.931284635,2886.771551,2515.504688,4994.177107,4540.463343,9925,659.0305445,19850,-4732416,349184,-4383232,79
9137,777,22,8,0.0783740165,0.921625983,2891.603894,2480.619916,4971.439641,4793.579151,9914,842.3109601,19828,-4678144,397824,-4280320,79
8910,961,23,7,0.097355891,0.902644109,2860.441228,2680.570441,4874.887205,5502.612903,9871,721.0372535,19742,-4561920,492032,-4069888,79
2741,194,22,8,0.0660988075,0.933901193,839.7282411,942.7306571,1474.367749,1378.030928,2935,45.25828836,5870,-1403392,99328,-1304064,79
2764,334,19,11,0.107811491,0.892188509,878.7857031,1009.036274,1560.635673,1457.347305,3098,57.97155689,6196,-1415168,171008,-1244160,80
2758,341,19,11,0.110035495,0.889964505,878.6788435,1013.298261,1555.149384,1508.351906,3099,70.9478022,6198,-1412096,174592,-1237504,80
398,67,19,11,0.144086022,0.855913978,130.6363237,111.9813019,249.4371859,135.358209,465,9.795660417,930,-203776,34304,-169472,80
2764,328,19,11,0.106080207,0.893919793,877.166242,1010.222614,1555.247467,1472.786585,3092,72.94173154,6184,-1415168,167936,-1247232,80
2672,343,19,11,0.113764511,0.886235489,856.5215837,968.3452832,1517.303518,1435.524781,3015,74.79533614,6030,-1368064,175616,-1192448,80
2751,333,19,11,0.107976654,0.892023346,869.7639639,1041.481836,1551.44602,1468.594595,3084,76.92691444,6168,-1408512,170496,-1238016,80
2752,331,19,11,0.107362958,0.892637042,875.0312372,1003.173811,1550.166061,1474.10574,3083,64.36325678,6166,-1409024,169472,-1239552,80
2758,352,19,11,0.11318328,0.88681672,875.8555139,1053.872349,1554.768673,1561.230114,3110,54.51358457,6220,-1412096,180224,-1231872,80
2751,333,19,11,0.107976654,0.892023346,874.2061859,1007.84702,1554.518357,1443.213213,3084,74.17027417,6168,-1408512,170496,-1238016,80
2300,286,19,11,0.110595514,0.889404486,731.3945331,854.3831067,1303.318261,1214.541958,2586,68.86817577,5172,-1177600,146432,-1031168,80
2305,282,19,11,0.109006571,0.890993429,730.1687319,868.997526,1300.701085,1239.22695,2587,65.24590164,5174,-1180160,144384,-1035776,80
2703,350,19,11,0.114641336,0.885358664,867.0040256,984.5486377,1530.36552,1501.008571,3053,78.30212875,6106,-1383936,179200,-1204736,80
2747,332,19,11,0.107827217,0.892172783,873.56507,1003.475786,1548.590826,1468.918675,3079,73.73084291,6158,-1406464,169984,-1236480,80
2712,355,19,11,0.115748288,0.884251712,869.4286003,996.9304822,1526.550516,1590.909859,3067,54.08217246,6134,-1388544,181760,-1206784,80
2707,357,19,11,0.11651436,0.88348564,867.3911909,1004.483006,1535.624307,1508.809524,3064,62.63286999,6128,-1385984,182784,-1203200,80
2324,283,19,11,0.108553893,0.891446107,735.8150445,874.0725214,1313.777539,1223.706714,2607,66.59003831,5214,-1189888,144896,-1044992,80
2752,333,19,11,0.107941653,0.892058347,873.4346927,1019.447953,1549.78343,1486.93994,3085,71.84443409,6170,-1409024,170496,-1238528,80
3114,381,19,11,0.109012876,0.890987124,991.0442171,1143.551722,1753.659281,1701.745407,3495,80.08707608,6990,-1594368,195072,-1399296,80
778,116,19,11,0.129753915,0.870246085,252.9128928,259.3546573,465.651671,325.7586207,894,13.99061033,1788,-398336,59392,-338944,80
932,121,19,11,0.114909782,0.885090218,294.6688998,334.1616471,545.7821888,382.3305785,1053,16.66930505,2106,-477184,61952,-415232,80
453,77,22,8,0.145283019,0.854716981,146.3249188,158.4385118,281.2582781,172.7922078,530,17.80315754,1060,-231936,39424,-192512,80
989,155,22,8,0.13548951,0.86451049,319.4331825,390.7786102,577.4823054,540.7096774,1144,28.12192724,2288,-506368,79360,-427008,80
611,126,22,8,0.170963365,0.829036635,204.4973988,247.4943744,374.0212766,344.6507937,737,18.74364191,1474,-312832,64512,-248320,80
1445,218,22,8,0.131088394,0.868911606,466.0023783,563.376716,837.0062284,798.8165138,1663,41.81543877,3326,-739840,111616,-628224,80
1443,201,22,8,0.122262774,0.877737226,462.941521,547.4843063,830.5814276,764.4825871,1644,39.92229237,3288,-738816,102912,-635904,80
1445,214,22,8,0.128993369,0.871006631,464.8302406,564.8496358,830.8387543,824.3364486,1659,29.13593256,3318,-739840,109568,-630272,80
1485,209,22,8,0.123376623,0.876623377,475.6283298,573.3699663,853.5959596,804.1866029,1694,41.40796871,3388,-760320,107008,-653312,80
1460,208,22,8,0.12470024,0.87529976,472.1176528,538.7794304,843.380137,772.1682692,1668,40.48543689,3336,-747520,106496,-641024,80
1441,204,22,8,0.124012158,0.875987842,462.9915456,548.6427442,830.482304,770.1470588,1645,40.16113281,3290,-737792,104448,-633344,80
1007,159,22,8,0.136363636,0.863636364,327.1119871,389.3166005,589.3525323,546.4339623,1166,30.70845404,2332,-515584,81408,-434176,80
1448,208,22,8,0.125603865,0.874396135,463.9867013,565.0559407,833.5973757,793.0144231,1656,40.83847102,3312,-741376,106496,-634880,80
1451,207,22,8,0.124849216,0.875150784,465.8092267,559.2598266,834.0055134,797.9178744,1658,39.58930277,3316,-742912,105984,-636928,80
1433,199,22,8,0.121936275,0.878063725,461.7022087,527.3553563,827.4605722,737.5728643,1632,40.3461063,3264,-733696,101888,-631808,80
1423,198,22,8,0.122146823,0.877853177,458.0452267,530.6851972,818.3836964,757.9343434,1621,39.05083113,3242,-728576,101376,-627200,80
1444,204,22,8,0.123786408,0.876213592,463.2012284,554.8059585,830.1537396,784.4803922,1648,39.4541537,3296,-739328,104448,-634880,80
1437,207,22,8,0.125912409,0.874087591,463.3918667,542.9331651,830.2533055,768.6763285,1644,32.95249549,3288,-735744,105984,-629760,80
460,66,22,8,0.125475285,0.874524715,143.2595625,179.8474075,275.7717391,177.969697,526,40.18334607,1052,-235520,33792,-201728,80
1459,216,22,8,0.128955224,0.871044776,472.0427578,553.9994799,842.4482522,807.9537037,1675,41.16490538,3350,-747008,110592,-636416,80
1468,204,22,8,0.122009569,0.877990431,469.2036588,568.7957466,841.7752044,798.5392157,1672,39.48051948,3344,-751616,104448,-647168,80
1455,206,22,8,0.124021674,0.875978326,468.0290991,551.0324687,838.2213058,779.9951456,1661,37.18379225,3322,-744960,105472,-639488,80
304,48,22,8,0.136363636,0.863636364,97.02940486,108.9155648,186.0427632,116.0625,352,7.853636769,704,-155648,24576,-131072,80
1231,181,22,8,0.128186969,0.871813031,396.8583688,474.0976945,708.4281072,693.3867403,1412,37.98762443,2824,-630272,92672,-537600,80
1213,170,22,8,0.122921186,0.877078814,390.5744048,453.8216837,698.2374279,647.4941176,1383,36.68435013,2766,-621056,87040,-534016,80
1657,218,22,8,0.116266667,0.883733333,528.4085915,629.0004059,943.3379602,897.4266055,1875,45.70941004,3750,-848384,111616,-736768,80
1659,212,22,8,0.113308391,0.886691609,528.3096476,620.0051121,945.3086197,863.1556604,1871,44.5900858,3742,-849408,108544,-740864,80
1711,238,22,8,0.122113905,0.877886095,544.676004,677.1068212,979.0824079,945.6512605,1949,36.01922011,3898,-876032,121856,-754176,80
1629,205,22,8,0.111777535,0.888222465,517.1359687,613.8076111,926.5162676,845.8536585,1834,44.37454633,3668,-834048,104960,-729088,80
1644,217,22,8,0.116603976,0.883396024,523.8243648,627.9878652,936.4890511,889.4147465,1861,46.77054536,3722,-841728,111104,-730624,80
1676,228,22,8,0.119747899,0.880252101,534.7853851,646.4479735,959.0059666,904.6754386,1904,43.22360953,3808,-858112,116736,-741376,80
1579,207,24,6,0.115901456,0.884098544,506.6060506,572.2412687,904.7156428,807.9468599,1786,31.26203396,3572,-808448,105984,-702464,80
1629,225,22,8,0.121359223,0.878640777,520.9869523,628.2635785,930.2160835,907.8355556,1854,37.60649087,3708,-834048,115200,-718848,80
1645,216,22,8,0.116066631,0.883933369,525.8934276,613.461924,938.8218845,871.4305556,1861,44.46833931,3722,-842240,110592,-731648,80
1191,165,22,8,0.121681416,0.878318584,380.5503057,459.1442092,685.7464316,626.1939394,1356,36.52033396,2712,-609792,84480,-525312,80
1671,223,22,8,0.117740232,0.882259768,533.903398,631.6866291,955.3686415,888.5381166,1894,44.58568738,3788,-855552,114176,-741376,80
1637,214,22,8,0.115613182,0.884386818,524.286492,604.1190592,931.4294441,884.4672897,1851,45.23460411,3702,-838144,109568,-728576,80
1217,174,22,8,0.125089863,0.874910137,392.0200633,459.9755748,702.7411668,648.8505747,1391,31.90366972,2782,-623104,89088,-534016,80
1652,222,22,8,0.11846318,0.88153682,529.6140157,616.5607085,944.4521792,885.7657658,1874,37.78225806,3748,-845824,113664,-732160,80
1648,215,22,8,0.11540526,0.88459474,528.4664556,579.7107098,953.0618932,770.5581395,1863,41.63128492,3726,-843776,110080,-733696,80
1647,213,22,8,0.114516129,0.885483871,523.6390206,628.1413359,936.9180328,880.8732394,1860,42.00542005,3720,-843264,109056,-734208,80
1670,218,22,8,0.115466102,0.884533898,534.876152,615.7879884,949.642515,905.1055046,1888,41.51275286,3776,-855040,111616,-743424,80
1479,211,22,8,0.124852071,0.875147929,474.1672969,571.8307482,853.2339419,791.2890995,1690,40.97963143,3380,-757248,108032,-649216,80
1175,174,22,8,0.128984433,0.871015567,388.0502446,349.6376998,701.4434043,496.4310345,1349,26.68117089,2698,-601600,89088,-512512,80
1462,206,22,8,0.123501199,0.876498801,469.8035387,554.2236651,842.5512996,777.3592233,1668,40.56420233,3336,-748544,105472,-643072,80
1470,197,22,8,0.118176365,0.881823635,471.0407727,543.1946833,845.8414966,745.6395939,1667,41.60219616,3334,-752640,100864,-651776,80
1447,201,22,8,0.121966019,0.878033981,465.3578395,540.4265884,833.3082239,761.0895522,1648,41.2722264,3296,-740864,102912,-637952,80
1489,221,22,8,0.129239766,0.870760234,488.5052292,518.3760006,868.567495,767.4570136,1710,33.91511305,3420,-762368,113152,-649216,80
1474,204,22,8,0.121573302,0.878426698,474.1878131,544.9432212,851.3792402,753.6666667,1678,36.82247092,3356,-754688,104448,-650240,80
1479,210,22,8,0.124333925,0.875666075,477.5553027,547.6779625,855.1737661,773.347619,1689,29.97338066,3378,-757248,107520,-649728,80
1441,214,22,8,0.129305136,0.870694864,464.711001,555.9658731,834.1172797,786.8084112,1655,34.75430491,3310,-737792,109568,-628224,80
1443,210,22,8,0.127041742,0.872958258,464.5850429,552.266241,835.8198198,766.3952381,1653,38.51351351,3306,-738816,107520,-631296,80
1453,206,22,8,0.124171187,0.875828813,464.6286375,565.6654051,838.8382657,767.6601942,1659,37.17230562,3318,-743936,105472,-638464,80
1467,214,22,8,0.127305175,0.872694825,472.2830527,564.2665035,847.5126108,796.3551402,1681,42.63251331,3362,-751104,109568,-641536,80
1475,215,22,8,0.127218935,0.872781065,473.01926,578.273038,850.6779661,809.9767442,1690,29.5971979,3380,-755200,110080,-645120,80
1036,167,22,8,0.138819618,0.861180382,336.0344287,408.1642444,608.0868726,564.239521,1203,29.28432327,2406,-530432,85504,-444928,80
1437,202,22,8,0.123245882,0.876754118,462.0778429,538.0682785,831.7202505,736.6237624,1639,39.6660213,3278,-735744,103424,-632320,80
1513,219,22,8,0.126443418,0.873556582,489.2250883,553.5856586,884.172505,744.4063927,1732,38.86894075,3464,-774656,112128,-662528,80
1494,219,22,8,0.127845884,0.872154116,482.061752,569.1090274,865.1131191,801.652968,1713,40.27745121,3426,-764928,112128,-652800,80
1456,204,22,8,0.122891566,0.877108434,467.9435201,545.1932183,842.5947802,744.1764706,1660,41.16042648,3320,-745472,104448,-641024,80
1457,207,22,8,0.124399038,0.875600962,468.9494986,552.7509788,837.5085793,797.2463768,1664,30.27656477,3328,-745984,105984,-640000,80
1489,211,22,8,0.124117647,0.875882353,475.9946145,580.6938022,859.1719275,789.3033175,1700,37.32981994,3400,-762368,108032,-654336,80
1457,201,22,8,0.121230398,0.878769602,467.4562951,545.037088,841.4907344,742.5820896,1658,39.45740124,3316,-745984,102912,-643072,80
1486,201,22,8,0.119146414,0.880853586,478.1399341,540.223842,855.7072678,757.4477612,1687,39.01480111,3374,-760832,102912,-657920,80
1482,209,22,8,0.123595506,0.876404494,475.6387643,564.4265601,855.5323887,778.4066986,1691,37.8384426,3382,-758784,107008,-651776,80
1452,196,22,8,0.118932039,0.881067961,464.3187484,547.0966539,834.7348485,748.6785714,1648,36.9423896,3296,-743424,100352,-643072,80
1474,199,22,8,0.118947998,0.881052002,474.5757066,532.0968135,849.3744912,745.3417085,1673,42.01406328,3346,-754688,101888,-652800,80
1470,209,22,8,0.124478856,0.875521144,473.5577882,552.4159385,849.1734694,775.4784689,1679,39.14665423,3358,-752640,107008,-645632,80
1021,158,22,8,0.134011874,0.865988126,329.833432,398.5415517,597.2526934,543.1329114,1179,27.48251748,2358,-522752,80896,-441856,80
1014,181,22,8,0.151464435,0.848535565,341.8394205,357.2164613,607.6311637,544.0441989,1195,21.34690961,2390,-519168,92672,-426496,80
1445,201,22,8,0.122114216,0.877885784,462.9601944,550.8476156,832.3543253,759.8457711,1646,41.05762035,3292,-739840,102912,-636928,80
1472,207,22,8,0.123287671,0.876712329,473.9264672,549.5900487,850.3783967,766.1980676,1679,43.19526627,3358,-753664,105984,-647680,80
1474,211,22,8,0.125222552,0.874777448,474.6887351,558.1083251,851.3236092,784.8530806,1685,40.69065443,3370,-754688,108032,-646656,80
1456,206,22,8,0.123947052,0.876052948,468.673354,547.5946939,840.6442308,766.868932,1662,31.00746269,3324,-745472,105472,-640000,80
1457,207,22,8,0.124399038,0.875600962,468.6813757,551.4270314,841.566232,768.6859903,1664,42.71047228,3328,-745984,105984,-640000,80
1461,204,22,8,0.122522523,0.877477477,469.0011754,549.4107041,844.9527721,747.3970588,1665,43.33680375,3330,-748032,104448,-643584,80
1440,202,22,8,0.123020706,0.876979294,463.0452098,540.5835871,831.3805556,751.0643564,1642,38.72641509,3284,-737280,103424,-633856,80
1473,200,22,8,0.119545726,0.880454274,472.8886845,543.9137339,848.5756959,751.745,1673,37.68018018,3346,-754176,102400,-651776,80
1491,209,22,8,0.122941176,0.877058824,479.1057637,563.3650331,858.804829,791.2535885,1700,39.72890862,3400,-763392,107008,-656384,80
1457,199,22,8,0.120169082,0.879830918,466.7583576,548.0223323,838.6533974,754.160804,1656,39.93248131,3312,-745984,101888,-644096,80
1451,193,22,8,0.117396594,0.882603406,465.3112822,523.9784237,838.3962784,702.9896373,1644,31.24881201,3288,-742912,98816,-644096,80
1468,200,22,8,0.119904077,0.880095923,470.5820206,546.277215,847.153951,741.62,1668,35.93278759,3336,-751616,102400,-649216,80
1522,223,22,8,0.127793696,0.872206304,492.6816632,570.1341886,881.5341656,814.7533632,1745,44.42464358,3490,-779264,114176,-665088,80
1496,225,21,9,0.130737943,0.869262057,490.4432343,530.270782,873.0822193,780.6666667,1721,33.43695357,3442,-765952,115200,-650752,80
1480,210,22,8,0.124260355,0.875739645,476.3353548,560.3010739,851.9918919,799.747619,1690,39.94327582,3380,-757760,107520,-650240,80
1461,203,22,8,0.121995192,0.878004808,467.2616707,562.3077119,840.5790554,774.3546798,1664,39.85628743,3328,-748032,103936,-644096,80
1057,172,22,8,0.13995118,0.86004882,345.5630767,405.6706545,619.7161779,586.0174419,1229,31.76531403,2458,-541184,88064,-453120,80
1477,205,22,8,0.121878716,0.878121284,477.8042791,530.4850842,853.2186865,757.0682927,1682,40.55944056,3364,-756224,104960,-651264,80
1490,207,22,8,0.121979965,0.878020035,480.1752987,551.6958615,856.5798658,794.4396135,1697,39.4926693,3394,-762880,105984,-656896,80
1457,203,19,11,0.122289157,0.877710843,472.378257,514.8618977,844.2807138,731.591133,1660,30.29749954,3320,-745984,103936,-642048,80
1484,212,22,8,0.125,0.875,477.5758286,565.1060915,854.0330189,809.7688679,1696,42.82828283,3392,-759808,108544,-651264,80
1496,207,22,8,0.121550206,0.878449794,482.1931412,551.2835531,860.2733957,792.2077295,1703,36.69467787,3406,-765952,105984,-659968,80
1460,204,22,8,0.122596154,0.877403846,470.1726241,544.1687279,840.6657534,774.0588235,1664,39.60961676,3328,-747520,104448,-643072,80
1479,213,22,8,0.125886525,0.874113475,476.6308595,562.4833551,851.3678161,812.6995305,1692,43.25153374,3384,-757248,109056,-648192,80
1498,210,22,8,0.12295082,0.87704918,481.9649624,561.6962347,863.5480641,789.9571429,1708,31.18495527,3416,-766976,107520,-659456,80
1482,207,22,8,0.122557726,0.877442274,477.3181234,550.6320155,854.5850202,776.3768116,1689,40.79710145,3378,-758784,105984,-652800,80
1478,196,22,8,0.117084827,0.882915173,474.3500792,536.409789,849.958728,743.5510204,1674,30.24936755,3348,-756736,100352,-656384,80
1521,211,22,8,0.12182448,0.87817552,489.6695475,564.5064636,875.60881,800.8388626,1732,40.26970472,3464,-778752,108032,-670720,80
1016,147,22,8,0.126397248,0.873602752,328.0863206,376.6883158,592.3740157,510.2993197,1163,26.18779554,2326,-520192,75264,-444928,80
1504,208,22,8,0.121495327,0.878504673,485.9366525,546.5821499,864.8410904,796.1875,1712,37.56033348,3424,-770048,106496,-663552,80
470,79,22,8,0.143897996,0.856102004,153.9877814,177.7128212,281.7617021,234.7721519,549,6.46034361,1098,-240640,40448,-200192,80
467,73,22,8,0.135185185,0.864814815,151.1457879,167.6263056,281.2890792,201.4794521,540,8.617938079,1080,-239104,37376,-201728,80
1850,281,22,8,0.131862975,0.868137025,601.4185359,698.5753729,1062.715676,1087.622776,2131,49.69682836,4262,-947200,143872,-803328,80
1781,291,22,8,0.140444015,0.859555985,588.776146,648.5786256,1047.312184,970.3264605,2072,37.21932818,4144,-911872,148992,-762880,80
1836,277,22,8,0.131093232,0.868906768,596.0230947,695.2891165,1058.577342,1046.545126,2113,51.99311024,4226,-940032,141824,-798208,80
2202,332,22,8,0.131018153,0.868981847,717.7745825,816.7270017,1268.014532,1264.087349,2534,63.49285893,5068,-1127424,169984,-957440,80
1851,281,22,8,0.131801126,0.868198874,600.5349505,705.8971203,1066.84711,1064.213523,2132,51.81044957,4264,-947712,143872,-803840,80
1863,296,22,8,0.137100509,0.862899491,605.20693,726.509219,1078.340848,1090.442568,2159,55.8747412,4318,-953856,151552,-802304,80
1877,316,22,8,0.144094847,0.855905153,619.6714168,706.5840398,1102.324987,1065.370253,2193,38.73873874,4386,-961024,161792,-799232,80
885,142,22,8,0.138266796,0.861733204,294.1840226,300.9076556,525.3050847,443.5422535,1027,18.51451235,2054,-453120,72704,-380416,80
577,105,22,8,0.153958944,0.846041056,189.9051278,228.3084789,347.8786828,306.447619,682,15.19607843,1364,-295424,53760,-241664,80
2213,349,22,8,0.136221702,0.863778298,726.5161059,817.3741144,1284.38545,1263.203438,2562,51.77849636,5124,-1133056,178688,-954368,80
1917,304,22,8,0.136875281,0.863124719,624.6771533,736.5591407,1111.647887,1106.914474,2221,53.88161087,4442,-981504,155648,-825856,80
2189,344,22,8,0.135807343,0.864192657,714.6875129,828.4852114,1264.291,1284.238372,2533,45.77159378,5066,-1120768,176128,-944640,80
2219,332,22,8,0.130145041,0.869854959,723.9841854,814.492594,1277.927895,1263.114458,2551,53.90955199,5102,-1136128,169984,-966144,80
1877,306,22,8,0.140174072,0.859825928,613.1982751,725.2002434,1087.976026,1116.683007,2183,44.02985075,4366,-961024,156672,-804352,80
1396,244,22,8,0.148780488,0.851219512,459.2340698,547.4370045,818.3316619,832.9057377,1640,41.34106378,3280,-714752,124928,-589824,80
1827,293,22,8,0.138207547,0.861792453,597.893119,693.1885195,1057.589491,1078.648464,2120,53.02651326,4240,-935424,150016,-785408,80
1830,290,22,8,0.136792453,0.863207547,595.6178456,706.2626968,1063.786885,1039.758621,2120,52.13969503,4240,-936960,148480,-788480,80
2225,360,22,8,0.13926499,0.86073501,726.3492307,857.6734499,1286.046742,1335.975,2585,50.75593952,5170,-1139200,184320,-954880,80
1843,287,22,8,0.134741784,0.865258216,598.7025379,710.0208929,1065.729788,1064.02439,2130,50.36651691,4260,-943616,146944,-796672,80
523,94,22,8,0.152350081,0.847649919,170.7649908,208.2072502,317.4952199,261.7340426,617,9.693637078,1234,-267776,48128,-219648,80
1450,199,22,8,0.1206792,0.8793208,464.2589866,548.026038,835.6758621,747.2110553,1649,39.75409836,3298,-742400,101888,-640512,80
1472,203,22,8,0.12119403,0.87880597,472.0258039,555.2541609,847.3335598,770.320197,1675,38.24200913,3350,-753664,103936,-649728,80
1466,213,22,8,0.126861227,0.873138773,472.5140908,559.0488137,846.8826739,792.629108,1679,41.3546798,3358,-750592,109056,-641536,80
1470,225,22,8,0.132743363,0.867256637,473.9734892,579.2323389,850.8204082,829.5733333,1695,29.73162603,3390,-752640,115200,-637440,80
1456,221,22,8,0.131782946,0.868217054,468.6113858,575.1294102,843.1373626,811.7420814,1677,29.17536534,3354,-745472,113152,-632320,80
1461,212,22,8,0.12671847,0.87328153,469.7905389,561.7960291,845.6344969,777.495283,1673,35.36997886,3346,-748032,108544,-639488,80
1504,221,22,8,0.128115942,0.871884058,487.2259284,547.051563,882.7413564,728.6515837,1725,31.28967894,3450,-770048,113152,-656896,80
1470,207,22,8,0.123434705,0.876565295,471.4356932,564.158874,845.0088435,796.3285024,1677,41.74757282,3354,-752640,105984,-646656,80
1032,170,22,8,0.141430948,0.858569052,335.7682409,406.6696712,607.4515504,565.3705882,1202,31.34289439,2404,-528384,87040,-441344,80
1514,221,22,8,0.127377522,0.872622478,493.6636983,533.7238948,884.6783355,753.7420814,1735,33.33973866,3470,-775168,113152,-662016,80
1480,205,22,8,0.121661721,0.878338279,475.3499316,557.008142,850.3337838,790.0536585,1685,40.48534358,3370,-757760,104960,-652800,80
1012,157,22,8,0.134302823,0.865697177,331.0723436,373.8696417,590.8320158,547.4076433,1169,27.0164086,2338,-518144,80384,-437760,80
1454,206,22,8,0.124096386,0.875903614,467.5167883,551.2113023,838.7517194,772.2572816,1660,36.33180127,3320,-744448,105472,-638976,80
1455,204,22,8,0.122965642,0.877034358,467.7640034,548.8960017,837.5896907,775.8676471,1659,38.4651055,3318,-744960,104448,-640512,80
1478,212,22,8,0.125443787,0.874556213,476.3352136,556.8638504,855.3457375,776.8584906,1690,39.86789337,3380,-756736,108544,-648192,80
1462,213,22,8,0.127164179,0.872835821,471.6726385,553.2566452,848.0533516,768.9953052,1675,39.17212348,3350,-748544,109056,-639488,80
1463,205,22,8,0.122901679,0.877098321,469.1141773,556.0612336,845.2768284,757.5902439,1668,39.98082454,3336,-749056,104960,-644096,80
1456,217,22,8,0.129707113,0.870292887,468.2320266,570.9882149,841.7568681,805.0829493,1673,29.45941187,3346,-745472,111104,-634368,80
1443,195,22,8,0.119047619,0.880952381,463.6212032,519.1933699,836.5065835,693.6512821,1638,34.45519562,3276,-738816,99840,-638976,80
1453,203,22,8,0.122584541,0.877415459,465.5848154,554.133636,838.3179628,758.226601,1656,39.98068566,3312,-743936,103936,-640000,80
1478,206,22,8,0.122327791,0.877672209,474.9690773,555.1145728,851.8457375,775.4466019,1684,40.33532934,3368,-756736,105472,-651264,80
1468,200,22,8,0.119904077,0.880095923,469.5872063,553.2290816,846.6410082,745.385,1668,41.74174174,3336,-751616,102400,-649216,80
1456,211,22,8,0.126574685,0.873425315,468.5870508,557.8646431,841.6229396,781.3981043,1667,35.38526852,3334,-745472,108032,-637440,80
495,106,22,8,0.176372712,0.823627288,168.1801273,195.9497087,303.6181818,288.7735849,601,15.49368394,1202,-253440,54272,-199168,80
1022,169,22,8,0.141897565,0.858102435,332.248501,406.4231687,598.6643836,579.887574,1191,31.36686858,2382,-523264,86528,-436736,80
1035,167,22,8,0.138935108,0.861064892,336.4594286,405.2855209,605.5661836,576.2994012,1202,27.11482066,2404,-529920,85504,-444416,80
1467,206,22,8,0.123132098,0.876867902,471.9377729,550.8487735,846.0313565,772.684466,1673,42.4188641,3346,-751104,105472,-645632,80
1014,157,22,8,0.134073442,0.865926558,328.3972691,391.0261936,593.7140039,536.1783439,1171,30.25839793,2342,-519168,80384,-438784,80
1474,211,22,8,0.125222552,0.874777448,473.2191271,566.9497364,851.0881954,786.4976303,1685,37.10636424,3370,-754688,108032,-646656,80
1036,163,22,8,0.135946622,0.864053378,337.0394381,394.2535811,609.0135135,542.7116564,1199,31.31365892,2398,-530432,83456,-446976,80
1459,204,22,8,0.122669874,0.877330126,467.3489091,559.8869526,839.3673749,779.3088235,1663,41.83647799,3326,-747008,104448,-642560,80
1444,196,22,8,0.119512195,0.880487805,464.0747932,527.5012473,833.533241,724.4795918,1640,34.12401165,3280,-739328,100352,-638976,80
1484,204,22,8,0.120853081,0.879146919,479.1801476,533.6918324,857.1219677,752.6813725,1688,39.79255068,3376,-759808,104448,-655360,80
1193,147,22,8,0.109701493,0.890298507,379.9476687,413.957985,687.3746857,533.5510204,1340,29.4246816,2680,-610816,75264,-535552,80
1473,216,22,8,0.127886323,0.872113677,473.9229344,570.5950126,850.5532926,807.1296296,1689,38.89912483,3378,-754176,110592,-643584,80
1485,212,22,8,0.124926341,0.875073659,476.2087576,573.2094421,857.3845118,790.2688679,1697,40.61752034,3394,-760320,108544,-651776,80
999,158,22,8,0.136560069,0.863439931,324.0743873,386.6853094,587.4614615,525.5,1157,26.89446769,2314,-511488,80896,-430592,80
1466,205,22,8,0.122681029,0.877318971,470.6652227,556.1961704,843.3472033,783.4585366,1671,43.91590013,3342,-750592,104960,-645632,80
1033,162,22,8,0.135564854,0.864435146,335.5562101,395.7540548,606.2691191,545.2716049,1195,29.91239049,2390,-528896,82944,-445952,80
459,78,22,8,0.145251397,0.854748603,149.2135476,176.8206318,277.8278867,217.0512821,537,8.221065524,1074,-235008,39936,-195072,80
2107,122,22,8,0.0547330642,0.945266936,632.1430494,695.7690526,1138.83009,703.442623,2229,145.7815566,4458,-1078784,62464,-1016320,80
2126,117,22,8,0.0521622827,0.947837717,636.9553796,699.0724455,1144.516933,712.8461538,2243,196.5819457,4486,-1088512,59904,-1028608,80
2104,117,22,8,0.0526789734,0.947321027,630.349992,699.2751751,1133.248099,710.9145299,2221,38.80831732,4442,-1077248,59904,-1017344,80
2097,116,22,8,0.0524175328,0.947582467,628.5219899,682.3257083,1129.775393,695.2758621,2213,174.5268139,4426,-1073664,59392,-1014272,80
2096,116,22,8,0.0524412297,0.94755877,628.0153364,685.7220932,1129.267653,695.112069,2212,161.8141917,4424,-1073152,59392,-1013760,80
2130,119,22,8,0.0529124055,0.947087594,638.454399,718.6012728,1146.300469,743.7394958,2249,170.5079606,4498,-1090560,60928,-1029632,80
2111,117,22,8,0.052513465,0.947486535,632.7670197,689.6403616,1137.229749,704.3931624,2228,158.4637269,4456,-1080832,59904,-1020928,80
2107,116,22,8,0.0521817364,0.947818264,631.1175304,692.9740489,1134.539155,702.6034483,2223,121.4090661,4446,-1078784,59392,-1019392,80
2113,116,22,8,0.0520412741,0.947958726,633.1383783,690.7016732,1137.481779,705.4827586,2229,203.9341263,4458,-1081856,59392,-1022464,80
2105,123,22,8,0.0552064632,0.944793537,631.4754489,737.5852916,1134.556295,771.2601626,2228,103.7727061,4456,-1077760,62976,-1014784,80
2104,115,22,8,0.0518251465,0.948174854,630.5686951,671.9887084,1133.281844,684.0434783,2219,162.6832845,4438,-1077248,58880,-1018368,80
2111,116,22,8,0.0520880108,0.947911989,632.6340347,682.9342788,1136.993368,695.5603448,2227,139.6238245,4454,-1080832,59392,-1021440,80
2114,116,22,8,0.0520179372,0.947982063,633.405598,684.9283892,1138.537843,695.6551724,2230,150.3708699,4460,-1082368,59392,-1022976,80
2130,121,22,8,0.0537538872,0.946246113,638.2387308,745.2085851,1145.864789,776.3140496,2251,61.23503808,4502,-1090560,61952,-1028608,80
2122,117,22,8,0.0522554712,0.947744529,635.7679382,699.4472158,1142.419416,713.3846154,2239,178.4063745,4478,-1086464,59904,-1026560,80
2132,127,22,8,0.0562195662,0.943780434,639.4076821,695.3207092,1156.978893,677.0944882,2259,150.8010681,4518,-1091584,65024,-1026560,80
2095,116,22,8,0.052464948,0.947535052,627.884061,681.6873245,1128.864439,693.0603448,2211,178.7388844,4422,-1072640,59392,-1013248,80
2127,119,22,8,0.052983081,0.947016919,637.2715381,721.7371817,1144.891866,741.1428571,2246,191.4748508,4492,-1089024,60928,-1028096,80
2115,116,22,8,0.0519946212,0.948005379,633.7282176,684.4694032,1139.054374,695.6551724,2231,169.9162224,4462,-1082880,59392,-1023488,80
2105,116,22,8,0.0522287258,0.947771274,630.6404058,686.8956652,1133.870309,695.9827586,2221,126.2649233,4442,-1077760,59392,-1018368,80
5855,362,22,8,0.0582274409,0.941772559,1775.342593,2048.892217,3131.474979,2745.48895,6217,222.7517019,12434,-2997760,185344,-2812416,81
6103,410,22,8,0.062951021,0.937048979,1867.291967,2007.624039,3287.58037,2801.8,6513,199.7852761,13026,-3124736,209920,-2914816,81
5907,371,22,8,0.0590952533,0.940904747,1795.762956,2017.851128,3164.086169,2748.043127,6278,224.3745533,12556,-3024384,189952,-2834432,81
7172,421,22,8,0.0554458053,0.944554195,2171.488127,2482.093851,3819.942694,3406.15677,7593,238.9238515,15186,-3672064,215552,-3456512,81
5885,398,21,9,0.0633455356,0.936654464,1796.846438,2022.487571,3162.846389,2833.756281,6283,231.6740413,12566,-3013120,203776,-2809344,81
5868,399,22,8,0.0636668262,0.936333174,1789.42485,2036.687151,3160.931834,2737.919799,6267,204.737014,12534,-3004416,204288,-2800128,81
5958,378,22,8,0.0596590909,0.940340909,1810.296227,2093.735896,3180.365895,2981.470899,6336,182.5936599,12672,-3050496,193536,-2856960,81
5885,380,22,8,0.0606544294,0.939345571,1788.373951,2050.924617,3160.167375,2712.263158,6265,222.3207949,12530,-3013120,194560,-2818560,81
5908,389,22,8,0.0617754486,0.938224551,1796.388806,2097.728067,3166.865437,2877.66581,6297,216.3917526,12594,-3024896,199168,-2825728,81
6172,363,22,8,0.0555470543,0.944452946,1871.705956,2109.760678,3281.106935,3045.146006,6535,195.2494771,13070,-3160064,185856,-2974208,81
7174,417,22,8,0.0549334739,0.945066526,2171.652596,2491.467337,3811.134932,3535.621103,7591,240.0695762,15182,-3673088,213504,-3459584,81
5871,380,22,8,0.0607902736,0.939209726,1787.350895,2014.51062,3150.304548,2750.494737,6251,202.69131,12502,-3005952,194560,-2811392,81
5929,367,22,8,0.0582909784,0.941709022,1800.967424,2006.034243,3178.262439,2667.678474,6296,190.0392394,12592,-3035648,187904,-2847744,81
5941,347,22,8,0.0551844784,0.944815522,1792.476444,2165.365713,3139.113112,3236.729107,6288,198.7357775,12576,-3041792,177664,-2864128,81
7183,411,22,8,0.054121675,0.945878325,2168.211531,2566.910731,3809.265488,3591.875912,7594,230.190967,15188,-3677696,210432,-3467264,81
5438,329,22,8,0.0570487255,0.942951274,1657.483164,1667.232033,2920.833211,2275.18845,5767,101.3176388,11534,-2784256,168448,-2615808,81
5911,388,22,8,0.0615970789,0.938402921,1797.50683,2109.991687,3153.686686,3093.835052,6299,199.6513471,12598,-3026432,198656,-2827776,81
7220,409,22,8,0.0536112203,0.94638878,2181.422227,2479.409161,3846.100831,3265.982885,7629,247.3735409,15258,-3696640,209408,-3487232,81
5860,363,22,8,0.0583319942,0.941668006,1778.206436,2044.15346,3131.001706,2805.250689,6223,223.1265687,12446,-3000320,185856,-2814464,81
4493,230,21,9,0.0486978615,0.951302138,1347.948313,1471.339831,2397.765635,1663.326087,4723,59.4686477,9446,-2300416,117760,-2182656,81
1741,113,24,6,0.0609492988,0.939050701,523.0325397,553.7872312,954.05112,518.4247788,1854,33.0953231,3708,-891392,57856,-833536,81
9337,612,23,7,0.06151372,0.93848628,2841.383563,3246.454765,4935.839884,5572.447712,9949,712.1689334,19898,-4780544,313344,-4467200,81
9300,648,24,6,0.0651387214,0.934861279,2848.604038,3179.888039,4961.963441,5154.42284,9948,631.6190476,19896,-4761600,331776,-4429824,81
9334,619,23,7,0.0621923038,0.937807696,2852.143986,3172.205889,4971.006535,5067.376414,9953,497.8989495,19906,-4779008,316928,-4462080,81
9319,627,23,7,0.0630404183,0.936959582,2831.04783,3321.699182,4922.647709,5729.30941,9946,504.3610548,19892,-4771328,321024,-4450304,81
9300,647,23,7,0.0650447371,0.934955263,2830.478837,3352.918383,4933.566452,5555.193199,9947,618.5945274,19894,-4761600,331264,-4430336,81
9366,581,24,6,0.0584095707,0.941590429,2850.991234,3097.663708,4929.883622,5685.177281,9947,1021.252567,19894,-4795392,297472,-4497920,81
9296,651,24,6,0.0654468684,0.934553132,2846.392307,3133.929451,4927.598967,5636.58679,9947,602.1186441,19894,-4759552,333312,-4426240,81
9336,612,22,8,0.0615199035,0.938480097,2845.668794,3242.542535,4969.293702,5053.921569,9948,1039.498433,19896,-4780032,313344,-4466688,81
2833,154,23,7,0.0515567459,0.948443254,851.0685314,920.9391046,1520.391458,1008.5,2987,52.13824402,5974,-1450496,78848,-1371648,81
9326,625,24,6,0.062807758,0.937192242,2845.770771,3246.318452,4972.397598,5029.7536,9951,808.3671812,19902,-4774912,320000,-4454912,81
9307,643,24,6,0.0646231156,0.935376884,2837.055734,3329.794028,4956.995165,5243.345257,9950,1104.328524,19900,-4765184,329216,-4435968,81
9423,535,23,7,0.0537256477,0.946274352,2863.408954,2998.2344,4944.230075,5600.71215,9958,605.3495441,19916,-4824576,273920,-4550656,81
9321,627,23,7,0.0630277443,0.936972256,2847.009756,3194.738887,4949.877374,5340.54067,9948,764.6425826,19896,-4772352,321024,-4451328,81
9331,613,24,6,0.0616452132,0.938354787,2849.701787,3073.299691,4922.654485,5731.241436,9944,860.952381,19888,-4777472,313856,-4463616,81
9367,574,24,6,0.05774067,0.94225933,2852.542112,3047.024178,4926.687093,5694.134146,9941,576.2898551,19882,-4795904,293888,-4502016,81
9369,580,24,6,0.0582973163,0.941702684,2842.558786,3246.318774,4935.589924,5611.608621,9949,721.988389,19898,-4796928,296960,-4499968,81
9315,634,24,6,0.0637249975,0.936275003,2853.555056,3122.951939,4960.304455,5190.913249,9949,921.2037037,19898,-4769280,324608,-4444672,81
9324,623,23,7,0.0626319493,0.937368051,2845.516786,3150.986623,4926.658945,5682.520064,9947,322.4311183,19894,-4773888,318976,-4454912,81
9276,672,23,7,0.0675512666,0.932448733,2835.893547,3312.952698,4952.888098,5272.821429,9948,388.1388997,19896,-4749312,344064,-4405248,81
3709,283,24,6,0.0708917836,0.929108216,1145.592152,1217.640636,1980.034241,2212.300353,3992,142.418837,7984,-1899008,144896,-1754112,81
528,71,24,6,0.118530885,0.881469115,170.6253937,133.6494956,316.8863636,174.4225352,599,15.15304832,1198,-270336,36352,-233984,81
3606,288,24,6,0.0739599384,0.926040062,1126.148739,1069.527556,1966.639767,1707.854167,3894,82.92163543,7788,-1846272,147456,-1698816,81
3653,301,24,6,0.0761254426,0.923874557,1126.10082,1303.767976,1965.067342,2128.385382,3954,145.2074917,7908,-1870336,154112,-1716224,81
3697,271,24,6,0.068296371,0.931703629,1135.974865,1247.279266,1968.414931,2203.933579,3968,144.1860465,7936,-1892864,138752,-1754112,81
3688,247,24,6,0.0627700127,0.937229987,1127.244145,1257.039118,1963.930043,2028.769231,3935,150.3055768,7870,-1888256,126464,-1761792,81
3670,298,24,6,0.0751008065,0.924899194,1129.367565,1310.18665,1967.676022,2191.694631,3968,138.2578397,7936,-1879040,152576,-1726464,81
3654,279,24,6,0.0709382151,0.929061785,1126.508002,1235.971968,1955.689929,2115.125448,3933,106.2972973,7866,-1870848,142848,-1728000,81
3674,285,24,6,0.0719878757,0.928012124,1131.690154,1262.70391,1965.170659,2171.168421,3959,120.9224191,7918,-1881088,145920,-1735168,81
3680,300,23,7,0.0753768844,0.924623116,1136.637791,1281.577174,1978.836957,2133.566667,3980,125.8697027,7960,-1884160,153600,-1730560,81
3781,286,22,8,0.0703221047,0.929677895,1165.590673,1225.55592,2006.927797,2391.902098,4067,112.8468368,8134,-1935872,146432,-1789440,81
3715,290,24,6,0.0724094881,0.927590512,1145.030332,1262.928106,1983.208883,2256.531034,4005,153.213466,8010,-1902080,148480,-1753600,81
3681,298,23,7,0.0748931892,0.925106811,1136.036653,1267.897766,1969.779136,2239.775168,3979,137.0651051,7958,-1884672,152576,-1732096,81
3683,281,23,7,0.0708879919,0.929112008,1135.159382,1237.005098,1965.634266,2203.55516,3964,146.2730627,7928,-1885696,143872,-1741824,81
3672,287,23,7,0.0724930538,0.927506946,1132.467998,1241.398159,1960.409041,2230.655052,3959,149.3962264,7918,-1880064,146944,-1733120,81
3682,291,23,7,0.0732443997,0.9267556,1135.453435,1278.492651,1978.808528,2090.646048,3973,106.772373,7946,-1885184,148992,-1736192,81
3735,301,23,7,0.0745787909,0.925421209,1151.730775,1309.234238,2005.646854,2177.990033,4036,131.08152,8072,-1912320,154112,-1758208,81
3733,305,24,6,0.0755324418,0.924467558,1150.852065,1330.838884,2012.567372,2104.35082,4038,146.569873,8076,-1911296,156160,-1755136,81
3683,282,24,6,0.0711223203,0.92887768,1134.059736,1233.656636,1959.457507,2290.471631,3965,133.9979723,7930,-1885696,144384,-1741312,81
2441,159,23,7,0.0611538462,0.938846154,735.9674401,901.2916551,1318.783695,1019.805031,2600,35.59206023,5200,-1249792,81408,-1168384,81
1069,123,23,7,0.103187919,0.896812081,331.8355999,428.8306515,605.3264733,519.7886179,1192,100.6756757,2384,-547328,62976,-484352,81
1057,124,23,7,0.104995766,0.895004234,329.7990621,420.485572,597.1135289,538.8870968,1181,92.55485893,2362,-541184,63488,-477696,81
1086,126,22,8,0.103960396,0.896039604,338.3229366,428.7132576,615.7762431,526.547619,1212,98.61676159,2424,-556032,64512,-491520,81
1084,100,23,7,0.0844594595,0.915540541,335.6202211,402.5731083,591.7573801,600.55,1184,72.77197296,2368,-555008,51200,-503808,81
1108,105,23,7,0.0865622424,0.913437758,341.895463,427.495785,608.3935018,592.2952381,1213,80.65159574,2426,-567296,53760,-513536,81
1108,126,23,7,0.102106969,0.897893031,344.1057408,437.3461223,628.4151625,521.515873,1234,86.90140845,2468,-567296,64512,-502784,81
1078,119,23,7,0.0994152047,0.900584795,335.1065741,423.1941422,606.1539889,534.1932773,1197,105.6487202,2394,-551936,60928,-491008,81
1111,135,23,7,0.108346709,0.891653291,345.4779147,443.1843891,637.7551755,506.1851852,1246,85.81267218,2492,-568832,69120,-499712,81
1078,101,23,7,0.0856658185,0.914334182,332.6642088,413.5579287,590.0083488,589.9108911,1179,93.72019078,2358,-551936,51712,-500224,81
1085,121,21,9,0.100331675,0.899668325,338.8389036,421.0955308,607.1493088,570.7768595,1206,72.25883763,2412,-555520,61952,-493568,81
1084,128,23,7,0.105610561,0.894389439,340.8923438,417.0301903,610.1023985,575.9921875,1212,100.6644518,2424,-555008,65536,-489472,81
1056,121,23,7,0.102803738,0.897196262,328.3501222,421.1968365,596.3835227,524.5619835,1177,106.5158371,2354,-540672,61952,-478720,81
1077,126,23,7,0.104738155,0.895261845,335.5179247,429.701528,609.4921077,537.9603175,1203,110.0640439,2406,-551424,64512,-486912,81
879,91,24,6,0.093814433,0.906185567,266.5709075,296.0718837,509.9852105,248.989011,970,19.87297685,1940,-450048,46592,-403456,81
1092,99,22,8,0.0831234257,0.916876574,338.6761901,394.6918013,593.1373626,627.5757576,1191,87.70250368,2382,-559104,50688,-508416,81
52,44,23,7,0.458333333,0.541666667,33.0505709,19.16727152,51.07692308,45.45454545,96,2.361042794,192,-26624,22528,-4096,81
1074,125,22,8,0.104253545,0.895746455,335.0785538,425.9025253,606.0726257,547.824,1199,102.7420737,2398,-549888,64000,-485888,81
1087,130,23,7,0.106820049,0.893179951,335.9762654,449.4619716,620.0579577,516.5384615,1217,44.36748086,2434,-556544,66560,-489984,81
1038,117,23,7,0.101298701,0.898701299,321.5744054,416.1606907,586.8188825,499.7606838,1155,126.6447368,2310,-531456,59904,-471552,81
947,119,23,7,0.11163227,0.88836773,291.5429191,392.4238137,549.3389652,407.4537815,1066,16.54252017,2132,-484864,60928,-423936,81
913,120,23,7,0.116166505,0.883833495,289.0285723,352.0879127,526.5235487,444.5416667,1033,100.6822612,2066,-467456,61440,-406016,81
867,96,23,7,0.0996884735,0.900311526,274.8625021,304.8210112,481.9365629,482.5729167,963,79.45544554,1926,-443904,49152,-394752,81
904,117,21,9,0.114593536,0.885406464,286.1663213,346.9705408,519.5685841,444.7948718,1021,95.24253731,2042,-462848,59904,-402944,81
913,122,22,8,0.117874396,0.882125604,291.5727869,345.8580667,522.837897,481.795082,1035,76.72349889,2070,-467456,62464,-404992,81
865,119,23,7,0.120934959,0.879065041,274.0004045,339.470564,502.6878613,418.4453782,984,95.34883721,1968,-442880,60928,-381952,81
894,112,23,7,0.111332008,0.888667992,281.4918304,348.4622116,510.5939597,446.875,1006,78.96389325,2012,-457728,57344,-400384,81
889,125,23,7,0.123274162,0.876725838,281.5560278,351.7674596,518.920135,426.28,1014,81.51125402,2028,-455168,64000,-391168,81
882,126,22,8,0.125,0.875,280.3254088,347.4615349,515.3310658,428.6825397,1008,89.44099379,2016,-451584,64512,-387072,81
876,124,22,8,0.124,0.876,277.7717214,345.8552305,511.8573059,420.266129,1000,93.6329588,2000,-448512,63488,-385024,81
892,128,21,9,0.125490196,0.874509804,280.9498303,363.8158425,522.8464126,424.4609375,1020,61.11443978,2040,-456704,65536,-391168,81
877,101,21,9,0.103271984,0.896728016,276.0731136,331.3013262,491.2428734,474.3663366,978,88.10810811,1956,-449024,51712,-397312,81
884,97,23,7,0.0988786952,0.901121305,276.3660763,339.0997183,490.7205882,493.5463918,981,45.79831933,1962,-452608,49664,-402944,81
918,129,23,7,0.123209169,0.876790831,290.3676251,360.4889441,538.0969499,423.6821705,1047,93.14946619,2094,-470016,66048,-403968,81
894,116,23,7,0.114851485,0.885148515,281.4218771,358.0767919,510.3310962,468.2672414,1010,39.81080016,2020,-457728,59392,-398336,81
899,97,23,7,0.0973895582,0.902610442,283.9355462,318.1176199,500.6863181,478.2371134,996,87.52196837,1992,-460288,49664,-410624,81
901,100,22,8,0.0999000999,0.9000999,284.089319,328.0058858,497.5405105,532.17,1001,59.26583777,2002,-461312,51200,-410112,81
913,129,23,7,0.123800384,0.876199616,288.4107485,356.1081279,537.8751369,405.6046512,1042,82.04724409,2084,-467456,66048,-401408,81
886,100,23,7,0.101419878,0.898580122,278.5399355,333.2227687,491.4029345,512.08,986,69.48555321,1972,-453632,51200,-402432,81
912,132,23,7,0.126436782,0.873563218,294.1007674,342.9936861,530.0537281,470.3106061,1044,62.85370259,2088,-466944,67584,-399360,81
885,110,23,7,0.110552764,0.889447236,281.4280129,324.7344426,505.0350282,441.4,995,107.4514039,1990,-453120,56320,-396800,81
3670,298,22,8,0.0751008065,0.924899194,1130.00041,1310.995274,1971.743052,2141.607383,3968,135.3804162,7936,-1879040,152576,-1726464,81
3763,296,22,8,0.0729243656,0.927075634,1160.769054,1276.375562,2010.117725,2282.760135,4059,145.1716738,8118,-1926656,151552,-1775104,81
3697,300,23,7,0.0750562922,0.924943708,1144.281913,1255.81869,1986.713281,2150.413333,3997,124.633614,7994,-1892864,153600,-1739264,81
3693,268,24,6,0.0676596819,0.932340318,1135.586271,1223.059373,1964.081235,2214.13806,3961,140.6605114,7922,-1890816,137216,-1753600,81
3703,305,24,6,0.0760978044,0.923902196,1143.701956,1304.761115,1997.41885,2090.472131,4008,141.4754677,8016,-1895936,156160,-1739776,81
3425,255,23,7,0.0692934783,0.930706522,1054.449856,1160.490699,1845.912701,1767.8,3680,75.10204082,7360,-1753600,130560,-1623040,81
3747,291,24,6,0.0720653789,0.927934621,1153.146241,1309.185509,2009.254337,2151.426117,4038,127.4218997,8076,-1918464,148992,-1769472,81
3693,284,24,6,0.071410611,0.928589389,1139.396436,1238.25242,1973.722448,2187.661972,3977,137.4222529,7954,-1890816,145408,-1745408,81
3686,285,24,6,0.0717703349,0.928229665,1136.70369,1227.040265,1963.325556,2279.25614,3971,134.4278944,7942,-1887232,145920,-1741312,81
3694,303,24,6,0.0758068551,0.924193145,1138.563928,1323.44872,1992.597455,2077.056106,3997,150.9441088,7994,-1891328,155136,-1736192,81
3674,270,24,6,0.0684584178,0.931541582,1126.805889,1281.793296,1963.867447,2089.966667,3944,138.2404487,7888,-1881088,138240,-1742848,81
3669,291,23,7,0.0734848485,0.926515152,1128.481561,1302.778214,1967.322704,2146.642612,3960,146.3955638,7920,-1878528,148992,-1729536,81
3644,285,23,7,0.0725375414,0.927462459,1121.10427,1289.916064,1966.305982,1948.301754,3929,140.1212553,7858,-1865728,145920,-1719808,81
3703,307,24,6,0.0765586035,0.923441397,1148.609519,1259.406093,2000.694032,2063.469055,4010,145.9243086,8020,-1895936,157184,-1738752,81
3697,306,23,7,0.076442668,0.923557332,1140.249015,1325.371011,1997.23208,2059.604575,4003,154.1393916,8006,-1892864,156672,-1736192,81
3658,285,24,6,0.0722799899,0.92772001,1128.102886,1225.494341,1949.63532,2259.052632,3943,153.6034281,7886,-1872896,145920,-1726976,81
3629,310,23,7,0.0787001777,0.921299822,1123.444645,1280.12536,1959.829705,2089.058065,3939,127.7651638,7878,-1858048,158720,-1699328,81
3900,321,24,6,0.0760483298,0.92395167,1211.561425,1269.092083,2133.227179,1840.950156,4221,124.8816568,8442,-1996800,164352,-1832448,81
3760,301,24,6,0.074119675,0.925880325,1159.082578,1321.099617,2021.814628,2145.740864,4061,128.7571338,8122,-1925120,154112,-1771008,81
3672,293,23,7,0.0738965952,0.926103405,1129.143249,1311.001834,1969.320806,2154.433447,3965,104.2597949,7930,-1880064,150016,-1730048,81
1590,174,23,7,0.0986394558,0.901360544,504.7799116,546.3519394,887.1176101,840.3045977,1764,125.5516014,3528,-814080,89088,-724992,81
1612,191,23,7,0.105934554,0.894065446,511.4429283,578.0826934,915.9199752,784.5183246,1803,171.3878327,3606,-825344,97792,-727552,81
1627,184,23,7,0.101601325,0.898398675,515.7798243,571.2538831,917.4259373,804.9673913,1811,144.4178628,3622,-833024,94208,-738816,81
1585,201,22,8,0.112541993,0.887458007,505.1779042,574.5116559,910.1526814,762.1840796,1786,141.1857708,3572,-811520,102912,-708608,81
1436,163,23,7,0.101938712,0.898061288,453.7162998,520.2781,791.7513928,872.6687117,1599,28.19608535,3198,-735232,83456,-651776,81
1484,194,23,7,0.115613826,0.884386174,472.1139451,557.6082981,853.828841,729.8917526,1678,86.58410733,3356,-759808,99328,-660480,81
1495,172,23,7,0.103179364,0.896820636,475.9399668,523.2384861,838.5371237,794.5639535,1667,126.6717325,3334,-765440,88064,-677376,81
1598,177,23,7,0.0997183099,0.90028169,507.0111173,554.5040261,895.1727159,823.2429379,1775,114.738203,3550,-818176,90624,-727552,81
1595,188,23,7,0.105440269,0.894559731,506.9265866,561.2143561,906.707837,767.2180851,1783,103.5423926,3566,-816640,96256,-720384,81
1532,199,21,9,0.114962449,0.885037551,487.1913787,575.2268944,880.3655352,755.4070352,1731,104.5289855,3462,-784384,101888,-682496,81
1495,167,23,7,0.100481348,0.899518652,476.4714776,507.237602,827.8267559,864.3832335,1662,59.31477516,3324,-765440,85504,-679936,81
1621,163,23,7,0.091367713,0.908632287,512.7438054,535.9847793,895.4762492,862.9018405,1784,140.3619197,3568,-829952,83456,-746496,81
1608,191,21,9,0.106170094,0.893829906,509.957465,578.8784254,914.1094527,781.2146597,1799,157.530648,3598,-823296,97792,-725504,81
1564,187,23,7,0.106796117,0.893203883,502.1716041,529.3883626,882.2365729,823.8395722,1751,89.47368421,3502,-800768,95744,-705024,81
1536,174,23,7,0.101754386,0.898245614,490.8181962,517.5601814,853.703125,871.362069,1710,88.50931677,3420,-786432,89088,-697344,81
1483,177,23,7,0.106626506,0.893373494,470.8773727,542.572419,834.8745786,793.8474576,1660,113.3105802,3320,-759296,90624,-668672,81
1533,184,23,7,0.107163658,0.892836342,484.9725039,569.5457852,869.4990215,771.5271739,1717,149.8254799,3434,-784896,94208,-690688,81
1458,173,23,7,0.106069896,0.893930104,467.2740042,499.7778413,815.6694102,818.7861272,1631,93.14677327,3262,-746496,88576,-657920,81
1629,190,23,7,0.104452996,0.895547004,516.2074247,595.4291204,912.6709638,887.1,1819,32.26893738,3638,-834048,97280,-736768,81
708,92,22,8,0.115,0.885,218.3213501,241.4476484,424.5367232,215.5217391,800,18.57872736,1600,-362496,47104,-315392,81
1243,128,23,7,0.0933625091,0.906637491,396.6988857,386.4300443,687.3411102,672.9765625,1371,44.78928455,2742,-636416,65536,-570880,81
1213,126,23,7,0.0941000747,0.905899925,387.1742533,380.3147677,670.3940643,666.2063492,1339,43.93044619,2678,-621056,64512,-556544,81
1214,130,23,7,0.0967261905,0.90327381,386.4317331,400.541938,668.8509061,706.5769231,1344,51.49425287,2688,-621568,66560,-555008,81
1202,125,23,7,0.0941974378,0.905802562,381.3092828,398.7398069,661.3710483,689.28,1327,47.2073995,2654,-615424,64000,-551424,81
1214,130,23,7,0.0967261905,0.90327381,386.0764701,404.91944,670.6721582,689.5692308,1344,49.42993748,2688,-621568,66560,-555008,81
1199,124,23,7,0.0937263794,0.906273621,381.0595759,387.9374751,657.9507923,701.1532258,1323,44.0266223,2646,-613888,63488,-550400,81
1201,132,23,7,0.0990247562,0.900975244,383.4520666,396.0730499,664.3422148,691.1818182,1333,45.47935858,2666,-614912,67584,-547328,81
1208,130,23,7,0.0971599402,0.90284006,384.7758941,398.3652723,666.2127483,700.0461538,1338,48.26839827,2676,-618496,66560,-551936,81
1202,127,23,7,0.0955605719,0.904439428,381.7138228,400.3866601,661.9916805,693.4724409,1329,49.44196429,2658,-615424,65024,-550400,81
1212,139,23,7,0.102886751,0.897113249,385.5384342,426.4745163,673.8556106,694.6978417,1351,50.41044776,2702,-620544,71168,-549376,81
1197,138,24,6,0.103370787,0.896629213,382.6882653,407.3552614,670.4920635,646.384058,1335,47.76386404,2670,-612864,70656,-542208,81
1202,146,21,9,0.108308605,0.891691395,383.1985354,433.9801056,671.2013311,701.6575342,1348,48.69942197,2696,-615424,74752,-540672,81
1246,138,23,7,0.0997109827,0.900289017,397.0161282,420.056579,696.1805778,659.2681159,1384,55.22745411,2768,-637952,70656,-567296,81
1209,134,23,7,0.0997766195,0.90022338,384.989626,405.2217545,664.6170389,738.6119403,1343,47.91295041,2686,-619008,68608,-550400,81
1200,140,23,7,0.104477612,0.895522388,383.9469504,410.5099763,671.74,659.8714286,1340,44.68156052,2680,-614400,71680,-542720,81
1254,147,22,8,0.104925054,0.895074946,399.6711044,440.0928477,706.6052632,653.1836735,1401,45.60546875,2802,-642048,75264,-566784,81
1204,133,23,7,0.0994764398,0.90052356,383.6699995,406.0746067,669.3646179,665.6992481,1337,43.80733945,2674,-616448,68096,-548352,81
249,29,21,9,0.104316547,0.895683453,77.26522212,87.13417155,145.4216867,88.65517241,278,16.2668227,556,-127488,14848,-112640,81
902,72,23,7,0.0739219713,0.926078029,276.5608933,316.7571944,495.5277162,386.9305556,974,22.83704572,1948,-461824,36864,-424960,81
1241,137,23,7,0.0994194485,0.900580552,396.643706,406.4457659,693.3086221,655,1378,41.92272589,2756,-635392,70144,-565248,81
3194,278,22,8,0.0800691244,0.919930876,984.1875558,1184.27541,1746.717595,1619.107914,3472,140.9090909,6944,-1635328,142336,-1492992,81
3230,260,22,8,0.0744985673,0.925501433,990.1482099,1200.890814,1749.664087,1693.769231,3490,132.5987842,6980,-1653760,133120,-1520640,81
3203,271,21,9,0.0780080599,0.92199194,986.7195385,1176.452889,1740.273806,1704.715867,3474,112.6824522,6948,-1639936,138752,-1501184,81
3208,259,21,9,0.0747043554,0.925295645,987.4941845,1152.695483,1737.068267,1695.996139,3467,125.4795512,6934,-1642496,132608,-1509888,81
3184,269,22,8,0.0779032725,0.922096727,982.954629,1146.763206,1731.34108,1675.6171,3453,106.1808118,6906,-1630208,137728,-1492480,81
3211,283,21,9,0.0809959931,0.919004007,990.5734003,1179.223838,1763.614139,1564.664311,3494,132.7003418,6988,-1644032,144896,-1499136,81
3124,267,21,9,0.0787378354,0.921262165,966.8881711,1109.713757,1697.104033,1683.082397,3391,118.8573431,6782,-1599488,136704,-1462784,81
3239,280,22,8,0.0795680591,0.920431941,998.2636132,1194.495318,1770.096326,1643.207143,3519,131.5022422,7038,-1658368,143360,-1515008,81
3223,277,22,8,0.0791428571,0.920857143,996.6490975,1153.720263,1758.752715,1654.476534,3500,125.0446588,7000,-1650176,141824,-1508352,81
3148,268,22,8,0.0784543326,0.921545667,972.4948454,1132.726404,1712.734117,1658.764925,3416,128.1801126,6832,-1611776,137216,-1474560,81
3189,291,22,8,0.0836206897,0.91637931,985.447659,1188.480102,1750.896519,1626.56701,3480,130.9255079,6960,-1632768,148992,-1483776,81
3264,286,22,8,0.0805633803,0.91943662,1018.253417,1030.571903,1807.015012,1415.832168,3550,141.3216561,7100,-1671168,146432,-1524736,81
3181,275,22,8,0.0795717593,0.920428241,981.3441894,1160.67735,1740.712355,1587.236364,3456,129.1479821,6912,-1628672,140800,-1487872,81
1987,142,22,8,0.0666979803,0.93330202,601.040106,752.5567345,1079.124308,867.3591549,2129,82.45546088,4258,-1017344,72704,-944640,81
3200,257,22,8,0.074341915,0.925658085,985.1514189,1144.809475,1731.827812,1693.789883,3457,119.4953336,6914,-1638400,131584,-1506816,81
3181,291,22,8,0.0838133641,0.916186636,982.7858075,1187.056923,1748.400817,1606.408935,3472,113.3899412,6944,-1628672,148992,-1479680,81
3171,283,22,8,0.0819339896,0.91806601,980.6266329,1162.551676,1734.828445,1645.385159,3454,118.8166495,6908,-1623552,144896,-1478656,81
3173,264,22,8,0.0768111725,0.923188827,978.7527799,1140.472722,1722.31642,1679.140152,3437,130.4859529,6874,-1624576,135168,-1489408,81
3220,268,22,8,0.0768348624,0.923165138,993.6707841,1151.798001,1750.247205,1675.447761,3488,95.01498229,6976,-1648640,137216,-1511424,81
3238,288,21,9,0.0816789563,0.918321044,1000.318412,1184.821484,1778.379555,1596.208333,3526,116.9485904,7052,-1657856,147456,-1510400,81
1108,147,20,10,0.117131474,0.882868526,358.5565829,389.1439242,626.8276173,636.8367347,1255,47.21595184,2510,-567296,75264,-492032,81
1135,165,19,11,0.126923077,0.873076923,368.8143997,415.4068215,645.5057269,684.8545455,1300,22.8631727,2600,-581120,84480,-496640,81
1094,148,20,10,0.119162641,0.880837359,355.2249084,382.083482,620.9305302,625.7094595,1242,41.1122145,2484,-560128,75776,-484352,81
1137,142,20,10,0.111024238,0.888975762,366.592548,389.1652737,637.8830255,656.9507042,1279,46.49218466,2558,-582144,72704,-509440,81
1104,143,19,11,0.114675221,0.885324779,356.7779662,383.4303553,621.9918478,639.5034965,1247,41.27772261,2494,-565248,73216,-492032,81
1130,147,20,10,0.115113547,0.884886453,365.6723832,390.5468143,637.7318584,648.7482993,1277,44.5413324,2554,-578560,75264,-503296,81
1106,155,20,10,0.122918319,0.877081681,357.8519931,404.8850334,628.562387,648.3935484,1261,47.40601504,2522,-566272,79360,-486912,81
1110,157,20,10,0.123914759,0.876085241,361.1371599,394.5974584,628.4153153,673.4840764,1267,47.24086503,2534,-568320,80384,-487936,81
1108,147,20,10,0.117131474,0.882868526,358.7944784,387.4621385,629.2969314,618.2244898,1255,46.15667525,2510,-567296,75264,-492032,81
1097,149,20,10,0.119582665,0.880417335,356.0463928,384.1626721,619.4886053,653.033557,1246,22.03749558,2492,-561664,76288,-485376,81
1095,144,20,10,0.11622276,0.88377724,355.4932882,372.3033685,615.8767123,651.3541667,1239,38.46631481,2478,-560640,73728,-486912,81
694,63,20,10,0.0832232497,0.91677675,212.8181067,240.4925501,390.3472622,254,757,53.34742777,1514,-355328,32256,-323072,81
1127,143,20,10,0.112598425,0.887401575,364.2818186,382.4155161,630.689441,673.4125874,1270,49.16763453,2540,-577024,73216,-503808,81
1102,151,20,10,0.120510774,0.879489226,357.2593906,392.5141921,625.6025408,637.1986755,1253,41.06850213,2506,-564224,77312,-486912,81
1097,143,20,10,0.115322581,0.884677419,355.0232648,378.6769813,617.0683683,646.8251748,1240,43.94046775,2480,-561664,73216,-488448,81
1100,153,20,10,0.122106943,0.877893057,357.3838636,390.5669835,623.6609091,651.0065359,1253,36.57326328,2506,-563200,78336,-484864,81
1113,147,20,10,0.116666667,0.883333333,359.9094122,388.6758061,624.7214735,674.2517007,1260,47.43975904,2520,-569856,75264,-494592,81
1105,157,20,10,0.124405705,0.875594295,358.172526,404.4013215,628.9149321,649.6942675,1262,22.26534933,2524,-565760,80384,-485376,81
1098,147,20,10,0.118072289,0.881927711,356.429822,378.1337562,617.284153,665.6938776,1245,43.47067039,2490,-562176,75264,-486912,81
1067,127,20,10,0.106365159,0.893634841,342.3257116,363.8406989,597.4901593,597.5826772,1194,37.91679898,2388,-546304,65024,-481280,81
34,16,20,10,0.32,0.68,13.86592373,15.51612065,25.02941176,26.5,50,6.501950585,100,-17408,8192,-9216,82
7899,588,23,7,0.069282432,0.930717568,2434.627595,2615.582285,4214.482213,4640.532313,8487,198.7122454,16974,-4044288,301056,-3743232,82
34,16,20,10,0.32,0.68,13.86592373,15.51612065,25.02941176,26.5,50,8.361204013,100,-17408,8192,-9216,82
8775,844,23,7,0.0877430086,0.912256991,2729.507586,3202.402171,4773.194074,5192.668246,9619,181.3536953,19238,-4492800,432128,-4060672,82
35,16,20,10,0.31372549,0.68627451,14.10850084,15.91726657,25.48571429,27.125,51,5.549510337,102,-17920,8192,-9728,82
9056,866,23,7,0.0872807902,0.91271921,2837.781542,3060.938681,4902.871466,5574.594688,9922,594.8441247,19844,-4636672,443392,-4193280,82
1470,89,24,6,0.0570878768,0.942912123,442.6559211,476.5378333,797.0789116,497.9101124,1559,27.98420391,3118,-752640,45568,-707072,82
35,15,21,9,0.3,0.7,13.72130773,15.84452236,24.8,27.13333333,50,5.500550055,100,-17920,7680,-10240,82
7677,606,22,8,0.0731618979,0.926838102,2377.625939,2550.668212,4129.938908,4294.793729,8283,208.0110497,16566,-3930624,310272,-3620352,82
5456,280,22,8,0.0488145049,0.951185495,1649.134881,1738.772477,2887.905609,2490.367857,5736,279.2599805,11472,-2793472,143360,-2650112,82
8371,782,24,6,0.0854364689,0.914563531,2619.762952,2842.037042,4540.105125,4971.945013,9153,187.599918,18306,-4285952,400384,-3885568,82
34,16,20,10,0.32,0.68,13.90290104,15.45141074,25.05882353,26.4375,50,7.052186178,100,-17408,8192,-9216,82
8066,691,21,9,0.0789083019,0.921091698,2487.584043,2870.880915,4320.25874,5064.683068,8757,170.7683307,17514,-4129792,353792,-3776000,82
35,15,21,9,0.3,0.7,13.72130773,15.84452236,24.8,27.13333333,50,7.987220447,100,-17920,7680,-10240,82
5263,270,22,8,0.0487981204,0.95120188,1593.009727,1640.112528,2784.635759,2423.233333,5533,97.80802546,11066,-2694656,138240,-2556416,82
7981,624,23,7,0.0725159791,0.927484021,2469.289644,2644.448974,4277.746523,4625.99359,8605,185.292851,17210,-4086272,319488,-3766784,82
1810,154,22,8,0.0784114053,0.921588595,559.4340136,636.720291,992.7132597,862.461039,1964,31.62131702,3928,-926720,78848,-847872,82
37,17,20,10,0.314814815,0.685185185,15.14246927,16.44514842,26.94594595,28.70588235,54,0.845599749,108,-18944,8704,-10240,82
35,17,19,11,0.326923077,0.673076923,14.51850332,15.94019967,26.11428571,27.29411765,52,5.153617443,104,-17920,8704,-9216,82
34,16,20,10,0.32,0.68,13.86592373,15.51612065,25.02941176,26.5,50,5.470459519,100,-17408,8192,-9216,82
4930,581,23,7,0.105425513,0.894574487,1566.010316,1696.660187,2693.074442,3289.946644,5511,116.8327327,11022,-2524160,297472,-2226688,82
4647,503,24,6,0.0976699029,0.902330097,1473.53729,1571.664665,2543.079406,2875.019881,5150,187.6822157,10300,-2379264,257536,-2121728,82
5053,488,23,7,0.0880707454,0.911929255,1582.017892,1743.300492,2742.277459,3068.407787,5541,124.2098184,11082,-2587136,249856,-2337280,82
6364,836,22,8,0.116111111,0.883888889,2056.850984,2106.047496,3507.680704,4307.08134,7200,152.027027,14400,-3258368,428032,-2830336,82
4748,495,24,6,0.0944115964,0.905588404,1492.857424,1665.40548,2588.630371,2942.078788,5243,137.0002613,10486,-2430976,253440,-2177536,82
4676,507,23,7,0.0978197955,0.902180205,1478.978923,1593.843355,2549.423225,2984.680473,5183,97.16910386,10366,-2394112,259584,-2134528,82
4850,551,24,6,0.102018145,0.897981855,1541.093441,1664.081196,2658.745567,3072.931034,5401,139.5607235,10802,-2483200,282112,-2201088,82
4895,590,23,7,0.107566089,0.892433911,1555.50258,1725.841614,2685.541982,3219.70678,5485,95.95871239,10970,-2506240,302080,-2204160,82
6489,908,22,8,0.122752467,0.877247533,2096.896008,2197.527444,3575.153028,4584.069383,7397,129.2278127,14794,-3322368,464896,-2857472,82
5243,577,22,8,0.0991408935,0.900859107,1658.755813,1774.389792,2851.275987,3448.64818,5820,148.8871834,11640,-2684416,295424,-2388992,82
7120,958,23,7,0.118593711,0.881406289,2302.424162,2364.10094,3922.03441,4912.521921,8078,142.0432566,16156,-3645440,490496,-3154944,82
281,46,22,8,0.140672783,0.859327217,91.90711201,102.8479708,169.1814947,132.3478261,327,7.72136954,654,-143872,23552,-120320,82
5259,575,23,7,0.0985601646,0.901439835,1663.740174,1786.539824,2863.666667,3409.864348,5834,142.1886425,11668,-2692608,294400,-2398208,82
6576,790,23,7,0.107249525,0.892750475,2123.92691,2072.748491,3620.093674,4211.297468,7366,135.7037583,14732,-3366912,404480,-2962432,82
4717,478,24,6,0.0920115496,0.90798845,1493.890784,1534.965665,2573.662285,2838.169456,5195,112.0336424,10390,-2415104,244736,-2170368,82
6764,786,22,8,0.10410596,0.89589404,2157.795759,2274.37378,3707.037995,4364.656489,7550,133.2744925,15100,-3463168,402432,-3060736,82
4800,556,24,6,0.103808813,0.896191187,1529.678055,1642.025826,2638.728333,3021.852518,5356,116.2074203,10712,-2457600,284672,-2172928,82
51,31,23,7,0.37804878,0.62195122,24.51703423,21.87334653,39.66666667,44.51612903,82,1.701597842,164,-26112,15872,-10240,82
4687,483,22,8,0.0934235977,0.906576402,1479.61476,1565.922995,2548.075101,2948.668737,5170,125.0907331,10340,-2399744,247296,-2152448,82
4646,476,22,8,0.0929324483,0.907067552,1457.253535,1635.764337,2527.413043,2894.205882,5122,92.50496659,10244,-2378752,243712,-2135040,82
35,17,20,10,0.326923077,0.673076923,14.2335046,16.29167533,25.48571429,28.58823529,52,7.669616519,104,-17920,8704,-9216,82
9365,583,23,7,0.0586047447,0.941395255,2868.290981,2924.680248,4980.884891,4871.936535,9948,1027.68595,19896,-4794880,298496,-4496384,82
34,17,20,10,0.333333333,0.666666667,13.96712031,15.96405998,25.08823529,27.82352941,51,7.703927492,102,-17408,8704,-8704,82
35,17,20,10,0.326923077,0.673076923,14.23746137,16.27318681,25.45714286,28.64705882,52,6.242496999,104,-17920,8704,-9216,82
36,18,19,11,0.333333333,0.666666667,14.88930348,16.73366165,26.55555556,29.38888889,54,8.13253012,108,-18432,9216,-9216,82
35,17,20,10,0.326923077,0.673076923,14.23746137,16.27318681,25.45714286,28.64705882,52,7.902735562,104,-17920,8704,-9216,82
34,17,20,10,0.333333333,0.666666667,13.96712031,15.96405998,25.08823529,27.82352941,51,9.622641509,102,-17408,8704,-8704,82
35,17,20,10,0.326923077,0.673076923,14.23746137,16.27318681,25.45714286,28.64705882,52,8.074534161,104,-17920,8704,-9216,82
34,17,20,10,0.333333333,0.666666667,13.96712031,15.96405998,25.08823529,27.82352941,51,8.292682927,102,-17408,8704,-8704,82
36,17,20,10,0.320754717,0.679245283,14.47400821,16.68930412,25.94444444,29.23529412,53,6.992084433,106,-18432,8704,-9728,82
37,17,20,10,0.314814815,0.685185185,14.98443312,16.68930412,26.7027027,29.23529412,54,2.517482517,108,-18944,8704,-10240,82
35,20,20,10,0.363636364,0.636363636,14.23746137,17.5256241,25.45714286,32.45,55,0.976389135,110,-17920,10240,-7680,82
9354,594,22,8,0.0597104946,0.940289505,2870.085869,2896.056444,4968.550674,5068.186869,9948,1014.067278,19896,-4789248,304128,-4485120,82
4256,299,23,7,0.0656421515,0.934357849,1313.230309,1321.432529,2292.540883,2071.023411,4555,81.41197498,9110,-2179072,153088,-2025984,82
34,18,19,11,0.346153846,0.653846154,14.38244316,16.0173517,25.70588235,28,52,5.909090909,104,-17408,9216,-8192,82
9385,566,23,7,0.0568787057,0.943121294,2870.426175,2899.344573,4989.517741,4751.858657,9951,1049.683544,19902,-4805120,289792,-4515328,82
9385,567,23,7,0.0569734727,0.943026527,2867.067478,2967.211909,4979.622696,4924.813051,9952,783.0055075,19904,-4805120,290304,-4514816,82
36,18,20,10,0.333333333,0.666666667,15.05360791,16.47304195,26.66666667,29.16666667,54,0.804649084,108,-18432,9216,-9216,82
36,18,20,10,0.333333333,0.666666667,15.05360791,16.47304195,26.66666667,29.16666667,54,0.78057242,108,-18432,9216,-9216,82
38,18,20,10,0.321428571,0.678571429,15.55761787,17.18248103,27.5,30.61111111,56,0.845155448,112,-19456,9216,-10240,82
9012,895,23,7,0.0903401635,0.909659836,2823.751556,3034.751518,4857.479361,5925.892737,9907,452.1679598,19814,-4614144,458240,-4155904,82
6918,587,22,8,0.0782145237,0.921785476,2142.860225,2410.254285,3729.1963,4033.534923,7505,185.2171767,15010,-3542016,300544,-3241472,82
7029,594,22,8,0.0779220779,0.922077922,2175.569018,2459.633423,3788.009816,4095.883838,7623,152.064632,15246,-3598848,304128,-3294720,82
6868,590,22,8,0.0791096809,0.920890319,2133.823674,2359.904124,3717.877548,3864.79322,7458,277.0430906,14916,-3516416,302080,-3214336,82
7065,638,23,7,0.0828248734,0.917175127,2199.379467,2453.073551,3822.471054,4178.99373,7703,139.5723863,15406,-3617280,326656,-3290624,82
7250,616,22,8,0.0783117213,0.921688279,2244.777703,2522.740551,3899.810897,4330.003247,7866,191.9472914,15732,-3712000,315392,-3396608,82
8975,931,23,7,0.0939834444,0.906016556,2826.612143,3015.048799,4860.036323,5854.505908,9906,471.9390186,19812,-4595200,476672,-4118528,82
8966,946,23,7,0.0954398709,0.904560129,2813.495755,3111.100413,4852.11354,5945.854123,9912,218.663137,19824,-4590592,484352,-4106240,82
3140,201,23,7,0.0601616283,0.939838372,955.8731136,1022.725292,1694.379299,1305.771144,3341,58.89300194,6682,-1607680,102912,-1504768,82
7187,586,23,7,0.0753891676,0.924610832,2224.268207,2464.897489,3872.648115,4063.018771,7773,172.6949567,15546,-3679744,300032,-3379712,82
6985,596,23,7,0.0786175966,0.921382403,2169.507362,2367.356993,3759.046815,4165.484899,7581,153.4615385,15162,-3576320,305152,-3271168,82
7123,616,24,6,0.0795968471,0.920403153,2206.559702,2501.379202,3838.293696,4236.62987,7739,198.3850295,15478,-3646976,315392,-3331584,82
7267,618,23,7,0.0783766646,0.921623335,2255.442571,2488.623858,3917.950599,4237.553398,7885,185.6604662,15770,-3720704,316416,-3404288,82
7877,697,22,8,0.081292279,0.918707721,2447.277912,2716.175424,4241.336042,4809.212339,8574,162.6327769,17148,-4033024,356864,-3676160,82
8489,863,23,7,0.0922797263,0.907720274,2658.598097,2981.519563,4603.715043,5392.457706,9352,181.8747569,18704,-4346368,441856,-3904512,82
7343,660,23,7,0.0824690741,0.917530926,2279.107741,2584.269226,3958.961596,4480.834848,8003,185.5122856,16006,-3759616,337920,-3421696,82
7136,610,23,7,0.0787503227,0.921249677,2229.274276,2308.983256,3886.217349,3724.727869,7746,258.4584585,15492,-3653632,312320,-3341312,82
8904,1002,23,7,0.101150818,0.898849182,2807.968728,3034.929522,4819.913634,6140.578842,9906,220.7711166,19812,-4558848,513024,-4045824,82
632,70,23,7,0.0997150997,0.9002849,199.466021,228.9775214,350.0332278,364.7428571,702,11.34637142,1404,-323584,35840,-287744,82
306,26,23,7,0.078313253,0.921686747,92.36842245,129.6074923,167.2124183,158.1153846,332,5.246523388,664,-156672,13312,-143360,82
5953,436,23,7,0.0682422914,0.931757709,1850.693618,1732.407927,3215.008735,2921.807339,6389,225.2820874,12778,-3047936,223232,-2824704,82
8373,633,23,7,0.0702864757,0.929713524,2587.869727,2752.857311,4503.472829,4503.8594,9006,188.2525084,18012,-4286976,324096,-3962880,82
35,17,20,10,0.326923077,0.673076923,14.20117845,16.38169288,25.57142857,28.41176471,52,4.541484716,104,-17920,8704,-9216,82
9218,718,23,7,0.0722624799,0.92773752,2861.156251,2958.038716,4970.528531,4942.456825,9936,342.6206897,19872,-4719616,367616,-4352000,82
36,17,20,10,0.320754717,0.679245283,14.4767534,16.67250186,25.91666667,29.29411765,53,5.626326964,106,-18432,8704,-9728,82
9194,735,23,7,0.0740255816,0.925974418,2853.478254,3020.091455,4957.850663,5054.429932,9929,585.7817109,19858,-4707328,376320,-4331008,82
36,17,20,10,0.320754717,0.679245283,14.4767534,16.67250186,25.91666667,29.29411765,53,8.57605178,106,-18432,8704,-9728,82
35,18,19,11,0.339622642,0.660377358,14.61075924,16.43918835,26.2,28.55555556,53,7.133243607,106,-17920,9216,-8704,82
36,17,20,10,0.320754717,0.679245283,14.4767534,16.67250186,25.91666667,29.29411765,53,5.386178862,106,-18432,8704,-9728,82
35,17,20,10,0.326923077,0.673076923,14.21140674,16.34235798,25.51428571,28.52941176,52,7.242339833,104,-17920,8704,-9216,82
8613,725,23,7,0.0776397516,0.922360248,2666.120596,2997.880423,4637.154418,5053.765517,9338,163.137666,18676,-4409856,371200,-4038656,82
36,17,20,10,0.320754717,0.679245283,14.477846,16.7261683,26.05555556,29,53,4.267310789,106,-18432,8704,-9728,82
8462,623,24,6,0.0685745735,0.931425427,2610.014223,2786.015768,4550.68329,4438.640449,9085,212.2167718,18170,-4332544,318976,-4013568,82
35,17,20,10,0.326923077,0.673076923,14.20117845,16.38169288,25.57142857,28.41176471,52,9.829867675,104,-17920,8704,-9216,82
37,18,20,10,0.327272727,0.672727273,15.1210359,17.15767474,27.05405405,29.94444444,55,5.572441743,110,-18944,9216,-9728,82
37,17,20,10,0.314814815,0.685185185,14.71079865,17.10945832,26.43243243,29.82352941,54,9.836065574,108,-18944,8704,-10240,82
8644,833,23,7,0.0878970138,0.912102986,2694.741068,3055.736223,4676.630148,5386.208884,9477,188.6345541,18954,-4425728,426496,-3999232,82
35,17,20,10,0.326923077,0.673076923,14.20117845,16.38169288,25.57142857,28.41176471,52,5.491024287,104,-17920,8704,-9216,82
38,18,20,10,0.321428571,0.678571429,15.52185485,17.27947473,27.57894737,30.44444444,56,0.856269113,112,-19456,9216,-10240,82
1185,126,23,7,0.0961098398,0.90389016,376.8305371,386.5736971,663.3679325,586.7063492,1311,21.18274358,2622,-606720,64512,-542208,82
34,19,20,10,0.358490566,0.641509434,13.86592373,17.00887824,25.02941176,30.52631579,53,0.923184114,106,-17408,9728,-7680,82
6431,629,24,6,0.0890934844,0.910906516,2013.328155,2209.231866,3479.643601,4050.464229,7060,127.4598303,14120,-3292672,322048,-2970624,82
34,16,20,10,0.32,0.68,13.86592373,15.51612065,25.02941176,26.5,50,5.973715651,100,-17408,8192,-9216,82
35,15,21,9,0.3,0.7,13.72130773,15.84452236,24.8,27.13333333,50,6.858710562,100,-17920,7680,-10240,82
35,16,20,10,0.31372549,0.68627451,14.13849861,15.83792422,25.4,27.3125,51,8.333333333,102,-17920,8192,-9728,82
35,15,21,9,0.3,0.7,13.72130773,15.84452236,24.8,27.13333333,50,7.396449704,100,-17920,7680,-10240,82
3805,217,22,8,0.0539532571,0.946046743,1156.768179,1180.486336,2031.38975,1662.741935,4022,321.2460064,8044,-1948160,111104,-1837056,82
6325,570,23,7,0.0826686004,0.9173314,1959.399972,2276.051877,3415.623715,3807.263158,6895,161.9304838,13790,-3238400,291840,-2946560,82
35,17,19,11,0.326923077,0.673076923,14.51850332,15.94019967,26.11428571,27.29411765,52,5.349794239,104,-17920,8704,-9216,82
36,16,20,10,0.307692308,0.692307692,14.37740855,16.2552876,25.88888889,27.875,52,9.454545455,104,-18432,8192,-10240,82
7235,766,23,7,0.0957380327,0.904261967,2282.028121,2532.347664,3965.898825,4332.536554,8001,163.5527392,16002,-3704320,392192,-3312128,82
6221,563,24,6,0.0829893868,0.917010613,1939.317588,2132.245093,3363.835557,3709.234458,6784,177.7312025,13568,-3185152,288256,-2896896,82
34,16,20,10,0.32,0.68,13.90290104,15.45141074,25.05882353,26.4375,50,4.75737393,100,-17408,8192,-9216,82
6836,591,24,6,0.0795745254,0.920425475,2126.446017,2307.324635,3683.015506,4072.392555,7427,157.1186799,14854,-3500032,302592,-3197440,82
34,17,19,11,0.333333333,0.666666667,14.28261459,15.53275365,25.64705882,26.70588235,51,9.239130435,102,-17408,8704,-8704,82
8811,990,23,7,0.101010101,0.898989899,2801.992536,2932.595514,4807.292021,5735.00101,9801,188.8803238,19602,-4511232,506880,-4004352,82
863,99,20,10,0.102910603,0.897089397,274.5448389,289.6358659,491.4855156,394.4545455,962,14.36893204,1924,-441856,50688,-391168,82
7993,1003,23,7,0.111493997,0.888506003,2538.218434,2736.745183,4346.264231,5711.680957,8996,179.5967259,17992,-4092416,513536,-3578880,82
8504,911,23,7,0.0967604886,0.903239511,2710.210448,2730.183617,4650.282455,5246.781559,9415,166.4015553,18830,-4354048,466432,-3887616,82
36,16,20,10,0.307692308,0.692307692,14.52775122,15.97996793,26,27.625,52,5.579399142,104,-18432,8192,-10240,82
9366,581,23,7,0.0584095707,0.941590429,2872.363327,2849.882454,4985.884262,4782.419966,9947,845.1146984,19894,-4795392,297472,-4497920,82
34,18,19,11,0.346153846,0.653846154,14.38244316,16.0173517,25.70588235,28,52,9.43738657,104,-17408,9216,-8192,82
34,17,20,10,0.333333333,0.666666667,13.96712031,15.96405998,25.08823529,27.82352941,51,4.434782609,102,-17408,8704,-8704,82
34,17,20,10,0.333333333,0.666666667,13.96712031,15.96405998,25.08823529,27.82352941,51,5.902777778,102,-17408,8704,-8704,82
34,17,20,10,0.333333333,0.666666667,13.96712031,15.96405998,25.08823529,27.82352941,51,6.071428571,102,-17408,8704,-8704,82
35,17,20,10,0.326923077,0.673076923,14.2073278,16.36034534,25.54285714,28.47058824,52,7.536231884,104,-17920,8704,-9216,82
34,17,20,10,0.333333333,0.666666667,13.97253856,15.94432354,25.05882353,27.88235294,51,2.50984252,102,-17408,8704,-8704,82
35,17,20,10,0.326923077,0.673076923,14.23746137,16.27318681,25.45714286,28.64705882,52,9.171075838,104,-17920,8704,-9216,82
9374,572,23,7,0.057510557,0.942489443,2873.578799,2828.361142,4981.109665,4848.791958,9946,1371.862069,19892,-4799488,292864,-4506624,82
9416,537,23,7,0.0539535818,0.946046418,2870.540399,2878.960605,5003.77432,4507.527002,9953,684.0549828,19906,-4820992,274944,-4546048,82
9375,574,23,7,0.0576942406,0.942305759,2871.795635,2872.988334,4982.604587,4850.796167,9949,576.7536232,19898,-4800000,293888,-4506112,82
34,17,20,10,0.333333333,0.666666667,13.97253856,15.94432354,25.05882353,27.88235294,51,7.919254658,102,-17408,8704,-8704,82
35,20,20,10,0.363636364,0.636363636,14.23746137,17.5256241,25.45714286,32.45,55,0.968821561,110,-17920,10240,-7680,82
9327,616,23,7,0.0619531329,0.938046867,2876.793137,2705.269384,5010.103034,4395.073052,9943,274.0628445,19886,-4775424,315392,-4460032,82
9418,536,23,7,0.0538476994,0.946152301,2868.165558,2901.341654,5011.374496,4382.294776,9954,928.5447761,19908,-4822016,274432,-4547584,82
34,17,20,10,0.333333333,0.666666667,13.97253856,15.94432354,25.05882353,27.88235294,51,8.644067797,102,-17408,8704,-8704,82
35,18,19,11,0.339622642,0.660377358,14.80016547,16.16198863,26.42857143,28.11111111,53,5.18590998,106,-17920,9216,-8704,82
35,17,20,10,0.326923077,0.673076923,14.23746137,16.27318681,25.45714286,28.64705882,52,5.322415558,104,-17920,8704,-9216,82
34,17,20,10,0.333333333,0.666666667,13.97253856,15.94432354,25.05882353,27.88235294,51,7.727272727,102,-17408,8704,-8704,82
38,18,20,10,0.321428571,0.678571429,15.58632471,17.13742565,27.52631579,30.55555556,56,0.865132087,112,-19456,9216,-10240,82
8488,749,22,8,0.081086933,0.918913067,2644.786267,2880.561831,4589.817507,4949.708945,9237,210.649943,18474,-4345856,383488,-3962368,82
36,17,20,10,0.320754717,0.679245283,14.4767534,16.67250186,25.91666667,29.29411765,53,6.910039113,106,-18432,8704,-9728,82
35,17,20,10,0.326923077,0.673076923,14.21140674,16.34235798,25.51428571,28.52941176,52,5.427974948,104,-17920,8704,-9216,82
36,17,20,10,0.320754717,0.679245283,14.51234043,16.61866212,25.94444444,29.23529412,53,6.856403622,106,-18432,8704,-9728,82
3567,153,19,11,0.0411290323,0.958870968,1071.639339,1119.278883,1865.113541,1752.941176,3720,277.1982116,7440,-1826304,78336,-1747968,82
36,21,19,11,0.368421053,0.631578947,14.84550063,18.2077953,26.66666667,33,57,0.992685475,114,-18432,10752,-7680,82
8404,740,22,8,0.0809273841,0.919072616,2619.055248,2857.430958,4557.282366,4745.322973,9144,235.8524632,18288,-4302848,378880,-3923968,82
35,17,20,10,0.326923077,0.673076923,14.37872578,16.07981821,25.62857143,28.29411765,52,3.837638376,104,-17920,8704,-9216,82
8178,677,22,8,0.0764539808,0.923546019,2538.199061,2762.50912,4419.399242,4531.895126,8855,232.8424928,17710,-4187136,346624,-3840512,82
8212,739,22,8,0.0825606078,0.917439392,2564.331796,2786.23603,4459.909279,4654.805142,8951,159.5259312,17902,-4204544,378368,-3826176,82
35,17,20,10,0.326923077,0.673076923,14.21140674,16.34235798,25.51428571,28.52941176,52,5.531914894,104,-17920,8704,-9216,82
36,17,20,10,0.320754717,0.679245283,14.4767534,16.67250186,25.91666667,29.29411765,53,4.169944925,106,-18432,8704,-9728,82
36,18,19,11,0.333333333,0.666666667,14.88067248,16.79248803,26.69444444,29.11111111,54,5.993340733,108,-18432,9216,-9216,82
9132,790,22,8,0.0796210441,0.920378956,2841.685436,3097.739861,4935.900788,5257.413924,9922,524.1415742,19844,-4675584,404480,-4271104,82
8331,977,22,8,0.104963472,0.895036528,2642.401783,2870.47098,4543.192414,5603.633572,9308,162.4716355,18616,-4265472,500224,-3765248,82
9167,756,23,7,0.0761866371,0.923813363,2854.023241,2985.920371,4951.405913,5090.460317,9923,564.7694935,19846,-4693504,387072,-4306432,82
8394,740,22,8,0.0810159842,0.918984016,2608.322192,2925.612683,4542.839171,4847.233784,9134,170.1247905,18268,-4297728,378880,-3918848,82
8223,687,23,7,0.0771043771,0.922895623,2550.475177,2812.729373,4441.631278,4621.500728,8910,167.0103093,17820,-4210176,351744,-3858432,82
2655,263,23,7,0.0901302262,0.909869774,834.435685,918.1312423,1457.12693,1483.456274,2918,51.60035367,5836,-1359360,134656,-1224704,82
36,17,20,10,0.320754717,0.679245283,14.4767534,16.67250186,25.91666667,29.29411765,53,7.142857143,106,-18432,8704,-9728,82
6600,789,24,6,0.106780349,0.893219651,2098.735302,2258.095717,3602.904545,4465.380228,7389,139.1263416,14778,-3379200,403968,-2975232,82
35,17,19,11,0.326923077,0.673076923,14.557248,15.85269562,26.02857143,27.47058824,52,8.595041322,104,-17920,8704,-9216,82
7401,895,24,6,0.107883317,0.892116683,2374.371538,2455.534344,4066.671801,4825.159777,8296,154.7472486,16592,-3789312,458240,-3331072,82
34,16,20,10,0.32,0.68,13.86592373,15.51612065,25.02941176,26.5,50,6.849315068,100,-17408,8192,-9216,82
5559,590,24,6,0.0959505611,0.904049439,1748.769908,1939.75169,3023.425076,3560.940678,6149,158.2754183,12298,-2846208,302080,-2544128,82
7071,832,22,8,0.105276477,0.894723523,2259.456306,2354.643601,3872.73059,4625.694712,7903,152.9218266,15806,-3620352,425984,-3194368,82
5522,589,24,6,0.0963835706,0.903616429,1733.789469,1960.874272,3004.22184,3541.431239,6111,147.146641,12222,-2827264,301568,-2525696,82
35,16,20,10,0.31372549,0.68627451,14.10850084,15.91726657,25.48571429,27.125,51,8.688245315,102,-17920,8192,-9728,82
36,16,20,10,0.307692308,0.692307692,14.37740855,16.2552876,25.88888889,27.875,52,9.829867675,104,-18432,8192,-10240,82
6949,842,23,7,0.108073418,0.891926582,2212.702446,2432.666423,3816.757375,4549.986936,7791,141.3205151,15582,-3557888,431104,-3126784,82
35,20,19,11,0.363636364,0.636363636,14.557248,17.41974454,26.02857143,31.45,55,0.959358102,110,-17920,10240,-7680,82
7083,827,23,7,0.104551201,0.895448799,2248.300541,2409.320742,3858.405337,4787.085852,7910,139.3587033,15820,-3626496,423424,-3203072,82
34,16,20,10,0.32,0.68,13.86592373,15.51612065,25.02941176,26.5,50,4.725897921,100,-17408,8192,-9216,82
7178,847,22,8,0.105545171,0.894454829,2289.46884,2382.223576,3916.256757,4832.861865,8025,141.8345705,16050,-3675136,433664,-3241472,82
36,16,20,10,0.307692308,0.692307692,14.37740855,16.2552876,25.88888889,27.875,52,8.188976378,104,-18432,8192,-10240,82
35,16,20,10,0.31372549,0.68627451,14.13462964,15.85283886,25.42857143,27.25,51,6.181818182,102,-17920,8192,-9728,82
35,15,21,9,0.3,0.7,13.72130773,15.84452236,24.8,27.13333333,50,3.443526171,100,-17920,7680,-10240,82
6065,610,23,7,0.0913857678,0.908614232,1897.535825,2116.793212,3281.36488,3901.101639,6675,156.3598032,13350,-3105280,312320,-2792960,82
941,114,23,7,0.108056872,0.891943128,302.5920185,317.0515808,533.1849097,485.2017544,1055,12.68028846,2110,-481792,58368,-423424,82
37,16,21,9,0.301886792,0.698113208,14.74259295,16.39311975,26.2972973,28.625,53,0.826575172,106,-18944,8192,-10752,82
37,17,20,10,0.314814815,0.685185185,14.71079865,17.10945832,26.43243243,29.82352941,54,8.8091354,108,-18944,8704,-10240,82
37,18,20,10,0.327272727,0.672727273,15.1210359,17.15767474,27.05405405,29.94444444,55,8.566978193,110,-18944,9216,-9728,82
129,35,23,7,0.213414634,0.786585366,48.01529988,36.5312726,88.72868217,59.54285714,164,3.198127925,328,-66048,17920,-48128,82
36,17,20,10,0.320754717,0.679245283,14.44238767,16.78048793,26.02777778,29.05882353,53,8.091603053,106,-18432,8704,-9728,82
6741,641,23,7,0.0868328366,0.913167163,2115.079903,2278.726078,3669.345053,3924.48986,7382,139.414542,14764,-3451392,328192,-3123200,82
35,17,20,10,0.326923077,0.673076923,14.20117845,16.38169288,25.57142857,28.41176471,52,8.087091757,104,-17920,8704,-9216,82
2327,213,20,10,0.0838582677,0.916141732,719.7322709,858.3113683,1281.325312,1152.234742,2540,43.99030135,5080,-1191424,109056,-1082368,82
7515,709,22,8,0.0862110895,0.913788911,2352.932965,2570.613153,4085.916833,4394.266573,8224,194.5587887,16448,-3847680,363008,-3484672,82
37,17,20,10,0.314814815,0.685185185,14.71079865,17.10945832,26.43243243,29.82352941,54,5.157593123,108,-18944,8704,-10240,82
36,18,19,11,0.333333333,0.666666667,14.88544218,16.7497927,26.58333333,29.33333333,54,7.307171854,108,-18432,9216,-9216,82
8995,913,23,7,0.0921477594,0.907852241,2838.138905,3026.325129,4905.167093,5440.534502,9908,621.1912226,19816,-4605440,467456,-4137984,82
36,18,19,11,0.333333333,0.666666667,14.88544218,16.7497927,26.58333333,29.33333333,54,11.51385928,108,-18432,9216,-9216,82
36,17,20,10,0.320754717,0.679245283,14.4767534,16.67250186,25.91666667,29.29411765,53,8.562197092,106,-18432,8704,-9728,82
36,18,19,11,0.333333333,0.666666667,14.88544218,16.7497927,26.58333333,29.33333333,54,6.345475911,108,-18432,9216,-9216,82
4454,197,23,7,0.0423564825,0.957643518,1339.675521,1364.174496,2341.039291,1985.974619,4651,148.7368084,9302,-2280448,100864,-2179584,82
9092,827,24,6,0.0833753403,0.91662466,2862.114219,2866.742755,4938.735152,5193.784764,9919,429.952319,19838,-4655104,423424,-4231680,82
36,17,20,10,0.320754717,0.679245283,14.46928953,16.70940311,25.97222222,29.17647059,53,6.416464891,106,-18432,8704,-9728,82
7324,638,23,7,0.0801306204,0.91986938,2283.571194,2458.730117,3969.96095,4113.96395,7962,187.7830189,15924,-3749888,326656,-3423232,82
9038,877,23,7,0.0884518406,0.911548159,2856.723921,2908.087626,4935.523457,5189.633979,9915,646.7710372,19830,-4627456,449024,-4178432,82
9059,860,23,7,0.0867022885,0.913297711,2848.111477,3003.218184,4931.674247,5258.375581,9919,432.3888405,19838,-4638208,440320,-4197888,82
3777,326,21,9,0.079454058,0.920545942,1161.756358,1387.562013,2026.610802,2346.156442,4103,88.61771058,8206,-1933824,166912,-1766912,83
3923,340,21,9,0.0797560403,0.92024396,1207.96251,1397.999444,2095.042315,2558.426471,4263,74.60623031,8526,-2008576,174080,-1834496,83
3855,313,21,9,0.0750959693,0.924904031,1180.648503,1369.65116,2046.743969,2549.514377,4168,81.77359231,8336,-1973760,160256,-1813504,83
4157,321,21,9,0.0716837874,0.928316213,1267.29374,1525.706682,2207.490017,2654.034268,4478,96.6335779,8956,-2128384,164352,-1964032,83
3802,322,21,9,0.0780795344,0.921920466,1163.799607,1397.341594,2025.516833,2499.177019,4124,78.23942326,8248,-1946624,164864,-1781760,83
3812,319,21,9,0.0772210119,0.922778988,1168.549986,1350.141705,2023.81191,2570.141066,4131,81.25491739,8262,-1951744,163328,-1788416,83
3800,328,21,9,0.0794573643,0.920542636,1164.906408,1391.693706,2026.244211,2507.707317,4128,80.35818571,8256,-1945600,167936,-1777664,83
4165,343,21,9,0.0760869565,0.923913043,1275.037409,1531.563374,2221.77407,2651.886297,4508,80.17072737,9016,-2132480,175616,-1956864,83
3762,324,22,8,0.0792951542,0.920704846,1154.062398,1374.189101,2007.208931,2464.87963,4086,90.86057372,8172,-1926144,165888,-1760256,83
3734,315,21,9,0.0777969869,0.922203013,1148.03758,1359.900831,2000.920728,2310.434921,4049,75.42846498,8098,-1911808,161280,-1750528,83
3816,325,21,9,0.0784834581,0.921516542,1170.569164,1398.326406,2037.933176,2459.255385,4141,84.23515053,8282,-1953792,166400,-1787392,83
4189,336,21,9,0.0742541436,0.925745856,1280.79705,1492.968497,2220.838864,2788.633929,4525,87.27097396,9050,-2144768,172032,-1972736,83
3786,281,22,8,0.0690926973,0.930907303,1153.857158,1332.314749,1999.182779,2503.103203,4067,81.37254902,8134,-1938432,143872,-1794560,83
3778,321,21,9,0.0783117834,0.921688217,1157.462322,1398.928849,2017.948915,2427.224299,4099,79.9804878,8198,-1934336,164352,-1769984,83
3802,311,22,8,0.0756139071,0.924386093,1162.620262,1337.885889,2011.862967,2608.803859,4113,74.6867623,8226,-1946624,159232,-1787392,83
4241,331,21,9,0.0723972003,0.9276028,1292.583217,1530.069847,2244.473945,2824.966767,4572,91.29392971,9144,-2171392,169472,-2001920,83
3260,221,21,9,0.0634875036,0.936512496,992.1492314,1174.484896,1745.792945,1670.298643,3481,49.97846375,6962,-1669120,113152,-1555968,83
3789,332,21,9,0.0805629702,0.91943703,1163.047766,1391.919363,2024.230404,2480.638554,4121,76.85565088,8242,-1939968,169984,-1769984,83
4168,331,23,7,0.0735719049,0.926428095,1274.085807,1481.455971,2208.760797,2769.29003,4499,88.2676084,8998,-2134016,169472,-1964544,83
3795,314,22,8,0.0764176199,0.92358238,1161.306861,1390.568579,2021.395257,2461.146497,4109,73.54573116,8218,-1943040,160768,-1782272,83
1611,222,22,8,0.12111293,0.87888707,526.7662126,537.7868595,904.7603973,1005.81982,1833,49.12891986,3666,-824832,113664,-711168,83
1643,229,21,9,0.12232906,0.87767094,536.6621918,563.328269,928.6920268,992.5196507,1872,49.58940397,3744,-841216,117248,-723968,83
1588,225,22,8,0.124103696,0.875896304,518.6955684,548.8332923,895.8583123,985.6355556,1813,45.89873418,3626,-813056,115200,-697856,83
1607,220,22,8,0.120415982,0.879584018,525.3145842,540.6781229,908.3503423,955.2681818,1827,48.99436846,3654,-822784,112640,-710144,83
1648,225,22,8,0.120128137,0.879871863,541.3266009,532.4319197,929.1025485,994.8444444,1873,46.78990757,3746,-843776,115200,-728576,83
1617,224,21,9,0.121673004,0.878326996,526.5789297,560.8627502,911.7439703,987.8169643,1841,39.61695718,3682,-827904,114688,-713216,83
1602,221,21,9,0.121228744,0.878771256,525.199583,529.6039744,903.3196005,974.9230769,1823,48.82163899,3646,-820224,113152,-707072,83
1608,220,21,9,0.120350109,0.879649891,520.2018813,572.764898,903.1523632,997.4409091,1828,42.22684223,3656,-823296,112640,-710656,83
1615,221,22,8,0.12037037,0.87962963,528.5543606,534.2506383,907.9752322,995.4117647,1836,49.15662651,3672,-826880,113152,-713728,83
1614,203,22,8,0.11172262,0.88827738,517.5397334,564.2266993,894.6635688,1022.985222,1817,43.53138476,3634,-826368,103936,-722432,83
1620,224,21,9,0.121475054,0.878524946,530.6874069,540.3426309,914.3876543,981.1696429,1844,46.28514056,3688,-829440,114688,-714752,83
1633,216,21,9,0.116819903,0.883180097,530.3647309,546.071323,910.279853,1036.287037,1849,46.5625787,3698,-836096,110592,-725504,83
1619,221,22,8,0.120108696,0.879891304,529.0723349,543.6056615,913.6547251,970.6470588,1840,49.22418406,3680,-828928,113152,-715776,83
1608,222,21,9,0.121311475,0.878688525,523.9828052,553.0105448,905.4993781,987.9369369,1830,44.24564797,3660,-823296,113664,-709632,83
1606,217,22,8,0.119034558,0.880965442,525.7990061,520.5522647,899.6276463,1003.56682,1823,48.9922064,3646,-822272,111104,-711168,83
1605,217,22,8,0.11909989,0.88090011,520.8002787,549.9663353,896.3937695,1023.230415,1822,44.08420034,3644,-821760,111104,-710656,83
1635,218,21,9,0.117647059,0.882352941,532.5943678,549.7886668,920.8061162,973.4541284,1853,47.9306777,3706,-837120,111616,-725504,83
947,119,21,9,0.11163227,0.88836773,301.2626403,354.4823422,531.2228089,551.6218487,1066,14.24371994,2132,-484864,60928,-423936,83
1595,219,21,9,0.120727674,0.879272326,519.659223,547.0426427,898.0959248,975.9908676,1814,45.71572581,3628,-816640,112128,-704512,83
537,43,22,8,0.074137931,0.925862069,163.6571151,206.8908863,292.726257,262.6976744,580,40.96045198,1160,-274944,22016,-252928,83
1642,224,22,8,0.120042872,0.879957128,531.059193,583.4717551,921.1023143,1024.379464,1866,49.95983936,3732,-840704,114688,-726016,83
186,30,20,10,0.138888889,0.861111111,60.9535667,41.28008667,117.0376344,55.56666667,216,3.946647177,432,-95232,15360,-79872,83
1603,231,21,9,0.125954198,0.874045802,526.2972206,546.418945,908.2888334,981.4199134,1834,45.56521739,3668,-820736,118272,-702464,83
1627,211,22,8,0.114798694,0.885201306,529.1140121,534.0045081,908.3318992,1005.616114,1838,46.54342872,3676,-833024,108032,-724992,83
1598,230,21,9,0.125820569,0.874179431,520.9702437,556.7362542,896.6833542,1038.286957,1828,46.04534005,3656,-818176,117760,-700416,83
1598,214,22,8,0.118101545,0.881898455,522.158618,526.2538288,898.6921151,964.8037383,1812,48.98621249,3624,-818176,109568,-708608,83
543,51,21,9,0.0858585859,0.914141414,167.4221092,198.440781,303.6169429,232.372549,594,14.50195313,1188,-278016,26112,-251904,83
1587,217,22,8,0.120288248,0.879711752,520.1023176,521.7119005,894.2885948,962.5529954,1804,47.15107162,3608,-812544,111104,-701440,83
1591,224,22,8,0.123415978,0.876584022,518.7864746,552.3255282,896.4613451,989.9553571,1815,48.4,3630,-814592,114688,-699904,83
1612,224,22,8,0.122004357,0.877995643,521.6297267,574.1777748,902.7506203,1031.839286,1836,43.73511196,3672,-825344,114688,-710656,83
1603,214,21,9,0.117776555,0.882223445,519.5530868,551.3513097,896.4597629,1002.934579,1817,45.76826196,3634,-820736,109568,-711168,83
1620,215,22,8,0.117166213,0.882833787,525.7453564,552.7130833,907.7851852,994.9674419,1835,47.36706247,3670,-829440,110080,-719360,83
1579,220,21,9,0.122290161,0.877709839,516.9905553,529.8993354,889.6548448,974.25,1799,44.66236346,3598,-808448,112640,-695808,83
1602,211,22,8,0.116381688,0.883618312,524.4938097,510.5385641,898.8745318,968.6919431,1813,47.44831196,3626,-820224,108032,-712192,83
1654,227,22,8,0.120680489,0.879319511,542.0504133,548.8123036,936.6505441,972.69163,1881,51.03092784,3762,-846848,116224,-730624,83
1603,224,21,9,0.122605364,0.877394636,526.0772754,530.7655765,903.4541485,989.46875,1827,48.39735099,3654,-820736,114688,-706048,83
1646,232,22,8,0.123535676,0.876464324,540.2761342,551.8688941,931.5844471,995.6594828,1878,44.24028269,3756,-842752,118784,-723968,83
920,117,21,9,0.112825458,0.887174542,292.9758559,345.2711965,520.3021739,508.7606838,1037,15.58929645,2074,-471040,59904,-411136,83
900,105,23,7,0.104477612,0.895522388,283.7056048,339.987062,501.7977778,513.3047619,1005,14.96649293,2010,-460800,53760,-407040,83
920,109,22,8,0.105928086,0.894071914,291.5375436,340.0013348,514.7793478,516.8623853,1029,42.82147316,2058,-471040,55808,-415232,83
3496,403,21,9,0.103359836,0.896640164,1139.897837,981.2963861,1966.125286,1810.114144,3899,92.74500476,7798,-1789952,206336,-1583616,83
3372,404,21,9,0.106991525,0.893008475,1100.938114,980.9288732,1906.970937,1734.331683,3776,88.47235239,7552,-1726464,206848,-1519616,83
3394,396,22,8,0.104485488,0.895514512,1101.586946,1023.262873,1905.76812,1807.494949,3790,94.20830226,7580,-1737728,202752,-1534976,83
3386,395,22,8,0.104469717,0.895530283,1102.986575,969.9227646,1911.397224,1716.151899,3781,89.38534279,7562,-1733632,202240,-1531392,83
3437,393,21,9,0.102610966,0.897389034,1119.115692,973.2722107,1927.697701,1808.824427,3830,87.74341352,7660,-1759744,201216,-1558528,83
3427,401,22,8,0.104754441,0.895245559,1116.850696,989.0009948,1929.720163,1784.426434,3828,91.38219145,7656,-1754624,205312,-1549312,83
3408,392,22,8,0.103157895,0.896842105,1108.984866,983.9578943,1907.92723,1835.928571,3800,95.64560785,7600,-1744896,200704,-1544192,83
3405,402,21,9,0.105594957,0.894405043,1110.056281,983.9370814,1924.130984,1733.487562,3807,78.88520514,7614,-1743360,205824,-1537536,83
3420,385,22,8,0.101182654,0.898817346,1110.416424,982.1910998,1911.402924,1828.355844,3805,91.46634615,7610,-1751040,197120,-1553920,83
3399,405,22,8,0.106466877,0.893533123,1104.05937,1041.900412,1914.065019,1805.439506,3804,91.50829925,7608,-1740288,207360,-1532928,83
3368,383,22,8,0.102106105,0.897893895,1093.396713,971.3030223,1893.597684,1721.250653,3751,89.39466158,7502,-1724416,196096,-1528320,83
3365,393,21,9,0.104576903,0.895423097,1095.882273,966.1698726,1900.82526,1696.905852,3758,75.93453223,7516,-1722880,201216,-1521664,83
3380,394,21,9,0.104398516,0.895601484,1100.025547,981.3325325,1905.100888,1736.507614,3774,88.71650212,7548,-1730560,201728,-1528832,83
3404,386,22,8,0.101846966,0.898153034,1101.551948,1022.374821,1904.528202,1815.88342,3790,96.07097592,7580,-1742848,197632,-1545216,83
3373,371,22,8,0.0990918803,0.90090812,1089.882004,971.1884817,1894.813223,1669.636119,3744,75.39267016,7488,-1726976,189952,-1537024,83
3438,388,22,8,0.101411396,0.898588604,1118.496795,959.3764756,1929.788831,1769.167526,3826,76.96640515,7652,-1760256,198656,-1561600,83
3371,407,21,9,0.107728957,0.892271043,1102.083425,978.9471888,1906.726787,1746.818182,3778,89.88817511,7556,-1725952,208384,-1517568,83
1041,126,21,9,0.107969152,0.892030848,327.6867533,404.8214248,585.1853987,574.2063492,1167,17.65506808,2334,-532992,64512,-468480,83
1068,130,21,9,0.10851419,0.89148581,338.1252783,403.5767489,600.1685393,594.0076923,1198,15.82144744,2396,-546816,66560,-480256,83
1056,130,22,8,0.109612142,0.890387858,333.9771498,403.9178185,591.9886364,605.7769231,1186,17.76512882,2372,-540672,66560,-474112,83
1956,124,22,8,0.0596153846,0.940384615,589.8177092,687.7179698,1058.642638,754.3145161,2080,65.57377049,4160,-1001472,63488,-937984,83
1981,130,22,8,0.0615821885,0.938417811,598.1183143,729.0419297,1069.828874,845.2692308,2111,68.89686684,4222,-1014272,66560,-947712,83
1960,125,21,9,0.0599520384,0.940047962,592.3655419,686.4536821,1059.284694,787.656,2085,71.97100449,4170,-1003520,64000,-939520,83
1954,123,22,8,0.0592200289,0.940779971,590.8849472,701.3010038,1049.935005,865.2845528,2077,68.59313078,4154,-1000448,62976,-937472,83
1879,120,22,8,0.060030015,0.939969985,568.9260038,635.1485123,1017.021288,733.475,1999,69.62730756,3998,-962048,61440,-900608,83
1958,129,22,8,0.0618112123,0.938188788,593.8853281,674.3330078,1060.14811,798.8992248,2087,71.4481342,4174,-1002496,66048,-936448,83
2001,125,22,8,0.0587958608,0.941204139,602.8935562,694.5171064,1083.158421,748.808,2126,67.90162887,4252,-1024512,64000,-960512,83
1944,129,22,8,0.0622286541,0.937771346,588.5554707,696.138004,1051.371399,820.4263566,2073,36.05844495,4146,-995328,66048,-929280,83
969,70,22,8,0.0673724735,0.932627526,293.2101669,358.6822606,528.9638803,395.9142857,1039,57.49861649,2078,-496128,35840,-460288,83
1966,126,21,9,0.0602294455,0.939770554,594.0733297,689.6969093,1063.2706,784.8253968,2092,79.24242424,4184,-1006592,64512,-942080,83
1914,124,22,8,0.0608439647,0.939156035,578.2859924,698.6563073,1031.847962,828.9032258,2038,68.82809862,4076,-979968,63488,-916480,83
1966,124,21,9,0.0593301435,0.940669856,597.1718855,656.3873247,1059.232452,827.7741935,2090,58.74086565,4180,-1006592,63488,-943104,83
1961,123,22,8,0.0590211132,0.940978887,594.1790686,657.7734703,1058.679245,784.5528455,2084,77.5297619,4168,-1004032,62976,-941056,83
1958,114,22,8,0.055019305,0.944980695,589.869735,674.4113339,1051.642492,776.4210526,2072,74.47879224,4144,-1002496,58368,-944128,83
1895,120,22,8,0.0595533499,0.94044665,573.2752633,646.5272614,1024.665963,744.8166667,2015,72.2481176,4030,-970240,61440,-908800,83
1974,115,22,8,0.0550502633,0.944949737,594.0308126,692.8546907,1059.852077,790.0608696,2089,50.90155945,4178,-1010688,58880,-951808,83
1806,118,22,8,0.0613305613,0.938669439,547.3222246,610.5517447,979.5121816,702.1271186,1924,28.45312038,3848,-924672,60416,-864256,83
1806,123,22,8,0.0637636081,0.936236392,546.7863197,632.5107834,982.8250277,703.2764228,1929,25.85097829,3858,-924672,62976,-861696,83
1811,123,22,8,0.063598759,0.936401241,548.8945246,633.3758488,984.1032579,723.0406504,1934,28.82265276,3868,-927232,62976,-864256,83
1811,120,22,8,0.0621439669,0.937856033,548.1095393,634.072413,982.2611817,720.5916667,1931,29.58480159,3862,-927232,61440,-865792,83
1966,149,22,8,0.0704491726,0.929550827,600.0457034,730.6557347,1052.034588,1136.711409,2115,84.83754513,4230,-1006592,76288,-930304,83
1613,140,22,8,0.0798630918,0.920136908,496.4998269,601.8226481,871.6199628,938.9857143,1753,63.05755396,3506,-825856,71680,-754176,83
1603,135,22,8,0.0776754891,0.922324511,491.7218835,604.884632,874.4479102,810.7481481,1738,60.1800554,3476,-820736,69120,-751616,83
1864,156,22,8,0.0772277228,0.922772277,570.358987,713.8195967,1004.055258,1087.50641,2020,74.2101396,4040,-954368,79872,-874496,83
1761,162,22,8,0.0842433697,0.91575663,540.2008819,690.7682491,953.8069279,1051.061728,1923,33.61888112,3846,-901632,82944,-818688,83
1510,123,22,8,0.0753214942,0.924678506,464.1528279,552.3916717,815.4390728,836.1626016,1633,62.54308694,3266,-773120,62976,-710144,83
1753,155,22,8,0.0812368973,0.918763103,540.5282379,652.112113,948.6263548,1020.929032,1908,75.17730496,3816,-897536,79360,-818176,83
1725,165,22,8,0.0873015873,0.912698413,532.9388773,653.3932894,934.8950725,1056.369697,1890,73.42657343,3780,-883200,84480,-798720,83
1498,133,22,8,0.0815450644,0.918454936,458.8901973,588.7903415,816.4218959,811.2481203,1631,40.775,3262,-766976,68096,-698880,83
1661,169,22,8,0.0923497268,0.907650273,516.4765641,624.2760479,905.563516,1013.159763,1830,73.08306709,3660,-850432,86528,-763904,83
1745,171,22,8,0.0892484342,0.910751566,538.9374653,677.5277137,952.0750716,1024.064327,1916,79.10817506,3832,-893440,87552,-805888,83
1725,159,22,8,0.0843949045,0.915605096,530.495341,668.8673215,936.7669565,1004.698113,1884,72.71323813,3768,-883200,81408,-801792,83
1633,134,22,8,0.0758347482,0.924165252,498.0459329,638.8498341,884.3312921,879.9626866,1767,60.2044293,3534,-836096,68608,-767488,83
1751,192,22,8,0.0988162635,0.901183736,548.494939,645.0340077,955.8743575,1119.0625,1943,48.69674185,3886,-896512,98304,-798208,83
1624,143,22,8,0.0809281268,0.919071873,497.717732,630.4593741,878.4624384,946.8881119,1767,70.34235669,3534,-831488,73216,-758272,83
1525,133,22,8,0.0802171291,0.919782871,467.9291682,587.2637078,828.1298361,845.2105263,1658,57.35039779,3316,-780800,68096,-712704,83
1650,137,22,8,0.0766648013,0.923335199,506.841431,610.5213443,888.6533333,958.3941606,1787,60.82368958,3574,-844800,70144,-774656,83
1702,150,22,8,0.0809935205,0.919006479,525.0680828,628.3776969,920.0135135,1000.1,1852,66.40372894,3704,-871424,76800,-794624,83
1681,148,22,8,0.0809185347,0.919081465,515.4523041,647.4692088,907.4009518,1001.310811,1829,72.78153601,3658,-860672,75776,-784896,83
1623,141,22,8,0.0799319728,0.920068027,502.2895131,580.4598923,877.8601356,935.9078014,1764,65.33333333,3528,-830976,72192,-758784,83
827,94,22,8,0.102062975,0.897937025,261.4208413,300.474965,464.4727932,430.4468085,921,31.66036439,1842,-423424,48128,-375296,83
825,97,22,8,0.105206074,0.894793926,263.1780691,288.8814506,464.6557576,434.6597938,922,31.36054422,1844,-422400,49664,-372736,83
838,103,22,8,0.109458023,0.890541977,265.3406319,318.0696345,472.451074,459.1941748,941,29.07911001,1882,-429056,52736,-376320,83
831,94,22,8,0.101621622,0.898378378,262.9906291,298.1543915,466.8748496,428.7446809,925,31.71066164,1850,-425472,48128,-377344,83
824,93,22,8,0.101417666,0.898582334,260.6072207,297.9411283,461.2038835,439.4731183,917,32.64506942,1834,-421888,47616,-374272,83
860,106,22,8,0.109730849,0.890269151,272.5548212,325.3912081,484.6116279,474.4811321,966,16.99208443,1932,-440320,54272,-386048,83
839,89,24,6,0.0959051724,0.904094828,263.383761,306.2025325,466.920143,441.6853933,928,29.76266838,1856,-429568,45568,-384000,83
852,104,22,8,0.108786611,0.891213389,272.2872557,304.3230435,479.6784038,468.8461538,956,32.30821223,1912,-436224,53248,-382976,83
828,103,22,8,0.110633727,0.889366273,264.295318,302.1592308,466.7958937,459.6019417,931,34.88197827,1862,-423936,52736,-371200,83
835,98,22,8,0.105037513,0.894962487,264.763566,304.7567037,469.3856287,446.6734694,933,31.61640122,1866,-427520,50176,-377344,83
827,96,22,8,0.104008667,0.895991333,265.6133507,261.1160772,470.949214,384.90625,923,23.56996936,1846,-423424,49152,-374272,83
171,16,24,6,0.0855614973,0.914438503,52.41846,68.1935435,94.57309942,87.875,187,10.25219298,374,-87552,8192,-79360,83
845,96,22,8,0.102019129,0.897980871,268.2772906,297.4752818,474.8733728,436.90625,941,33.25088339,1882,-432640,49152,-383488,83
862,91,22,8,0.0954879328,0.904512067,271.6853704,303.7458169,480.3990719,444.8021978,953,28.27893175,1906,-441344,46592,-394752,83
854,101,22,8,0.105759162,0.894240838,270.4843795,312.2345071,483.6217799,430.4653465,955,29.12473315,1910,-437248,51712,-385536,83
859,100,22,8,0.104275287,0.895724713,273.5576367,303.1047238,481.8533178,464.08,959,29.28244275,1918,-439808,51200,-388608,83
842,102,22,8,0.108050847,0.891949153,268.6034376,302.487543,474.1532067,458.8529412,944,33.34510774,1888,-431104,52224,-378880,83
750,101,22,8,0.118683901,0.881316099,242.8038272,263.8991075,430.1466667,395.2079208,851,12.47251942,1702,-384000,51712,-332288,83
768,100,22,8,0.115207373,0.884792627,246.7728799,275.7889938,438.7929688,401.53,868,13.48663766,1736,-393216,51200,-342016,83
461,70,22,8,0.131826742,0.868173258,153.0138085,150.8134413,271.1041215,232.3857143,531,7.736013986,1062,-236032,35840,-200192,83
142,19,22,8,0.118012422,0.881987578,45.88437985,35.68956644,85.52112676,47.21052632,161,27.80656304,322,-72704,9728,-62976,83
142,19,22,8,0.118012422,0.881987578,45.83533355,35.7057845,85.57746479,46.78947368,161,30.14981273,322,-72704,9728,-62976,83
143,20,21,9,0.122699387,0.877300613,46.26927714,36.72451497,86.88111888,47.1,163,12.96738266,326,-73216,10240,-62976,83
142,19,21,9,0.118012422,0.881987578,45.73136036,35.83441451,85.68309859,46,161,18.69918699,322,-72704,9728,-62976,83
140,17,22,8,0.108280255,0.891719745,44.5293179,36.59230165,83.13571429,44.94117647,157,20.31047865,314,-71680,8704,-62976,83
142,18,22,8,0.1125,0.8875,45.42838918,37.64453627,84.74647887,47,160,37.12296984,320,-72704,9216,-63488,83
142,20,21,9,0.12345679,0.87654321,45.94327769,35.7425167,86.52112676,45.85,162,8.871851041,324,-72704,10240,-62464,83
141,17,22,8,0.107594937,0.892405063,44.767408,38.13289455,83.53900709,46,158,28.36624776,316,-72192,8704,-63488,83
142,16,22,8,0.101265823,0.898734177,44.74981257,37.04805789,83.49295775,44.0625,158,23.03206997,316,-72704,8192,-64512,83
142,19,21,9,0.118012422,0.881987578,45.54138235,38.36094794,85.58450704,46.73684211,161,32.65720081,322,-72704,9728,-62976,83
143,16,21,9,0.100628931,0.899371069,44.94432742,38.01721444,84.02097902,44.0625,159,27.99295775,318,-73216,8192,-65024,83
142,19,21,9,0.118012422,0.881987578,45.63413591,36.28877714,85.73943662,45.57894737,161,32.13572854,322,-72704,9728,-62976,83
143,15,22,8,0.0949367089,0.905063291,44.77251197,38.7525483,83.0979021,45.2,158,37.17647059,316,-73216,7680,-65536,83
142,15,22,8,0.0955414013,0.904458599,44.44023389,38.58819624,82.64084507,44.53333333,157,31.08910891,314,-72704,7680,-65024,83
143,19,22,8,0.117283951,0.882716049,46.12280796,35.81895071,86.09090909,46.94736842,162,20.79589217,324,-73216,9728,-63488,83
144,15,22,8,0.0943396226,0.905660377,45.01908835,39.78307848,83.5625,45.8,159,22.33146067,318,-73728,7680,-66048,83
142,21,22,8,0.128834356,0.871165644,45.86592903,47.9180612,85.55633803,57.95238095,163,2.536964981,326,-72704,10752,-61952,83
145,22,21,9,0.131736527,0.868263473,46.73736878,51.02197307,87.57931034,60.40909091,167,2.652477764,334,-74240,11264,-62976,83
142,22,21,9,0.134146341,0.865853659,45.97042424,49.63369956,86.04225352,59.63636364,164,2.546583851,328,-72704,11264,-61440,83
141,22,21,9,0.134969325,0.865030675,45.84540563,46.67657313,85.9858156,56.45454545,163,2.531448983,326,-72192,11264,-60928,83
1690,253,22,8,0.130211014,0.869788986,552.7644781,598.7723995,954.0307692,1092.031621,1943,33.81482771,3886,-865280,129536,-735744,83
1775,233,21,9,0.116035857,0.883964143,576.1295468,601.9705105,996.0225352,1069.081545,2008,47.01475064,4016,-908800,119296,-789504,83
1713,230,22,8,0.118373649,0.881626351,557.5202352,574.2023287,957.6187974,1079.108696,1943,45.71764706,3886,-877056,117760,-759296,83
1627,232,21,9,0.124798279,0.875201721,528.5463931,579.5797556,915.0319607,1034.969828,1859,38.25890101,3718,-833024,118784,-714240,83
1671,238,21,9,0.124672603,0.875327397,545.9908468,576.6993266,941.4673848,1050.012605,1909,49.94767138,3818,-855552,121856,-733696,83
1662,247,22,8,0.129387114,0.870612886,548.2095197,565.6340601,945.2081829,1020.88664,1909,50.13130252,3818,-850944,126464,-724480,83
1658,230,22,8,0.121822034,0.878177966,544.1503599,545.0462856,933.7907117,1021.7,1888,50.09286283,3776,-848896,117760,-731136,83
1633,240,21,9,0.128136679,0.871863321,538.4795628,550.9355849,927.2639314,1003.245833,1873,46.71988027,3746,-836096,122880,-713216,83
1620,226,21,9,0.122426869,0.877573131,530.5652955,540.2650356,910.5339506,1016.442478,1846,49.34509489,3692,-829440,115712,-713728,83
1657,234,21,9,0.123744051,0.876255949,543.9175304,551.0188554,933.0826795,1037.470085,1891,46.00973236,3782,-848384,119808,-728576,83
1658,231,21,9,0.122286924,0.877713076,543.6986815,552.4225134,935.9921592,1009.65368,1889,47.798583,3778,-848896,118272,-730624,83
1690,235,22,8,0.122077922,0.877922078,552.0226667,571.6506605,949.1449704,1062.638298,1925,48.9821883,3850,-865280,120320,-744960,83
1652,233,21,9,0.123607427,0.876392573,542.8212039,549.9124734,934.6924939,1001.901288,1885,49.16536255,3770,-845824,119296,-726528,83
1664,236,22,8,0.124210526,0.875789474,547.094386,555.8280148,943.7157452,998.3347458,1900,48.8306348,3800,-851968,120832,-731136,83
1647,241,21,9,0.127648305,0.872351695,542.417855,559.5880491,936.7279903,997.6141079,1888,51.48622852,3776,-843264,123392,-719872,83
933,120,21,9,0.113960114,0.886039886,297.3401574,350.4688898,524.0578778,549.875,1053,13.97478434,2106,-477696,61440,-416256,83
929,114,22,8,0.109300096,0.890699904,294.2914967,350.8400656,519.3067815,543.9473684,1043,15.77673574,2086,-475648,58368,-417280,83
935,113,22,8,0.107824427,0.892175573,295.5731047,354.8165464,523.568984,532.2035398,1048,15.42537533,2096,-478720,57856,-420864,83
578,107,21,9,0.15620438,0.84379562,192.3165607,222.3180324,337.3373702,373.588785,685,12.03866432,1370,-295936,54784,-241152,83
976,150,21,9,0.13321492,0.86678508,320.106798,339.6659424,548.4754098,661.26,1126,24.55298735,2252,-499712,76800,-422912,83
1151,165,23,7,0.125379939,0.874620061,372.6258378,418.4246139,670.0390964,578.0060606,1316,42.04472843,2632,-589312,84480,-504832,83
1145,156,23,7,0.119907763,0.880092237,369.5998122,410.0750591,660.4969432,581.2948718,1301,42.53023864,2602,-586240,79872,-506368,83
1164,152,23,7,0.11550152,0.88449848,374.4030655,413.1244394,667.5085911,589.5131579,1316,43.2183908,2632,-595968,77824,-518144,83
1165,156,23,7,0.118092354,0.881907646,374.2575211,424.5208082,670.0377682,593.5064103,1321,38.33430064,2642,-596480,79872,-516608,83
1150,158,23,7,0.120795107,0.879204893,370.0861972,422.3774914,663.5982609,588.278481,1308,45.30654659,2616,-588800,80896,-507904,83
1143,164,23,7,0.125478194,0.874521806,369.0075502,425.154199,663.2195976,589.7439024,1307,43.03589068,2614,-585216,83968,-501248,83
1160,164,23,7,0.123867069,0.876132931,376.7946606,401.3867138,678.1689655,551.6707317,1324,37.0039128,2648,-593920,83968,-509952,83
1178,171,23,7,0.126760563,0.873239437,382.8359635,422.5050239,687.2691002,590.4795322,1349,44.65408805,2698,-603136,87552,-515584,83
1151,154,23,7,0.118007663,0.881992337,369.0781103,422.578923,662.6907037,580.5714286,1305,41.42857143,2610,-589312,78848,-510464,83
1159,165,23,7,0.124622356,0.875377644,374.7195351,425.0364349,672.1311475,594.8484848,1324,42.94518326,2648,-593408,84480,-508928,83
1164,163,23,7,0.122833459,0.877166541,374.1449902,440.3024592,668.4441581,632.2638037,1327,47.07343029,2654,-595968,83456,-512512,83
1164,164,23,7,0.123493976,0.876506024,375.1977298,431.0275351,673.9458763,597.4573171,1328,49.22164566,2656,-595968,83968,-512000,83
1164,155,23,7,0.117513268,0.882486732,373.3919605,423.9709214,670.4441581,581.5677419,1319,44.60601961,2638,-595968,79360,-516608,83
1149,162,23,7,0.123569794,0.876430206,370.2308871,427.4136818,664.5587467,595.2962963,1311,50.89285714,2622,-588288,82944,-505344,83
1168,162,23,7,0.121804511,0.878195489,375.6014155,434.6775609,673.8381849,605.382716,1330,39.36075762,2660,-598016,82944,-515072,83
1165,156,23,7,0.118092354,0.881907646,377.0519163,400.1491267,673.311588,569.0576923,1321,36.01417666,2642,-596480,79872,-516608,83
1157,161,23,7,0.12215478,0.87784522,374.2262769,414.6590431,670.1728608,582.8012422,1318,44.1689008,2636,-592384,82432,-509952,83
1188,158,23,7,0.117384844,0.882615156,380.1798313,442.7965657,680.706229,619.3164557,1346,46.44582471,2692,-608256,80896,-527360,83
845,118,22,8,0.122533749,0.877466251,272.5127306,300.3930734,494.1680473,394.8644068,963,14.12644858,1926,-432640,60416,-372224,83
859,124,23,7,0.126144456,0.873855544,278.2855213,304.3558345,504.9685681,402.1612903,983,14.96878331,1966,-439808,63488,-376320,83
2510,242,23,7,0.0879360465,0.912063953,786.5701152,865.9439595,1385.807171,1279.966942,2752,257.6779026,5504,-1285120,123904,-1161216,84
2522,220,23,7,0.0802334063,0.919766594,791.7801118,777.152757,1382.833466,1241.577273,2742,172.4528302,5484,-1291264,112640,-1178624,84
2712,266,23,7,0.0893216924,0.910678308,851.2666637,939.1463257,1495.200959,1431.37594,2978,51.89961659,5956,-1388544,136192,-1252352,84
2679,239,23,7,0.0819054147,0.918094585,836.9185593,884.1596945,1474.338932,1293.167364,2918,279.7698945,5836,-1371648,122368,-1249280,84
2744,254,23,7,0.0847231488,0.915276851,865.4064692,849.1962564,1514.487609,1337.586614,2998,298.0119284,5996,-1404928,130048,-1274880,84
4682,478,23,7,0.0926356589,0.907364341,1485.089608,1531.353589,2574.261427,2641.606695,5160,227.9151943,10320,-2397184,244736,-2152448,84
2742,263,23,7,0.0875207987,0.912479201,869.8529682,839.3515074,1509.351204,1436.78327,3005,317.653277,6010,-1403904,134656,-1269248,84
2470,248,23,7,0.0912435614,0.908756439,782.8133902,796.884437,1368.473279,1270.129032,2718,220.4379562,5436,-1264640,126976,-1137664,84
2430,255,23,7,0.094972067,0.905027933,768.4611542,832.6725152,1350.037449,1275.937255,2685,306.8571429,5370,-1244160,130560,-1113600,84
960,82,23,7,0.0786948177,0.921305182,293.6470975,285.3665802,541.384375,288.7073171,1042,26.64280235,2084,-491520,41984,-449536,84
2518,224,23,7,0.0816921955,0.918307805,786.0862906,846.1331997,1378.858221,1288.785714,2742,268.0351906,5484,-1289216,114688,-1174528,84
2701,258,24,6,0.0871916188,0.912808381,855.8758895,824.3908767,1492.851907,1345.453488,2959,217.5735294,5918,-1382912,132096,-1250816,84
2415,237,23,7,0.0893665158,0.910633484,767.9906367,740.3772617,1325.834369,1333.2827,2652,218.0921053,5304,-1236480,121344,-1115136,84
2698,253,23,7,0.0857336496,0.91426635,852.5711556,829.5565043,1490.170867,1324.881423,2951,301.7382413,5902,-1381376,129536,-1251840,84
2563,260,22,8,0.0921006022,0.907899398,808.1237507,878.3670372,1415.714397,1375.384615,2823,165.1843183,5646,-1312256,133120,-1179136,84
2509,240,22,8,0.0873044744,0.912695526,795.8934022,766.7414891,1369.817856,1429.175,2749,255.7209302,5498,-1284608,122880,-1161728,84
2681,273,23,7,0.0924170616,0.907582938,852.507371,842.5041419,1491.679224,1338.252747,2954,215.620438,5908,-1372672,139776,-1232896,84
1695,116,24,6,0.0640530094,0.935946991,513.23981,602.4378908,921.5221239,679.1896552,1811,176.5107212,3622,-867840,59392,-808448,84
2457,271,23,7,0.099340176,0.900659824,780.6749461,844.3140935,1371.457061,1301.424354,2728,77.5220233,5456,-1257984,138752,-1119232,84
993,92,23,7,0.0847926267,0.915207373,300.7470208,382.5615588,559.427996,365.6847826,1085,16.27662766,2170,-508416,47104,-461312,84
2420,255,23,7,0.0953271028,0.904672897,761.8297585,864.4980633,1337.786777,1340.023529,2675,271.0233029,5350,-1239040,130560,-1108480,84
2273,276,23,7,0.108277756,0.891722244,714.9508347,877.3047363,1258.271887,1412.764493,2549,216.3837012,5098,-1163776,141312,-1022464,84
2271,287,23,7,0.112197029,0.887802971,715.2716373,883.1384328,1258.283135,1447.38676,2558,44.83786152,5116,-1162752,146944,-1015808,84
2423,281,24,6,0.103920118,0.896079882,764.1993292,901.9020236,1339.494016,1464.647687,2704,47.9943202,5408,-1240576,143872,-1096704,84
2322,257,23,7,0.0996510275,0.900348972,729.1187741,861.9383205,1276.704134,1410.128405,2579,191.889881,5158,-1188864,131584,-1057280,84
2272,291,23,7,0.113538822,0.886461178,721.584667,855.5152513,1263.240317,1428.467354,2563,172.4764468,5126,-1163264,148992,-1014272,84
2436,270,23,7,0.0997782705,0.900221729,768.975483,883.2704073,1351.470443,1371.811111,2706,248.7132353,5412,-1247232,138240,-1108992,84
1539,106,22,8,0.06443769,0.93556231,470.8964589,516.8583613,830.5750487,713.0188679,1645,241.202346,3290,-787968,54272,-733696,84
2202,272,23,7,0.109943411,0.890056589,696.435007,838.6141377,1226.1703,1329.220588,2474,203.2867707,4948,-1127424,139264,-988160,84
2434,267,22,8,0.0988522769,0.901147723,768.1608701,877.9612903,1352.139277,1340.614232,2701,268.7562189,5402,-1246208,136704,-1109504,84
2446,260,23,7,0.096082779,0.903917221,771.4598667,867.0459113,1352.826247,1359.838462,2706,226.2541806,5412,-1252352,133120,-1119232,84
2446,275,23,7,0.101065785,0.898934215,774.0808306,879.5555255,1356.785773,1398.483636,2721,225.4349627,5442,-1252352,140800,-1111552,84
2191,256,23,7,0.104617899,0.895382101,692.0376732,811.3264649,1211.645824,1329.734375,2447,223.2664234,4894,-1121792,131072,-990720,84
2482,274,22,8,0.0994194485,0.900580552,789.9368175,845.0241947,1379.365834,1370.656934,2756,386.5357644,5512,-1270784,140288,-1130496,84
2283,269,23,7,0.105407524,0.894592476,719.0100508,871.4033655,1271.61717,1317.94052,2552,185.3304285,5104,-1168896,137728,-1031168,84
2406,245,23,7,0.0924179555,0.907582045,763.6056483,775.7332573,1316.800499,1416.342857,2651,257.129001,5302,-1231872,125440,-1106432,84
2389,267,23,7,0.100527108,0.899472892,754.5461983,868.0877645,1328.743826,1326.318352,2656,263.4920635,5312,-1223168,136704,-1086464,84
2442,266,23,7,0.0982274742,0.901772526,772.0855925,863.9653607,1359.43448,1309.199248,2708,232.0479863,5416,-1250304,136192,-1114112,84
2434,265,23,7,0.0981845128,0.901815487,767.4523338,879.1812488,1350.596138,1344.524528,2699,235.720524,5398,-1246208,135680,-1110528,84
897,90,23,7,0.0911854103,0.90881459,273.9215028,317.4795874,513.522854,299.4222222,987,15.86306654,1974,-459264,46080,-413184,84
2310,287,23,7,0.110512129,0.889487871,730.3853739,876.58617,1281.001299,1443.867596,2597,274.2344245,5194,-1182720,146944,-1035776,84
2280,297,23,7,0.115250291,0.884749709,727.9647729,842.6317428,1270.170175,1433.552189,2577,179.2072323,5154,-1167360,152064,-1015296,84
2268,277,23,7,0.108840864,0.891159136,717.1165217,854.6014664,1257.462081,1400.220217,2545,148.3100233,5090,-1161216,141824,-1019392,84
2478,277,23,7,0.100544465,0.899455535,778.6545816,926.4620808,1368.201372,1465.65704,2755,48.04673875,5510,-1268736,141824,-1126912,84
2473,275,23,7,0.10007278,0.89992722,779.7929967,902.1072898,1366.144763,1449.636364,2748,198.9862419,5496,-1266176,140800,-1125376,84
2274,281,23,7,0.109980431,0.890019569,719.905387,855.9256167,1261.645558,1410.348754,2555,198.9875389,5110,-1164288,143872,-1020416,84
2420,254,23,7,0.0949887809,0.905011219,759.1548317,883.9866578,1335.066116,1360.688976,2674,163.347587,5348,-1239040,130048,-1108992,84
2480,278,23,7,0.100797679,0.899202321,785.0802944,887.1459352,1373.460887,1433.374101,2758,157.6901086,5516,-1269760,142336,-1127424,84
2457,270,23,7,0.099009901,0.900990099,777.8105886,867.970757,1362.188034,1380.488889,2727,270,5454,-1257984,138240,-1119744,84
2475,281,23,7,0.101959361,0.898040639,782.1873689,905.0792319,1379.059798,1373.569395,2756,290.7172996,5512,-1267200,143872,-1123328,84
2463,275,23,7,0.100438276,0.899561724,780.8781381,870.7800102,1367.501015,1387.403636,2738,215.7604413,5476,-1261056,140800,-1120256,84
2295,277,23,7,0.107698289,0.892301711,727.1011317,841.361713,1266.578214,1451.555957,2572,181.6384181,5144,-1175040,141824,-1033216,84
2253,271,23,7,0.107369255,0.892630745,711.0552555,844.1896962,1243.345761,1421.741697,2524,141.9572553,5048,-1153536,138752,-1014784,84
2385,227,23,7,0.086906585,0.913093415,748.4814342,803.2724645,1315.9174,1207.555066,2612,55.75240128,5224,-1221120,116224,-1104896,84
2274,273,24,6,0.107184923,0.892815077,717.2661745,857.4241554,1256.76737,1417.542125,2547,232.6027397,5094,-1164288,139776,-1024512,84
2342,301,22,8,0.113885736,0.886114264,744.0694138,888.0902325,1307.171648,1437.375415,2643,154.8330404,5286,-1199104,154112,-1044992,84
2264,265,23,7,0.1047845,0.8952155,712.9415736,854.1081346,1251.656802,1378.996226,2529,177.7231202,5058,-1159168,135680,-1023488,84
2483,278,22,8,0.100688156,0.899311844,783.9558272,905.405588,1382.287958,1369.496403,2761,177.5562701,5522,-1271296,142336,-1128960,84
2166,235,23,7,0.097875885,0.902124115,681.7085478,787.5367122,1193.974146,1265.757447,2401,142.8316478,4802,-1108992,120320,-988672,84
2262,269,23,7,0.106282102,0.893717898,713.059013,852.2407051,1249.744032,1402.695167,2531,193.797856,5062,-1158144,137728,-1020416,84
2953,327,23,7,0.099695122,0.900304878,935.0247385,1039.433511,1626.740264,1764.75841,3280,316.9082126,6560,-1511936,167424,-1344512,84
2985,355,23,7,0.106287425,0.893712575,952.900438,1051.090164,1661.377889,1747.202817,3340,308.4025854,6680,-1528320,181760,-1346560,84
2792,336,23,7,0.10741688,0.89258312,889.3373381,993.0896941,1544.079155,1734.1875,3128,231.5321984,6256,-1429504,172032,-1257472,84
2916,353,23,7,0.107984093,0.892015907,929.1951222,1037.074202,1612.395405,1821.728045,3269,182.421875,6538,-1492992,180736,-1312256,84
3259,354,23,7,0.0979795184,0.902020482,1042.425898,1047.720867,1809.908561,1780.223164,3613,272.4736048,7226,-1668608,181248,-1487360,84
2973,351,23,7,0.105595668,0.894404332,954.0881681,1000.641993,1652.456105,1747.57265,3324,300,6648,-1522176,179712,-1342464,84
2743,353,23,7,0.114018088,0.885981912,877.3903802,1000.182113,1529.973387,1692.461756,3096,62.92682927,6192,-1404416,180736,-1223680,84
2970,330,23,7,0.1,0.9,942.7572373,1031.628696,1639.137037,1752.766667,3300,278.9518174,6600,-1520640,168960,-1351680,84
2900,317,23,7,0.0985390115,0.901460988,916.3792985,1030.477314,1599.741034,1693.70347,3217,211.3666229,6434,-1484800,162304,-1322496,84
2815,346,23,7,0.109459032,0.890540968,897.0497067,1014.118766,1560.343162,1749.060694,3161,229.8909091,6322,-1441280,177152,-1264128,84
2652,314,22,8,0.105866487,0.894133513,844.1786429,906.9097816,1451.167044,1756.579618,2966,348.9411765,5932,-1357824,160768,-1197056,84
2805,341,23,7,0.108391608,0.891608392,890.204702,1022.682055,1549.233512,1773.111437,3146,196.0124611,6292,-1436160,174592,-1261568,84
2971,324,23,7,0.0983308042,0.901669196,942.0036542,1025.036303,1635.99798,1758.055556,3295,356.2162162,6590,-1521152,165888,-1355264,84
2961,338,22,8,0.102455289,0.897544711,936.59501,1072.676484,1635.963526,1772.964497,3299,349.1005291,6598,-1516032,173056,-1342976,84
2961,333,23,7,0.101092896,0.898907104,939.7238678,1041.793102,1638.782506,1725.015015,3294,290.9893993,6588,-1516032,170496,-1345536,84
2710,330,23,7,0.108552632,0.891447368,865.7751205,953.9850865,1500.94059,1681.124242,3040,316.008316,6080,-1387520,168960,-1218560,84
2978,346,23,7,0.104091456,0.895908544,951.0761796,1027.032559,1654.417394,1732.066474,3324,309.7856477,6648,-1524736,177152,-1347584,84
2960,337,23,7,0.102214134,0.897785866,940.7370478,1036.171772,1635.587162,1766.810089,3297,247.7084899,6594,-1515520,172544,-1342976,84
2846,361,23,7,0.112566261,0.887433739,905.658067,1046.226177,1576.483837,1820.927978,3207,251.5294118,6414,-1457152,184832,-1272320,84
805,85,23,7,0.095505618,0.904494382,246.9578415,291.3609697,462.5006211,284.4941176,890,13.90190565,1780,-412160,43520,-368640,84
2429,292,23,7,0.107313488,0.892686512,767.0813686,917.737339,1348.337999,1466.328767,2721,50.86932137,5442,-1243648,149504,-1094144,84
2433,264,23,7,0.0978865406,0.902113459,767.837636,871.1204374,1348.181669,1356.541667,2697,245.1818182,5394,-1245696,135168,-1110528,84
2419,239,23,7,0.089917231,0.910082769,761.729093,818.7963376,1323.170318,1393.564854,2658,254.354067,5316,-1238528,122368,-1116160,84
2450,254,22,8,0.0939349112,0.906065089,767.8790306,891.9719176,1358.212245,1297.401575,2704,179.6677741,5408,-1254400,130048,-1124352,84
2848,322,23,7,0.101577287,0.898422713,907.7597953,977.6090036,1586.132374,1579.906832,3170,107.8231293,6340,-1458176,164864,-1293312,84
1055,113,23,7,0.0967465753,0.903253425,323.3574973,428.7026739,597.0066351,467.7345133,1168,26.74604992,2336,-540160,57856,-482304,84
3024,326,23,7,0.0973134328,0.902686567,964.8708891,986.021447,1680.336971,1630.631902,3350,252.8301887,6700,-1548288,166912,-1381376,84
2213,274,24,6,0.110172899,0.889827101,699.6001214,845.739467,1232.279711,1338.660584,2487,198.96,4974,-1133056,140288,-992768,84
2261,262,23,7,0.103844629,0.896155371,709.46621,859.0949123,1244.162318,1415.935115,2523,199.4466403,5046,-1157632,134144,-1023488,84
2238,261,23,7,0.104441777,0.895558223,708.9812991,808.1964298,1234.572386,1382.287356,2499,446.25,4998,-1145856,133632,-1012224,84
1616,132,23,7,0.0755148741,0.924485126,497.7088531,561.5032413,886.6540842,725.7045455,1748,109.318324,3496,-827392,67584,-759808,84
2428,294,23,7,0.108008817,0.891991183,771.7627424,890.6309724,1353.881384,1424.418367,2722,112.0625772,5444,-1243136,150528,-1092608,84
3020,308,22,8,0.0925480769,0.907451923,958.1635815,977.5906671,1676.480795,1547.025974,3328,217.6586004,6656,-1546240,157696,-1388544,84
2450,283,23,7,0.103549213,0.896450787,775.7657997,894.4779862,1363.660816,1395.908127,2733,228.8944724,5466,-1254400,144896,-1109504,84
2228,252,23,7,0.101612903,0.898387097,701.2622791,825.4841535,1227.504937,1355.392857,2480,209.9915326,4960,-1140736,129024,-1011712,84
2440,267,23,7,0.0986331733,0.901366827,771.4556025,864.8320932,1347.061066,1417.411985,2707,246.0909091,5414,-1249280,136704,-1112576,84
2218,251,23,7,0.101660591,0.898339409,699.1272388,812.7669733,1220.922002,1359.40239,2469,128.7949922,4938,-1135616,128512,-1007104,84
2423,268,23,7,0.09959123,0.90040877,767.30225,857.7526313,1348.68799,1321.697761,2691,333.8709677,5382,-1240576,137216,-1103360,84
2619,287,22,8,0.0987611838,0.901238816,827.4259992,937.0400882,1453.836197,1450.432056,2906,121.8959732,5812,-1340928,146944,-1193984,84
847,83,23,7,0.0892473118,0.910752688,257.0634253,317.2755286,482.377804,293.2650602,930,14.44323653,1860,-433664,42496,-391168,84
2818,347,23,7,0.109636651,0.890363349,895.8305494,1038.41674,1567.233144,1711.043228,3165,273.3160622,6330,-1442816,177664,-1265152,84
2899,330,24,6,0.102198823,0.897801177,922.9328648,1005.066696,1604.983788,1702.990909,3229,206.8545804,6458,-1484288,168960,-1315328,84
2700,298,23,7,0.0993995997,0.9006004,853.4151838,952.1988049,1481.445556,1663.080537,2998,154.218107,5996,-1382400,152576,-1229824,84
3081,337,23,7,0.09859567,0.90140433,976.1067914,1076.464156,1702.360597,1774.771513,3418,233.6295284,6836,-1577472,172544,-1404928,84
3091,331,22,8,0.0967270602,0.90327294,980.7296955,1049.442889,1704.065675,1780.924471,3422,218.1007011,6844,-1582592,169472,-1413120,84
3051,339,23,7,0.1,0.9,972.7678315,1026.709202,1687.252376,1769.728614,3390,289.4961571,6780,-1562112,173568,-1388544,84
2852,306,23,7,0.0968967701,0.90310323,905.3190289,966.521466,1573.139201,1638.784314,3158,183.4979663,6316,-1460224,156672,-1303552,84
2925,332,23,7,0.101934295,0.898065705,925.2211075,1061.911588,1623.339487,1678.870482,3257,323.7574553,6514,-1497600,169984,-1327616,84
3067,328,23,7,0.0966126657,0.903387334,975.3575684,1022.231273,1694.223671,1733.310976,3395,325.5033557,6790,-1570304,167936,-1402368,84
3036,374,23,7,0.109677419,0.890322581,966.241467,1096.581052,1678.547431,1924.291444,3410,60.39674106,6820,-1554432,191488,-1362944,84
2951,318,23,7,0.0972774549,0.902722545,929.947801,1051.986367,1619.608607,1777.830189,3269,212.1349773,6538,-1510912,162816,-1348096,84
3066,335,23,7,0.098500441,0.901499559,974.560716,1044.591191,1696.287671,1744.128358,3401,331.804878,6802,-1569792,171520,-1398272,84
2980,339,22,8,0.102139199,0.897860801,949.5902792,1027.439455,1652.17651,1728.772861,3319,367.5526024,6638,-1525760,173568,-1352192,84
2946,330,23,7,0.100732601,0.899267399,928.7988659,1074.215636,1622.309912,1783.033333,3276,259.7938144,6552,-1508352,168960,-1339392,84
2888,328,23,7,0.10199005,0.89800995,913.9185843,1045.150533,1601.594529,1669.301829,3216,380.141844,6432,-1478656,167936,-1310720,84
2551,318,23,7,0.110840014,0.889159986,805.2121074,974.515848,1412.212074,1617.805031,2869,53.18872822,5738,-1306112,162816,-1143296,84
2850,314,23,7,0.0992414665,0.900758534,897.730946,1032.466474,1565.867018,1733.468153,3164,266.5543387,6328,-1459200,160768,-1298432,84
2886,333,23,7,0.103448276,0.896551724,918.7442692,1006.425532,1595.025295,1739.780781,3219,316.519174,6438,-1477632,170496,-1307136,84
3056,319,23,7,0.0945185185,0.905481481,963.6747948,1069.184762,1682.626963,1739.473354,3375,283.8519765,6750,-1564672,163328,-1401344,84
2860,321,23,7,0.100911663,0.899088337,899.5246858,1059.586783,1574.446154,1738.489097,3181,255.9131134,6362,-1464320,164352,-1299968,84
4479,395,23,7,0.0810422651,0.918957735,1398.548913,1485.883602,2454.563965,2244.007595,4874,85.41885734,9748,-2293248,202240,-2091008,84
159,51,22,8,0.242857143,0.757142857,62.89355786,52.26151965,107.8113208,98.29411765,210,7.258900795,420,-81408,26112,-55296,84
62,8,23,7,0.114285714,0.885714286,19.38438605,18.13792643,37.70967742,18.375,70,29.16666667,140,-31744,4096,-27648,84
3841,400,24,6,0.094317378,0.905682622,1217.480565,1287.472971,2118.844311,2141.7,4241,324.7320061,8482,-1966592,204800,-1761792,84
2901,354,22,8,0.10875576,0.89124424,919.4608068,1066.927874,1601.735608,1843.234463,3255,372.8522337,6510,-1485312,181248,-1304064,84
6227,462,22,8,0.0690686201,0.93093138,1931.436368,1782.996037,3396.821744,2646.528139,6689,621.6542751,13378,-3188224,236544,-2951680,84
3981,397,22,8,0.0906806761,0.909319324,1264.217579,1257.407396,2196.915348,2115.141058,4378,506.712963,8756,-2038272,203264,-1835008,84
6179,449,22,8,0.0677429089,0.932257091,1908.626929,1882.49177,3356.883153,2731.23608,6628,118.866571,13256,-3163648,229888,-2933760,84
6575,462,23,7,0.0656529771,0.934347023,2027.772585,1911.009237,3575.198023,2719.212121,7037,536.3567073,14074,-3366400,236544,-3129856,84
4342,379,23,7,0.0802796018,0.919720398,1359.047548,1387.164091,2379.943114,2143.978892,4721,637.972973,9442,-2223104,194048,-2029056,84
4595,409,24,6,0.0817346123,0.918265388,1447.235402,1380.231807,2528.615452,2209.100244,5004,256.352459,10008,-2352640,209408,-2143232,84
2217,160,23,7,0.0673117375,0.932688263,676.8314565,760.3679746,1207.342355,934.84375,2377,207.9615048,4754,-1135104,81920,-1053184,84
4108,373,24,6,0.0832403481,0.916759652,1291.361648,1295.913262,2261.624635,2013.852547,4481,383.9760069,8962,-2103296,190976,-1912320,84
5434,394,23,7,0.0676046671,0.932395333,1680.644556,1640.242694,2947.445344,2460.121827,5828,350.8729681,11656,-2782208,201728,-2580480,84
5484,431,23,7,0.0728655959,0.927134404,1703.772865,1684.904988,2994.999818,2487.218097,5915,490.8713693,11830,-2807808,220672,-2587136,84
130,41,24,6,0.239766082,0.760233918,51.40807905,42.2241265,86.13076923,85.58536585,171,8.23699422,342,-66560,20992,-45568,84
9413,543,22,8,0.0545399759,0.945460024,2859.177778,2849.993708,5049.798683,3742.524862,9956,856.0619089,19912,-4819456,278016,-4541440,84
3936,377,23,7,0.0874101553,0.912589845,1236.209459,1327.837645,2168.638211,2035.493369,4313,379.3315743,8626,-2015232,193024,-1822208,84
1914,146,23,7,0.0708737864,0.929126214,583.2834782,700.0702431,1045.091432,839.2123288,2060,36.6417645,4120,-979968,74752,-905216,84
834,82,23,7,0.0895196507,0.910480349,254.7704235,330.5918703,468.6127098,355.6463415,916,14.0018343,1832,-427008,41984,-385024,84
2474,245,23,7,0.0901066569,0.909893343,783.3909231,794.6417979,1351.217462,1448.685714,2719,291.7381974,5438,-1266688,125440,-1141248,84
2423,260,23,7,0.096906448,0.903093552,764.902801,858.887115,1342.968221,1332.976923,2683,372.1220527,5366,-1240576,133120,-1107456,84
210,63,23,7,0.230769231,0.769230769,79.03441729,76.02669897,141.6428571,121.5238095,273,4.808877928,546,-107520,32256,-75264,84
2518,283,23,7,0.101035345,0.898964655,795.2623362,918.5252425,1402.274821,1389.657244,2801,115.2674897,5602,-1289216,144896,-1144320,84
2212,252,23,7,0.102272727,0.897727273,695.9612329,829.62927,1223.421338,1312.190476,2464,238.0676329,4928,-1132544,129024,-1003520,84
2300,258,23,7,0.100860047,0.899139953,729.2481526,814.6816054,1275.086957,1318.841085,2558,119.9249883,5116,-1177600,132096,-1045504,84
2383,237,23,7,0.0904580153,0.909541985,751.6917539,800.3232212,1306.445657,1351.265823,2620,229.020979,5240,-1220096,121344,-1098752,84
2240,277,23,7,0.110051649,0.889948351,709.7364496,834.827666,1239.895089,1413.494585,2517,43.91903682,5034,-1146880,141824,-1005056,84
2551,270,23,7,0.0957107409,0.904289259,807.7342316,873.3975002,1406.757742,1451.081481,2821,228.236246,5642,-1306112,138240,-1167872,84
2448,250,24,6,0.0926612305,0.907338769,770.3583857,857.3152614,1347.659314,1367.524,2698,259.1738713,5396,-1253376,128000,-1125376,84
2375,314,23,7,0.116772034,0.883227966,753.3535034,910.338029,1320.552421,1529.914013,2689,47.29991205,5378,-1216000,160768,-1055232,84
2545,274,23,7,0.0971975878,0.902802412,804.1488238,898.2287879,1410.900982,1401.631387,2819,329.7076023,5638,-1303040,140288,-1162752,84
2200,259,23,7,0.105327369,0.894672631,696.4045502,804.2956549,1215.214545,1355.590734,2459,206.1190277,4918,-1126400,132608,-993792,84
2257,267,23,7,0.105784469,0.894215531,709.9510777,858.2584186,1246.19362,1400.340824,2524,60.49856184,5048,-1155584,136704,-1018880,84
2424,264,23,7,0.0982142857,0.901785714,764.9950024,869.4813593,1340.862624,1377.897727,2688,227.9898219,5376,-1241088,135168,-1105920,84
2403,255,23,7,0.0959367946,0.904063205,764.9985488,783.7246338,1320.627549,1413.109804,2658,183.6903939,5316,-1230336,130560,-1099776,84
2226,271,23,7,0.108530236,0.891469764,698.64234,874.1652504,1235.389488,1360.797048,2497,184.2804428,4994,-1139712,138752,-1000960,84
2538,286,22,8,0.101274788,0.898725212,800.5776303,932.6866293,1405.247045,1476.863636,2824,197.4825175,5648,-1299456,146432,-1153024,84
2231,260,23,7,0.104375753,0.895624247,707.7024741,808.9196399,1240.883012,1289.907692,2491,350.3516174,4982,-1142272,133120,-1009152,84
2285,281,23,7,0.109508963,0.890491037,723.1152998,866.1499546,1272.939168,1369.377224,2566,109.0059473,5132,-1169920,143872,-1026048,84
3930,314,23,7,0.0739868049,0.926013195,1224.021047,1170.381369,2153.76743,1731.159236,4244,292.0853407,8488,-2012160,160768,-1851392,84
2702,270,23,7,0.0908479139,0.909152086,853.6743887,899.3583481,1488.222428,1469.262963,2972,182.2194972,5944,-1383424,138240,-1245184,84
2833,270,24,6,0.0870125685,0.912987432,889.9853126,946.911489,1562.745146,1439.255556,3103,336.5509761,6206,-1450496,138240,-1312256,84
2748,258,23,7,0.0858283433,0.914171657,864.8182869,895.8502501,1509.649927,1437.996124,3006,290.9970958,6012,-1406976,132096,-1274880,84
3020,303,23,7,0.0911826663,0.908817334,955.8034689,984.1561194,1674.742715,1534.993399,3323,282.5680272,6646,-1546240,155136,-1391104,84
2710,247,23,7,0.0835306053,0.916469395,847.1262097,917.0198906,1487.166052,1389.404858,2957,259.1586328,5914,-1387520,126464,-1261056,84
2748,267,23,7,0.0885572139,0.911442786,864.9557603,920.7337763,1515.308224,1432.782772,3015,305.1619433,6030,-1406976,136704,-1270272,84
2214,158,23,7,0.0666104553,0.933389545,672.8077542,782.876118,1206.351852,908.3227848,2372,323.6016371,4744,-1133568,80896,-1052672,84
2722,284,23,7,0.0944777112,0.905522289,861.2208314,928.074557,1503.413299,1504.330986,3006,259.3615186,6012,-1393664,145408,-1248256,84
2743,256,23,7,0.0853617873,0.914638213,863.1961473,885.3103926,1510.094058,1391.84375,2999,269.6942446,5998,-1404416,131072,-1273344,84
3565,305,23,7,0.0788113695,0.92118863,1118.23564,1061.745651,1960.541094,1642.806557,3870,328.5229202,7740,-1825280,156160,-1669120,84
2106,139,23,7,0.0619153675,0.938084633,639.1829643,708.867518,1142.278253,830.9136691,2245,173.6272235,4490,-1078272,71168,-1007104,84
2811,235,23,7,0.0771503611,0.922849639,877.2800409,903.1498483,1523.044468,1528.948936,3046,53.46673688,6092,-1439232,120320,-1318912,84
4135,315,23,7,0.0707865169,0.929213483,1282.15004,1227.020767,2260.511729,1765.901587,4450,346.3035019,8900,-2117120,161280,-1955840,84
2963,285,24,6,0.0877463054,0.912253695,933.205265,976.3006095,1634.465407,1520.894737,3248,288.9679715,6496,-1517056,145920,-1371136,84
3038,281,23,7,0.0846640554,0.915335945,953.2528509,1002.26014,1670.426267,1547.27758,3319,246.3994061,6638,-1555456,143872,-1411584,84
4124,391,23,7,0.0866002215,0.913399779,1292.896916,1404.002883,2247.169496,2372.232737,4515,219.4944093,9030,-2111488,200192,-1911296,84
4104,301,23,7,0.0683314415,0.931668558,1266.868195,1275.86608,2230.729045,1824.92691,4405,400.0908265,8810,-2101248,154112,-1947136,84
4121,323,23,7,0.0726822682,0.927317732,1281.791015,1209.829082,2257.696433,1773.44582,4444,651.6129032,8888,-2109952,165376,-1944576,84
3326,303,23,7,0.0834940755,0.916505924,1049.438314,990.9030759,1838.614251,1555.788779,3629,236.8798956,7258,-1702912,155136,-1547776,84
2701,350,23,7,0.114716486,0.885283514,867.9426728,941.5788639,1495.653832,1760.185714,3051,284.0782123,6102,-1382912,179200,-1203712,84
2820,346,23,7,0.109286166,0.890713834,892.5401337,1048.91707,1557.548227,1795.014451,3166,232.6230713,6332,-1443840,177152,-1266688,84
585,80,23,7,0.120300752,0.879699248,188.1051082,177.9550575,349.1846154,214.65,665,11.78451178,1330,-299520,40960,-258560,84
2933,343,23,7,0.104700855,0.895299145,936.3592846,1014.842764,1625.055574,1753.463557,3276,301.9354839,6552,-1501696,175616,-1326080,84
3018,340,23,7,0.101250744,0.898749256,965.0659814,1002.932889,1670.111001,1762.841176,3358,155.5349699,6716,-1545216,174080,-1371136,84
3048,357,23,7,0.104845815,0.895154185,972.8512188,1061.207066,1692.812008,1789.983193,3405,313.2474701,6810,-1560576,182784,-1377792,84
2944,346,23,7,0.105167173,0.894832827,942.9540541,997.654326,1631.439198,1765.138728,3290,340.2275078,6580,-1507328,177152,-1330176,84
2959,366,22,8,0.110075188,0.889924812,946.2448635,1058.332516,1650.867523,1761.087432,3325,261.1940299,6650,-1515008,187392,-1327616,84
2819,340,23,7,0.107628997,0.892371003,897.1602819,1009.635532,1559.084072,1753.417647,3159,227.1028037,6318,-1443328,174080,-1269248,84
2898,338,23,7,0.104449938,0.895550062,924.7841663,1007.615296,1609.484127,1695.801775,3236,92.2200057,6472,-1483776,173056,-1310720,84
3032,359,23,7,0.105868475,0.894131525,966.2081625,1073.786863,1682.906662,1806.582173,3391,457.6248313,6782,-1552384,183808,-1368576,84
2812,321,23,7,0.102457708,0.897542292,897.9063078,957.9891569,1561.018137,1619.401869,3133,99.14556962,6266,-1439744,164352,-1275392,84
2790,325,23,7,0.104333868,0.895666132,886.2133924,993.8111397,1542.275986,1692.984615,3115,328.9334741,6230,-1428480,166400,-1262080,84
2712,355,23,7,0.115748288,0.884251712,868.8269693,993.4192201,1517.194322,1662.385915,3067,79.00566718,6134,-1388544,181760,-1206784,84
2778,306,23,7,0.0992217899,0.90077821,879.7151695,944.3907555,1514.764939,1794.29085,3084,226.7647059,6168,-1422336,156672,-1265664,84
1877,118,23,7,0.0591478697,0.94085213,572.7093046,621.5062055,1001.76878,938.0508475,1995,171.3917526,3990,-961024,60416,-900608,84
2976,363,23,7,0.108715184,0.891284816,954.4127571,1035.213387,1660.788978,1745.515152,3339,188.8574661,6678,-1523712,185856,-1337856,84
2945,347,21,9,0.105407047,0.894592953,945.4332311,971.698097,1624.916469,1829.680115,3292,285.2686308,6584,-1507840,177664,-1330176,84
3017,349,24,6,0.103683898,0.896316102,963.5395056,1034.06494,1671.97945,1783.091691,3366,371.9337017,6732,-1544704,178688,-1366016,84
2756,338,22,8,0.109243697,0.890756303,878.4533151,988.9286148,1526.725327,1716.893491,3094,333.7648328,6188,-1411072,173056,-1238016,84
4258,588,20,10,0.121337185,0.878662815,1348.360078,1547.046536,2325.816581,3130.87415,4846,116.2667946,9692,-2180096,301056,-1879040,85
3972,539,20,10,0.119485702,0.880514298,1276.606366,1342.668249,2177.543051,2834.165121,4511,112.0466965,9022,-2033664,275968,-1757696,85
4291,522,20,10,0.108456264,0.891543736,1365.49696,1409.959128,2327.123048,3063.613027,4813,101.6473073,9626,-2196992,267264,-1929728,85
3919,503,20,10,0.113749435,0.886250565,1252.720508,1337.25087,2144.194182,2735.89662,4422,117.0150834,8844,-2006528,257536,-1748992,85
3973,519,20,10,0.115538736,0.884461264,1253.613988,1448.160314,2166.308331,2860.375723,4492,125.1950948,8984,-2034176,265728,-1768448,85
4075,540,20,10,0.117009751,0.882990249,1302.478719,1410.096762,2231.430184,2885.818519,4615,122.4787686,9230,-2086400,276480,-1809920,85
4360,512,20,10,0.105090312,0.894909688,1379.799978,1456.843648,2358.947018,3096.912109,4872,120.923306,9744,-2232320,262144,-1970176,85
4009,560,20,10,0.122565113,0.877434887,1292.722714,1347.910063,2200.883762,2887.182143,4569,115.7881399,9138,-2052608,286720,-1765888,85
4148,555,20,10,0.118009781,0.881990219,1314.14456,1445.249438,2252.821601,3093.246847,4703,115.9230959,9406,-2123776,284160,-1839616,85
3992,499,21,9,0.111111111,0.888888889,1256.493718,1406.821962,2161.22495,2924.200401,4491,129.2374101,8982,-2043904,255488,-1788416,85
4237,559,20,10,0.116555463,0.883444537,1335.104066,1488.401845,2293.321926,3195.708408,4796,118.3029107,9592,-2169344,286208,-1883136,85
4000,543,20,10,0.119524543,0.880475457,1268.239827,1421.94861,2180.22325,2948.071823,4543,108.4765998,9086,-2048000,278016,-1769984,85
4032,516,20,10,0.113456464,0.886543536,1285.812759,1344.2016,2192.177827,2917.761628,4548,121.9629928,9096,-2064384,264192,-1800192,85
4216,567,20,10,0.118544846,0.881455154,1358.259687,1377.280366,2305.693548,3033.742504,4783,152.9581068,9566,-2158592,290304,-1868288,85
3937,532,20,10,0.119042291,0.880957709,1262.976981,1351.24506,2159.88951,2790.845865,4469,83.45471522,8938,-2015744,272384,-1743360,85
4154,544,20,10,0.115793955,0.884206045,1314.984761,1477.688254,2262.748195,3011.939338,4698,91.24101767,9396,-2126848,278528,-1848320,85
3848,512,20,10,0.117431193,0.882568807,1219.379357,1333.60032,2088.941008,2868.623047,4360,100.4608295,8720,-1970176,262144,-1708032,85
4067,520,20,10,0.113363854,0.886636146,1280.962671,1439.191829,2203.736661,2999.963462,4587,131.5834768,9174,-2082304,266240,-1816064,85
4080,532,19,11,0.115351258,0.884648742,1303.63108,1387.609362,2228.198039,2907.011278,4612,106.6358382,9224,-2088960,272384,-1816576,85
4023,516,20,10,0.113681428,0.886318572,1268.48354,1398.950582,2176.428287,2999.532946,4539,99.84601848,9078,-2059776,264192,-1795584,85
3325,395,20,10,0.106182796,0.893817204,1053.03419,1190.363784,1823.369023,2173.058228,3720,78.18411097,7440,-1702400,202240,-1500160,85
3452,485,20,10,0.123190246,0.876809754,1097.211974,1227.84373,1884.872538,2567.779381,3937,69.94137502,7874,-1767424,248320,-1519104,85
3713,568,20,10,0.132679281,0.867320719,1186.619804,1313.322997,2032.359817,2851.177817,4281,74.81649773,8562,-1901056,290816,-1610240,85
3460,480,20,10,0.121827411,0.878172589,1105.672453,1172.63851,1885.130058,2585.875,3940,86.02620087,7880,-1771520,245760,-1525760,85
3787,563,20,10,0.129425287,0.870574713,1235.835958,1230.980461,2088.310536,2761.976909,4350,114.4435675,8700,-1938944,288256,-1650688,85
2439,181,20,10,0.0690839695,0.930916031,749.774525,838.3816634,1313.833948,1265.574586,2620,385.8615611,5240,-1248768,92672,-1156096,85
3366,466,20,10,0.121607516,0.878392484,1078.620928,1144.425195,1839.818479,2470.38412,3832,105.3905391,7664,-1723392,238592,-1484800,85
3555,555,20,10,0.135036496,0.864963504,1148.703995,1242.655604,1960.494796,2664.046847,4110,78.18147232,8220,-1820160,284160,-1536000,85
3869,566,20,10,0.127621195,0.872378805,1242.423151,1368.936231,2129.677436,2821.745583,4435,107.2032874,8870,-1980928,289792,-1691136,85
3269,480,20,10,0.128034142,0.871965858,1048.451669,1159.052216,1797.657082,2401.7375,3749,89.09220532,7498,-1673728,245760,-1427968,85
3778,521,20,10,0.121190975,0.878809025,1204.095006,1312.340137,2061.138168,2794.3762,4299,87.00667881,8598,-1934336,266752,-1667584,85
3687,521,20,10,0.123811787,0.876188213,1195.517436,1185.728848,2021.094657,2694.740883,4208,107.1828833,8416,-1887744,266752,-1620992,85
3592,557,20,10,0.134249217,0.865750783,1162.82208,1251.817826,1983.906737,2662.445242,4149,92.8603402,8298,-1839104,285184,-1553920,85
3793,509,20,10,0.118317062,0.881682938,1219.039478,1237.201555,2068.827577,2767.563851,4302,112.7063139,8604,-1942016,260608,-1681408,85
3597,510,20,10,0.124178232,0.875821768,1150.484323,1264.130559,1971.563247,2635.421569,4107,138.2828283,8214,-1841664,261120,-1580544,85
3559,537,20,10,0.131103516,0.868896484,1149.64759,1192.631203,1950.838438,2695.757914,4096,93.23924425,8192,-1822208,274944,-1547264,85
3531,558,20,10,0.136463683,0.863536317,1137.170052,1209.482698,1934.680261,2743.098566,4089,71.8250483,8178,-1807872,285696,-1522176,85
3851,533,20,10,0.121578467,0.878421533,1242.93909,1276.52049,2112.330304,2771.737336,4384,108.7301587,8768,-1971712,272896,-1698816,85
3949,556,20,10,0.123418424,0.876581576,1279.961857,1285.85368,2168.192201,2855.348921,4505,110.0659663,9010,-2021888,284672,-1737216,85
3606,494,20,10,0.120487805,0.879512195,1148.362788,1246.266498,1964.610926,2677.455466,4100,104.9667179,8200,-1846272,252928,-1593344,85
3861,501,20,10,0.114855571,0.885144429,1223.14272,1324.586929,2093.39368,2860.499002,4362,105.8737864,8724,-1976832,256512,-1720320,85
3639,540,20,10,0.129217516,0.870782484,1161.193544,1307.554044,1995.424292,2727.335185,4179,73.96460177,8358,-1863168,276480,-1586688,85
3759,532,19,11,0.123980424,0.876019576,1216.752539,1260.272467,2070.255387,2681.195489,4291,104.3023821,8582,-1924608,272384,-1652224,85
3708,511,20,10,0.121118749,0.878881251,1198.558828,1226.125351,2036.979234,2639.864971,4219,107.8752237,8438,-1898496,261632,-1636864,85
3786,494,20,10,0.115420561,0.884579439,1197.644665,1303.621034,2050.857898,2827.51417,4280,103.2071377,8560,-1938432,252928,-1685504,85
3654,500,20,10,0.120365912,0.879634088,1180.914542,1182.56653,2000.840175,2637.73,4154,105.0581689,8308,-1870848,256000,-1614848,85
3757,492,20,10,0.115791951,0.884208049,1186.720275,1294.572437,2032.591696,2830.646341,4249,119.052956,8498,-1923584,251904,-1671680,85
3810,537,20,10,0.123533471,0.876466529,1217.891211,1325.077424,2083.764829,2814.216015,4347,100.8818751,8694,-1950720,274944,-1675776,85
3653,483,20,10,0.116779497,0.883220503,1162.982563,1280.095786,1996.140159,2615.768116,4136,99.01843428,8272,-1870336,247296,-1623040,85
3728,536,20,10,0.125703565,0.874296435,1209.616732,1201.736526,2044.095762,2747.371269,4264,109.4175006,8528,-1908736,274432,-1634304,85
3523,522,20,10,0.129048208,0.870951792,1127.648571,1242.170136,1931.190463,2642.626437,4045,99.16646237,8090,-1803776,267264,-1536512,85
43,14,20,10,0.245614035,0.754385965,16.91143858,13.46745889,30.8372093,23.35714286,57,2.434856899,114,-22016,7168,-14848,85
3811,529,20,10,0.121889401,0.878110599,1232.137137,1221.39299,2083.375492,2798.15879,4340,113.1681877,8680,-1951232,270848,-1680384,85
3877,573,20,10,0.128764045,0.871235955,1263.787717,1311.727925,2151.401341,2726.862129,4450,96.92877369,8900,-1985024,293376,-1691648,85
3863,509,20,10,0.11642269,0.88357731,1227.480125,1325.244859,2099.758996,2844.811395,4372,122.0206531,8744,-1977856,260608,-1717248,85
3577,467,20,10,0.115479723,0.884520277,1133.307257,1246.613989,1943.915013,2624.423983,4044,107.868765,8088,-1831424,239104,-1592320,85
1976,149,20,10,0.0701176471,0.929882353,607.8252704,672.8561166,1071.730263,947.2214765,2125,34.11462514,4250,-1011712,76288,-935424,85
2228,178,19,11,0.0739817124,0.926018288,691.9757647,703.3252249,1217.349641,1030.146067,2406,38.33652008,4812,-1140736,91136,-1049600,85
2111,164,20,10,0.0720879121,0.927912088,652.9112398,698.8843242,1144.410232,1055.487805,2275,34.95160547,4550,-1080832,83968,-996864,85
2169,169,20,10,0.0722840034,0.927715997,670.8826418,717.530547,1177.170586,1071.053254,2338,35.88090853,4676,-1110528,86528,-1024000,85
3709,556,20,10,0.130363423,0.869636577,1207.831655,1200.446655,2038.705851,2762.023381,4265,107.3766365,8530,-1899008,284672,-1614336,85
4033,588,20,10,0.127245185,0.872754815,1311.9795,1329.455507,2223.6727,2909.964286,4621,111.6723055,9242,-2064896,301056,-1763840,85
3685,545,20,10,0.128841608,0.871158392,1200.809851,1173.152508,2023.210312,2739.513761,4230,128.0266344,8460,-1886720,279040,-1607680,85
3731,533,20,10,0.125,0.875,1192.904862,1258.971986,2031.172608,2841.791745,4264,112.0042028,8528,-1910272,272896,-1637376,85
3739,558,20,10,0.12985804,0.87014196,1204.990389,1260.389762,2047.56352,2828.697133,4297,110.5764282,8594,-1914368,285696,-1628672,85
3357,462,20,10,0.120974077,0.879025923,1060.778543,1184.441826,1821.775693,2551.058442,3819,66.96475539,7638,-1718784,236544,-1482240,85
3714,514,20,10,0.121570482,0.878429518,1187.081715,1297.747899,2033.787291,2697.70428,4228,105.3313403,8456,-1901568,263168,-1638400,85
2710,203,20,10,0.0696876073,0.930312393,837.6176071,877.8871736,1464.309225,1359.423645,2913,296.3377416,5826,-1387520,103936,-1283584,85
3970,497,20,10,0.111260354,0.888739646,1250.74983,1388.683565,2148.81864,2914.422535,4467,126.4006791,8934,-2032640,254464,-1778176,85
3914,468,20,10,0.106800548,0.893199452,1229.908622,1360.347518,2113.10373,2847.147436,4382,93.03609342,8764,-2003968,239616,-1764352,85
3603,517,20,10,0.125485437,0.874514563,1157.768082,1208.778941,1968.522065,2701.499033,4120,99.66134494,8240,-1844736,264704,-1580032,85
3782,566,20,10,0.130174793,0.869825207,1214.448889,1285.056284,2066.758858,2894.424028,4348,141.7671992,8696,-1936384,289792,-1646592,85
3637,547,20,10,0.130736138,0.869263862,1169.533196,1252.234845,1993.756943,2749.042048,4184,84.25291986,8368,-1862144,280064,-1582080,85
3775,564,19,11,0.129983867,0.870016133,1229.407787,1235.895384,2079.032318,2778.870567,4339,112.7012987,8678,-1932800,288768,-1644032,85
3895,512,20,10,0.116178806,0.883821194,1247.915918,1284.304496,2122.547625,2823.642578,4407,112.4234694,8814,-1994240,262144,-1732096,85
3960,627,20,10,0.136690647,0.863309353,1287.597586,1294.253738,2172.572475,3060.910686,4587,83.06772908,9174,-2027520,321024,-1706496,85
3918,542,20,10,0.121524664,0.878475336,1244.165514,1411.091186,2142.624043,2865.736162,4460,90.3199676,8920,-2006016,277504,-1728512,85
3774,575,20,10,0.132214302,0.867785698,1254.318037,1132.556548,2095.712242,2695.403478,4349,102.2091657,8698,-1932288,294400,-1637888,85
4032,551,20,10,0.120226926,0.879773074,1282.121207,1432.684635,2203.474454,2939.794918,4583,109.930439,9166,-2064384,282112,-1782272,85
3994,516,20,10,0.114412417,0.885587583,1262.632293,1367.656816,2160.97321,2987.166667,4510,112.2728404,9020,-2044928,264192,-1780736,85
3737,517,20,10,0.121532675,0.878467325,1191.077695,1236.258762,2024.928017,2868.914894,4254,100.4249292,8508,-1913344,264704,-1648640,85
3859,477,19,11,0.110009225,0.889990775,1214.351788,1365.649676,2090.556621,2799.073375,4336,136.5669291,8672,-1975808,244224,-1731584,85
3901,508,20,10,0.11521887,0.88478113,1234.742945,1372.486133,2121.16483,2848.781496,4409,102.0601852,8818,-1997312,260096,-1737216,85
4063,558,20,10,0.120753084,0.879246916,1310.081925,1363.68836,2231.649028,2888.783154,4621,121.1588883,9242,-2080256,285696,-1794560,85
3903,526,20,10,0.1187627,0.8812373,1240.543186,1359.704785,2125.887266,2876.230038,4429,93.47826087,8858,-1998336,269312,-1729024,85
3700,510,20,10,0.121140143,0.878859857,1187.467291,1283.338829,2032.904595,2632.172549,4210,128.7461774,8420,-1894400,261120,-1633280,85
3674,482,20,10,0.115976901,0.884023099,1161.855312,1281.719264,1993.182363,2728.825726,4156,96.53890825,8312,-1881088,246784,-1634304,85
3861,508,20,10,0.116273747,0.883726253,1225.419867,1363.07474,2105.865579,2786.452756,4369,93.75536481,8738,-1976832,260096,-1716736,85
3978,539,20,10,0.119326987,0.880673013,1279.835995,1306.703694,2173.461036,2890.306122,4517,135.4829034,9034,-2036736,275968,-1760768,85
3718,508,20,10,0.120208235,0.879791765,1183.52647,1288.986201,2025.889457,2754.712598,4226,100.6909697,8452,-1903616,260096,-1643520,85
3947,564,20,10,0.12502771,0.87497229,1280.884751,1301.102449,2172.693438,2838.998227,4511,105.8671673,9022,-2020864,288768,-1732096,85
3986,540,20,10,0.11931065,0.88068935,1266.167598,1410.317266,2174.976668,2916.933333,4526,164.0449438,9052,-2040832,276480,-1764352,85
3997,525,20,10,0.116099071,0.883900929,1265.9136,1422.720769,2178.414811,2894.055238,4522,98.64746946,9044,-2046464,268800,-1777664,85
3857,512,20,10,0.117189288,0.882810712,1236.257498,1280.503484,2104.104745,2794.400391,4369,97.19688543,8738,-1974784,262144,-1712640,85
3955,515,20,10,0.115212528,0.884787472,1251.249621,1389.287334,2149.004298,2899.753398,4470,102.7822488,8940,-2024960,263680,-1761280,85
3909,508,20,10,0.115010188,0.884989812,1239.403089,1377.159084,2129.815042,2818.318898,4417,108.7931034,8834,-2001408,260096,-1741312,85
3886,502,20,10,0.114402917,0.885597083,1227.202435,1364.316124,2108.038857,2863.798805,4388,138.0742605,8776,-1989632,257024,-1732608,85
3678,504,20,10,0.120516499,0.879483501,1169.433561,1249.046718,1995.934475,2788.900794,4182,107.8669074,8364,-1883136,258048,-1625088,85
3767,532,20,10,0.123749709,0.876250291,1219.99056,1212.202162,2062.603929,2768.836466,4299,102.1382751,8598,-1928704,272384,-1656320,85
2357,170,20,10,0.0672734468,0.932726553,723.3564356,791.4714539,1275.883751,1099.235294,2527,39.62678375,5054,-1206784,87040,-1119744,85
3422,550,20,10,0.138469285,0.861530715,1108.03138,1187.420842,1886.865283,2606.409091,3972,121.6166565,7944,-1752064,281600,-1470464,85
3524,557,20,10,0.136486155,0.863513845,1160.426675,1131.794995,1951.881669,2604.829443,4081,102.6408451,8162,-1804288,285184,-1519104,85
3603,534,20,10,0.129079043,0.870920957,1160.074184,1221.532789,1973.47738,2713.509363,4137,103.1670823,8274,-1844736,273408,-1571328,85
3401,512,20,10,0.130845898,0.869154102,1096.427676,1166.788543,1867.697442,2550.199219,3913,101.7156226,7826,-1741312,262144,-1479168,85
3376,487,20,10,0.126067823,0.873932177,1081.365284,1173.504375,1848.770142,2508.969199,3863,94.12768031,7726,-1728512,249344,-1479168,85
3608,560,20,10,0.134357006,0.865642994,1184.66522,1164.742427,1995.929601,2655.146429,4168,100.0720288,8336,-1847296,286720,-1560576,85
3426,535,20,10,0.135066902,0.864933098,1109.042989,1157.43547,1882.073847,2614.497196,3961,113.5933467,7922,-1754112,273920,-1480192,85
2270,180,20,10,0.0734693878,0.926530612,708.1253491,692.8236277,1230.705286,1159.855556,2450,77.7284264,4900,-1162240,92160,-1070080,85
3672,515,20,10,0.122999761,0.877000239,1191.312725,1201.1619,2020.24183,2619.902913,4187,98.33255049,8374,-1880064,263680,-1616384,85
3489,551,20,10,0.136386139,0.863613861,1126.547976,1192.377497,1915.206076,2687.23412,4040,70.11454356,8080,-1786368,282112,-1504256,85
3463,488,20,10,0.123513035,0.876486965,1110.55897,1188.555463,1896.034941,2543.456967,3951,114.8212729,7902,-1773056,249856,-1523200,85
3488,503,20,10,0.126033576,0.873966424,1118.20115,1176.699011,1902.944954,2641.280318,3991,87.77215747,7982,-1785856,257536,-1528320,85
3305,491,20,10,0.129346681,0.870653319,1065.857589,1098.091911,1807.511649,2510.95723,3796,92.51767,7592,-1692160,251392,-1440768,85
3502,556,20,10,0.137013307,0.862986693,1161.549298,1110.062167,1950.70217,2525.81295,4058,114.4065407,8116,-1793024,284672,-1508352,85
3446,573,20,10,0.142572779,0.857427221,1114.838843,1207.414546,1900.193268,2670.373473,4019,72.20625225,8038,-1764352,293376,-1470976,85
3459,489,20,10,0.123860182,0.876139818,1109.659114,1193.466797,1895.953455,2530.108384,3948,95.77874818,7896,-1771008,250368,-1520640,85
3525,517,19,11,0.127906977,0.872093023,1148.947028,1148.685806,1943.50383,2553.29207,4042,94.97180451,8084,-1804800,264704,-1540096,85
3512,535,20,10,0.132196689,0.867803311,1151.634434,1149.854354,1946.792995,2530.824299,4047,85.48795944,8094,-1798144,273920,-1524224,85
42,14,20,10,0.25,0.75,16.61688143,13.46745889,30.21428571,23.35714286,56,2.223987292,112,-21504,7168,-14336,85
3534,545,19,11,0.133611179,0.866388821,1144.188305,1220.996221,1949.524052,2626.682569,4079,79.49717404,8158,-1809408,279040,-1530368,85
3554,546,20,10,0.133170732,0.866829268,1147.244356,1185.233884,1944.698368,2739.179487,4100,90.05051614,8200,-1819648,279552,-1540096,85
3624,480,20,10,0.116959064,0.883040936,1153.574507,1225.1534,1968.778974,2684.59375,4104,121.7442895,8208,-1855488,245760,-1609728,85
3628,506,20,10,0.122399613,0.877600387,1172.499758,1219.791928,1997.076351,2572.434783,4134,100.4373178,8268,-1857536,259072,-1598464,85
3592,483,20,10,0.118527607,0.881472393,1157.192482,1163.126543,1961.893653,2603.991718,4075,96.35847718,8150,-1839104,247296,-1591808,85
3359,491,20,10,0.127532468,0.872467532,1072.745114,1178.819329,1836.682048,2533.11609,3850,96.53961886,7700,-1719808,251392,-1468416,85
3699,526,20,10,0.124497041,0.875502959,1182.234109,1302.828093,2026.54339,2720.990494,4225,130.845463,8450,-1893888,269312,-1624576,85
3588,518,20,10,0.126156844,0.873843156,1146.40844,1261.579333,1963.828595,2674.621622,4106,87.52931145,8212,-1837056,265216,-1571840,85
3754,533,20,10,0.124329368,0.875670632,1217.064539,1219.59828,2060.151838,2734.555347,4287,92.11431027,8574,-1922048,272896,-1649152,85
3702,536,20,10,0.126474752,0.873525248,1188.24584,1258.967405,2024.066721,2778.630597,4238,102.6647287,8476,-1895424,274432,-1620992,85
3752,523,20,10,0.122339181,0.877660819,1197.869375,1293.489612,2047.364072,2788.221797,4275,100.6355932,8550,-1921024,267776,-1653248,85
3362,468,20,10,0.122193211,0.877806789,1072.096674,1155.466799,1831.802499,2516.762821,3830,121.896881,7660,-1721344,239616,-1481728,85
3789,489,20,10,0.11430575,0.88569425,1216.436095,1241.558034,2069.164951,2684.488753,4278,81.40818268,8556,-1939968,250368,-1689600,85
3633,555,20,10,0.13252149,0.86747851,1170.27526,1250.632112,1993.869529,2753.221622,4188,106.5648855,8376,-1860096,284160,-1575936,85
3678,523,20,10,0.124494168,0.875505832,1193.287692,1203.882186,2022.258836,2654.74761,4201,86.15668581,8402,-1883136,267776,-1615360,85
3627,513,20,10,0.123913043,0.876086957,1157.648218,1247.100925,1977.237662,2729.881092,4140,96.4360587,8280,-1857024,262656,-1594368,85
3752,503,20,10,0.118213866,0.881786134,1192.780314,1272.975576,2036.353145,2811.616302,4255,95.33945776,8510,-1921024,257536,-1663488,85
3676,558,19,11,0.131790269,0.868209731,1183.568616,1276.256566,2019.698041,2761.801075,4234,102.1225277,8468,-1882112,285696,-1596416,85
3724,485,20,10,0.115229271,0.884770729,1191.396905,1257.836364,2034.531418,2646.082474,4209,77.13029137,8418,-1906688,248320,-1658368,85
2066,165,20,10,0.0739578664,0.926042134,640.5331384,669.1693469,1127.732333,969.0969697,2231,35.17263125,4462,-1057792,84480,-973312,85
2054,174,20,10,0.0780969479,0.921903052,641.1087798,666.9965801,1114.403603,1115.637931,2228,32.52554745,4456,-1051648,89088,-962560,85
8121,675,23,7,0.076739427,0.923260573,2501.624368,2899.924499,4353.610639,4938.568889,8796,209.8282443,17592,-4157952,345600,-3812352,85
8261,675,23,7,0.0755371531,0.924462847,2556.438578,2797.345284,4426.549328,4981.914074,8936,311.2504354,17872,-4229632,345600,-3884032,85
8099,644,23,7,0.0736589271,0.926341073,2494.109627,2822.733944,4331.408692,4882.479814,8743,227.1499091,17486,-4146688,329728,-3816960,85
8393,748,22,8,0.0818291215,0.918170878,2619.868175,2807.350267,4533.019659,4997.161765,9141,221.9227968,18282,-4297216,382976,-3914240,85
3699,259,23,7,0.0654370894,0.934562911,1146.214065,1009.651688,2007.175453,1584.243243,3958,70.21465318,7916,-1893888,132608,-1761280,85
8252,688,23,7,0.0769574944,0.923042506,2546.42911,2912.961377,4427.668808,4984.225291,8940,234.5840987,17880,-4225024,352256,-3872768,85
7598,611,23,7,0.0744305031,0.925569497,2350.870232,2547.305929,4067.557252,4570.613748,8209,212.7235035,16418,-3890176,312832,-3577344,85
8269,662,23,7,0.0741238383,0.925876162,2571.38911,2632.371581,4435.879429,4842.234139,8931,209.8449248,17862,-4233728,338944,-3894784,85
8047,700,23,7,0.080027438,0.919972562,2497.311064,2822.271538,4364.99739,4477.491429,8747,178.9850624,17494,-4120064,358400,-3761664,85
8196,689,23,7,0.0775464266,0.922453573,2520.742521,2961.357095,4387.118716,5107.735849,8885,229.7646755,17770,-4196352,352768,-3843584,85
8042,648,23,7,0.0745684695,0.92543153,2482.687212,2772.203314,4309.790102,4788.677469,8690,218.12249,17380,-4117504,331776,-3785728,85
8421,687,23,7,0.075428195,0.924571805,2635.031132,2546.441167,4535.9753,4781.569141,9108,227.245509,18216,-4311552,351744,-3959808,85
8107,669,23,7,0.076230629,0.923769371,2490.789371,2925.817719,4335.126311,5035.286996,8776,206.2514689,17552,-4150784,342528,-3808256,85
8211,725,21,9,0.0811324978,0.918867502,2546.523423,2877.067373,4422.360248,4991.056552,8936,157.9356663,17872,-4204032,371200,-3832832,85
48,12,23,7,0.2,0.8,16.779087,18.73110159,31.5625,26.25,60,1.238134544,120,-24576,6144,-18432,85
8155,665,23,7,0.0753968254,0.924603175,2513.842741,2901.561873,4390.33366,4657.803008,8820,189.8815931,17640,-4175360,340480,-3834880,85
8231,680,22,8,0.0763101784,0.923689822,2537.103461,2849.894494,4390.656542,5246.944118,8911,224.2325113,17822,-4214272,348160,-3866112,85
1709,153,23,7,0.08216971,0.91783029,535.9877633,554.2603323,931.6922177,929.3529412,1862,29.78723404,3724,-875008,78336,-796672,85
1985,162,23,7,0.075454122,0.924545878,620.2736706,613.7317023,1074.549622,1067.265432,2147,34.22059292,4294,-1016320,82944,-933376,85
1657,154,23,7,0.0850358918,0.914964108,521.4659845,535.738772,902.9499095,938.8181818,1811,28.98527529,3622,-848384,78848,-769536,85
3480,532,20,10,0.132602193,0.867397807,1140.351935,1138.314104,1926.793103,2527.890977,4012,100.8800603,8024,-1781760,272384,-1509376,85
3599,537,20,10,0.12983559,0.87016441,1177.174516,1166.463718,1988.343984,2605.709497,4136,92.3626619,8272,-1842688,274944,-1567744,85
3271,495,20,10,0.131439193,0.868560807,1055.248979,1128.704695,1798.931519,2442.335354,3766,84.36379928,7532,-1674752,253440,-1421312,85
2486,223,20,10,0.0823181986,0.917681801,774.6024509,855.3124301,1346.970636,1444.511211,2709,142.2047244,5418,-1272832,114176,-1158656,85
3063,448,20,10,0.127598975,0.872401025,984.2386568,1067.52305,1682.704538,2257.125,3511,83.77475543,7022,-1568256,229376,-1338880,85
3316,495,19,11,0.129887169,0.870112831,1087.026815,1109.586285,1848.373341,2292.040404,3811,68.42010772,7622,-1697792,253440,-1444352,85
3552,533,19,11,0.130477356,0.869522644,1143.432179,1222.54299,1949.113176,2668.677298,4085,95.98214286,8170,-1818624,272896,-1545728,85
3342,509,20,10,0.132173461,0.867826539,1093.301749,1118.91811,1855.050569,2391.840864,3851,84.23009624,7702,-1711104,260608,-1450496,85
3369,507,20,10,0.130804954,0.869195046,1083.443368,1212.496534,1861.555654,2449.792899,3876,96.77902622,7752,-1724928,259584,-1465344,85
3373,515,20,10,0.132458848,0.867541152,1136.485544,996.7608399,1910.448562,2167.520388,3888,91.59010601,7776,-1726976,263680,-1463296,85
3471,528,20,10,0.132033008,0.867966992,1119.185601,1200.481642,1908.372515,2602.346591,3999,119.9460108,7998,-1777152,270336,-1506816,85
3450,531,20,10,0.133383572,0.866616428,1132.119125,1112.379235,1907.857681,2531.190207,3981,105.8776596,7962,-1766400,271872,-1494528,85
3372,485,20,10,0.125745398,0.874254602,1080.750141,1148.504094,1841.945136,2534.25567,3857,110.6743185,7714,-1726464,248320,-1478144,85
3345,477,20,10,0.124803768,0.875196232,1073.745552,1123.581654,1826.462481,2507.832285,3822,90.71920247,7644,-1712640,244224,-1468416,85
3403,512,20,10,0.130779055,0.869220945,1116.943455,1101.716959,1886.347047,2434.240234,3915,104.9597855,7830,-1742336,262144,-1480192,85
3430,482,20,10,0.123210634,0.876789366,1098.453481,1162.520676,1871.955977,2558.130705,3912,80.57672503,7824,-1756160,246784,-1509376,85
42,15,20,10,0.263157895,0.736842105,17.0365753,13.76856323,30.57142857,24.6,57,2.134831461,114,-21504,7680,-13824,85
3348,515,20,10,0.133316076,0.866683924,1084.242444,1149.768595,1845.655914,2493.320388,3863,84.52954048,7726,-1714176,263680,-1450496,85
2415,234,19,11,0.0883352208,0.911664779,754.5817126,861.9398389,1327.036853,1303.978632,2649,47.6953547,5298,-1236480,119808,-1116672,85
3642,540,20,10,0.129124821,0.870875179,1192.875366,1164.493136,2011.546129,2630.744444,4182,92.9746554,8364,-1864704,276480,-1588224,85
3618,548,20,10,0.131541047,0.868458953,1182.916844,1162.581998,1993.668325,2676.585766,4166,107.0125867,8332,-1852416,280576,-1571840,85
3690,518,20,10,0.123098859,0.876901141,1179.322716,1289.806965,2019.703252,2708.554054,4208,96.60238751,8416,-1889280,265216,-1624064,85
3683,528,20,10,0.125385894,0.874614106,1194.794616,1239.282908,2033.565572,2611.257576,4211,80.74784276,8422,-1885696,270336,-1615360,85
3589,530,20,10,0.128672008,0.871327992,1152.472257,1225.649819,1963.345222,2714.516981,4119,99.6371553,8238,-1837568,271360,-1566208,85
3597,520,20,10,0.126305562,0.873694438,1173.220253,1149.327034,1980.122324,2604.621154,4117,103.1829574,8234,-1841664,266240,-1575424,85
3475,505,20,10,0.126884422,0.873115578,1128.195722,1185.54355,1924.064173,2447.657426,3980,72.38995999,7960,-1779200,258560,-1520640,85
3710,565,20,10,0.132163743,0.867836257,1213.687694,1208.923013,2049.476819,2719.276106,4275,132.7639752,8550,-1899520,289280,-1610240,85
3663,527,20,10,0.125775656,0.874224344,1190.283305,1181.089127,2011.558013,2678.952562,4190,104.8024012,8380,-1875456,269824,-1605632,85
3920,574,19,11,0.127725857,0.872274143,1274.32071,1292.108712,2159.173724,2850.703833,4494,120.1604278,8988,-2007040,293888,-1713152,85
3645,566,20,10,0.134409879,0.865590121,1196.2379,1202.968761,2022.822771,2641.655477,4211,100.0712928,8422,-1866240,289792,-1576448,85
3652,532,20,10,0.127151052,0.872848948,1188.812596,1214.517431,2018.401698,2601.159774,4184,100.3357314,8368,-1869824,272384,-1597440,85
2586,230,20,10,0.0816761364,0.918323864,805.0148613,896.6779337,1406.805491,1427.552174,2816,74.04680515,5632,-1324032,117760,-1206272,85
3360,479,20,10,0.124772076,0.875227924,1075.400106,1169.461181,1839.613393,2483.881002,3839,81.28308279,7678,-1720320,245248,-1475072,85
3712,543,19,11,0.127614571,0.872385429,1207.734593,1197.523696,2039.730603,2731.418048,4255,100.9729473,8510,-1900544,278016,-1622528,85
3328,480,20,10,0.12605042,0.87394958,1064.47828,1165.175215,1822.174579,2475.289583,3808,83.78437844,7616,-1703936,245760,-1458176,85
3573,525,20,10,0.128111274,0.871888726,1147.877308,1188.556771,1948.323258,2738.08,4098,117.826337,8196,-1829376,268800,-1560576,85
3619,526,20,10,0.126899879,0.873100121,1154.338512,1267.011831,1976.076817,2739.853612,4145,93.39792699,8290,-1852928,269312,-1583616,85
3492,521,20,10,0.129828059,0.870171941,1139.230316,1138.527365,1925.631443,2552.372361,4013,97.49757046,8026,-1787904,266752,-1521152,85
3388,479,20,10,0.123868632,0.876131368,1080.699147,1197.467836,1853.99026,2499.914405,3867,119.3150262,7734,-1734656,245248,-1489408,85
3667,550,20,10,0.130424472,0.869575528,1180.51859,1262.03827,2012.311426,2753.649091,4217,106.8135765,8434,-1877504,281600,-1595904,85
2609,119,22,8,0.0436217009,0.956378299,776.831552,946.1550534,1377.959371,1069.411765,2728,278.0835882,5456,-1335808,60928,-1274880,86
2617,110,23,7,0.0403373671,0.959662633,779.002498,934.149989,1373.494077,1138.127273,2727,221.3474026,5454,-1339904,56320,-1283584,86
2609,106,22,8,0.0390423573,0.960957643,776.3843688,933.4024946,1364.419701,1199.990566,2715,239.6293027,5430,-1335808,54272,-1281536,86
2601,113,22,8,0.0416359617,0.958364038,774.1744491,951.7918773,1366.109573,1159.327434,2714,232.5621251,5428,-1331712,57856,-1273856,86
2603,107,20,10,0.0394833948,0.960516605,774.7258521,895.2137438,1368.102574,1048.915888,2710,213.2179386,5420,-1332736,54784,-1277952,86
2608,112,22,8,0.0411764706,0.958823529,776.8825261,909.9671816,1373.178298,1065.276786,2720,254.4434051,5440,-1335296,57344,-1277952,86
2605,108,22,8,0.0398083303,0.96019167,775.2334156,941.7485902,1363.425336,1202.018519,2713,210.8003108,5426,-1333760,55296,-1278464,86
2588,103,22,8,0.0382757339,0.961724266,770.1241948,896.9691092,1355.508114,1107.097087,2691,230.3938356,5382,-1325056,52736,-1272320,86
2602,108,22,8,0.0398523985,0.960147601,774.3268857,926.912099,1364.794005,1131.583333,2710,226.7782427,5420,-1332224,55296,-1276928,86
2606,108,22,8,0.0397936625,0.960206338,775.5607697,932.235957,1365.829624,1156.509259,2714,188.2108183,5428,-1334272,55296,-1278976,86
2622,111,22,8,0.0406147091,0.959385291,780.7870117,950.8934596,1372.993135,1225.432432,2733,129.957204,5466,-1342464,56832,-1285632,86
2605,118,23,7,0.0433345575,0.956665443,775.9088607,954.9072238,1372.499808,1130.20339,2723,216.9721116,5446,-1333760,60416,-1273344,86
2606,116,22,8,0.0426157237,0.957384276,775.8392196,942.5462212,1373.630468,1088.982759,2722,222.5674571,5444,-1334272,59392,-1274880,86
2602,109,23,7,0.0402065658,0.959793434,774.489174,913.0010781,1367.6299,1078.376147,2711,191.1847673,5422,-1332224,55808,-1276416,86
2605,114,22,8,0.0419271791,0.958072821,775.4667859,956.6987946,1368.28714,1170.631579,2719,220.5190592,5438,-1333760,58368,-1275392,86
2614,116,21,9,0.0424908425,0.957509158,778.2635438,941.3987564,1377.892119,1086.25,2730,237.5979112,5460,-1338368,59392,-1278976,86
2607,110,22,8,0.04048583,0.95951417,776.0757908,912.3382182,1371.266206,1068.290909,2717,205.677517,5434,-1334784,56320,-1278464,86
2601,112,22,8,0.0412827129,0.958717287,774.4083986,897.6929082,1371.885044,1011.321429,2713,186.5887208,5426,-1331712,57344,-1274368,86
2620,126,22,8,0.0458849235,0.954115076,780.4463761,1001.51296,1381.109924,1215.261905,2746,217.418844,5492,-1341440,64512,-1276928,86
2601,110,21,9,0.0405754334,0.959424567,774.2054485,927.8837456,1366.18416,1115.190909,2711,296.6083151,5422,-1331712,56320,-1275392,86
445,21,23,7,0.0450643777,0.954935622,132.711442,147.0945829,237.2786517,153.4285714,466,51.09649123,932,-227840,10752,-217088,86
428,21,24,6,0.0467706013,0.953229399,127.7631149,145.4679056,228.5046729,153.5714286,449,53.26215896,898,-219136,10752,-208384,86
441,23,24,6,0.0495689655,0.950431034,131.6744039,169.1079677,234.031746,203.1304348,464,58.36477987,928,-225792,11776,-214016,86
438,20,24,6,0.0436681223,0.956331878,130.5930613,146.6363188,232.7511416,158.3,458,47.70833333,916,-224256,10240,-214016,86
443,25,23,7,0.0534188034,0.946581197,132.3088892,170.4108259,237.2099323,186.48,468,60.46511628,936,-226816,12800,-214016,86
437,25,24,6,0.0541125541,0.945887446,130.5242385,169.3384776,234.1258581,185.6,462,53.10344828,924,-223744,12800,-210944,86
439,23,23,7,0.0497835498,0.95021645,131.1684265,144.2829084,236.0888383,143.9130435,462,49.35897436,924,-224768,11776,-212992,86
436,21,23,7,0.04595186,0.95404814,130.0134369,147.7564184,232.6330275,153.5714286,457,55.25997582,914,-223232,10752,-212480,86
441,26,23,7,0.0556745182,0.944325482,131.8121091,169.5149886,237.138322,180.7692308,467,52.53093363,934,-225792,13312,-212480,86
443,25,22,8,0.0534188034,0.946581197,132.6572463,142.0033802,239.9006772,138.8,468,46.8,936,-226816,12800,-214016,86
438,22,23,7,0.047826087,0.952173913,130.7557397,145.8154684,234.6141553,148.5909091,460,52.57142857,920,-224256,11264,-212992,86
448,21,24,6,0.0447761194,0.955223881,133.6980438,148.0214331,238.5848214,158.5238095,469,30.79448457,938,-229376,10752,-218624,86
440,23,23,7,0.0496760259,0.950323974,131.4476258,145.1233228,236.5590909,144.7826087,463,49.25531915,926,-225280,11776,-213504,86
441,25,23,7,0.0536480687,0.946351931,131.6233029,171.7320052,236.0952381,187.72,466,50.65217391,932,-225792,12800,-212992,86
436,21,23,7,0.04595186,0.95404814,129.9761181,149.8978942,232.4977064,156.3809524,457,58.14249364,914,-223232,10752,-212480,86
440,21,23,7,0.0455531453,0.954446855,131.2510085,146.2498096,234.7431818,152.5714286,461,47.92099792,922,-225280,10752,-214528,86
436,27,22,8,0.0583153348,0.941684665,130.3575753,168.7254895,235.5344037,174.9259259,463,54.79289941,926,-223232,13824,-209408,86
444,23,23,7,0.0492505353,0.950749465,132.6627251,144.0085983,238.6644144,143.9565217,467,50.43196544,934,-227328,11776,-215552,86
436,23,24,6,0.0501089325,0.949891068,130.4057468,144.9584257,234.2981651,148.5217391,459,66.42547033,918,-223232,11776,-211456,86
439,28,23,7,0.0599571734,0.940042827,131.3969238,174.3004495,236.7949886,190.1785714,467,57.65432099,934,-224768,14336,-210432,86
49,10,22,8,0.169491525,0.830508475,17.05453438,12.37133784,32.14285714,19.5,59,6.990521327,118,-25088,5120,-19968,86
55,12,23,7,0.179104478,0.820895522,19.11378716,18.99762412,35.43636364,27.41666667,67,6.871794872,134,-28160,6144,-22016,86
47,10,23,7,0.175438596,0.824561404,16.53058676,12.82809417,30.87234043,20.2,57,6.968215159,114,-24064,5120,-18944,86
47,13,23,7,0.216666667,0.783333333,16.63478768,19.51725075,30.91489362,29,60,5.859375,120,-24064,6656,-17408,86
48,9,24,6,0.157894737,0.842105263,16.34772962,13.43388015,30.79166667,19.44444444,57,7.196969697,114,-24576,4608,-19968,86
50,13,23,7,0.206349206,0.793650794,17.64495395,19.92144335,32.66,29.46153846,63,10.09615385,126,-25600,6656,-18944,86
55,13,23,7,0.191176471,0.808823529,18.79885701,22.6540747,35.05454545,32.15384615,68,7.053941909,136,-28160,6656,-21504,86
47,9,24,6,0.160714286,0.839285714,16.12771571,12.43451985,30.36170213,18.77777778,56,5.691056911,112,-24064,4608,-19456,86
54,12,22,8,0.181818182,0.818181818,19.17725598,15.43984744,35.53703704,24.33333333,66,6.088560886,132,-27648,6144,-21504,86
49,10,23,7,0.169491525,0.830508475,17.07825534,13.24537655,31.91836735,20.6,59,6.868451688,118,-25088,5120,-19968,86
48,9,23,7,0.157894737,0.842105263,16.38088317,12.16552506,31,18.33333333,57,7.002457002,114,-24576,4608,-19968,86
49,13,23,7,0.209677419,0.790322581,17.27799023,19.92144335,32.04081633,29.46153846,62,7.533414338,124,-25088,6656,-18432,86
48,10,23,7,0.172413793,0.827586207,16.79718427,13.24537655,31.35416667,20.6,58,6.962785114,116,-24576,5120,-19456,86
49,10,23,7,0.169491525,0.830508475,17.07825534,13.24537655,31.91836735,20.6,59,7.212713936,118,-25088,5120,-19968,86
48,10,22,8,0.172413793,0.827586207,16.78850001,12.01499064,31.64583333,19.2,58,6.863905325,116,-24576,5120,-19456,86
55,12,23,7,0.179104478,0.820895522,18.79233183,20.93027446,35.10909091,28.91666667,67,6.314797361,134,-28160,6144,-22016,86
70,18,23,7,0.204545455,0.795454545,24.79748588,27.37243139,45.35714286,41.16666667,88,8.669950739,176,-35840,9216,-26624,86
55,13,23,7,0.191176471,0.808823529,19.15944408,21.02238874,35.45454545,30.46153846,68,5.384006334,136,-28160,6656,-21504,86
55,13,22,8,0.191176471,0.808823529,19.17043178,20.56509365,35.8,29,68,5.728727885,136,-28160,6656,-21504,86
50,11,23,7,0.180327869,0.819672131,17.43588254,16.74850431,32.5,24.18181818,61,8.144192256,122,-25600,5632,-19968,86
2632,108,22,8,0.0394160584,0.960583942,783.5369577,943.0354973,1376.400456,1226.703704,2740,202.3633678,5480,-1347584,55296,-1292288,86
2627,124,22,8,0.0450745184,0.954925482,783.6846759,969.481733,1385.2756,1179.491935,2751,144.1823899,5502,-1345024,63488,-1281536,86
2615,114,22,8,0.0417735434,0.958226457,778.5391067,925.5577224,1378.256597,1060.912281,2729,224.0558292,5458,-1338880,58368,-1280512,86
2607,109,22,8,0.0401325479,0.959867452,775.9570143,920.9304582,1369.201764,1102.541284,2716,219.2090395,5432,-1334784,55808,-1278976,86
2624,110,22,8,0.0402340892,0.959765911,781.1349972,948.1464069,1374.304116,1205.190909,2734,190.7885555,5468,-1343488,56320,-1287168,86
2611,101,22,8,0.0372418879,0.962758112,777.9509808,875.6358634,1364.581769,1147.574257,2712,235.2124892,5424,-1336832,51712,-1285120,86
2611,116,23,7,0.0425375871,0.957462413,777.2805415,944.323424,1376.131367,1090.939655,2727,271.3432836,5454,-1336832,59392,-1277440,86
2599,98,21,9,0.0363366704,0.96366333,773.2348316,880.5294135,1357.263563,1129.846939,2697,238.8839681,5394,-1330688,50176,-1280512,86
2619,117,21,9,0.0427631579,0.957236842,779.8360253,980.1764356,1373.613593,1254.034188,2736,79.69705797,5472,-1340928,59904,-1281024,86
2630,105,22,8,0.0383912249,0.961608775,782.9880499,929.3293793,1373.139163,1239.27619,2735,128.7664783,5470,-1346560,53760,-1292800,86
2611,101,23,7,0.0372418879,0.962758112,776.8364743,912.1487852,1362.484106,1201.80198,2712,194.4086022,5424,-1336832,51712,-1285120,86
2606,113,22,8,0.0415593968,0.958440603,775.8172707,937.2811547,1370.804298,1110.831858,2719,234.5987921,5438,-1334272,57856,-1276416,86
2625,117,22,8,0.0426695842,0.957330416,781.4801088,951.5834122,1383.54819,1101.188034,2742,212.5581395,5484,-1344000,59904,-1284096,86
2613,112,22,8,0.0411009174,0.958899083,777.8567763,937.336106,1373.347876,1121.580357,2725,223.727422,5450,-1337856,57344,-1280512,86
2606,113,21,9,0.0415593968,0.958440603,775.7050393,926.8313085,1372.612433,1069.132743,2719,286.814346,5438,-1334272,57856,-1276416,86
2611,117,22,8,0.042888563,0.957111437,777.2890184,951.498298,1376.229414,1102.74359,2728,231.3825276,5456,-1336832,59904,-1276928,86
2587,111,21,9,0.0411415864,0.958858414,769.9582032,936.0810435,1359.002706,1128.027027,2698,231.9862425,5396,-1324544,56832,-1267712,86
2614,107,21,9,0.039323778,0.960676222,778.2095037,923.0605167,1369.307575,1158.046729,2721,151.9262982,5442,-1338368,54784,-1283584,86
2611,107,21,9,0.0393671818,0.960632818,777.752347,899.8543116,1369.949062,1104.523364,2718,201.3333333,5436,-1336832,54784,-1282048,86
2609,114,22,8,0.0418655894,0.958134411,776.732428,925.4242838,1375.195094,1060.017544,2723,218.8906752,5446,-1335808,58368,-1277440,86
93,16,22,8,0.146788991,0.853211009,31.32582326,27.67155297,57.6344086,39.6875,109,9.053156146,218,-47616,8192,-39424,86
92,26,22,8,0.220338983,0.779661017,32.70553736,38.42931342,60,57.73076923,118,8.925869894,236,-47104,13312,-33792,86
93,21,22,8,0.184210526,0.815789474,32.32902947,34.71183609,58.87096774,51.42857143,114,8.857808858,228,-47616,10752,-36864,86
91,22,22,8,0.194690265,0.805309735,32.1145193,33.06595588,59.23076923,47.77272727,113,9.860383944,226,-46592,11264,-35328,86
88,18,22,8,0.169811321,0.830188679,30.34828605,29.12595042,55.875,41.88888889,106,11.87010078,212,-45056,9216,-35840,86
90,21,21,9,0.189189189,0.810810811,31.28881984,34.57287154,57.25555556,50.61904762,111,9.857904085,222,-46080,10752,-35328,86
105,23,21,9,0.1796875,0.8203125,36.35147647,37.270888,67.13333333,52.47826087,128,12.62327416,256,-53760,11776,-41984,86
91,16,22,8,0.14953271,0.85046729,30.537989,28.59899201,56.6043956,39.1875,107,11.41942369,214,-46592,8192,-38400,86
91,19,22,8,0.172727273,0.827272727,31.71341755,27.94037974,58.43956044,41.42105263,110,10.98901099,220,-46592,9728,-36864,86
92,21,21,9,0.185840708,0.814159292,32.6416844,28.01174033,60.40217391,42.0952381,113,9.377593361,226,-47104,10752,-36352,86
90,19,21,9,0.174311927,0.825688073,30.40204671,35.32735711,56.4,48.36842105,109,11.24871001,218,-46080,9728,-36352,86
94,16,22,8,0.145454545,0.854545455,31.32249491,29.66104084,58.17021277,39.8125,110,7.472826087,220,-48128,8192,-39936,86
91,19,21,9,0.172727273,0.827272727,31.61242619,27.82314547,58.65934066,40.36842105,110,13.0952381,220,-46592,9728,-36864,86
90,20,22,8,0.181818182,0.818181818,30.83880832,34.89967765,56.88888889,49.25,110,10.44634378,220,-46080,10240,-35840,86
93,22,21,9,0.191304348,0.808695652,32.23381167,35.84046953,59.94623656,49.77272727,115,12.04188482,230,-47616,11264,-36352,86
92,18,22,8,0.163636364,0.836363636,31.63225566,28.14424924,58.35869565,40.88888889,110,10.90188305,220,-47104,9216,-37888,86
102,26,21,9,0.203125,0.796875,36.20374258,39.23825343,65.93137255,58.88461538,128,18.18181818,256,-52224,13312,-38912,86
96,21,23,7,0.179487179,0.820512821,33.68416934,31.84920536,61.45833333,47.76190476,117,14.13043478,234,-49152,10752,-38400,86
91,20,22,8,0.18018018,0.81981982,32.00992706,27.91863177,59.18681319,41.5,111,10.02710027,222,-46592,10240,-36352,86
91,19,22,8,0.172727273,0.827272727,31.73771724,27.67780594,58.48351648,41.21052632,110,12.70207852,220,-46592,9728,-36864,86
1821,66,23,7,0.0349761526,0.965023847,541.8280475,604.3411108,948.8423943,810.3939394,1887,208.9700997,3774,-932352,33792,-898560,86
1808,68,22,8,0.0362473348,0.963752665,537.910932,611.3068146,944.2389381,785.9117647,1876,194.6058091,3752,-925696,34816,-890880,86
1880,67,22,8,0.0344119158,0.965588084,559.3026921,615.3379944,979.3930851,822.6716418,1947,200.9287926,3894,-962560,34304,-928256,86
1827,65,24,6,0.0343551797,0.96564482,543.5982782,600.6674051,950.9742748,820.7384615,1892,195.0515464,3784,-935424,33280,-902144,86
1824,62,24,6,0.032873807,0.967126193,542.6443711,588.8859341,946.3157895,860.6612903,1886,231.4110429,3772,-933888,31744,-902144,86
1841,67,23,7,0.035115304,0.964884696,547.6771219,609.1065498,960.3063552,794.9552239,1908,135.8974359,3816,-942592,34304,-908288,86
1837,66,24,6,0.0346820809,0.965317919,546.5635242,618.9512035,954.1295591,892.7272727,1903,201.1627907,3806,-940544,33792,-906752,86
1823,65,22,8,0.0344279661,0.965572034,542.3714319,601.0650732,949,818.2923077,1888,122.9967427,3776,-933376,33280,-900096,86
1670,61,24,6,0.0352397458,0.964760254,496.8816736,552.4565866,871.2347305,722.6885246,1731,30.80071174,3462,-855040,31232,-823808,86
1849,65,22,8,0.0339602926,0.966039707,550.1357562,600.8161124,962.2898864,821.2461538,1914,192.1686747,3828,-946688,33280,-913408,86
1829,68,22,8,0.0358460727,0.964153927,544.2919189,609.3541782,954.9108803,790.0147059,1897,190.6532663,3794,-936448,34816,-901632,86
1821,66,22,8,0.0349761526,0.965023847,541.6511163,607.3477378,949.0532674,804.5757576,1887,190.9919028,3774,-932352,33792,-898560,86
1825,63,23,7,0.0333686441,0.966631356,542.7274579,598.3650695,948.0915068,840.4603175,1888,169.0241719,3776,-934400,32256,-902144,86
1823,68,25,5,0.0359598096,0.96404019,542.5333407,620.1706211,949.8699945,842.25,1891,166.6079295,3782,-933376,34816,-898560,86
1831,63,24,6,0.0332629356,0.966737064,544.9369033,589.2776717,950.7509558,853.015873,1894,213.7697517,3788,-937472,32256,-905216,86
1859,72,23,7,0.0372863801,0.96271362,553.2907413,644.9601503,970.4168908,851.9583333,1931,159.8509934,3862,-951808,36864,-914944,86
1833,66,22,8,0.0347551343,0.965244866,545.4810631,602.5234355,954.9885434,811.4545455,1899,196.9917012,3798,-938496,33792,-904704,86
1846,64,23,7,0.0335078534,0.966492147,549.2952332,595.3442208,959.7329361,833.40625,1910,170.2317291,3820,-945152,32768,-912384,86
1824,71,23,7,0.0374670185,0.962532982,543.4307961,613.4027343,953.9259868,795.7605634,1895,213.4009009,3790,-933888,36352,-897536,86
1824,66,24,6,0.0349206349,0.965079365,542.6716123,604.9801779,950.4797149,807.8787879,1890,204.3243243,3780,-933888,33792,-900096,86
2602,111,21,9,0.0409141172,0.959085883,774.8740537,905.2708632,1370.014604,1051.918919,2713,206.1550152,5426,-1332224,56832,-1275392,86
2608,115,21,9,0.0422328314,0.957767169,776.235179,938.3124612,1374.628834,1075.6,2723,188.9659958,5446,-1335296,58880,-1276416,86
2620,122,21,9,0.0444930708,0.955506929,780.4922021,926.257263,1388.64084,1003.393443,2742,161.9610159,5484,-1341440,62464,-1278976,86
2603,101,22,8,0.037352071,0.962647929,774.4517814,901.8219541,1360.257011,1152.584158,2704,242.2939068,5408,-1332736,51712,-1281024,86
2607,113,21,9,0.0415441176,0.958455882,776.0421174,925.2186999,1373.246644,1066.424779,2720,237.5545852,5440,-1334784,57856,-1276928,86
2606,102,22,8,0.0376661743,0.962333826,775.5497796,895.1386757,1363.57099,1122.745098,2708,122.0919748,5416,-1334272,52224,-1282048,86
2611,105,21,9,0.0386597938,0.961340206,777.5311945,922.2991382,1363.624665,1231.066667,2716,208.4420568,5432,-1336832,53760,-1283072,86
2625,123,23,7,0.0447598253,0.955240175,781.9985759,980.9526173,1384.350476,1164.276423,2748,119.2190889,5496,-1344000,62976,-1281024,86
2602,104,22,8,0.0384331116,0.961566888,774.3263794,899.0449066,1363.695234,1098.423077,2706,262.7184466,5412,-1332224,53248,-1278976,86
2605,103,22,8,0.0380354505,0.961964549,776.1767177,888.7256095,1362.272169,1157.932039,2708,176.6470972,5416,-1333760,52736,-1281024,86
2608,101,22,8,0.0372831303,0.96271687,776.3661338,888.7998987,1363.423313,1137.49505,2709,184.6625767,5418,-1335296,51712,-1283584,86
2604,111,22,8,0.0408839779,0.959116022,775.1002799,915.8168165,1370.660522,1060.990991,2715,208.045977,5430,-1333248,56832,-1276416,86
2595,98,22,8,0.0363906424,0.963609358,772.4227566,880.3036294,1353.811946,1166.622449,2693,157.3933372,5386,-1328640,50176,-1278464,86
2607,111,22,8,0.0408388521,0.959161148,775.8759738,953.8290516,1366.258918,1200.756757,2718,231.516184,5436,-1334784,56832,-1277952,86
2601,110,22,8,0.0405754334,0.959424567,774.1151156,923.4592685,1367.110727,1093.281818,2711,175.0161394,5422,-1331712,56320,-1275392,86
2687,119,21,9,0.0424091233,0.957590877,800.7024466,935.365726,1418.524749,1064.243697,2806,113.8336714,5612,-1375744,60928,-1314816,86
2610,107,22,8,0.039381671,0.960618329,776.7465495,918.8572204,1368.813793,1119.616822,2717,166.7894414,5434,-1336320,54784,-1281536,86
2622,109,23,7,0.0399121201,0.96008788,780.3683293,935.6835174,1374.928299,1151.229358,2731,163.5329341,5462,-1342464,55808,-1286656,86
2610,99,21,9,0.0365448505,0.96345515,776.4586826,910.0818962,1359.051724,1248.181818,2709,255.0847458,5418,-1336320,50688,-1285632,86
2604,105,21,9,0.0387596899,0.96124031,774.9242485,893.1744038,1366.715054,1064.466667,2709,308.1911263,5418,-1333248,53760,-1279488,86
49,8,24,6,0.140350877,0.859649123,16.23258686,13.06175237,30.81632653,17.875,57,5.87628866,114,-25088,4096,-20992,86
49,10,22,8,0.169491525,0.830508475,16.99935075,13.21362933,32.04081633,20,59,25.10638298,118,-25088,5120,-19968,86
52,12,23,7,0.1875,0.8125,17.63631399,21.5140458,33.13461538,29.75,64,7.673860911,128,-26624,6144,-20480,86
52,11,23,7,0.174603175,0.825396825,17.5710203,20.04457842,33.09615385,26.81818182,63,7.865168539,126,-26624,5632,-20992,86
51,12,24,6,0.19047619,0.80952381,17.39966016,21.11608129,32.39215686,30.33333333,63,6.09874153,126,-26112,6144,-19968,86
53,9,23,7,0.14516129,0.85483871,17.71110277,13.8572974,33.52830189,19.55555556,62,8.083441982,124,-27136,4608,-22528,86
54,10,23,7,0.15625,0.84375,18.40968016,14.77024035,34.48148148,21.8,64,8.454425363,128,-27648,5120,-22528,86
51,10,23,7,0.163934426,0.836065574,17.59502132,13.96030086,32.94117647,21.1,61,7.942708333,122,-26112,5120,-20992,86
50,9,25,5,0.152542373,0.847457627,16.94461566,14.58648114,31.6,21.11111111,59,7.804232804,118,-25600,4608,-20992,86
63,12,23,7,0.16,0.84,20.9876807,23.74283518,39.26984127,31.33333333,75,8.161044614,150,-32256,6144,-26112,86
52,9,23,7,0.147540984,0.852459016,17.45196281,13.1318104,33.07692308,19,61,5.407801418,122,-26624,4608,-22016,86
78,15,23,7,0.161290323,0.838709677,26.95293826,23.62729119,49.02564103,36.46666667,93,9.841269841,186,-39936,7680,-32256,86
78,18,23,7,0.1875,0.8125,27.04155859,30.01090337,49.56410256,43.88888889,96,7.553107789,192,-39936,9216,-30720,86
62,12,23,7,0.162162162,0.837837838,21.13004799,20.50609665,39.14516129,29,74,6.813996317,148,-31744,6144,-25600,86
64,14,22,8,0.179487179,0.820512821,22.16252446,22.28525641,41.296875,31.28571429,78,7.155963303,156,-32768,7168,-25600,86
53,12,23,7,0.184615385,0.815384615,17.8981335,21.95386577,33.64150943,30.16666667,65,7.975460123,130,-27136,6144,-20992,86
60,14,24,6,0.189189189,0.810810811,20.24406635,25.58509212,37.33333333,38.21428571,74,6.654676259,148,-30720,7168,-23552,86
81,20,22,8,0.198019802,0.801980198,29.63606412,24.98094274,53.33333333,41.55,101,8.340214699,202,-41472,10240,-31232,86
67,18,24,6,0.211764706,0.788235294,24.19559968,25.7346982,43.28358209,41.94444444,85,8.744855967,170,-34304,9216,-25088,86
60,11,24,6,0.154929577,0.845070423,20.16669421,20.8825919,37.26666667,29.09090909,71,7.186234818,142,-30720,5632,-25088,86
61,10,24,6,0.14084507,0.85915493,20.09988495,20.86719914,37.37704918,27.6,71,5.670926518,142,-31232,5120,-26112,86
53,10,23,7,0.158730159,0.841269841,18.13887725,14.34712515,34,21.4,63,8.087291399,126,-27136,5120,-22016,86
52,9,25,5,0.147540984,0.852459016,17.50152149,14.97487608,32.65384615,21.44444444,61,6.186612576,122,-26624,4608,-22016,86
51,11,24,6,0.177419355,0.822580645,16.97805989,21.50725421,31.98039216,29.27272727,62,7.134637514,124,-26112,5632,-20480,86
52,9,23,7,0.147540984,0.852459016,17.43062114,13.8572974,32.98076923,19.55555556,61,7.287933094,122,-26624,4608,-22016,86
53,11,22,8,0.171875,0.828125,18.51194375,14.49935878,34.60377358,22.36363636,64,8.322496749,128,-27136,5632,-21504,86
52,10,23,7,0.161290323,0.838709677,17.84121077,14.77024035,33.36538462,21.8,62,8,124,-26624,5120,-21504,86
51,9,25,5,0.15,0.85,17.23354293,14.58648114,32.15686275,21.11111111,60,6.335797254,120,-26112,4608,-21504,86
63,15,23,7,0.192307692,0.807692308,21.38270223,26.74571617,39.61904762,39,78,8.387096774,156,-32256,7680,-24576,86
52,9,23,7,0.147540984,0.852459016,17.43062114,13.8572974,32.98076923,19.55555556,61,7.634543179,122,-26624,4608,-22016,86
53,10,23,7,0.158730159,0.841269841,18.13887725,14.34712515,34,21.4,63,8.583106267,126,-27136,5120,-22016,86
53,10,23,7,0.158730159,0.841269841,18.11998694,14.81080687,33.9245283,21.8,63,6.745182013,126,-27136,5120,-22016,86
53,13,23,7,0.196969697,0.803030303,18.31275694,21.66310091,34.03773585,31.30769231,66,7.829181495,132,-27136,6656,-20480,86
52,10,23,7,0.161290323,0.838709677,17.86417359,14.38228076,33.42307692,21.5,62,7.142857143,124,-26624,5120,-21504,86
63,10,24,6,0.136986301,0.863013699,20.70842829,20.4685124,38.61904762,26.8,73,6.95900858,146,-32256,5120,-27136,86
62,12,23,7,0.162162162,0.837837838,21.14884567,20.44691637,39.12903226,29.08333333,74,7.047619048,148,-31744,6144,-25600,86
82,17,22,8,0.171717172,0.828282828,28.68362161,24.41325297,52.6097561,37.41176471,99,7.184325109,198,-41984,8704,-33280,86
84,20,22,8,0.192307692,0.807692308,29.29122093,32.81783052,53.02380952,50.3,104,8.950086059,208,-43008,10240,-32768,86
53,12,24,6,0.184615385,0.815384615,17.91970144,21.93725269,33.54716981,30.58333333,65,6.871035941,130,-27136,6144,-20992,86
63,11,24,6,0.148648649,0.851351351,20.86605593,21.57784294,39.19047619,27.81818182,74,6.727272727,148,-32256,5632,-26624,86
2611,101,22,8,0.0372418879,0.962758112,776.8593902,907.0176196,1363.423209,1177.524752,2712,192.750533,5424,-1336832,51712,-1285120,86
2593,100,22,8,0.0371333086,0.962866691,771.5509403,895.8072165,1354.268415,1158.53,2693,236.8513632,5386,-1327616,51200,-1276416,86
2603,111,21,9,0.040899042,0.959100958,774.8458133,913.9491317,1370.267,1058.108108,2714,241.4590747,5428,-1332736,56832,-1275904,86
2607,103,23,7,0.0380073801,0.96199262,775.8056338,909.2853094,1363.413502,1155.203883,2710,241.7484389,5420,-1334784,52736,-1282048,86
2595,112,21,9,0.041374215,0.958625785,772.5018794,914.535261,1367.1079,1050.294643,2707,205.2312358,5414,-1328640,57344,-1271296,86
2626,105,23,7,0.0384474551,0.961552545,782.1815878,905.3560308,1374.317593,1157.980952,2731,257.6415094,5462,-1344512,53760,-1290752,86
2604,111,22,8,0.0408839779,0.959116022,774.9521208,949.4314404,1365.772273,1175.666667,2715,262.0656371,5430,-1333248,56832,-1276416,86
2622,107,22,8,0.0392085013,0.960791499,780.5001957,940.4677782,1370.13196,1239.242991,2729,62.16400911,5458,-1342464,54784,-1287680,86
2601,103,21,9,0.038091716,0.961908284,773.9855488,904.0323118,1361.254133,1131.436893,2704,245.5949137,5408,-1331712,52736,-1278976,86
2610,112,22,8,0.041146216,0.958853784,776.8972524,909.3403205,1375.673946,1031.196429,2722,247.0054446,5444,-1336320,57344,-1278976,86
2607,109,22,8,0.0401325479,0.959867452,776.199371,920.3764779,1368.556962,1117.963303,2716,201.6332591,5432,-1334784,55808,-1278976,86
2621,105,22,8,0.0385179751,0.961482025,780.1029064,916.8566352,1371.889737,1154.07619,2726,190.4961565,5452,-1341952,53760,-1288192,86
2602,103,21,9,0.038077634,0.961922366,774.1533288,931.5281621,1355.933513,1278.893204,2705,206.0167555,5410,-1332224,52736,-1279488,86
2614,113,23,7,0.0414374771,0.958562523,778.3780816,936.8054806,1374.557383,1119.778761,2727,203.8116592,5454,-1338368,57856,-1280512,86
2622,109,22,8,0.0399121201,0.96008788,780.7638268,941.8292582,1371.993898,1221.816514,2731,72.30606301,5462,-1342464,55808,-1286656,86
2603,105,21,9,0.038774003,0.961225997,775.6535566,907.781141,1360.329235,1209.990476,2708,176.7624021,5416,-1332736,53760,-1278976,86
2610,103,22,8,0.037965352,0.962034648,776.6078921,899.7764952,1366.742529,1110.126214,2713,201.5601783,5426,-1336320,52736,-1283584,86
2607,112,22,8,0.0411916146,0.958808385,775.8890871,934.3108515,1371.192558,1099.473214,2719,174.2948718,5438,-1334784,57344,-1277440,86
2598,113,20,10,0.0416820361,0.958317964,773.208034,942.1986056,1366.482294,1115,2711,237.5985977,5422,-1330176,57856,-1272320,86
2611,111,22,8,0.0407788391,0.959221161,777.1390853,917.7642327,1374.169284,1063.486486,2722,194.289793,5444,-1336832,56832,-1280000,86
3500,379,22,8,0.0977055942,0.902294406,1079.655099,1400.131507,1906.146571,2252.630607,3879,82.37417711,7758,-1792000,194048,-1597952,87
3514,395,22,8,0.101048862,0.898951138,1090.993453,1395.48888,1927.796244,2197.010127,3909,81.25129911,7818,-1799168,202240,-1596928,87
3495,392,22,8,0.100848984,0.899151016,1081.865164,1403.711596,1914.129328,2210.321429,3887,92.85714286,7774,-1789440,200704,-1588736,87
334,37,21,9,0.0997304582,0.900269542,107.6410099,97.11963509,189.2994012,156.2162162,371,28.67078825,742,-171008,18944,-152064,87
3522,396,21,9,0.101071975,0.898928025,1087.374397,1406.641175,1916.605054,2341.005051,3918,68.43668122,7836,-1803264,202752,-1600512,87
1082,148,22,8,0.120325203,0.879674797,348.6961783,344.4414869,641.2319778,427.3783784,1230,23.80491581,2460,-553984,75776,-478208,87
3469,376,20,10,0.0977893368,0.902210663,1072.797593,1370.523324,1890.124532,2226.31117,3845,88.37048954,7690,-1776128,192512,-1583616,87
3579,400,22,8,0.100527771,0.899472229,1107.327754,1430.099426,1955.157865,2301.75,3979,92.81548869,7958,-1832448,204800,-1627648,87
3562,403,21,9,0.101639344,0.898360656,1101.23142,1453.662584,1957.223189,2210.833747,3965,97.61201379,7930,-1823744,206336,-1617408,87
3510,413,21,9,0.105276574,0.894723426,1090.358773,1431.816875,1943.382621,2120.225182,3923,94.62132176,7846,-1797120,211456,-1585664,87
3524,401,22,8,0.102165605,0.897834395,1090.466077,1432.667745,1935.8584,2201.521197,3925,93.1198102,7850,-1804288,205312,-1598976,87
3555,389,22,8,0.0986308316,0.901369168,1099.930535,1362.323348,1922.671167,2427.876607,3944,102.4415584,7888,-1820160,199168,-1620992,87
3531,409,20,10,0.103807107,0.896192893,1092.615586,1441.066619,1939.724441,2236.193154,3940,108.0340005,7880,-1807872,209408,-1598464,87
3580,352,21,9,0.0895218718,0.910478128,1102.189704,1335.8522,1919.397765,2445.551136,3932,97.4956608,7864,-1832960,180224,-1652736,87
3727,408,21,9,0.0986698912,0.901330109,1155.918985,1484.28139,2049.394419,2237.958333,4135,94.38484364,8270,-1908224,208896,-1699328,87
3659,414,21,9,0.101644979,0.898355021,1137.818441,1455.145448,2015.257994,2229.15942,4073,80.65346535,8146,-1873408,211968,-1661440,87
3638,411,20,10,0.101506545,0.898493455,1128.770795,1461.549375,2002.259208,2226.291971,4049,99.24019608,8098,-1862656,210432,-1652224,87
571,99,21,9,0.147761194,0.852238806,196.8009642,129.0003389,353.8476357,229.6767677,670,18.49806737,1340,-292352,50688,-241664,87
3577,348,22,8,0.0886624204,0.91133758,1099.689046,1346.146348,1917.755941,2428.051724,3925,94.55552879,7850,-1831424,178176,-1653248,87
3484,406,22,8,0.10437018,0.89562982,1079.901244,1428.631584,1925.251435,2119.258621,3890,89.92140546,7780,-1783808,207872,-1575936,87
9501,470,19,11,0.0471366964,0.952863304,2854.315902,3146.285153,5038.335017,3928.053191,9971,1422.396576,19942,-4864512,240640,-4623872,87
9496,475,19,11,0.0476381506,0.952361849,2856.732303,3148.77163,5031.065396,4085.071579,9971,1234.034653,19942,-4861952,243200,-4618752,87
9522,449,18,12,0.0450305887,0.954969411,2862.828529,2992.955323,5036.912098,3906.300668,9971,1083.804348,19942,-4875264,229888,-4645376,87
9516,455,19,11,0.0456323338,0.954367666,2861.199377,3076.012481,5029.955969,4066.692308,9971,1565.306122,19942,-4872192,232960,-4639232,87
9478,491,20,10,0.0492526833,0.950747317,2855.383064,2976.792135,5054.65594,3640.399185,9969,421.3440406,19938,-4852736,251392,-4601344,87
9517,455,20,10,0.0456277577,0.954372242,2862.440097,3045.310891,5032.299569,4028.534066,9972,1115.436242,19944,-4872704,232960,-4639744,87
9510,460,18,12,0.0461384152,0.953861585,2860.430392,3055.966441,5033.669716,3989.643478,9970,914.6788991,19940,-4869120,235520,-4633600,87
9517,454,19,11,0.0455320429,0.954467957,2861.370253,3074.188432,5029.744983,4068.993392,9971,1322.413793,19942,-4872704,232448,-4640256,87
9478,492,18,12,0.0493480441,0.950651956,2855.78703,3139.35604,5033.28888,4064.884146,9970,1058.386412,19940,-4852736,251904,-4600832,87
9497,473,19,11,0.047442327,0.952557673,2854.938385,3153.969279,5034.132989,4009.035941,9970,1131.668558,19940,-4862464,242176,-4620288,87
9519,453,20,10,0.0454271961,0.954572804,2860.395588,3079.682518,5033.133102,4006.587196,9972,1515.50152,19944,-4873728,231936,-4641792,87
9499,471,20,10,0.0472417252,0.952758275,2859.613179,3098.803794,5029.300769,4102.138004,9970,1092.004381,19940,-4863488,241152,-4622336,87
9521,450,20,10,0.0451308796,0.95486912,2864.664279,3013.367358,5029.109652,4073.895556,9971,1045.178197,19942,-4874752,230400,-4644352,87
9509,462,19,11,0.0463343697,0.95366563,2861.735626,3040.861543,5033.556631,4007.177489,9971,1148.732719,19942,-4868608,236544,-4632064,87
9488,483,20,10,0.0484404774,0.951559523,2852.342265,3017.531799,5058.144709,3568.797101,9971,885.5239787,19942,-4857856,247296,-4610560,87
9483,485,19,11,0.0486556982,0.951344302,2857.017184,3052.457008,5040.512074,3889.319588,9968,729.7218155,19936,-4855296,248320,-4606976,87
8171,440,19,11,0.0510974335,0.948902566,2464.325076,2613.255444,4366.32138,3185.804545,8611,152.4070796,17222,-4183552,225280,-3958272,87
9516,454,19,11,0.0455366098,0.95446339,2861.12248,2970.41166,5042.610656,3788.440529,9970,251.3234182,19940,-4872192,232448,-4639744,87
9500,472,19,11,0.0473325311,0.952667469,2855.31656,3140.779657,5037.758105,3954.822034,9972,1128.054299,19944,-4864000,241664,-4622336,87
9479,490,20,10,0.0491523724,0.950847628,2854.905366,3079.149021,5043.346556,3856.291837,9969,819.1454396,19938,-4853248,250880,-4602368,87
2638,353,21,9,0.118020729,0.881979271,836.0719227,1021.821478,1468.234647,1703.492918,2991,76.0488177,5982,-1350656,180736,-1169920,87
2668,351,21,9,0.116263663,0.883736337,840.6229167,1062.066821,1487.358321,1682.102564,3019,59.71123418,6038,-1366016,179712,-1186304,87
2449,279,21,9,0.102272727,0.897727273,762.7675412,957.5464255,1342.937117,1553.774194,2728,70.71021255,5456,-1253888,142848,-1111040,87
2703,348,20,10,0.114060964,0.885939036,853.8781908,1016.8427,1486.963744,1829.204023,3051,71.97452229,6102,-1383936,178176,-1205760,87
2566,310,21,9,0.107788595,0.892211405,809.8045261,941.2097631,1406.086516,1706.8,2876,70.02678354,5752,-1313792,158720,-1155072,87
2834,379,21,9,0.117958294,0.882041706,895.8941387,1097.195246,1569.835215,1884.902375,3213,67.58519142,6426,-1451008,194048,-1256960,87
2755,359,21,9,0.115285806,0.884714194,872.0879637,1045.103338,1522.679129,1824.718663,3114,72.16685979,6228,-1410560,183808,-1226752,87
2669,345,21,9,0.114465826,0.885534174,843.7606619,1012.630615,1473.014238,1774.289855,3014,68.05147889,6028,-1366528,176640,-1189888,87
2679,365,21,9,0.119908016,0.880091984,847.752489,1046.999858,1489.057484,1767.958904,3044,66.52097902,6088,-1371648,186880,-1184768,87
2600,350,21,9,0.118644068,0.881355932,824.7447487,998.6509188,1443.975769,1709.68,2950,69.41176471,5900,-1331200,179200,-1152000,87
2631,334,21,9,0.112647555,0.887352445,829.8041105,998.1247807,1448.514633,1754.649701,2965,74.21777222,5930,-1347072,171008,-1176064,87
2737,365,21,9,0.117666022,0.882333978,867.5200361,1016.665851,1505.006211,1900.139726,3102,73.80442541,6204,-1401344,186880,-1214464,87
2786,369,21,9,0.116957211,0.883042789,883.0186427,1057.286865,1541.185212,1855.95664,3155,79.05286896,6310,-1426432,188928,-1237504,87
1431,154,21,9,0.0971608833,0.902839117,453.9821925,469.4271492,807.1726066,661.3051948,1585,170.613563,3170,-732672,78848,-653824,87
2669,350,20,10,0.115932428,0.884067572,843.9508489,1032.842074,1481.53728,1727.048571,3019,60.8546664,6038,-1366528,179200,-1187328,87
2685,366,20,10,0.119960669,0.880039331,854.7292907,1019.878568,1492.944507,1768.497268,3051,60.78900179,6102,-1374720,187392,-1187328,87
2705,360,21,9,0.117455139,0.882544861,856.637978,1015.007243,1489.514972,1859.741667,3065,63.01398026,6130,-1384960,184320,-1200640,87
2662,341,21,9,0.113553114,0.886446886,840.148395,1025.899214,1473.610819,1723.618768,3003,74.98127341,6006,-1362944,174592,-1188352,87
2670,355,21,9,0.117355372,0.882644628,847.1431727,1001.373634,1473.994757,1806.36338,3025,65.74657683,6050,-1367040,181760,-1185280,87
2654,339,21,9,0.113264283,0.886735717,835.311507,1012.081,1458.224943,1800.566372,2993,76.13838718,5986,-1358848,173568,-1185280,87
3199,393,21,9,0.1094098,0.8905902,1001.639103,1252.642914,1761.420756,2082.043257,3592,83.24449594,7184,-1637888,201216,-1436672,87
3152,344,20,10,0.0983981693,0.901601831,977.0342063,1223.987603,1714.775698,2057.508721,3496,70.74059085,6992,-1613824,176128,-1437696,87
3190,411,21,9,0.114134963,0.885865037,997.5471021,1300.227659,1772.920063,2018.944039,3601,87.12799419,7202,-1633280,210432,-1422848,87
3180,404,21,9,0.112723214,0.887276786,994.978365,1279.369771,1761.571698,2035.945545,3584,97.7365694,7168,-1628160,206848,-1421312,87
3167,358,21,9,0.101560284,0.898439716,985.0104261,1214.138506,1723.149984,2115.527933,3525,71.08287961,7050,-1621504,183296,-1438208,87
3243,391,21,9,0.107594937,0.892405063,1012.303207,1293.59564,1790.718471,2039.629156,3634,78.57297297,7268,-1660416,200192,-1460224,87
3209,369,21,9,0.10313024,0.89686976,998.2429424,1244.535111,1750.269243,2130.669377,3578,79.4934459,7156,-1643008,188928,-1454080,87
3211,398,21,9,0.110279856,0.889720144,1003.848226,1274.146664,1770.161943,2086.067839,3609,71.55035686,7218,-1644032,203776,-1440256,87
2995,329,21,9,0.098977136,0.901022864,928.7844591,1204.00288,1663.522204,1653.194529,3324,60.89027294,6648,-1533440,168448,-1364992,87
3151,393,21,9,0.110891648,0.889108352,983.4981491,1285.997159,1752.325611,1934.254453,3544,86.82018618,7088,-1613312,201216,-1412096,87
3226,408,20,10,0.112272977,0.887727023,1006.596321,1308.961474,1784.419095,2079.066176,3634,94.93207941,7268,-1651712,208896,-1442816,87
3212,390,21,9,0.108273182,0.891726818,999.7673255,1298.8691,1771.881694,2045.433333,3602,82.57679963,7204,-1644544,199680,-1444864,87
3156,388,21,9,0.109480813,0.890519187,985.1382148,1272.371119,1747.281052,1977.631443,3544,67.5176224,7088,-1615872,198656,-1417216,87
3240,404,21,9,0.110867179,0.889132821,1014.45535,1296.265889,1796.92284,2027.623762,3644,93.53182752,7288,-1658880,206848,-1452032,87
3222,399,21,9,0.110190555,0.889809445,1008.025963,1273.424178,1776.162011,2092.323308,3621,91.23204837,7242,-1649664,204288,-1445376,87
3282,381,21,9,0.104013104,0.895986896,1023.819739,1249.032294,1787.993297,2211.081365,3663,86.55482042,7326,-1680384,195072,-1485312,87
3201,385,21,9,0.107361963,0.892638037,999.1651992,1266.694989,1762.087785,2054.67013,3586,81.20471014,7172,-1638912,197120,-1441792,87
3182,388,21,9,0.108683473,0.891316527,994.8832271,1263.301491,1757.553426,2014.690722,3570,84.85856905,7140,-1629184,198656,-1430528,87
3187,393,21,9,0.109776536,0.890223464,996.0208581,1272.539819,1760.883903,2030.669211,3580,86.22350674,7160,-1631744,201216,-1430528,87
3288,394,21,9,0.107007061,0.892992939,1026.498899,1310.22449,1816.740572,2048.121827,3682,77.72852016,7364,-1683456,201728,-1481728,87
6249,323,21,9,0.0491479002,0.9508521,1878.006303,2125.216587,3321.514162,2609.089783,6572,562.6712329,13144,-3199488,165376,-3034112,87
6298,346,21,9,0.052077062,0.947922938,1891.449495,2282.974275,3352.0235,2785.104046,6644,115.4273801,13288,-3224576,177152,-3047424,87
6234,308,21,9,0.0470804035,0.952919596,1871.40683,2136.444422,3298.086301,2733.386364,6542,785.3541417,13084,-3191808,157696,-3034112,87
6287,347,21,9,0.0523063009,0.947693699,1889.322367,2209.159492,3357.776841,2587.757925,6634,532.423756,13268,-3218944,177664,-3041280,87
6260,309,21,9,0.0470391232,0.952960877,1878.050322,2213.790731,3299.543131,2990.372168,6569,576.2280702,13138,-3205120,158208,-3046912,87
6257,310,21,9,0.0472057256,0.952794274,1877.047663,2146.842467,3314.870545,2660.912903,6567,551.3853904,13134,-3203584,158720,-3044864,87
6360,316,21,9,0.0473337328,0.952666267,1908.243651,2245.110713,3356.41761,2977.879747,6676,822.1674877,13352,-3256320,161792,-3094528,87
6408,325,21,9,0.0482697163,0.951730284,1925.378644,2215.733238,3392.331461,2867.541538,6733,686.3404689,13466,-3280896,166400,-3114496,87
6290,310,21,9,0.046969697,0.953030303,1887.268838,2200.149573,3320.53911,2893.9,6600,967.7419355,13200,-3220480,158720,-3061760,87
2642,189,21,9,0.0667608619,0.933239138,804.9721819,859.2013686,1447.504921,975.5978836,2831,50.56260046,5662,-1352704,96768,-1255936,87
6212,297,21,9,0.0456291289,0.954370871,1865.13744,2007.458139,3290.731326,2507.649832,6509,168.3652354,13018,-3180544,152064,-3028480,87
6261,333,21,9,0.050500455,0.949499545,1878.733398,2257.490444,3325.412394,2772.696697,6594,771.2280702,13188,-3205632,170496,-3035136,87
6242,321,21,9,0.0489105592,0.951089441,1873.520371,2137.695607,3319.610541,2550.64486,6563,601.5582035,13126,-3195904,164352,-3031552,87
6250,328,21,9,0.0498631803,0.95013682,1876.989098,2187.71681,3321.71408,2675.664634,6578,637.4031008,13156,-3200000,167936,-3032064,87
6406,357,21,9,0.0527872246,0.947212775,1928.407362,2238.252652,3419.033406,2717.473389,6763,444.3495401,13526,-3279872,182784,-3097088,87
6284,325,20,10,0.0491753669,0.950824633,1885.725382,2208.730742,3336.273393,2700.316923,6609,569.7413793,13218,-3217408,166400,-3051008,87
6179,309,21,9,0.0476263872,0.952373613,1856.449877,2075.041961,3276.52549,2604.093851,6488,153.0549658,12976,-3163648,158208,-3005440,87
6385,355,21,9,0.0526706231,0.947329377,1921.753387,2248.275439,3404.490838,2759.143662,6740,695.5624355,13480,-3269120,181760,-3087360,87
6584,352,21,9,0.0507497116,0.949250288,1977.551868,2328.410885,3502.501671,2832.514205,6936,797.2413793,13872,-3371008,180224,-3190784,87
6237,297,21,9,0.0454545455,0.954545455,1868.420947,2183.819965,3287.821068,2840.757576,6534,827.0886076,13068,-3193344,152064,-3041280,87
6311,326,21,9,0.0491185777,0.950881422,1894.18902,2160.319095,3358.275075,2558.677914,6637,605.0136737,13274,-3231232,166912,-3064320,87
6293,313,21,9,0.0473811686,0.952618831,1889.135801,2200.411142,3322.754489,2916.380192,6606,492.6174497,13212,-3222016,160256,-3061760,87
6454,338,21,9,0.0497644287,0.950235571,1940.04635,2242.13762,3426.876821,2816.464497,6792,595.2673094,13584,-3304448,173056,-3131392,87
6348,337,21,9,0.0504113687,0.949588631,1905.893266,2246.903379,3375.814272,2724.884273,6685,631.2559018,13370,-3250176,172544,-3077632,87
6317,336,21,9,0.0505035322,0.949496468,1897.2106,2247.094863,3356.076144,2780.35119,6653,891.8230563,13306,-3234304,172032,-3062272,87
6301,318,21,9,0.0480435111,0.951956489,1893.260149,2140.784739,3340.575147,2704.169811,6619,618.0205415,13238,-3226112,162816,-3063296,87
6290,333,21,9,0.0502793296,0.94972067,1889.543862,2151.196586,3353.036725,2536.861862,6623,735.0721421,13246,-3220480,170496,-3049984,87
6310,324,21,9,0.0488393126,0.951160687,1895.163101,2162.707209,3351.738352,2650.697531,6634,521.1311862,13268,-3230720,165888,-3064832,87
6309,322,21,9,0.0485597949,0.951440205,1895.900367,2156.98,3346.611032,2716.232919,6631,533.8969404,13262,-3230208,164864,-3065344,87
6344,311,21,9,0.0467317806,0.953268219,1897.642381,2338.63789,3338.851356,3106.646302,6655,628.4230406,13310,-3248128,159232,-3088896,87
6304,308,21,9,0.0465819722,0.953418028,1887.837201,2244.560421,3329.273477,2840.383117,6612,812.2850123,13224,-3227648,157696,-3069952,87
6314,346,20,10,0.051951952,0.948048048,1898.143606,2226.166003,3366.053215,2681.705202,6660,556.8561873,13320,-3232768,177152,-3055616,87
6313,334,21,9,0.0502482323,0.949751768,1894.423674,2264.992726,3352.722161,2781.116766,6647,115.8417567,13294,-3232256,171008,-3061248,87
6270,302,21,9,0.0459525259,0.954047474,1878.890647,2205.071209,3305.90941,2883.529801,6572,441.370047,13144,-3210240,154624,-3055616,87
6402,313,20,10,0.0466120625,0.953387937,1920.841873,2218.084113,3380.790066,2891.859425,6715,351.9392034,13430,-3277824,160256,-3117568,87
6356,279,20,10,0.0420497362,0.957950264,1899.925192,2237.637014,3320.388924,3263.577061,6635,677.0408163,13270,-3254272,142848,-3111424,87
6293,331,21,9,0.0499698068,0.950030193,1891.720678,2197.015604,3341.020658,2770.26284,6624,468.1272085,13248,-3222016,169472,-3052544,87
6297,296,20,10,0.0448961019,0.955103898,1883.904723,2251.541849,3312.253136,2972.510135,6593,442.186452,13186,-3224064,151552,-3072512,87
6425,347,21,9,0.0512404017,0.948759598,1933.976678,2155.226827,3430.002335,2581.017291,6772,439.7402597,13544,-3289600,177664,-3111936,87
6290,320,21,9,0.0484114977,0.951588502,1889.639481,2162.918292,3334.609698,2733.3125,6610,491.0846954,13220,-3220480,163840,-3056640,87
9430,537,18,12,0.0538777967,0.946122203,2845.950279,3196.584445,5044.764475,3916.944134,9967,726.4577259,19934,-4828160,274944,-4553216,87
9532,441,20,10,0.0442193924,0.955780608,2863.621831,3009.413452,5035.193244,3945.326531,9973,768.9282961,19946,-4880384,225792,-4654592,87
9481,490,18,12,0.0491425133,0.950857487,2853.3507,3119.433189,5044.120135,3861.434694,9971,1244.818976,19942,-4854272,250880,-4603392,87
9459,513,20,10,0.0514440433,0.948555957,2844.177237,3162.194115,5059.820171,3634.578947,9972,1225.061425,19944,-4843008,262656,-4580352,87
9525,448,20,10,0.0449212875,0.955078713,2859.763419,3130.302408,5028.913386,4095.872768,9973,1300.260756,19946,-4876800,229376,-4647424,87
9486,486,20,10,0.0487364621,0.951263538,2853.373449,3102.193441,5047.559878,3794.701646,9972,1114.189944,19944,-4856832,248832,-4608000,87
9511,462,19,11,0.0463250777,0.953674922,2859.717032,3104.133309,5032.642204,4047.383117,9973,1369.917582,19946,-4869632,236544,-4633088,87
9532,441,19,11,0.0442193924,0.955780608,2859.118189,3172.180357,5024.467898,4177.14966,9973,769.5216049,19946,-4880384,225792,-4654592,87
9514,459,20,10,0.0460242655,0.953975734,2860.608468,3070.754918,5035.095123,3990.100218,9973,1017.653061,19946,-4871168,235008,-4636160,87
9519,451,19,11,0.0452357071,0.954764293,2858.382598,3207.632679,5014.065658,4382.580931,9970,858.7424634,19940,-4873728,230912,-4642816,87
9440,531,18,12,0.0532544379,0.946745562,2846.769231,2991.584164,5073.447987,3431.369115,9971,815.2902698,19942,-4833280,271872,-4561408,87
9474,498,19,11,0.0499398315,0.950060168,2851.393439,3122.743965,5049.426536,3789.379518,9972,1371.664374,19944,-4850688,254976,-4595712,87
9459,514,20,10,0.0515391557,0.948460844,2846.192613,3133.043809,5060.414209,3635.978599,9973,957.1017274,19946,-4843008,263168,-4579840,87
9479,494,18,12,0.0495337411,0.950466259,2854.633256,3027.121861,5055.184724,3678.653846,9973,1058.704883,19946,-4853248,252928,-4600320,87
9521,452,19,11,0.0453223704,0.95467763,2861.770973,3019.45654,5038.850121,3894.820796,9973,1315.699208,19946,-4874752,231424,-4643328,87
9438,531,19,11,0.0532651219,0.946734878,2841.634818,3243.766252,5050.610087,3818.845574,9969,923.0555556,19938,-4832256,271872,-4560384,87
9483,490,19,11,0.0491326582,0.950867342,2850.270518,3161.715018,5048.145207,3803.653061,9973,1147.640967,19946,-4855296,250880,-4604416,87
9461,512,19,11,0.0513386143,0.948661386,2848.805562,3153.443219,5052.31392,3780.095703,9973,664.4237175,19946,-4844032,262144,-4581888,87
9456,510,18,12,0.0511739916,0.948826008,2858.902754,3077.143059,5028.257826,4153.637255,9966,225.4241122,19932,-4841472,261120,-4580352,87
9495,477,19,11,0.047833935,0.952166065,2858.347549,3028.919785,5045.18178,3818.400419,9972,953.3460803,19944,-4861440,244224,-4617216,87
3102,372,21,9,0.107081174,0.892918826,966.7541161,1233.850472,1706.198904,1998.510753,3474,70.58106461,6948,-1588224,190464,-1397760,87
2931,306,21,9,0.0945319741,0.905468026,905.026537,1179.259876,1616.20232,1645.797386,3237,180.3342618,6474,-1500672,156672,-1344000,87
3085,370,21,9,0.107091172,0.892908828,958.6369412,1240.348073,1694.376013,2008.351351,3455,68.76990446,6910,-1579520,189440,-1390080,87
3128,383,20,10,0.109085731,0.890914269,975.5187284,1232.679542,1715.076726,2090.224543,3511,62.8760745,7022,-1601536,196096,-1405440,87
3104,369,21,9,0.1062482,0.8937518,965.3820272,1258.839707,1715.657216,1916.533875,3473,80.41213244,6946,-1589248,188928,-1400320,87
2972,335,21,9,0.101300272,0.898699728,922.6702818,1188.563897,1635.105316,1821.626866,3307,260.3937008,6614,-1521664,171520,-1350144,87
3143,366,21,9,0.10430322,0.89569678,976.7586391,1261.112811,1729.328349,1975.453552,3509,63.33935018,7018,-1609216,187392,-1421824,87
711,82,21,9,0.103404792,0.896595208,227.6903409,208.4796189,409.8312236,285.7439024,793,99.49811794,1586,-364032,41984,-322048,87
2526,242,21,9,0.0874277457,0.912572254,787.6761611,809.6016424,1422.395487,988.946281,2768,48.36624148,5536,-1293312,123904,-1169408,87
3067,369,21,9,0.107392317,0.892607683,954.0839703,1243.277474,1693.197587,1928.804878,3436,76.06818685,6872,-1570304,188928,-1381376,87
3120,382,21,9,0.109080525,0.890919475,971.4249302,1270.184871,1726.06891,1959.209424,3502,76.66374781,7004,-1597440,195584,-1401856,87
3036,354,23,7,0.104424779,0.895575221,942.3930828,1203.118935,1659.433465,2004.816384,3390,79.52146376,6780,-1554432,181248,-1373184,87
3130,373,21,9,0.10648016,0.89351984,974.3923446,1270.452489,1735.173482,1893.198391,3503,72.8880566,7006,-1602560,190976,-1411584,87
3068,378,21,9,0.109692397,0.890307603,955.6513709,1242.02183,1693.567471,1966.444444,3446,68.14316789,6892,-1570816,193536,-1377280,87
3235,385,21,9,0.106353591,0.893646409,1008.355698,1249.102078,1764.926739,2193.433766,3620,85.55896951,7240,-1656320,197120,-1459200,87
3010,341,21,9,0.101760668,0.898239332,935.4428422,1113.814258,1624.384053,2131.612903,3351,80.98115031,6702,-1541120,174592,-1366528,87
3089,385,21,9,0.110823258,0.889176742,964.0808583,1257.612343,1715.17449,1916.625974,3474,74.6615087,6948,-1581568,197120,-1384448,87
3193,394,21,9,0.109841093,0.890158907,997.3699063,1267.885217,1758.595678,2080.918782,3587,89.92228629,7174,-1634816,201728,-1433088,87
3150,358,20,10,0.102052452,0.897947548,979.8359236,1230.142115,1722.563492,2035.505587,3508,67.52646776,7016,-1612800,183296,-1429504,87
3122,377,20,10,0.10774507,0.89225493,972.8963132,1234.037823,1712.529789,2060.297082,3499,75.81798483,6998,-1598464,193024,-1405440,87
3115,359,21,9,0.10333909,0.89666091,969.2537078,1216.211146,1702.719422,2039.286908,3474,72.69303202,6948,-1594880,183808,-1411072,87
3194,367,20,10,0.103060938,0.896939062,991.0120282,1269.260743,1747.434878,2073.117166,3561,77.22836695,7122,-1635328,187904,-1447424,87
3087,307,21,9,0.0904537419,0.909546258,950.0443777,1224.54287,1679.225138,1881.260586,3394,87.18212176,6788,-1580544,157184,-1423360,87
3115,376,21,9,0.107705529,0.892294471,969.3632504,1271.7141,1727.147352,1902.18617,3491,74.86596612,6982,-1594880,192512,-1402368,87
3165,365,20,10,0.103399433,0.896600567,983.5574883,1240.305784,1728.323223,2087.868493,3530,66.62891657,7060,-1620480,186880,-1433600,87
3051,329,21,9,0.0973372781,0.902662722,946.5441586,1131.055051,1645.505736,2107.756839,3380,68.36569579,6760,-1562112,168448,-1393664,87
3161,392,21,9,0.110329299,0.889670701,984.5494704,1281.93297,1744.950649,2035.438776,3553,85.04068933,7106,-1618432,200704,-1417728,87
3209,388,20,10,0.107867668,0.892132332,998.0147645,1283.644288,1761.117794,2112.309278,3597,77.57170584,7194,-1643008,198656,-1444352,87
2658,239,20,10,0.082499137,0.917500863,815.1749661,999.4621259,1474.593679,1164.364017,2897,52.16060497,5794,-1360896,122368,-1238528,87
3217,382,21,9,0.106140595,0.893859405,998.9104803,1308.644831,1773.947156,2019.403141,3599,90.42713568,7198,-1647104,195584,-1451520,87
3191,378,21,9,0.10591202,0.89408798,991.975706,1273.058317,1750.52366,2076.042328,3569,80.16621743,7138,-1633792,193536,-1440256,87
3152,380,21,9,0.107587769,0.892412231,980.3695939,1264.277642,1731.956218,2053.031579,3532,86.67484663,7064,-1613824,194560,-1419264,87
3080,375,20,10,0.10853835,0.89146165,960.3256537,1222.36866,1692.33539,2020.925333,3455,76.20202911,6910,-1576960,192000,-1384960,87
3110,400,20,10,0.113960114,0.886039886,970.1696627,1265.102817,1719.07299,2038.72,3510,63.71392267,7020,-1592320,204800,-1387520,87
3126,376,21,9,0.107367219,0.892632781,972.1898108,1268.708462,1725.767434,1965.43617,3502,85.81230091,7004,-1600512,192512,-1408000,87
3234,370,21,9,0.102663707,0.897336293,1004.480599,1279.571185,1770.564626,2081.632432,3604,84.87988695,7208,-1655808,189440,-1466368,87
3204,394,21,9,0.109505281,0.890494719,1000.712794,1283.802262,1771.109238,2030.373096,3598,72.03203203,7196,-1640448,201728,-1438720,87
3200,354,21,9,0.0996060777,0.900393922,992.793619,1252.50356,1746.203125,2060.409605,3554,79.1008235,7108,-1638400,181248,-1457152,87
3107,357,21,9,0.103060046,0.896939954,964.0877149,1260.601983,1715.577406,1879.778711,3464,75.50130776,6928,-1590784,182784,-1408000,87
2085,189,20,10,0.0831134565,0.916886544,640.7920736,716.8805464,1170.097842,777.8888889,2274,35.65380997,4548,-1067520,96768,-970752,87
3131,391,21,9,0.111016468,0.888983532,977.5901462,1265.72697,1733.528266,1985.488491,3522,87.41623232,7044,-1603072,200192,-1402880,87
3156,383,21,9,0.108222662,0.891777338,981.9064903,1280.6391,1742.082383,2000.046997,3539,90.0279827,7078,-1615872,196096,-1419776,87
3218,344,21,9,0.0965749579,0.903425042,993.6623375,1255.964994,1744.267247,2129.799419,3562,76.55276166,7124,-1647616,176128,-1471488,87
3135,383,21,9,0.108868675,0.891131325,975.2293193,1279.414127,1733.29059,1974.033943,3518,88.72635561,7036,-1605120,196096,-1409024,87
3241,370,21,9,0.102464691,0.897535309,1006.633173,1268.215434,1768.48627,2134.6,3611,95.65562914,7222,-1659392,189440,-1469952,87
2525,240,21,9,0.0867992767,0.913200723,779.7325867,936.4156177,1406.43802,1136.4125,2765,63.73905025,5530,-1292800,122880,-1169920,87
3167,353,21,9,0.100284091,0.899715909,984.4893256,1233.891214,1730.957689,2025.543909,3520,98.43400447,7040,-1621504,180736,-1440768,87
3218,378,20,10,0.105116796,0.894883204,997.5258999,1280.429517,1756.802672,2153.478836,3596,62.92213473,7192,-1647616,193536,-1454080,87
3137,386,21,9,0.109565711,0.890434289,975.0915093,1271.215827,1725.869621,2055.629534,3523,61.85042135,7046,-1606144,197632,-1408512,87
3123,359,21,9,0.103101666,0.896898334,970.2963524,1255.869907,1721.90554,1911.955432,3482,61.67198016,6964,-1598976,183808,-1415168,87
3160,357,21,9,0.101506966,0.898493034,978.5378087,1269.341878,1731.113608,2005.837535,3517,69.43731491,7034,-1617920,182784,-1435136,87
3276,396,21,9,0.107843137,0.892156863,1020.477361,1323.479075,1810.331197,2052.987374,3672,91.57107232,7344,-1677312,202752,-1474560,87
3162,367,21,9,0.103995466,0.896004534,982.8776495,1233.210909,1724.576218,2113.283379,3529,87.32986884,7058,-1618944,187904,-1431040,87
3096,362,21,9,0.104684789,0.895315211,962.8148832,1212.429441,1691.076227,2058.118785,3458,60.7412612,6916,-1585152,185344,-1399808,87
3279,383,20,10,0.104587657,0.895412343,1022.407346,1273.690187,1794.281183,2150.143603,3662,84.16455987,7324,-1678848,196096,-1482752,87
3229,394,21,9,0.108749655,0.891250345,1006.122463,1303.573415,1783.092908,2048.906091,3623,88.82078941,7246,-1653248,201728,-1451520,87
3142,361,21,9,0.103054525,0.896945475,977.1436524,1230.073712,1717.696372,2050.565097,3503,74.62718364,7006,-1608704,184832,-1423872,87
2731,277,21,9,0.092087766,0.907912234,847.4724948,1048.38423,1513.042109,1420.281588,3008,54.32544699,6016,-1398272,141824,-1256448,87
59,16,21,9,0.213333333,0.786666667,21.197841,22.00248566,39.79661017,31.375,75,3.135451505,150,-30208,8192,-22016,87
2102,186,21,9,0.0812937063,0.918706294,643.3120561,746.0871726,1175.394386,795.3602151,2288,35.48387097,4576,-1076224,95232,-980992,87
3766,369,23,7,0.0892382104,0.91076179,1173.913355,1379.171693,2069.206851,2055.682927,4135,239.1555813,8270,-1928192,188928,-1739264,88
3692,353,23,7,0.0872682324,0.912731768,1151.156758,1325.027989,2031.568527,1933.382436,4045,264.5519948,8090,-1890304,180736,-1709568,88
3858,370,24,6,0.0875118259,0.912488174,1191.008013,1479.994924,2095.877398,2308.678378,4228,97.30724971,8456,-1975296,189440,-1785856,88
3725,340,24,6,0.0836408364,0.916359164,1148.314517,1419.650382,2029.787114,2068.2,4065,508.125,8130,-1907200,174080,-1733120,88
3495,325,23,7,0.085078534,0.914921466,1080.972879,1314.193496,1911.236338,1902.581538,3820,283.1727205,7640,-1789440,166400,-1623040,88
3370,320,23,7,0.0867208672,0.913279133,1039.88384,1298.287223,1836.150742,1943.959375,3690,297.3408541,7380,-1725440,163840,-1561600,88
3195,194,23,7,0.0572440248,0.942755975,971.6206099,1032.348981,1714.240689,1378.123711,3389,396.8384075,6778,-1635840,99328,-1536512,88
3810,383,23,7,0.091342714,0.908657286,1187.954223,1413.58781,2091.97664,2146.971279,4193,273.694517,8386,-1950720,196096,-1754624,88
3198,329,23,7,0.0932804083,0.906719592,995.1991316,1205.467865,1746.260475,1936.43465,3527,288.3892069,7054,-1637376,168448,-1468928,88
3328,345,23,7,0.0939286687,0.906071331,1034.24886,1273.713811,1820.390625,1997.22029,3673,98.68350349,7346,-1703936,176640,-1527296,88
3416,356,22,8,0.0943796394,0.905620361,1063.205903,1306.994814,1877.818501,1969.803371,3772,318.8503804,7544,-1748992,182272,-1566720,88
3869,380,24,6,0.0894328077,0.910567192,1193.624765,1498.876052,2100.211941,2377.381579,4249,106.9468915,8498,-1980928,194560,-1786368,88
3663,348,24,6,0.0867614061,0.913238594,1140.766525,1324.452115,2004.034671,2026.686782,4011,265.2777778,8022,-1875456,178176,-1697280,88
3042,220,23,7,0.0674432863,0.932556714,933.7140836,998.7109377,1653.059829,1333.386364,3262,336.6357069,6524,-1557504,112640,-1444864,88
3254,308,23,7,0.0864682762,0.913531724,1007.851356,1197.938599,1759.101414,2018.13961,3562,312.7304653,7124,-1666048,157696,-1508352,88
3237,340,23,7,0.0950517193,0.904948281,1006.727376,1241.189039,1772.325919,1947.747059,3577,279.0171607,7154,-1657344,174080,-1483264,88
3250,334,22,8,0.0931919643,0.906808036,1013.819804,1207.448473,1776.443385,1948.739521,3584,252.0393812,7168,-1664000,171008,-1492992,88
3378,318,23,7,0.086038961,0.913961039,1042.112021,1295.747982,1837.216992,1968.355346,3696,327.079646,7392,-1729536,162816,-1566720,88
3156,307,23,7,0.0886514583,0.911348542,982.1476011,1150.960699,1715.416984,1902.47557,3463,202.989449,6926,-1615872,157184,-1458688,88
3080,264,24,6,0.0789473684,0.921052632,956.3487717,958.5910512,1710.581818,1228.212121,3344,53.95288803,6688,-1576960,135168,-1441792,88
5992,430,24,6,0.0669573342,0.933042666,1848.563788,1852.048031,3248.219626,2699.816279,6422,941.6422287,12844,-3067904,220160,-2847744,88
5961,434,23,7,0.0678655199,0.93213448,1837.652756,1888.742734,3234.315551,2699.205069,6395,527.640264,12790,-3052032,222208,-2829824,88
6259,456,23,7,0.0679076694,0.932092331,1929.990978,2000.367201,3389.883687,2920.368421,6715,511.0350076,13430,-3204608,233472,-2971136,88
5751,410,23,7,0.0665476384,0.933452362,1777.146109,1695.291184,3122.214919,2502.885366,6161,537.1403662,12322,-2944512,209920,-2734592,88
2638,218,21,9,0.0763305322,0.923669468,816.9995998,852.0196815,1453.852919,1121.706422,2856,86.49303452,5712,-1350656,111616,-1239040,88
5831,439,22,8,0.070015949,0.929984051,1802.48206,1806.52012,3179.839307,2546.56492,6270,275.6043956,12540,-2985472,224768,-2760704,88
5951,442,22,8,0.0691381198,0.93086188,1839.93491,1835.928753,3236.987229,2658.61991,6393,608.2778306,12786,-3046912,226304,-2820608,88
5768,435,23,7,0.0701273577,0.929872642,1783.146258,1783.033361,3147.00052,2505.303448,6203,628.4701114,12406,-2953216,222720,-2730496,88
6041,430,22,8,0.0664503168,0.933549683,1856.805428,1960.282161,3269.230591,2769.148837,6471,391.7070218,12942,-3092992,220160,-2872832,88
5824,404,23,7,0.0648683365,0.935131663,1800.746882,1702.411474,3143.338084,2698.774752,6228,548.2394366,12456,-2981888,206848,-2775040,88
6200,446,23,7,0.0671080349,0.932891965,1915.565256,1907.704391,3354.550645,2891.85426,6646,491.9319023,13292,-3174400,228352,-2946048,88
6038,422,23,7,0.0653250774,0.934674923,1861.411489,1840.269746,3265.863034,2724.523697,6460,598.1481481,12920,-3091456,216064,-2875392,88
6307,449,23,7,0.0664594435,0.933540557,1945.800174,1935.354131,3416.406691,2846.033408,6756,430.8673469,13512,-3229184,229888,-2999296,88
5953,431,23,7,0.0675125313,0.932487469,1840.740602,1813.878337,3225.00084,2743.596288,6384,368.591224,12768,-3047936,220672,-2827264,88
6159,411,24,6,0.0625570776,0.937442922,1898.582803,1811.382501,3314.607241,2849.316302,6570,399.8782715,13140,-3153408,210432,-2942976,88
6233,450,23,7,0.0673350292,0.932664971,1927.674822,1885.35661,3376.836034,2859.482222,6683,446.4261857,13366,-3191296,230400,-2960896,88
5828,405,23,7,0.0649767367,0.935023263,1799.005697,1733.238413,3150.549417,2634.219753,6233,664.4989339,12466,-2983936,207360,-2776576,88
6120,438,24,6,0.0667886551,0.933211345,1891.19576,1868.704405,3309.971242,2853.737443,6558,611.1835974,13116,-3133440,224256,-2909184,88
2442,185,22,8,0.0704225352,0.929577465,750.3596596,806.601988,1335.119574,1035.221622,2627,62.07466919,5254,-1250304,94720,-1155584,88
607,79,23,7,0.11516035,0.88483965,197.5551805,201.6408249,343.2784185,345.2025316,686,10.75909661,1372,-310784,40448,-270336,88
2689,243,23,7,0.0828785812,0.917121419,835.085993,950.8484651,1479.541093,1322.1893,2932,255.8464223,5864,-1376768,124416,-1252352,88
2643,260,23,7,0.0895625215,0.910437478,823.5482845,942.3644684,1474.748014,1220.757692,2903,86.47602026,5806,-1353216,133120,-1220096,88
2672,235,23,7,0.0808393533,0.919160647,833.3315807,902.9634197,1454.698728,1446.055319,2907,386.5691489,5814,-1368064,120320,-1247744,88
2784,252,23,7,0.0830039526,0.916996047,864.7509983,994.486908,1523.643319,1461.678571,3036,181.1455847,6072,-1425408,129024,-1296384,88
2684,232,23,7,0.0795610425,0.920438957,826.8388184,998.4734398,1458.573398,1457.650862,2916,398.9056088,5832,-1374208,118784,-1255424,88
2658,258,21,9,0.0884773663,0.911522634,825.5631935,985.3980438,1470.253198,1337.414729,2916,380.6788512,5832,-1360896,132096,-1228800,88
2645,256,24,6,0.0882454326,0.911754567,820.0430206,974.6989286,1471.523629,1238.949219,2901,210.0651702,5802,-1354240,131072,-1223168,88
2702,256,23,7,0.0865449628,0.913455037,836.5440461,1018.138889,1483.771281,1434.417969,2958,290.5697446,5916,-1383424,131072,-1252352,88
2679,242,23,7,0.0828483396,0.91715166,828.9851765,986.6514969,1463.803658,1429.96281,2921,203.4122563,5842,-1371648,123904,-1247744,88
2684,233,23,7,0.0798765855,0.920123414,831.7448546,952.1831807,1462.128539,1422.961373,2917,421.5317919,5834,-1374208,119296,-1254912,88
2786,242,21,9,0.0799207398,0.92007926,857.236658,1043.725162,1523.233309,1413.958678,3028,253.3891213,6056,-1426432,123904,-1302528,88
2799,227,23,7,0.0750165235,0.924983477,861.5647311,1006.201637,1519.84816,1435.22467,3026,267.55084,6052,-1433088,116224,-1316864,88
2673,237,22,8,0.081443299,0.918556701,828.0098729,961.8254324,1462.598204,1375.443038,2910,353.1553398,5820,-1368576,121344,-1247232,88
2794,248,23,7,0.0815253123,0.918474688,863.2376855,1031.017039,1523.759127,1496.048387,3042,206.7980965,6084,-1430528,126976,-1303552,88
2892,257,23,7,0.0816132105,0.918386789,893.3402419,1068.683271,1579.381743,1525.692607,3149,388.7654321,6298,-1480704,131584,-1349120,88
2819,268,22,8,0.0868156787,0.913184321,877.5917152,1011.604073,1557.733239,1399.544776,3087,168.9655172,6174,-1443328,137216,-1306112,88
2702,253,22,8,0.0856175973,0.914382403,841.2583807,967.2836235,1484.410437,1409.537549,2955,349.2907801,5910,-1383424,129536,-1253888,88
2667,238,22,8,0.0819277108,0.918072289,824.0348583,986.7974535,1455.526434,1424.689076,2905,456.7610063,5810,-1365504,121856,-1243648,88
2716,233,23,7,0.0790098338,0.920990166,837.0058591,1002.989696,1475.802283,1465.648069,2949,218.6063751,5898,-1390592,119296,-1271296,88
1770,176,23,7,0.0904419322,0.909558068,552.4222389,584.635807,1000.057627,706.4147727,1946,31.11608571,3892,-906240,90112,-816128,88
5121,170,20,10,0.0321300321,0.967869968,1522.734012,1650.381202,2652.198008,2459.294118,5291,169.5833333,10582,-2621952,87040,-2534912,88
5149,168,20,10,0.0315967651,0.968403235,1531.063428,1638.032085,2664.733929,2483.261905,5317,786.5384615,10634,-2636288,86016,-2550272,88
1160,49,21,9,0.0405293631,0.959470637,345.325606,390.831407,612.1172414,436.5102041,1209,25.81678411,2418,-593920,25088,-568832,88
5125,169,20,10,0.0319229316,0.968077068,1523.897998,1645.076431,2653.277854,2472.284024,5294,542.974359,10588,-2624000,86528,-2537472,88
5117,167,20,10,0.0316048448,0.968395155,1521.529886,1628.848587,2648.162986,2468.982036,5284,413.458529,10568,-2619904,85504,-2534400,88
5113,167,20,10,0.0316287879,0.968371212,1520.348079,1628.282609,2646.194211,2466.161677,5280,726.2723521,10560,-2617856,85504,-2532352,88
5122,168,20,10,0.031758034,0.968241966,1523.034078,1637.862115,2650.775674,2484.654762,5290,956.6003617,10580,-2622464,86016,-2536448,88
5120,169,20,10,0.0319531102,0.96804689,1522.43935,1640.564036,2651.716016,2441.532544,5289,554.9842602,10578,-2621440,86528,-2534912,88
5118,167,20,10,0.0315988647,0.968401135,1521.816989,1629.017949,2648.717468,2467.778443,5285,441.5204678,10570,-2620416,85504,-2534912,88
5113,166,20,10,0.0314453495,0.968554651,1520.330583,1622.691536,2645.090749,2483.198795,5279,852.8271405,10558,-2617856,84992,-2532864,88
5119,168,20,10,0.0317760545,0.968223946,1522.134075,1637.948542,2649.257863,2483.791667,5287,376.0312945,10574,-2620928,86016,-2534912,88
5125,168,20,10,0.031740034,0.968259966,1523.916114,1638.221114,2652.313561,2484.904762,5293,715.2702703,10586,-2624000,86016,-2537984,88
5122,168,20,10,0.031758034,0.968241966,1523.017505,1638.592302,2650.690746,2487.244048,5290,739.8601399,10580,-2622464,86016,-2536448,88
4039,136,21,9,0.0325748503,0.96742515,1201.058218,1305.846999,2094.996781,1880.205882,4175,73.68513943,8350,-2067968,69632,-1998336,88
5119,168,20,10,0.0317760545,0.968223946,1522.118377,1638.54374,2649.208634,2485.291667,5287,939.0763766,10574,-2620928,86016,-2534912,88
5121,168,20,10,0.0317640386,0.968235961,1522.705816,1638.648571,2650.283734,2483.940476,5289,406.5334358,10578,-2621952,86016,-2535936,88
5123,167,20,10,0.0315689981,0.968431002,1523.293224,1632.362486,2650.346086,2496.838323,5290,491.1792015,10580,-2622976,85504,-2537472,88
5118,166,20,10,0.0314155942,0.968584406,1521.792713,1623.434165,2647.673114,2483.006024,5284,729.8342541,10568,-2620416,84992,-2535424,88
5129,168,20,10,0.0317160657,0.968283934,1525.067823,1639.730859,2654.254241,2488.589286,5297,636.6586538,10594,-2626048,86016,-2540032,88
5129,168,20,10,0.0317160657,0.968283934,1525.088417,1639.042199,2654.287775,2487.565476,5297,999.4339623,10594,-2626048,86016,-2540032,88
3428,269,23,7,0.0727616987,0.927238301,1053.936036,1220.550639,1856.024796,1759.479554,3697,367.4950298,7394,-1755136,137728,-1617408,88
3428,277,23,7,0.0747638327,0.925236167,1057.521647,1194.479774,1867.233664,1676.851986,3705,470.177665,7410,-1755136,141824,-1613312,88
277,56,22,8,0.168168168,0.831831832,98.01672295,85.49617338,169,157.1071429,333,8.468972533,666,-141824,28672,-113152,88
3319,261,23,7,0.0729050279,0.927094972,1027.485283,1074.759047,1810.451341,1536.789272,3580,313.7598598,7160,-1699328,133632,-1565696,88
3301,258,23,7,0.0724922731,0.927507727,1023.574515,1048.757203,1797.796122,1552.306202,3559,431.9174757,7118,-1690112,132096,-1558016,88
3335,260,23,7,0.0723226704,0.92767733,1027.357453,1161.087911,1803.389505,1728.869231,3595,282.8481511,7190,-1707520,133120,-1574400,88
3373,257,23,7,0.0707988981,0.929201102,1037.345414,1168.72825,1826.079751,1676.645914,3630,516.3584637,7260,-1726976,131584,-1595392,88
3313,270,24,6,0.0753558471,0.924644153,1021.958106,1147.43457,1812.010263,1546.466667,3583,479.6519411,7166,-1696256,138240,-1558016,88
3311,263,23,7,0.0735870173,0.926412983,1013.657168,1232.154831,1795.69707,1684.304183,3574,771.9222462,7148,-1695232,134656,-1560576,88
3344,253,23,7,0.0703363914,0.929663609,1031.211188,1120.217086,1809.051734,1666.142292,3597,588.7070376,7194,-1712128,129536,-1582592,88
3332,274,23,7,0.0759844703,0.92401553,1026.397849,1192.238817,1816.804622,1641.708029,3606,516.6189112,7212,-1705984,140288,-1565696,88
3317,255,23,7,0.0713885778,0.928611422,1020.741334,1147.281422,1798.156768,1634.870588,3572,355.4228856,7144,-1698304,130560,-1567744,88
3315,247,23,7,0.0693430657,0.930656934,1019.769175,1128.004254,1791.232579,1650.878543,3562,437.5921376,7124,-1697280,126464,-1570816,88
1025,88,23,7,0.0790655885,0.920934412,313.6992124,379.6872216,567.1746341,438.4886364,1113,149.5967742,2226,-524800,45056,-479744,88
3327,291,23,7,0.0804311774,0.919568823,1022.161893,1270.833033,1813.122032,1768.089347,3618,64.10347271,7236,-1703424,148992,-1554432,88
3300,254,23,7,0.0714687676,0.928531232,1010.648641,1188.778223,1793.108788,1574.708661,3554,593.3222037,7108,-1689600,130048,-1559552,88
3348,270,23,7,0.0746268657,0.925373134,1023.898585,1270.892587,1813.093489,1764.940741,3618,62.8561501,7236,-1714176,138240,-1575936,88
3419,268,23,7,0.0726878221,0.927312178,1051.514326,1207.774971,1854.795262,1706.279851,3687,338.2568807,7374,-1750528,137216,-1613312,88
3293,266,23,7,0.0747400955,0.925259904,1016.271104,1139.980925,1795.028849,1593.947368,3559,398.5442329,7118,-1686016,136192,-1549824,88
2384,179,23,7,0.0698400312,0.930159969,726.5612647,811.3532535,1309.964765,909.5530726,2563,41.78350179,5126,-1220608,91648,-1128960,88
4978,165,20,10,0.0320824422,0.967917558,1480.216995,1606.518051,2576.656087,2431.527273,5143,89.53690808,10286,-2548736,84480,-2464256,88
4979,165,20,10,0.0320762053,0.967923795,1480.545133,1599.499035,2579.051416,2374.806061,5144,713.4535368,10288,-2549248,84480,-2464768,88
4979,163,20,10,0.0316997277,0.968300272,1480.517605,1588.002231,2577.104238,2400.312883,5142,421.4754098,10284,-2549248,83456,-2465792,88
4985,165,20,10,0.032038835,0.967961165,1482.303817,1600.03539,2582.202207,2373.012121,5150,401.4029618,10300,-2552320,84480,-2467840,88
4989,166,20,10,0.0322017459,0.967798254,1483.50355,1605.966634,2585.148527,2363.156627,5155,447.8714162,10310,-2554368,84992,-2469376,88
4972,165,20,10,0.0321199143,0.967880086,1478.469438,1599.225303,2575.452936,2374.551515,5137,683.1117021,10274,-2545664,84480,-2461184,88
4978,163,20,10,0.0317058938,0.968294106,1480.20587,1588.049101,2576.691844,2397.171779,5141,636.2623762,10282,-2548736,83456,-2465280,88
4983,163,20,10,0.0316750874,0.968324913,1481.713011,1587.868227,2579.165964,2400.288344,5146,552.7389903,10292,-2551296,83456,-2467840,88
4976,163,20,10,0.0317182331,0.968281767,1479.639328,1587.635402,2575.541198,2400.840491,5139,739.4244604,10278,-2547712,83456,-2464256,88
4984,165,20,10,0.0320450573,0.967954943,1481.998513,1600.494599,2581.624398,2374.90303,5149,837.2357724,10298,-2551808,84480,-2467328,88
4983,163,20,10,0.0316750874,0.968324913,1481.692716,1588.284021,2579.213125,2398.846626,5146,495.761079,10292,-2551296,83456,-2467840,88
4979,163,20,10,0.0316997277,0.968300272,1480.519434,1587.722722,2577.170717,2398.282209,5142,506.6009852,10284,-2549248,83456,-2465792,88
4946,162,20,10,0.0317149569,0.968285043,1470.68425,1578.391039,2560.158916,2381.728395,5108,194.5904762,10216,-2532352,82944,-2449408,88
4979,163,20,10,0.0316997277,0.968300272,1480.514319,1587.783192,2577.195421,2397.527607,5142,521.5010142,10284,-2549248,83456,-2465792,88
4990,163,20,10,0.031632059,0.968367941,1483.765192,1588.818955,2582.756513,2400.773006,5153,641.7185554,10306,-2554880,83456,-2471424,88
5010,164,20,10,0.0316969463,0.968303054,1489.722446,1598.100316,2593.151896,2414.841463,5174,309.4497608,10348,-2565120,83968,-2481152,88
4983,163,20,10,0.0316750874,0.968324913,1481.723596,1587.574543,2579.163556,2400.361963,5146,444.7709594,10292,-2551296,83456,-2467840,88
4984,165,20,10,0.0320450573,0.967954943,1482.154084,1599.86854,2580.588483,2406.193939,5149,81.86009539,10298,-2551808,84480,-2467328,88
4979,163,20,10,0.0316997277,0.968300272,1480.495906,1588.389265,2577.171721,2398.251534,5142,499.223301,10284,-2549248,83456,-2465792,88
4981,165,20,10,0.0320637388,0.967936261,1481.109751,1606.885488,2578.092752,2434.854545,5146,90.83848191,10292,-2550272,84480,-2465792,88
4623,329,23,7,0.0664378029,0.933562197,1421.60917,1405.04827,2519.235345,1875.99696,4952,416.1344538,9904,-2366976,168448,-2198528,88
4738,329,24,6,0.0649299388,0.935070061,1458.213076,1425.157384,2570.649852,2006.197568,5067,696.0164835,10134,-2425856,168448,-2257408,88
4826,306,23,7,0.0596258769,0.940374123,1477.05794,1433.641399,2602.658724,1996.232026,5132,502.1526419,10264,-2470912,156672,-2314240,88
4757,340,22,8,0.0667059054,0.933294095,1460.650463,1543.000077,2581.68972,2091.632353,5097,90.48464406,10194,-2435584,174080,-2261504,88
4754,318,21,9,0.0626971609,0.937302839,1453.642995,1481.141833,2577.90345,1917.531447,5072,363.5842294,10144,-2434048,162816,-2271232,88
4640,322,22,8,0.0648931882,0.935106812,1427.071851,1401.186468,2518.758405,1944.608696,4962,666.9354839,9924,-2375680,164864,-2210816,88
4741,327,23,7,0.0645224941,0.935477506,1452.408827,1498.345066,2573.584687,1967.831804,5068,336.9680851,10136,-2427392,167424,-2259968,88
3801,300,23,7,0.0731528895,0.92684711,1176.371659,1145.777241,2093.479874,1512.78,4101,71.5457083,8202,-1946112,153600,-1792512,88
4725,329,23,7,0.0650969529,0.934903047,1451.619119,1431.423281,2569.36254,1926.282675,5054,168.9735874,10108,-2419200,168448,-2250752,88
4799,328,23,7,0.0639750341,0.936024966,1476.662981,1386.328646,2606.576578,1941.057927,5127,207.73906,10254,-2457088,167936,-2289152,88
4691,317,22,8,0.063298722,0.936701278,1439.029824,1422.733225,2543.189085,1931.974763,5008,674.9326146,10016,-2401792,162304,-2239488,88
4608,300,23,7,0.0611246944,0.938875306,1414.523869,1337.221453,2490.12717,1907.266667,4908,1083.443709,9816,-2359296,153600,-2205696,88
4650,293,23,7,0.0592757435,0.940724257,1421.460526,1392.572944,2507.828602,1903.389078,4943,457.6851852,9886,-2380800,150016,-2230784,88
4789,341,23,7,0.0664717349,0.933528265,1475.609992,1424.910481,2608.048653,1967.947214,5130,755.5228277,10260,-2451968,174592,-2277376,88
4711,333,23,7,0.0660190325,0.933980967,1456.066875,1351.129491,2559.605816,1997.558559,5044,751.7138599,10088,-2412032,170496,-2241536,88
4751,304,24,6,0.0601384768,0.939861523,1453.640412,1440.810521,2562.481372,1989.115132,5055,583.7182448,10110,-2432512,155648,-2276864,88
4723,311,23,7,0.0617798967,0.938220103,1446.292408,1435.701335,2555.463265,1940.971061,5034,276.2897914,10068,-2418176,159232,-2258944,88
4712,305,23,7,0.0607933028,0.939206697,1443.628581,1409.749684,2544.379032,1962.422951,5017,1191.686461,10034,-2412544,156160,-2256384,88
4756,294,23,7,0.0582178218,0.941782178,1456.057998,1392.878322,2556.536165,2023.431973,5050,573.2122588,10100,-2435072,150528,-2284544,88
1853,182,23,7,0.0894348894,0.910565111,580.475327,631.8966505,1033.90286,856.0879121,2035,32.89154679,4070,-948736,93184,-855552,88
6869,450,22,8,0.0614838093,0.938516191,2105.47841,2130.047228,3700.097685,3047.931111,7319,480.564675,14638,-3516928,230400,-3286528,88
1626,153,23,7,0.0860033727,0.913996627,511.9857363,490.9699946,907.9391144,699.3529412,1779,35.65844859,3558,-832512,78336,-754176,88
7181,465,24,6,0.060816113,0.939183887,2196.220105,2321.839427,3853.476535,3360.572043,7646,588.6066205,15292,-3676672,238080,-3438592,88
7268,492,23,7,0.0634020619,0.936597938,2233.072217,2242.1403,3924.768024,3226.556911,7760,566.8371074,15520,-3721216,251904,-3469312,88
6926,447,23,7,0.0606266106,0.939373389,2125.276923,2109.501581,3720.455241,3168.630872,7373,530.4316547,14746,-3546112,228864,-3317248,88
6959,472,23,7,0.0635176961,0.936482304,2131.543906,2273.662365,3751.328208,3195.133475,7431,550.0370096,14862,-3563008,241664,-3321344,88
6955,459,24,6,0.0619099002,0.9380901,2134.629177,2128.059918,3748.690151,3083.366013,7414,471.6284987,14828,-3560960,235008,-3325952,88
1119,85,24,6,0.0705980066,0.929401993,342.1040766,405.9597669,607.9687221,530.5058824,1204,110.3574702,2408,-572928,43520,-529408,88
6931,449,23,7,0.0608401084,0.939159892,2123.365058,2152.075215,3728.722984,3100.469933,7380,457.532548,14760,-3548672,229888,-3318784,88
6859,462,23,7,0.063106133,0.936893867,2100.774019,2211.597313,3700.367984,3076.530303,7321,619.3739425,14642,-3511808,236544,-3275264,88
6828,452,23,7,0.0620879121,0.937912088,2095.373403,2095.321024,3681.952548,3014.309735,7280,510.1611773,14560,-3495936,231424,-3264512,88
6999,482,22,8,0.0644298891,0.935570111,2139.989093,2331.460478,3785.739248,3091.352697,7481,455.3256239,14962,-3583488,246784,-3336704,88
6882,473,23,7,0.0643099932,0.935690007,2117.563161,2098.666401,3722.684975,3027.84778,7355,697.1563981,14710,-3523584,242176,-3281408,88
6998,496,22,8,0.0661862824,0.933813718,2160.273205,2122.167105,3788.763933,3165.3125,7494,793.015873,14988,-3582976,253952,-3329024,88
6852,457,23,7,0.0625256533,0.937474347,2099.78669,2181.598025,3692.232925,3096.750547,7309,677.386469,14618,-3508224,233984,-3274240,88
7314,495,22,8,0.063388398,0.936611602,2237.264695,2482.565539,3919.162428,3695.739394,7809,137.0240393,15618,-3744768,253440,-3491328,88
108,31,23,7,0.223021583,0.776978417,40.78224317,37.7424869,69.88888889,70.38709677,139,2.943044675,278,-55296,15872,-39424,88
7256,492,23,7,0.0635002581,0.936499742,2227.444509,2240.426667,3924.880375,3131.49187,7748,763.3497537,15496,-3715072,251904,-3463168,88
6863,460,23,7,0.0628157859,0.937184214,2103.026134,2173.690347,3704.665015,3025.456522,7323,186.8112245,14646,-3513856,235520,-3278336,88
7069,498,23,7,0.0658120788,0.934187921,2177.56476,2248.601145,3809.379544,3423.742972,7567,135.0526504,15134,-3619328,254976,-3364352,88
1275,150,23,7,0.105263158,0.894736842,403.2044471,460.0252623,699.7968627,825.2266667,1425,116.7076167,2850,-652800,76800,-576000,88
1212,140,23,7,0.103550296,0.896449704,382.8597107,431.4883645,662.7235974,795.7642857,1352,181.9650067,2704,-620544,71680,-548864,88
1215,135,23,7,0.1,0.9,383.6335608,413.7426552,659.5160494,819.3555556,1350,199.4091581,2700,-622080,69120,-552960,88
1208,145,23,7,0.107169254,0.892830746,382.1108979,443.9346459,665.6730132,771.3655172,1353,96.36752137,2706,-618496,74240,-544256,88
1215,145,24,6,0.106617647,0.893382353,382.9453901,456.5824369,670.1654321,767.0965517,1360,145.4545455,2720,-622080,74240,-547840,88
1214,148,22,8,0.10866373,0.89133627,383.624366,455.4564746,671.2026359,765.9662162,1362,195.4088953,2724,-621568,75776,-545792,88
1200,144,23,7,0.107142857,0.892857143,379.7947844,417.7252218,653.3916667,831.7361111,1344,60.75949367,2688,-614400,73728,-540672,88
1199,145,22,8,0.107886905,0.892113095,378.9295669,440.7503458,659.1517932,782.8758621,1344,195.065312,2688,-613888,74240,-539648,88
1203,150,22,8,0.110864745,0.889135255,382.6568907,428.1631361,661.0756442,804.7133333,1353,204.0723982,2706,-615936,76800,-539136,88
1207,144,23,7,0.106587713,0.893412287,382.3265089,435.8068427,663.7257664,778.8819444,1351,123.2664234,2702,-617984,73728,-544256,88
1206,152,23,7,0.111929308,0.888070692,382.6357779,448.4182826,667.4552239,775.0657895,1358,159.0163934,2716,-617472,77824,-539648,88
1207,148,23,7,0.109225092,0.890774908,382.6390506,444.3208228,666.8276719,769.1148649,1355,141.8848168,2710,-617984,75776,-542208,88
1204,138,24,6,0.102831595,0.897168405,380.3190314,420.1347343,655.7641196,808.7898551,1342,179.4117647,2684,-616448,70656,-545792,88
1206,136,23,7,0.101341282,0.898658718,379.5393129,430.1188115,656.9394693,800.6176471,1342,89.70588235,2684,-617472,69632,-547840,88
1215,142,23,7,0.104642594,0.895357406,385.0685204,421.7612,663.4148148,812.3521127,1357,174.871134,2714,-622080,72704,-549376,88
1261,155,23,7,0.109463277,0.890536723,399.8627881,468.729525,699.5622522,781.2129032,1416,148.7394958,2832,-645632,79360,-566272,88
1211,140,23,7,0.103626943,0.896373057,382.3249049,433.6823638,662.4640793,793.0857143,1351,102.0392749,2702,-620032,71680,-548352,88
1213,145,21,9,0.106774669,0.893225331,383.8162318,442.52927,667.5985161,779.062069,1358,198.5380117,2716,-621056,74240,-546816,88
1232,151,22,8,0.109182936,0.890817064,390.278854,454.7099129,680.2378247,787.9668874,1383,140.1215805,2766,-630784,77312,-553472,88
1268,156,23,7,0.109550562,0.890449438,401.6558625,468.5132441,699.9487382,814.5192308,1424,153.613808,2848,-649216,79872,-569344,88
3176,263,23,7,0.0764757197,0.92352428,979.6668632,1138.971847,1720.357053,1715.688213,3439,440.8974359,6878,-1626112,134656,-1491456,88
3117,273,22,8,0.0805309735,0.919469027,966.1838717,1080.843886,1716.967918,1450.388278,3390,61.64757229,6780,-1595904,139776,-1456128,88
3641,304,23,7,0.0770595691,0.922940431,1123.195233,1306.20305,1982.542159,1858.713816,3945,322.5674571,7890,-1864192,155648,-1708544,88
3157,265,21,9,0.0774400935,0.922559906,977.1838602,1103.358773,1718.731391,1625.350943,3422,342.8857715,6844,-1616384,135680,-1480704,88
3213,300,23,7,0.0853970965,0.914602904,994.9148428,1178.809987,1777.357921,1538.966667,3513,231.4229249,7026,-1645056,153600,-1491456,88
3839,277,23,7,0.0672983479,0.932701652,1174.61727,1354.369449,2068.795259,1915.815884,4116,410.7784431,8232,-1965568,141824,-1823744,88
3158,300,21,9,0.0867553499,0.91324465,980.7712187,1149.393151,1747.488284,1540.143333,3458,334.4294004,6916,-1616896,153600,-1463296,88
3735,320,23,7,0.0789149199,0.92108508,1150.96076,1378.599125,2030.929317,1993.809375,4055,282.3816156,8110,-1912320,163840,-1748480,88
3165,281,23,7,0.0815438189,0.918456181,976.0518958,1184.874481,1726.513428,1689.558719,3446,514.3283582,6892,-1620480,143872,-1476608,88
3152,275,22,8,0.0802451123,0.919754888,968.8555042,1191.634977,1725.012373,1587.778182,3427,402.2300469,6854,-1613824,140800,-1473024,88
3150,265,23,7,0.0775988287,0.922401171,968.4572837,1165.052775,1718.831429,1579.249057,3415,353.1540848,6830,-1612800,135680,-1477120,88
3565,287,23,7,0.0745067497,0.92549325,1098.170025,1255.87273,1941.659748,1738.191638,3852,356.9972196,7704,-1825280,146944,-1678336,88
3755,314,22,8,0.0771688376,0.922831162,1156.845038,1362.393577,2046.123036,1901.984076,4069,468.2393556,8138,-1922560,160768,-1761792,88
3159,264,23,7,0.0771253287,0.922874671,971.2127855,1171.541308,1714.043685,1687.545455,3423,396.1805556,6846,-1617408,135168,-1482240,88
3080,287,23,7,0.0852390852,0.914760915,962.2152857,1002.319351,1717.647727,1322.902439,3367,92.34777839,6734,-1576960,146944,-1430016,88
3190,292,23,7,0.0838598507,0.916140149,989.3208567,1157.565507,1752.467712,1621.681507,3482,303.5745423,6964,-1633280,149504,-1483776,88
3134,277,23,7,0.0812078569,0.918792143,965.1775937,1177.577491,1715.631142,1597.032491,3411,70.90002079,6822,-1604608,141824,-1462784,88
3242,297,23,7,0.0839220119,0.916077988,1002.968217,1204.560129,1776.186613,1702.468013,3539,352.8414756,7078,-1659904,152064,-1507840,88
3193,252,23,7,0.073149492,0.926850508,981.0142847,1150.086251,1727.49953,1665.988095,3445,268.5113016,6890,-1634816,129024,-1505792,88
3576,287,23,7,0.0742945897,0.92570541,1105.974175,1210.174292,1946.035794,1757.114983,3863,221.3753582,7726,-1830912,146944,-1683968,88
6665,1171,21,9,0.149438489,0.850561511,2221.831591,2233.410858,3744.328132,4909.836892,7836,137.6427191,15672,-3412480,599552,-2812928,89
8874,999,21,9,0.10118505,0.89881495,2882.449938,2543.658453,4929.471602,5003.873874,9873,324.6629398,19746,-4543488,511488,-4032000,89
3476,267,21,9,0.0713331552,0.928666845,1065.60423,1239.066687,1888.336594,1659.318352,3743,258.4944751,7486,-1779712,136704,-1643008,89
8881,994,21,9,0.100658228,0.899341772,2876.573728,2604.57145,4951.774913,4814.926559,9875,622.2432262,19750,-4547072,508928,-4038144,89
458,78,21,9,0.145522388,0.854477612,157.8572612,132.4256437,272.5567686,244.6794872,536,66.33663366,1072,-234496,39936,-194560,89
8999,891,22,8,0.090091001,0.909908999,2801.798866,3232.345221,4864.127125,5767.356902,9890,371.94434,19780,-4607488,456192,-4151296,89
7402,1393,21,9,0.158385446,0.841614554,2518.945501,2403.181987,4208.327614,5405.864322,8795,155.3612436,17590,-3789824,713216,-3076608,89
8353,1200,21,9,0.12561499,0.87438501,2761.547687,2657.35537,4692.449419,5365.5425,9553,196.7257002,19106,-4276736,614400,-3662336,89
8036,1375,21,9,0.146105621,0.853894379,2744.907836,2419.153529,4580.644226,5438.624727,9411,168.4144596,18822,-4114432,704000,-3410432,89
3396,257,20,10,0.0703531344,0.929646866,1039.300818,1212.355888,1845.400471,1583.856031,3653,204.5352744,7306,-1738752,131584,-1607168,89
8995,900,21,9,0.0909550278,0.909044972,2796.658382,3275.912653,4862.391773,5803.606667,9895,630.6564691,19790,-4605440,460800,-4144640,89
7133,1169,21,9,0.140809444,0.859190556,2383.830872,2279.537737,4005.8549,5040.196749,8302,146.8340998,16604,-3652096,598528,-3053568,89
3411,271,22,8,0.0736013036,0.926398696,1046.675526,1240.200448,1852.973908,1697.081181,3682,214.3189756,7364,-1746432,138752,-1607680,89
3357,268,21,9,0.0739310345,0.926068966,1030.684669,1203.995502,1831.109622,1586.156716,3625,194.9973104,7250,-1718784,137216,-1581568,89
8368,1288,22,8,0.133388567,0.866611433,2738.756274,2856.60545,4661.534178,5913.259317,9656,168.9293212,19312,-4284416,659456,-3624960,89
9090,812,22,8,0.0820036356,0.917996364,2832.522676,3098.318389,4911.017932,5404.679803,9902,583.1566549,19804,-4654080,415744,-4238336,89
6588,1205,21,9,0.154625946,0.845374054,2191.243195,2321.436274,3721.437614,4856.838174,7793,148.7497614,15586,-3373056,616960,-2756096,89
6682,1188,21,9,0.150952986,0.849047014,2245.221488,2206.336924,3774.101018,4843.301347,7870,138.7273048,15740,-3421184,608256,-2812928,89
6979,1127,21,9,0.139032815,0.860967185,2297.724479,2319.676297,3882.077232,5115.043478,8106,150.361714,16212,-3573248,577024,-2996224,89
6697,368,22,8,0.0520877565,0.947912243,2016.274753,2329.443628,3568.755861,2882.30163,7065,549.8054475,14130,-3428864,188416,-3240448,89
6953,1377,23,7,0.165306122,0.834693878,2389.016798,2341.152888,4016.279735,4918.970225,8330,146.7582805,16660,-3559936,705024,-2854912,89
6375,1307,23,7,0.170137985,0.829862015,2193.600721,2188.057588,3691.320471,4574.013007,7682,135.2464789,15364,-3264000,669184,-2594816,89
2235,216,23,7,0.088127295,0.911872705,695.3332825,808.5076075,1240.345414,1077.564815,2451,192.0846395,4902,-1144320,110592,-1033728,89
6642,1224,23,7,0.155606407,0.844393593,2260.129349,2222.735365,3816.673442,4567.455882,7866,139.1966024,15732,-3400704,626688,-2774016,89
1407,169,23,7,0.107233503,0.892766497,438.929997,571.0235023,787.119403,799.9940828,1576,39.47895792,3152,-720384,86528,-633856,89
8186,1071,23,7,0.11569623,0.88430377,2640.769823,2887.200944,4593.320914,4901.706816,9257,205.9857588,18514,-4191232,548352,-3642880,89
6797,1247,23,7,0.155022377,0.844977623,2316.682664,2241.67101,3902.760483,4675.161989,8044,145.0153236,16088,-3480064,638464,-2841600,89
6158,1185,21,9,0.161378183,0.838621817,2082.046185,2191.589158,3545.742611,4328.112236,7343,131.5242701,14686,-3152896,606720,-2546176,89
9098,809,22,8,0.0816594327,0.918340567,2825.140927,3197.794596,4989.722137,4552.269468,9907,653.4960422,19814,-4658176,414208,-4243968,89
8654,1195,24,6,0.121332115,0.878667885,2880.041294,2558.939983,4935.712041,4847.425105,9849,667.2764228,19698,-4430848,611840,-3819008,89
2179,214,22,8,0.0894274969,0.910572503,679.697383,780.3090434,1211.289582,1051.5,2393,152.0330368,4786,-1115648,109568,-1006080,89
8905,974,23,7,0.098592975,0.901407025,2864.828907,2643.800613,5010.688714,4293.713552,9879,354.467169,19758,-4559360,498688,-4060672,89
2211,214,24,6,0.0882474227,0.911752577,690.8333657,780.6969937,1223.465853,1104.869159,2425,154.4585987,4850,-1132032,109568,-1022464,89
5935,1140,24,6,0.161130742,0.838869258,2006.937739,2070.01154,3397.980792,4266.959649,7075,126.2491078,14150,-3038720,583680,-2455040,89
7200,1338,23,7,0.156711174,0.843288826,2473.064914,2354.690084,4174.764583,4779.286996,8538,158.0525731,17076,-3686400,685056,-3001344,89
6883,1398,23,7,0.168820191,0.831179809,2361.72639,2365.367749,3976.073079,4953.011445,8281,149.6115628,16562,-3524096,715776,-2808320,89
6642,1299,23,7,0.163581413,0.836418587,2264.806232,2291.649167,3827.288618,4705.819861,7941,138.6831994,15882,-3400704,665088,-2735616,89
9071,835,22,8,0.0842923481,0.915707652,2881.890296,2308.961556,5059.818102,3798.516168,9906,487.9802956,19812,-4644352,427520,-4216832,89
8772,1096,24,6,0.111066072,0.888933928,2900.389838,2364.105394,4979.341199,4575.606752,9868,552.8291317,19736,-4491264,561152,-3930112,89
1431,163,21,9,0.102258469,0.897741531,451.1016896,516.0990424,811.8784067,671.2699387,1594,25.79705454,3188,-732672,83456,-649216,89
6404,1129,23,7,0.149873888,0.850126112,2135.345752,2281.011592,3653.770768,4409.267493,7533,143.4037693,15066,-3278848,578048,-2700800,89
5243,775,23,7,0.128780326,0.871219674,1729.134707,1777.028246,2978.515163,3219.117419,6018,105.8761436,12036,-2684416,396800,-2287616,89
6121,1276,22,8,0.172502366,0.827497634,2098.629519,2145.733021,3540.244568,4460.553292,7397,137.8494223,14794,-3133952,653312,-2480640,89
6366,1271,22,8,0.166426607,0.833573393,2156.324335,2251.708509,3651.452246,4658.188828,7637,135.8896797,15274,-3259392,650752,-2608640,89
8757,1113,23,7,0.112765957,0.887234043,2817.280061,3080.309368,4907.699098,5154.2354,9870,685.4166667,19740,-4483584,569856,-3913728,89
6700,1137,23,7,0.145081026,0.854918974,2233.293552,2329.147057,3812.237612,4548.118734,7837,162.6946232,15674,-3430400,582144,-2848256,89
7610,1446,23,7,0.159673145,0.840326855,2621.168107,2484.55318,4409.031932,5157.235823,9056,161.2535613,18112,-3896320,740352,-3155968,89
8817,1048,21,9,0.106234161,0.893765839,2863.834097,2678.992885,4978.146422,4553.175573,9865,385.8036762,19730,-4514304,536576,-3977728,89
6457,1297,23,7,0.167268507,0.832731493,2198.526732,2262.935097,3716.65882,4678.233616,7754,137.1903751,15508,-3305984,664064,-2641920,89
6175,1249,22,8,0.168238147,0.831761853,2114.124327,2106.875732,3551.214575,4509.88791,7424,132.0056899,14848,-3161600,639488,-2522112,89
2274,214,23,7,0.0860128617,0.913987138,706.196396,818.7511096,1259.430079,1085.850467,2488,213.3790738,4976,-1164288,109568,-1054720,89
6539,1272,22,8,0.162847267,0.837152733,2221.867612,2236.533917,3742.772136,4745.109277,7811,141.069171,15622,-3347968,651264,-2696704,89
5483,851,23,7,0.134354278,0.865645722,1828.308902,1809.572205,3128.61791,3418.017626,6334,111.2203687,12668,-2807296,435712,-2371584,89
6420,1281,23,7,0.166342034,0.833657966,2176.495068,2236.950792,3671.987383,4748.159251,7701,139.5867319,15402,-3287040,655872,-2631168,89
1760,197,21,9,0.100664282,0.899335718,559.4974922,541.4842648,1009.134659,709.7766497,1957,36.83418031,3914,-901120,100864,-800256,89
6674,1173,23,7,0.149483879,0.850516121,2232.055075,2248.848742,3768.281241,4809.990622,7847,138.7130988,15694,-3417088,600576,-2816512,89
6764,1359,21,9,0.167302721,0.832697279,2340.37458,2255.690473,3930.278238,4717.604121,8123,145.4171142,16246,-3463168,695808,-2767360,89
8404,1251,23,7,0.129570171,0.870429829,2744.299118,3004.324131,4747.628153,5367.924061,9655,210.2569686,19310,-4302848,640512,-3662336,89
6123,1213,23,7,0.165348964,0.834651036,2080.934434,2106.294462,3503.819533,4499.776587,7336,141.485053,14672,-3134976,621056,-2513920,89
6600,959,23,7,0.126868633,0.873131367,2189.404096,2101.923219,3732.27197,4108.472367,7559,134.4061166,15118,-3379200,491008,-2888192,89
6273,1296,23,7,0.171224732,0.828775268,2156.812816,2134.548124,3615.742388,4604.253858,7569,134.6797153,15138,-3211776,663552,-2548224,89
6397,1230,23,7,0.161269175,0.838730825,2177.65041,2140.657858,3655.173675,4640.026016,7627,136.3912732,15254,-3275264,629760,-2645504,89
6263,1145,23,7,0.154562635,0.845437365,2099.352022,2144.044725,3546.463037,4568.941485,7408,130.5604512,14816,-3206656,586240,-2620416,89
6590,1180,23,7,0.151866152,0.848133848,2187.919285,2344.366991,3729.218665,4758.291525,7770,142.9096928,15540,-3374080,604160,-2769920,89
7227,1243,21,9,0.146753247,0.853246753,2409.677047,2507.858402,4103.692403,5001.850362,8470,189.1891892,16940,-3700224,636416,-3063808,89
6657,1324,23,7,0.165893998,0.834106002,2258.874282,2316.554102,3811.647289,4892.77568,7981,140.3376121,15962,-3408384,677888,-2730496,89
2981,309,23,7,0.0939209726,0.906079027,932.7155657,1098.865361,1639.500839,1703.375405,3290,88.70315449,6580,-1526272,158208,-1368064,89
6452,1215,23,7,0.158471371,0.841528629,2172.934375,2240.18772,3677.599039,4664.534156,7667,135.1251322,15334,-3303424,622080,-2681344,89
8173,1141,23,7,0.122503758,0.877496242,2666.425475,2811.424088,4601.96831,5055.274321,9314,189.3474283,18628,-4184576,584192,-3600384,89
6908,1257,21,9,0.153949786,0.846050214,2317.133715,2364.7342,3916.591199,4997.520286,8165,141.9753086,16330,-3536896,643584,-2893312,89
6785,1257,22,8,0.156304402,0.843695598,2313.644784,2208.597395,3878.240236,4794.783612,8042,143.376716,16084,-3473920,643584,-2830336,89
2435,222,23,7,0.0835528792,0.916447121,753.9987487,879.0563217,1344.765503,1156.076577,2657,227.2882806,5314,-1246720,113664,-1133056,89
8660,1200,23,7,0.121703854,0.878296146,2886.582028,2537.034032,4929.640416,4936.703333,9860,599.0279465,19720,-4433920,614400,-3819520,89
2472,231,23,7,0.0854605993,0.914539401,771.2622151,862.5643357,1362.837783,1236.021645,2703,227.1428571,5406,-1265664,118272,-1147392,89
8691,1176,23,7,0.119185163,0.880814837,2887.684118,2538.386063,4927.475319,4982.219388,9867,560.943718,19734,-4449792,602112,-3847680,89
6909,1250,22,8,0.15320505,0.84679495,2334.504058,2279.734152,3922.994789,4947.7992,8159,144.2283896,16318,-3537408,640000,-2897408,89
2461,216,22,8,0.0806873366,0.919312663,759.8215587,877.0679877,1358.606258,1115.615741,2677,163.9314146,5354,-1260032,110592,-1149440,89
6249,1213,20,10,0.162556955,0.837443045,2111.752268,2172.827796,3567.781725,4574.925804,7462,133.1311329,14924,-3199488,621056,-2578432,89
1528,164,23,7,0.0969267139,0.903073286,480.0894851,542.267201,860.8723822,712.5914634,1692,27.00287265,3384,-782336,83968,-698368,89
1433,159,23,7,0.0998743719,0.900125628,447.5203821,536.7368368,811.9832519,656.9559748,1592,25.33015115,3184,-733696,81408,-652288,89
5660,1058,23,7,0.157487347,0.842512653,1900.550331,1955.368662,3212.514134,4145.832703,6718,130.4972805,13436,-2897920,541696,-2356224,89
5500,976,23,7,0.150710315,0.849289685,1828.290629,1914.347305,3102.849818,4002.922131,6476,166.9072165,12952,-2816000,499712,-2316288,89
5753,1014,21,9,0.149844835,0.850155165,1921.732145,1945.128133,3245.130541,4171.885602,6767,161.5807068,13534,-2945536,519168,-2426368,89
2450,217,23,7,0.0813648294,0.918635171,759.0927986,774.6930817,1369.925714,928.3870968,2667,46.92943868,5334,-1254400,111104,-1143296,89
2811,233,21,9,0.076544021,0.923455979,864.5715202,1030.064662,1529.991106,1432.124464,3044,224.1531664,6088,-1439232,119296,-1319936,89
5526,974,23,7,0.149846154,0.850153846,1844.020674,1866.680812,3112.643865,4032.628337,6500,156.0999039,13000,-2829312,498688,-2330624,89
6418,1136,23,7,0.150383903,0.849616097,2169.663387,2085.676077,3643.430664,4534.944542,7554,190.1812689,15108,-3286016,581632,-2704384,89
5658,1033,23,7,0.154386489,0.845613511,1868.525663,1976.154367,3166.989572,4326.484995,6691,119.3968594,13382,-2896896,528896,-2368000,89
5781,1013,22,8,0.149102149,0.850897851,1924.190707,1988.914073,3261.043245,4176.232971,6794,163.3958634,13588,-2959872,518656,-2441216,89
2798,223,23,7,0.073816617,0.926183383,858.9137781,1011.176376,1522.927091,1361.349776,3021,222.1323529,6042,-1432576,114176,-1318400,89
5775,1090,23,7,0.158776402,0.841223598,1948.321229,1950.271468,3276.24381,4263.520183,6865,138.46309,13730,-2956800,558080,-2398720,89
5973,968,23,7,0.139461173,0.860538827,1964.726051,2050.201431,3339.45036,4282.721074,6941,177.4284254,13882,-3058176,495616,-2562560,89
5586,1012,23,7,0.153379812,0.846620188,1863.23157,1920.107417,3150.123702,4124.021739,6598,119.011544,13196,-2860032,518144,-2341888,89
2998,241,23,7,0.0744056808,0.925594319,924.5525325,1045.21933,1631.953302,1471.302905,3239,183.3050368,6478,-1534976,123392,-1411584,89
5864,1083,23,7,0.155894631,0.844105369,1969.266294,1999.936304,3322.214188,4295.857802,6947,124.2310443,13894,-3002368,554496,-2447872,89
2807,242,22,8,0.0793702853,0.920629715,863.5408425,1042.830347,1537.693979,1377.760331,3049,178.408426,6098,-1437184,123904,-1313280,89
5565,969,21,9,0.148301194,0.851698806,1845.215867,1929.668262,3131.85894,4046.491228,6534,137.1248688,13068,-2849280,496128,-2353152,89
2923,239,22,8,0.0755850727,0.924414927,900.4918734,1039.547007,1593.998632,1428.640167,3162,205.7254392,6324,-1496576,122368,-1374208,89
5623,1075,23,7,0.16049567,0.83950433,1872.137077,1981.463528,3171.308554,4281.565581,6698,119.7996781,13396,-2878976,550400,-2328576,89
2787,225,23,7,0.0747011952,0.925298805,855.6159745,1011.950407,1519.592034,1344.333333,3012,229.5731707,6024,-1426944,115200,-1311744,89
3312,377,24,6,0.102195717,0.897804283,1046.008366,1213.836885,1833.474034,1946.257294,3689,103.0446927,7378,-1695744,193024,-1502720,89
5954,1001,24,6,0.143925234,0.856074766,1997.897463,1972.952856,3383.015452,4042.973027,6955,121.9747457,13910,-3048448,512512,-2535936,89
2327,203,23,7,0.0802371542,0.919762846,715.6513224,872.1166918,1276.223034,1142.581281,2530,316.25,5060,-1191424,103936,-1087488,89
1716,178,21,9,0.0939809926,0.906019007,535.4126208,644.7892641,951.2820513,911.0393258,1894,48.07106599,3788,-878592,91136,-787456,89
5522,991,24,6,0.152157224,0.847842776,1845.740011,1929.566156,3137.162803,3924.750757,6513,155.7016495,13026,-2827264,507392,-2319872,89
5969,1143,23,7,0.160714286,0.839285714,2020.50169,2060.560164,3413.798124,4301.72091,7112,139.8898505,14224,-3056128,585216,-2470912,89
3124,346,24,6,0.0997118156,0.900288184,983.0158669,1155.745197,1730.21863,1783.184971,3470,71.96184156,6940,-1599488,177152,-1422336,89
5453,962,23,7,0.149961029,0.850038971,1833.583425,1864.585701,3113.958188,3741.066528,6415,146.1941659,12830,-2791936,492544,-2299392,89
2356,216,24,6,0.0839813375,0.916018663,731.0348628,839.5808181,1301.747453,1120.189815,2572,197.0881226,5144,-1206272,110592,-1095680,89
5927,996,22,8,0.143868265,0.856131735,1960.81205,2092.097042,3351.500759,4119.559237,6923,165.4241338,13846,-3034624,509952,-2524672,89
6259,1037,23,7,0.142132675,0.857867325,2075.273104,2172.788291,3540.553124,4300.032787,7296,135.3115727,14592,-3204608,530944,-2673664,89
9161,757,24,6,0.0763258722,0.923674128,2869.61448,2558.633649,5046.398319,3907.88111,9918,723.9416058,19836,-4690432,387584,-4302848,89
2377,221,23,7,0.0850654349,0.914934565,739.3511148,837.0614699,1315.414388,1128.330317,2598,212.254902,5196,-1217024,113152,-1103872,89
2315,219,23,7,0.0864246251,0.913575375,715.6513458,880.5273051,1271.793952,1222.109589,2534,67.50133191,5068,-1185280,112128,-1073152,89
2530,244,23,7,0.0879596251,0.912040375,792.2212829,877.9734458,1397.533597,1283.463115,2774,55.16007158,5548,-1295360,124928,-1170432,89
5605,997,21,9,0.151014844,0.848985156,1875.135749,1934.851606,3180.943265,3979.253761,6602,157.4153553,13204,-2869760,510464,-2359296,89
2478,233,21,9,0.0859461453,0.914053855,772.5215535,867.2990084,1370.746973,1199.16309,2711,202.0119225,5422,-1268736,119296,-1149440,89
6001,996,23,7,0.14234672,0.85765328,1994.452197,2070.666046,3400.976504,4089.601406,6997,172.5524044,13994,-3072512,509952,-2562560,89
2460,232,21,9,0.0861812779,0.913818722,766.9112862,785.806898,1381.814634,972.0431034,2692,48.60083047,5384,-1259520,118784,-1140736,89
9082,829,23,7,0.0836444355,0.916355565,2869.850542,2564.193271,5045.903105,3971.078408,9911,767.6994578,19822,-4649984,424448,-4225536,89
8099,1284,23,7,0.136843227,0.863156773,2678.940556,2808.709206,4592.416471,5320.136293,9383,167.284721,18766,-4146688,657408,-3489280,89
2214,221,23,7,0.0907597536,0.909240246,693.774188,780.9978361,1228.5,1112.809955,2435,197.6461039,4870,-1133568,113152,-1020416,89
1022,143,21,9,0.122746781,0.877253219,333.1962158,300.9524659,608.3483366,401.8391608,1165,21.77977192,2330,-523264,73216,-450048,89
4756,686,23,7,0.126056597,0.873943403,1558.143329,1615.427647,2671.662742,3067.01895,5442,288.2415254,10884,-2435072,351232,-2083840,89
565,113,23,7,0.166666667,0.833333333,198.3343652,172.9617132,349.8973451,287.5132743,678,24.06815761,1356,-289280,57856,-231424,89
8951,940,23,7,0.0950358912,0.904964109,2852.679475,2834.031339,4997.192269,4458.529787,9891,563.2687927,19782,-4582912,481280,-4101632,89
8022,1158,23,7,0.126143791,0.873856209,2639.190743,2695.671342,4537.631264,4956.746114,9180,201.1393514,18360,-4107264,592896,-3514368,89
2152,202,22,8,0.0858113849,0.914188615,670.053234,765.365104,1187.497677,1070.990099,2354,178.3333333,4708,-1101824,103424,-998400,89
6687,1089,23,7,0.140046296,0.859953704,2212.752938,2340.189058,3788.572304,4502.105601,7776,173.1077471,15552,-3423744,557568,-2866176,89
6090,1237,21,9,0.168827624,0.831172376,2066.712412,2146.802787,3492.104598,4510.275667,7327,129.0873855,14654,-3118080,633344,-2484736,89
6418,1289,22,8,0.167250551,0.832749449,2200.186995,2181.060119,3696.818012,4636.617533,7707,136.4312268,15414,-3286016,659968,-2626048,89
6558,1198,23,7,0.154461062,0.845538938,2224.921845,2184.935328,3750.333943,4580.096828,7756,135.3577661,15512,-3357696,613376,-2744320,89
2210,211,23,7,0.0871540686,0.912845931,687.072502,803.4752616,1221.90905,1096.739336,2421,262.5813449,4842,-1131520,108032,-1023488,89
9004,897,22,8,0.0905969094,0.909403091,2885.220442,2400.073974,5038.558974,4072.091416,9901,591.4575866,19802,-4610048,459264,-4150784,89
2342,212,23,7,0.0830070478,0.916992952,728.3205175,821.8606147,1287.42912,1167.811321,2554,195.4093344,5108,-1199104,108544,-1090560,89
8982,920,23,7,0.0929105231,0.907089477,2887.682432,2388.843294,5040.102427,4086.470652,9902,490.1980198,19804,-4598784,471040,-4127744,89
2177,214,22,8,0.0895023003,0.9104977,678.4084902,766.0245291,1217.815802,974.0700935,2391,69.28426543,4782,-1114624,109568,-1005056,89
2207,208,22,8,0.0861283644,0.913871636,685.3379125,804.0498845,1218.193022,1099.846154,2415,153.4307497,4830,-1129984,106496,-1023488,89
6785,1235,21,9,0.153990025,0.846009975,2306.223604,2231.478537,3879.977745,4727.579757,8020,146.6983721,16040,-3473920,632320,-2841600,89
7847,1307,23,7,0.142779113,0.857220887,2651.295493,2538.571925,4498.851536,5049.69166,9154,167.2574456,18308,-4017664,669184,-3348480,89
7720,330,21,9,0.0409937888,0.959006211,2312.301775,2531.858925,4046.039249,3545.006061,8050,875.9521219,16100,-3952640,168960,-3783680,89
7972,346,24,6,0.0415965376,0.958403462,2389.477276,2632.624667,4174.758906,3807.927746,8318,505.0394657,16636,-4081664,177152,-3904512,89
7720,331,22,8,0.0411129052,0.958887095,2312.466426,2542.109957,4044.768135,3588.265861,8051,947.1764706,16102,-3952640,169472,-3783168,89
2840,223,22,8,0.0728044401,0.92719556,879.2166486,917.8149684,1549.17993,1313.206278,3063,54.5600285,6126,-1454080,114176,-1339904,89
8467,446,22,8,0.0500392685,0.949960732,2553.842649,2901.489465,4444.185426,4700.275785,8913,196.0624725,17826,-4335104,228352,-4106752,89
8483,454,22,8,0.0508000448,0.949199955,2560.257436,2919.479802,4462.000354,4599.788546,8937,199.7094972,17874,-4343296,232448,-4110848,89
8462,458,24,6,0.0513452915,0.948654709,2561.026454,2820.289879,4459.012054,4487.991266,8920,189.5855473,17840,-4332544,234496,-4098048,89
8488,462,22,8,0.0516201117,0.948379888,2563.719555,2910.534688,4459.768615,4764.521645,8950,215.5587669,17900,-4345856,236544,-4109312,89
8407,444,23,7,0.0501638233,0.949836177,2541.286865,2797.559847,4416.87439,4598.790541,8851,202.354824,17702,-4304384,227328,-4077056,89
7726,324,24,6,0.0402484472,0.959751553,2312.704809,2551.776638,4039.683924,3687.274691,8050,548.3651226,16100,-3955712,165888,-3789824,89
8443,444,23,7,0.0499606166,0.950039383,2549.338849,2851.543994,4450.845079,4313.835586,8887,156.4612676,17774,-4322816,227328,-4095488,89
8432,440,23,7,0.049594229,0.950405771,2546.253987,2825.656368,4427.597842,4607.097727,8872,227.3705792,17744,-4317184,225280,-4091904,89
8481,464,24,6,0.0518725545,0.948127446,2563.491308,2900.840522,4467.068506,4581.415948,8945,171.2945232,17890,-4342272,237568,-4104704,89
8425,451,23,7,0.0508111762,0.949188824,2544.924306,2858.55957,4426.86089,4655.926829,8876,217.9764244,17752,-4313600,230912,-4082688,89
7721,337,23,7,0.041821792,0.958178208,2313.550282,2585.58817,4040.343608,3781.062315,8058,140.5792045,16116,-3953152,172544,-3780608,89
8428,449,24,6,0.050580151,0.949419849,2547.157169,2835.084004,4434.575937,4522.042316,8877,187.4366554,17754,-4315136,229888,-4085248,89
8570,438,24,6,0.0486234458,0.951376554,2582.069207,2934.363263,4499.818903,4596.091324,9008,228.9199492,18016,-4387840,224256,-4163584,89
8463,450,22,8,0.0504880512,0.949511949,2557.23794,2849.983463,4450.705069,4575.386667,8913,199.3067979,17826,-4333056,230400,-4102656,89
8464,452,22,8,0.0506953791,0.949304621,2559.925533,2821.505566,4459.092155,4447.411504,8916,166.4985994,17832,-4333568,231424,-4102144,89
8428,432,24,6,0.048758465,0.951241535,2540.581575,2860.938603,4418.722473,4660.270833,8860,212.7761768,17720,-4315136,221184,-4093952,89
5887,1130,23,7,0.16103748,0.83896252,2027.02925,1932.502501,3406.610837,4042.420354,7017,182.7819745,14034,-3014144,578560,-2435584,89
5240,939,24,6,0.151966338,0.848033662,1771.859972,1745.909291,2989.775382,3649.29393,6179,110.280207,12358,-2682880,480768,-2202112,89
4799,822,22,8,0.146237324,0.853762676,1599.139472,1643.73898,2714.317566,3375.451338,5621,100.5006258,11242,-2457088,420864,-2036224,89
5412,1128,23,7,0.172477064,0.827522936,1845.939563,1871.360065,3099.369549,4091.562057,6540,115.9985811,13080,-2770944,577536,-2193408,89
6029,1125,24,6,0.157254683,0.842745317,2075.384083,1905.609719,3468.184276,4163.335111,7154,128.0243379,14308,-3086848,576000,-2510848,89
8368,1475,22,8,0.149852687,0.850147313,2883.520393,2585.787418,4898.813815,5053.540339,9843,186.7387592,19686,-4284416,755200,-3529216,89
5555,1167,23,7,0.173609045,0.826390955,1906.077038,1919.994529,3200.708731,4126.877464,6722,123.0234261,13444,-2844160,597504,-2246656,89
5315,1096,23,7,0.170956169,0.829043831,1810.309205,1841.007923,3043.095202,3995.999088,6411,119.1192865,12822,-2721280,561152,-2160128,89
5641,1151,22,8,0.169464075,0.830535925,1926.019608,1937.353459,3235.333806,4186.368375,6792,121.6114593,13584,-2888192,589312,-2298880,89
4365,697,23,7,0.137692612,0.862307388,1452.35891,1472.078647,2477.838717,2867.556671,5062,88.40377227,10124,-2234880,356864,-1878016,89
2624,341,24,6,0.115008432,0.884991568,822.3625072,1059.113238,1457.274771,1680.956012,2965,54.49365925,5930,-1343488,174592,-1168896,89
5548,1105,23,7,0.166090485,0.833909515,1890.017438,1900.947162,3179.329849,4068.424434,6653,115.483423,13306,-2840576,565760,-2274816,89
5136,1019,24,6,0.165556458,0.834443542,1741.248198,1783.458151,2936.844821,3789.455348,6155,112.2970261,12310,-2629632,521728,-2107904,89
2210,204,24,6,0.0845070423,0.915492958,683.8527916,801.5451255,1224.654751,1021.656863,2414,193.12,4828,-1131520,104448,-1027072,89
6063,1183,22,8,0.16326249,0.83673751,2103.007288,1940.165755,3515.095332,4179.085376,7246,128.6576705,14492,-3104256,605696,-2498560,89
2684,308,23,7,0.102941176,0.897058824,838.3810911,1047.696333,1479.620715,1643.590909,2992,54.82866044,5984,-1374208,157696,-1216512,89
2221,204,24,6,0.0841237113,0.915876289,686.8332757,807.1905984,1230.104457,1026.779412,2425,220.2543143,4850,-1137152,104448,-1032704,89
5720,1128,23,7,0.164719626,0.835280374,1933.663738,1973.329577,3256.370455,4277.071809,6848,124.1704442,13696,-2928640,577536,-2351104,89
8434,1417,24,6,0.143843265,0.856156735,2917.92005,2348.968121,4901.290017,5073.0741,9851,202.2377335,19702,-4318208,725504,-3592704,89
5742,1147,24,6,0.166497315,0.833502685,1965.175535,1959.526631,3306.062173,4140.537053,6889,122.7766886,13778,-2939904,587264,-2352640,89
8771,1097,23,7,0.11116741,0.88883259,2876.614653,2610.14651,4951.84483,4795.820419,9868,500.1520527,19736,-4490752,561664,-3929088,89
2452,219,23,7,0.0819917634,0.918008237,758.0793334,895.9386465,1346.089723,1223.031963,2671,279.3933054,5342,-1255424,112128,-1143296,89
2464,230,21,9,0.0853749072,0.914625093,767.1949711,872.4788793,1359.239448,1221.734783,2694,166.7079208,5388,-1261568,117760,-1143808,89
8763,1101,23,7,0.111618005,0.888381995,2871.275331,2643.110751,4956.071665,4744.8901,9864,254.0303889,19728,-4486656,563712,-3922944,89
2419,202,23,7,0.0770698207,0.922930179,744.0405787,878.6958123,1324.029764,1154.965347,2621,217.3300166,5242,-1238528,103424,-1135104,89
9131,784,23,7,0.079072113,0.920927887,2883.775509,2412.954968,5037.331508,4034.05102,9915,409.3724195,19830,-4675072,401408,-4273664,89
7239,996,23,7,0.120947177,0.879052823,2369.995171,2393.772991,4064.643459,4505.799197,8235,142.3017107,16470,-3706368,509952,-3196416,89
9096,806,21,9,0.0813976974,0.918602303,2870.411937,2598.424147,5019.778034,4180.957816,9902,600.4851425,19804,-4657152,412672,-4244480,89
7300,1263,23,7,0.147495037,0.852504963,2435.208237,2532.794019,4144.882877,5074.521774,8563,171.4314314,17126,-3737600,646656,-3090944,89
7145,1392,23,7,0.163054937,0.836945063,2464.134703,2306.889982,4113.740658,5065.931034,8537,157.3930678,17074,-3658240,712704,-2945536,89
2606,244,20,10,0.0856140351,0.914385965,814.9226981,886.3090041,1440.423254,1266.114754,2850,93.28968903,5700,-1334272,124928,-1209344,89
584,112,23,7,0.16091954,0.83908046,203.7859646,173.6744162,359.8202055,289.4732143,696,12.63616558,1392,-299008,57344,-241664,89
9080,829,21,9,0.083661318,0.916338682,2867.609144,2620.284823,5036.485903,4062.48854,9909,493.2304629,19818,-4648960,424448,-4224512,89
6644,1253,23,7,0.158667849,0.841332151,2253.892017,2228.554774,3789.512492,4794.678372,7897,139.6216407,15794,-3401728,641536,-2760192,89
2416,204,23,7,0.0778625954,0.922137405,749.0462937,828.1789104,1320.752483,1189.078431,2620,219.4304858,5240,-1236992,104448,-1132544,89
8735,1128,23,7,0.114366826,0.885633174,2818.645346,2996.438541,4856.998512,5512.796099,9863,409.253112,19726,-4472320,577536,-3894784,89
8756,1109,22,8,0.112417638,0.887582362,2821.858882,3019.044821,4885.936501,5304.585212,9865,342.4158278,19730,-4483072,567808,-3915264,89
2693,230,23,7,0.0786862812,0.921313719,832.9678958,957.6516333,1469.103973,1378.821739,2923,176.937046,5846,-1378816,117760,-1261056,89
7014,1299,23,7,0.156261278,0.843738722,2420.921282,2186.180847,4045.637297,4758.307159,8313,220.5039788,16626,-3591168,665088,-2926080,89
6899,1272,23,7,0.1556725,0.8443275,2322.484658,2340.075058,3915.825917,5008.980346,8171,144.0585331,16342,-3532288,651264,-2881024,89
2654,264,20,10,0.0904729267,0.909527073,828.1463152,969.3033795,1468.302185,1371.011364,2918,98.91525424,5836,-1358848,135168,-1223680,90
2763,274,20,10,0.0902206124,0.909779388,862.9196679,1001.18056,1527.513572,1433.149635,3037,103.0189959,6074,-1414656,140288,-1274368,90
9020,444,21,9,0.0469146238,0.953085376,2695.928137,3382.343188,4735.432816,4672.918919,9464,268.101983,18928,-4618240,227328,-4390912,90
2727,275,21,9,0.0916055963,0.908394404,852.5087643,982.8202565,1516.79648,1349.814545,3002,96.5583789,6004,-1396224,140800,-1255424,90
2827,283,22,8,0.0909967846,0.909003215,881.2694558,1034.388898,1571.881854,1391.855124,3110,97.46161078,6220,-1447424,144896,-1302528,90
2705,249,20,10,0.0842924848,0.915707515,845.5571462,927.2426151,1476.992237,1483.016064,2954,93.80755795,5908,-1384960,127488,-1257472,90
2777,263,21,9,0.0865131579,0.913486842,867.2782509,978.931561,1517.014764,1557.30038,3040,108.9605735,6080,-1421824,134656,-1287168,90
2638,239,20,10,0.0830726451,0.916927355,818.766136,950.4731101,1440.504928,1422.389121,2877,84.34476693,5754,-1350656,122368,-1228288,90
2703,250,21,9,0.0846596681,0.915340332,843.2743201,941.8773865,1484.874954,1391.856,2953,89.53911461,5906,-1383936,128000,-1255936,90
2682,249,20,10,0.0849539406,0.915046059,837.6612593,931.3401211,1469.629381,1426.907631,2931,101.5240734,5862,-1373184,127488,-1245696,90
2678,236,20,10,0.0809883322,0.919011668,833.6971475,921.916479,1458.889843,1441.728814,2914,103.9229672,5828,-1371136,120832,-1250304,90
8546,432,20,10,0.0481176209,0.951882379,2556.111571,3214.980872,4493.834425,4403.75463,8978,246.9876204,17956,-4375552,221184,-4154368,90
7847,386,21,9,0.0468844893,0.953115511,2348.174311,2893.18743,4111.256276,4233.764249,8233,255.1286024,16466,-4017664,197632,-3820032,90
2656,240,20,10,0.0828729282,0.917127072,826.3662054,935.7654086,1446.500377,1470.629167,2896,88.37351236,5792,-1359872,122880,-1236992,90
2697,254,20,10,0.0860725178,0.913927482,845.7112784,914.7627349,1476.929551,1466.129921,2951,98.07244932,5902,-1380864,130048,-1250816,90
2648,246,21,9,0.0850034554,0.914996545,823.1864532,956.9256855,1449.928248,1421.361789,2894,91.06356199,5788,-1355776,125952,-1229824,90
2134,191,20,10,0.0821505376,0.917849462,659.7814545,733.9173092,1187.431584,890.0314136,2325,88.20182094,4650,-1092608,97792,-994816,90
8836,670,20,10,0.070481801,0.929518199,2676.987765,3240.236685,4654.534518,6058.662687,9506,205.224525,19012,-4524032,343040,-4180992,90
2761,268,20,10,0.0884780456,0.911521954,862.3567035,987.964495,1520.80623,1455.182836,3029,93.63214838,6058,-1413632,137216,-1276416,90
2735,264,21,9,0.0880293431,0.911970657,850.0098577,1011.145399,1507.504205,1422.257576,2999,81.14177489,5998,-1400320,135168,-1265152,90
3375,604,20,10,0.151796934,0.848203066,1119.493556,1203.187257,1909.072296,2442.203642,3979,86.34982639,7958,-1728000,309248,-1418752,90
3684,683,20,10,0.156400275,0.843599725,1210.18251,1283.245793,2050.459012,2904.300146,4367,89.21348315,8734,-1886208,349696,-1536512,90
3349,673,20,10,0.167329687,0.832670313,1119.972411,1177.354043,1891.511496,2608.589896,4022,86.53184165,8044,-1714688,344576,-1370112,90
3380,527,20,10,0.134886102,0.865113898,1110.775355,1121.494729,1880.123077,2427.821632,3907,76.26390787,7814,-1730560,269824,-1460736,90
5728,678,20,10,0.105838277,0.894161723,1849.851063,1836.60285,3222.206355,3045.461652,6406,140.4516553,12812,-2932736,347136,-2585600,90
3869,621,20,10,0.13830735,0.86169265,1272.588748,1386.734941,2190.945205,2585.391304,4490,97.43923611,8980,-1980928,317952,-1662976,90
3780,587,20,10,0.13441722,0.86558278,1245.079704,1279.891251,2119.025661,2602.403748,4367,89.28644449,8734,-1935360,300544,-1634816,90
2852,537,20,10,0.158453821,0.841546179,923.9316033,1106.59788,1603.270337,2182.175047,3389,69.81870622,6778,-1460224,274944,-1185280,90
3935,730,20,10,0.156484459,0.843515541,1293.024021,1429.298964,2208.498856,3004.112329,4665,94.37588509,9330,-2014720,373760,-1640960,90
3409,577,20,10,0.144756648,0.855243352,1126.239832,1236.167532,1938.291874,2319.677643,3986,89.97742664,7972,-1745408,295424,-1449984,90
8255,829,21,9,0.0912593571,0.908740643,2593.615136,2875.822879,4572.375893,4245.002413,9084,197.0926448,18168,-4226560,424448,-3802112,90
4060,600,20,10,0.128755365,0.871244635,1303.581415,1528.843032,2265.991872,2767.005,4660,105.2156243,9320,-2078720,307200,-1771520,90
3395,546,20,10,0.138543517,0.861456483,1116.481988,1181.665485,1905.099264,2380.767399,3941,85.59947871,7882,-1738240,279552,-1458688,90
3666,608,22,8,0.142255498,0.857744502,1217.056124,1294.961652,2090.726678,2419.524671,4274,96.76250849,8548,-1876992,311296,-1565696,90
3439,607,21,9,0.150024716,0.849975284,1132.391662,1202.417016,1922.900552,2593.453048,4046,70.78376487,8092,-1760768,310784,-1449984,90
4971,651,20,10,0.115795091,0.884204909,1615.02618,1681.769012,2807.56729,2841.529954,5622,114.0365112,11244,-2545152,333312,-2211840,90
3787,674,20,10,0.1510872,0.8489128,1257.838079,1278.252631,2120.667547,2850.924332,4461,80.81521739,8922,-1938944,345088,-1593856,90
4063,592,20,10,0.127175081,0.872824919,1331.967635,1325.176914,2257.70982,2810.413851,4655,102.2627417,9310,-2080256,303104,-1777152,90
3348,635,20,10,0.159427567,0.840572433,1111.203744,1181.168117,1883.839606,2562.269291,3983,86.92710607,7966,-1714176,325120,-1389056,90
3450,576,21,9,0.143070045,0.856929955,1138.20558,1252.323331,1961.523478,2324.817708,4026,76.06272435,8052,-1766400,294912,-1471488,90
1458,169,20,10,0.103872157,0.896127843,461.3577079,517.369842,798.5898491,946.9467456,1627,43.15649867,3254,-746496,86528,-659968,90
1469,160,20,10,0.0982197667,0.901780233,463.9184898,508.6952291,801.6398911,937.6625,1629,37.81337047,3258,-752128,81920,-670208,90
1474,179,21,9,0.108287961,0.891712039,471.1442223,509.0206839,812.6166893,945.4413408,1653,45.21334792,3306,-754688,91648,-663040,90
1463,170,20,10,0.104102878,0.895897122,466.3870791,501.443504,805.3151059,917.5588235,1633,36.82904826,3266,-749056,87040,-662016,90
1505,158,21,9,0.0950090198,0.90499098,472.4142558,526.8597175,817.082392,974.0949367,1663,44.25226184,3326,-770560,80896,-689664,90
1121,80,20,10,0.0666111574,0.933388843,344.9863597,365.1534532,605.0553078,544.175,1201,44.00879443,2402,-573952,40960,-532992,90
1468,182,20,10,0.11030303,0.88969697,472.1761058,494.7864056,811.8038147,935.9725275,1650,41.91008382,3300,-751616,93184,-658432,90
1465,160,21,9,0.0984615385,0.901538462,459.8936078,522.0825173,796.3542662,965.4125,1625,43.42597541,3250,-750080,81920,-668160,90
1472,159,20,10,0.0974862048,0.902513795,464.344708,507.8401738,801.517663,950.0754717,1631,39.9754902,3262,-753664,81408,-672256,90
1462,164,20,10,0.100861009,0.899138991,463.0947539,503.5174507,798.8043776,944.5060976,1626,43.49919743,3252,-748544,83968,-664576,90
1426,171,20,10,0.107075767,0.892924233,455.6047909,494.4600566,788.0189341,890.5730994,1597,44.29958391,3194,-730112,87552,-642560,90
1467,177,21,9,0.107664234,0.892335766,470.7866285,499.646982,814.1888207,891.3841808,1644,45.48976204,3288,-751104,90624,-660480,90
1468,172,20,10,0.104878049,0.895121951,467.711987,506.3419033,807.5449591,931.0697674,1640,44.10973642,3280,-751616,88064,-663552,90
1466,170,20,10,0.10391198,0.89608802,466.0639426,509.50433,805.6589359,929.2352941,1636,43.97849462,3272,-750592,87040,-663552,90
1474,162,20,10,0.0990220049,0.900977995,464.4729408,515.4658561,802.4016282,964.9753086,1636,43.17761942,3272,-754688,82944,-671744,90
1469,182,21,9,0.11023622,0.88976378,469.69221,513.7427048,811.2178353,945.3131868,1651,41.79746835,3302,-752128,93184,-658944,90
1455,176,20,10,0.107909258,0.892090742,464.3805172,509.9812081,803.7718213,917.0909091,1631,41.91724492,3262,-744960,90112,-654848,90
1461,166,20,10,0.102028273,0.897971727,461.5398396,518.9507187,799.5735797,940.9698795,1627,40.47263682,3254,-748032,84992,-663040,90
1478,181,21,9,0.109101869,0.890898131,474.8606859,498.2783353,817.0108254,936.0662983,1659,45.95567867,3318,-756736,92672,-664064,90
871,91,20,10,0.0945945946,0.905405405,275.2681563,298.6608234,478.6509759,508.7692308,962,15.24564184,1924,-445952,46592,-399360,90
3408,586,21,9,0.14672008,0.85327992,1105.101376,1265.158163,1902.555751,2549.667235,3994,86.8449663,7988,-1744896,300032,-1444864,90
3388,550,20,10,0.139664804,0.860335196,1093.837445,1205.720515,1870.884002,2576.974545,3938,77.74925962,7876,-1734656,281600,-1453056,90
3373,480,20,10,0.124578251,0.875421749,1094.815625,1090.571959,1851.866588,2454.96875,3853,85.13035793,7706,-1726976,245760,-1481216,90
3391,551,20,10,0.139776763,0.860223237,1095.697454,1195.0948,1870.671188,2592.027223,3942,82.21063608,7884,-1736192,282112,-1454080,90
3571,445,20,10,0.110806773,0.889193227,1148.17535,1176.245793,1960.505461,2393.642697,4016,86.66378938,8032,-1828352,227840,-1600512,90
4761,551,20,10,0.10372741,0.89627259,1533.572911,1511.501569,2628.923756,2894.77677,5312,92.73743017,10624,-2437632,282112,-2155520,90
3433,478,20,10,0.122219381,0.877780619,1109.625595,1201.065485,1906.542674,2311.202929,3911,87.06589492,7822,-1757696,244736,-1512960,90
3115,577,19,11,0.156283857,0.843716143,1022.390558,1096.643978,1735.904655,2443.561525,3692,64.85157211,7384,-1594880,295424,-1299456,90
3387,535,20,10,0.136409995,0.863590005,1094.24958,1169.723048,1863.219663,2583.697196,3922,86.12209047,7844,-1734144,273920,-1460224,90
3320,560,20,10,0.144329897,0.855670103,1075.197853,1201.447911,1842.447892,2521.808929,3880,74.68719923,7760,-1699840,286720,-1413120,90
2850,432,21,9,0.131627057,0.868372943,912.1463086,1060.886373,1577.541053,2063.451389,3282,65.13197063,6564,-1459200,221184,-1238016,90
2838,428,21,9,0.131047152,0.868952848,909.8831876,1034.148966,1566.96864,2074.658879,3266,80.18659465,6532,-1453056,219136,-1233920,90
2839,445,21,9,0.135505481,0.864494519,913.6464094,1056.118721,1578.730539,2049.334831,3284,76.08897127,6568,-1453568,227840,-1225728,90
3376,560,21,9,0.142276423,0.857723577,1094.469956,1191.257962,1867.360486,2578.226786,3936,83.85172561,7872,-1728512,286720,-1441792,90
3080,446,21,9,0.126488939,0.873511061,980.4137298,1135.751658,1694.09513,2242.798206,3526,82.82828283,7052,-1576960,228352,-1348608,90
2910,406,20,10,0.122436671,0.877563329,928.3457581,1012.093623,1589.022337,2156.480296,3316,68.7966805,6632,-1489920,207872,-1282048,90
3414,524,20,10,0.133062468,0.866937532,1112.479945,1188.491649,1900.038079,2422.062977,3938,89.94974874,7876,-1747968,268288,-1479680,90
3503,524,21,9,0.130121679,0.869878321,1141.577417,1175.226944,1938.555524,2518.354962,4027,77.51684312,8054,-1793536,268288,-1525248,90
3367,582,21,9,0.147379083,0.852620917,1094.742458,1234.599015,1879.216216,2529.130584,3949,89.81123493,7898,-1723904,297984,-1425920,90
2857,420,21,9,0.128166005,0.871833995,913.2740072,1028.164461,1570.159258,2107.280952,3277,74.80027391,6554,-1462784,215040,-1247744,90
4470,466,20,10,0.0944084279,0.905591572,1429.732677,1376.758335,2463.481208,2516.641631,4936,102.406639,9872,-2288640,238592,-2050048,90
3246,477,21,9,0.128122482,0.871877518,1047.918523,1185.2183,1811.080715,2208.507338,3723,86.94535264,7446,-1661952,244224,-1417728,90
3183,566,20,10,0.150973593,0.849026407,1043.395492,1192.96497,1799.47628,2299.720848,3749,78.44737393,7498,-1629696,289792,-1339904,90
3184,546,20,10,0.146380697,0.853619303,1037.156293,1161.528097,1778.946608,2370.236264,3730,75.78220236,7460,-1630208,279552,-1350656,90
2737,445,20,10,0.139849151,0.860150849,881.1823039,1012.983858,1518.960541,2037.658427,3182,75.92460033,6364,-1401344,227840,-1173504,90
3220,486,20,10,0.131138694,0.868861306,1050.34842,1126.19259,1799.031988,2214.378601,3706,79.47673172,7412,-1648640,248832,-1399808,90
3167,489,21,9,0.133752735,0.866247265,1034.440208,1105.400839,1768.28197,2218.501022,3656,77.95309168,7312,-1621504,250368,-1371136,90
3177,565,21,9,0.150988776,0.849011224,1032.148745,1200.344052,1782.186969,2373.707965,3742,78.21906355,7484,-1626624,289280,-1337344,90
3251,497,21,9,0.132604055,0.867395945,1062.353335,1120.660239,1812.490618,2280.118712,3748,83.17798491,7496,-1664512,254464,-1410048,90
3259,497,22,8,0.132321619,0.867678381,1066.251161,1141.939149,1828.154035,2208.635815,3756,68.60273973,7512,-1668608,254464,-1414144,90
3280,591,21,9,0.152673728,0.847326272,1072.075248,1216.974134,1842.291159,2456.076142,3871,75.6645817,7742,-1679360,302592,-1376768,90
3372,471,20,10,0.1225605,0.8774395,1088.560648,1214.610029,1884.299822,2191.904459,3843,81.47127411,7686,-1726464,241152,-1485312,90
3138,515,20,10,0.140980016,0.859019984,1034.538245,1093.567387,1764.168579,2209.84466,3653,78.25621251,7306,-1606656,263680,-1342976,90
3002,559,21,9,0.156978377,0.843021623,987.982275,1087.254054,1686.18521,2290.184258,3561,64.62794918,7122,-1537024,286208,-1250816,90
2715,444,20,10,0.140550807,0.859449193,871.1998661,1060.133576,1520.937017,1941.162162,3159,71.53532609,6318,-1390080,227328,-1162752,90
3265,499,21,9,0.132571732,0.867428268,1067.064758,1130.554644,1822.548851,2274.765531,3764,90.39385207,7528,-1671680,255488,-1416192,90
3247,472,21,9,0.126915838,0.873084162,1056.753616,1093.097781,1798.599014,2282.391949,3719,76.91830403,7438,-1662464,241664,-1420800,90
3239,508,21,9,0.135575127,0.864424873,1058.868126,1147.293293,1814.792837,2251.503937,3747,74.53749751,7494,-1658368,260096,-1398272,90
3196,581,20,10,0.153825788,0.846174212,1040.541654,1196.492788,1791.382353,2425.981067,3777,79.04981164,7554,-1636352,297472,-1338880,90
709,98,21,9,0.121437423,0.878562577,230.6456839,237.0190964,413.9153738,332.2653061,807,12.44602097,1614,-363008,50176,-312832,90
1036,118,20,10,0.102253033,0.897746967,328.8715163,285.9187844,602.5743243,357.3559322,1154,21.12005857,2308,-530432,60416,-470016,90
4780,595,21,9,0.110697674,0.889302326,1561.433207,1455.657844,2712.458159,2491.512605,5375,94.13309982,10750,-2447360,304640,-2142720,90
4024,595,20,10,0.128815761,0.871184239,1326.281789,1354.25095,2273.019135,2560.102521,4619,99.80553155,9238,-2060288,304640,-1755648,90
4048,594,20,10,0.127962085,0.872037915,1330.095935,1359.217139,2272.289032,2656.863636,4642,105.4760282,9284,-2072576,304128,-1768448,90
3570,640,21,9,0.152019002,0.847980998,1192.803345,1255.028296,2030.863585,2521.83125,4210,82.84140102,8420,-1827840,327680,-1500160,90
3597,540,20,10,0.130529369,0.869470631,1180.550965,1249.671255,2029.100917,2334.772222,4137,93.91600454,8274,-1841664,276480,-1565184,90
4091,657,21,9,0.138374052,0.861625948,1362.739606,1401.530982,2341.628697,2579.182648,4748,96.32785555,9496,-2094592,336384,-1758208,90
3671,628,21,9,0.146080484,0.853919516,1218.935003,1310.308121,2090.702261,2496.627389,4299,103.0688084,8598,-1879552,321536,-1558016,90
3906,596,21,9,0.132385606,0.867614394,1282.120908,1364.833559,2201.809268,2577.157718,4502,98.85814668,9004,-1999872,305152,-1694720,90
1289,107,20,10,0.0766475645,0.923352436,398.3354406,432.0843253,709.9596587,560.4485981,1396,85.90769231,2792,-659968,54784,-605184,90
3818,572,20,10,0.130296128,0.869703872,1254.096004,1312.922569,2150.401781,2496.522727,4390,93.54357554,8780,-1954816,292864,-1661952,90
8473,768,22,8,0.0831078888,0.916892111,2671.194373,2426.180482,4708.700932,3653.434896,9241,171.7657993,18482,-4338176,393216,-3944960,90
5076,600,20,10,0.105708245,0.894291755,1628.01726,1712.058932,2815.093775,3036.516667,5676,129.4708029,11352,-2598912,307200,-2291712,90
3946,795,20,10,0.167686142,0.832313858,1362.41189,1320.845581,2286.279017,2791.514465,4741,92.92434339,9482,-2020352,407040,-1613312,90
3864,679,20,10,0.149460709,0.850539291,1297.315562,1296.93906,2191.341874,2731.002946,4543,89.51724138,9086,-1978368,347648,-1630720,90
3871,600,21,9,0.134198166,0.865801834,1261.10522,1408.793214,2176.921984,2617.151667,4471,94.18580156,8942,-1981952,307200,-1674752,90
1286,126,21,9,0.0892351275,0.910764873,401.144077,363.234915,734.1702955,424.0873016,1412,106.8887207,2824,-658432,64512,-593920,90
3612,606,21,9,0.143669986,0.856330014,1192.614189,1252.930321,2028.5,2592.292079,4218,85.54045832,8436,-1849344,310272,-1539072,90
3601,585,20,10,0.139751553,0.860248447,1192.8835,1212.093489,2022.776729,2528.841026,4186,88.85586924,8372,-1843712,299520,-1544192,90
681,97,20,10,0.124678663,0.875321337,222.9636489,221.1727667,400.3509545,313.3195876,778,11.90330477,1556,-348672,49664,-299008,90
3265,489,20,10,0.130261055,0.869738945,1070.797824,1134.284604,1839.715161,2129.785276,3754,68.3166515,7508,-1671680,250368,-1421312,90
3371,629,21,9,0.15725,0.84275,1115.568983,1175.164976,1888.379709,2601.386328,4000,83.00477277,8000,-1725952,322048,-1403904,90
4106,725,20,10,0.150072449,0.849927551,1355.192937,1512.393615,2331.246469,2895.997241,4831,99.48517298,9662,-2102272,371200,-1731072,90
3933,675,21,9,0.146484375,0.853515625,1322.658869,1281.404836,2226.135011,2761.106667,4608,90.05276529,9216,-2013696,345600,-1668096,90
1219,121,22,8,0.0902985075,0.909701493,381.5378176,345.7754968,695.7260049,416.3636364,1340,48.94083272,2680,-624128,61952,-562176,90
3950,650,21,9,0.141304348,0.858695652,1300.015382,1431.871517,2239.796203,2669.392308,4600,103.7204059,9200,-2022400,332800,-1689600,90
5177,632,20,10,0.108796695,0.891203305,1670.110526,1728.37147,2892.750048,3005.344937,5809,121.400209,11618,-2650624,323584,-2327040,90
3803,779,21,9,0.170013095,0.829986905,1277.265871,1376.267308,2168.807783,2890.471117,4582,87.60994264,9164,-1947136,398848,-1548288,90
8027,841,20,10,0.0948353631,0.905164637,2526.957683,2844.865996,4459.534695,4195.554102,8868,200.1354096,17736,-4109824,430592,-3679232,90
3719,617,21,9,0.142297048,0.857702952,1237.528366,1277.968631,2109.771444,2522.489465,4336,86.78943155,8672,-1904128,315904,-1588224,90
8160,823,20,10,0.0916174997,0.9083825,2559.696845,2894.712235,4469.403922,4716.038882,8983,189.4348376,17966,-4177920,421376,-3756544,90
3532,580,20,10,0.141050584,0.858949416,1167.951593,1241.020207,1999.039071,2406.417241,4112,90.77262693,8224,-1808384,296960,-1511424,90
4124,601,20,10,0.127195767,0.872804233,1360.096116,1361.735188,2324.749273,2625.472546,4725,100.4037399,9450,-2111488,307712,-1803776,90
3482,606,20,10,0.148238748,0.851761252,1152.97535,1253.054289,1975.19529,2442.716172,4088,92.6144087,8176,-1782784,310272,-1472512,90
2826,527,21,9,0.157172681,0.842827319,923.319691,1075.097728,1594.281316,2120.573055,3353,60.73175149,6706,-1446912,269824,-1177088,90
5024,617,20,10,0.10937777,0.89062223,1621.848785,1666.371897,2795.407046,3029.393841,5641,114.3059777,11282,-2572288,315904,-2256384,90
4670,622,20,10,0.117535903,0.882464097,1525.328272,1543.443773,2637.475375,2714.257235,5292,90.67854695,10584,-2391040,318464,-2072576,90
5315,661,21,9,0.110609103,0.889390897,1715.973735,1794.72892,2977.919285,3073.577912,5976,124.4222361,11952,-2721280,338432,-2382848,90
3684,756,20,10,0.17027027,0.82972973,1232.746784,1360.591958,2103.520901,2790.541005,4440,79.0879943,8880,-1886208,387072,-1499136,90
7078,738,20,10,0.0944216991,0.905578301,2229.706176,2489.84448,3889.93176,4086.584011,7816,140.0716846,15632,-3623936,377856,-3246080,90
3845,597,20,10,0.134398919,0.865601081,1266.765852,1315.665777,2162.246554,2603.123953,4442,81.92548875,8884,-1968640,305664,-1662976,90
3581,696,21,9,0.162730886,0.837269114,1180.031697,1334.66438,2023.497068,2733.275862,4277,90.59521288,8554,-1833472,356352,-1477120,90
5192,634,21,9,0.10882252,0.89117748,1669.263549,1764.629682,2885.445878,3143.242902,5826,130.657098,11652,-2658304,324608,-2333696,90
7124,750,20,10,0.0952501905,0.904749809,2260.601238,2387.157198,3943.23105,3883.062667,7874,170.691524,15748,-3647488,384000,-3263488,90
7352,833,20,10,0.101771533,0.898228467,2367.924689,2256.993385,4149.323041,3595.896759,8185,165.0534382,16370,-3764224,426496,-3337728,90
4181,667,21,9,0.137582508,0.862417492,1374.448211,1452.3215,2345.422148,2920.188906,4848,111.8081181,9696,-2140672,341504,-1799168,90
3588,581,22,8,0.139361957,0.860638043,1181.246411,1277.56967,2028.048495,2436.707401,4169,97.20214502,8338,-1837056,297472,-1539584,90
3739,590,20,10,0.136290136,0.863709864,1223.470979,1322.107097,2095.529286,2605.255932,4329,98.7004104,8658,-1914368,302080,-1612288,90
5266,661,20,10,0.111523536,0.888476464,1699.473939,1797.799303,2953.474174,3047.856278,5927,136.2215583,11854,-2696192,338432,-2357760,90
4260,632,21,9,0.129190515,0.870809485,1377.94726,1532.402309,2371.918779,2949.21519,4892,96.66073898,9784,-2181120,323584,-1857536,90
3529,550,21,9,0.13483697,0.86516303,1162.313794,1199.481486,1979.211108,2430.043636,4079,88.88646764,8158,-1806848,281600,-1525248,90
3519,599,20,10,0.145458961,0.854541039,1171.412757,1234.861181,2003.013924,2391.343907,4118,88.42602534,8236,-1801728,306688,-1495040,90
3294,637,21,9,0.162045281,0.837954719,1097.016213,1189.787193,1867.759259,2474.014129,3931,82.1353949,7862,-1686528,326144,-1360384,90
3507,574,20,10,0.140651801,0.859348199,1158.560457,1232.709904,1982.823496,2396.444251,4081,82.09615771,8162,-1795584,293888,-1501696,90
3804,751,20,10,0.164873765,0.835126235,1261.429408,1385.504487,2149.491062,2928.929427,4555,98.1046737,9110,-1947648,384512,-1563136,90
7458,758,20,10,0.0922590068,0.907740993,2363.540353,2369.066966,4169.395012,3509.350923,8216,146.7929248,16432,-3818496,388096,-3430400,90
4991,641,20,10,0.11381392,0.88618608,1622.15958,1653.890548,2813.907433,2836.686427,5632,127.3056058,11264,-2555392,328192,-2227200,90
4849,650,20,10,0.11820331,0.88179669,1571.330906,1695.086383,2729.767787,2900.932308,5499,97.9515497,10998,-2482688,332800,-2149888,90
3732,731,20,10,0.163791172,0.836208828,1239.247938,1358.542064,2112.120311,2844.025992,4463,88.8159204,8926,-1910784,374272,-1536512,90
1745,160,20,10,0.0839895013,0.916010499,541.3504878,560.9728502,979.2962751,666.20625,1905,56.32761679,3810,-893440,81920,-811520,90
1328,170,20,10,0.113484646,0.886515354,425.1928845,473.4342151,736.6415663,849.9470588,1498,40.46461372,2996,-679936,87040,-592896,90
1361,159,20,10,0.104605263,0.895394737,431.1675132,487.0123891,748.3475386,864.5220126,1520,40.35041147,3040,-696832,81408,-615424,90
1245,167,20,10,0.118271955,0.881728045,400.5223753,452.1977055,698.184739,768.491018,1412,38.10037777,2824,-637440,85504,-551936,90
1371,154,21,9,0.100983607,0.899016393,432.8832229,485.9737629,750.0722101,878.0909091,1525,38.0583978,3050,-701952,78848,-623104,90
1374,165,21,9,0.107212476,0.892787524,435.3219071,499.9961368,757.0982533,877.4363636,1539,39.01140684,3078,-703488,84480,-619008,90
1350,167,20,10,0.110085695,0.889914305,428.6314143,488.325601,743.1792593,886.8922156,1517,38.36621143,3034,-691200,85504,-605696,90
1268,151,20,10,0.106412967,0.893587033,402.1846158,458.0057588,699.4503155,798.589404,1419,36.89547582,2838,-649216,77312,-571904,90
1352,187,20,10,0.121507472,0.878492528,434.178263,495.2004117,753.4726331,889.4919786,1539,26.91500525,3078,-692224,95744,-596480,90
1367,168,20,10,0.109446254,0.890553746,437.3179418,478.5842834,757.0907096,856.7678571,1535,40.68380599,3070,-699904,86016,-613888,90
1242,180,21,9,0.126582278,0.873417722,402.9153542,457.483231,705.8140097,750.7333333,1422,37.22513089,2844,-635904,92160,-543744,90
1368,180,20,10,0.11627907,0.88372093,441.1846382,480.9004913,764.3062865,851.9722222,1548,32.53467844,3096,-700416,92160,-608256,90
1346,164,21,9,0.108609272,0.891390728,431.3475702,468.4560995,749.2459138,806.8292683,1510,40.76673866,3020,-689152,83968,-605184,90
1239,166,20,10,0.118149466,0.881850534,395.3687611,461.6041251,688.9225182,808.0722892,1405,37.37696196,2810,-634368,84992,-549376,90
1372,158,21,9,0.103267974,0.896732026,434.6136779,483.8058893,752.2682216,880.3987342,1530,37.40831296,3060,-702464,80896,-621568,90
1349,166,20,10,0.109570957,0.890429043,429.9991901,482.8487125,746.4544107,851.8253012,1515,39.42232631,3030,-690688,84992,-605696,90
1338,164,20,10,0.10918775,0.89081225,424.6376371,483.5781256,736.4895366,873.9634146,1502,39.30908139,3004,-685056,83968,-601088,90
920,83,21,9,0.0827517448,0.917248255,287.8978721,291.1691321,510.4532609,408.3012048,1003,29.08932715,2006,-471040,42496,-428544,90
1362,163,21,9,0.106885246,0.893114754,432.3854096,493.8397548,753.4574156,842.7361963,1525,39.17287439,3050,-697344,83456,-613888,90
1341,155,20,10,0.103609626,0.896390374,424.2030383,475.8652554,734.3378076,871.0258065,1496,40.50907122,2992,-686592,79360,-607232,90
738,89,20,10,0.107617896,0.892382104,237.6691399,247.0877154,412.6097561,425.5280899,827,13.0668352,1654,-377856,45568,-332288,90
2228,248,20,10,0.100161551,0.899838449,696.1043004,864.3536202,1236.898564,1252.887097,2476,54.91239743,4952,-1140736,126976,-1013760,90
3244,551,21,9,0.145191041,0.854808959,1052.169266,1136.526784,1791.880086,2522.778584,3795,84.93733214,7590,-1660928,282112,-1378816,90
3282,511,19,11,0.134721856,0.865278144,1074.295466,1122.097713,1827.921085,2340.67319,3793,77.42396407,7586,-1680384,261632,-1418752,90
3233,536,20,10,0.142212789,0.857787211,1045.837386,1165.642749,1791.860192,2446.79291,3769,78.21124715,7538,-1655296,274432,-1380864,90
3443,519,21,9,0.130994447,0.869005553,1105.32875,1305.783841,1922.546326,2372.593449,3962,69.07252441,7924,-1762816,265728,-1497088,90
3336,533,21,9,0.137761696,0.862238304,1092.30662,1204.409137,1880.154376,2278.273921,3869,85.18273888,7738,-1708032,272896,-1435136,90
3264,566,20,10,0.147780679,0.852219321,1061.175855,1196.742532,1821.386336,2458.233216,3830,73.48426708,7660,-1671168,289792,-1381376,90
3261,513,20,10,0.135930048,0.864069952,1064.534532,1156.376944,1823.59123,2293.750487,3774,81.54710458,7548,-1669632,262656,-1406976,90
2850,284,20,10,0.0906190172,0.909380983,897.7002481,972.0368338,1569.377895,1548.65493,3134,81.29701686,6268,-1459200,145408,-1313792,90
3376,472,20,10,0.122661123,0.877338877,1090.601259,1222.54755,1893.045616,2149.478814,3848,73.00322519,7696,-1728512,241664,-1486848,90
4416,465,19,11,0.0952673632,0.904732637,1406.807065,1421.214048,2425.23913,2590.677419,4881,101.3075965,9762,-2260992,238080,-2022912,90
4569,506,21,9,0.0997044335,0.900295567,1448.49858,1603.406555,2527.386518,2633.835968,5075,114.6633529,10150,-2339328,259072,-2080256,90
3355,469,21,9,0.122646444,0.877353556,1079.414234,1212.892357,1865.325484,2249.963753,3824,89.53406696,7648,-1717760,240128,-1477632,90
3179,533,21,9,0.143588362,0.856411638,1032.895534,1128.83293,1763.493237,2411.225141,3712,72.21789883,7424,-1627648,272896,-1354752,90
3257,502,21,9,0.133546156,0.866453844,1062.335872,1158.415938,1823.851704,2244.292829,3759,86.37408088,7518,-1667584,257024,-1410560,90
1332,114,20,10,0.0788381743,0.921161826,413.6054296,388.8626212,743.6388889,488.1929825,1446,94.75753604,2892,-681984,58368,-623616,90
2437,257,21,9,0.0953971789,0.904602821,768.8957806,851.9388285,1338.536725,1432.494163,2694,74.64671654,5388,-1247744,131584,-1116160,90
3380,516,21,9,0.132443532,0.867556468,1102.034263,1209.147887,1896.614793,2288.368217,3896,80.13163307,7792,-1730560,264192,-1466368,90
2713,428,20,10,0.136262337,0.863737663,869.1780451,1034.623833,1509.767416,1959.140187,3141,71.28915116,6282,-1389056,219136,-1169920,90
3336,495,21,9,0.129209084,0.870790916,1076.639675,1248.922953,1873.583333,2201.862626,3831,83.44587236,7662,-1708032,253440,-1454592,90
5562,234,21,9,0.0403726708,0.959627329,1666.87444,1754.398193,2917.859223,2438.346154,5796,147.6687898,11592,-2847744,119808,-2727936,91
5406,239,21,9,0.0423383525,0.957661647,1620.47898,1737.210161,2846.932482,2281.665272,5645,138.7659784,11290,-2767872,122368,-2645504,91
5553,225,21,9,0.03894081,0.96105919,1661.768142,1770.859635,2905.158653,2503.044444,5778,146.6869764,11556,-2843136,115200,-2727936,91
4623,245,21,9,0.0503286771,0.949671323,1392.35291,1468.771748,2470.996972,1745.82449,4868,85.53856967,9736,-2366976,125440,-2241536,91
5667,254,21,9,0.0428981591,0.957101841,1702.215401,1804.340487,2980.656608,2522.440945,5921,131.4025743,11842,-2901504,130048,-2771456,91
5672,242,21,9,0.0409198512,0.959080149,1702.298959,1798.545065,2968.826516,2692.028926,5914,138.3068288,11828,-2904064,123904,-2780160,91
5571,264,20,10,0.0452442159,0.954755784,1676.589595,1815.364855,2932.424699,2613.606061,5835,143.3660934,11670,-2852352,135168,-2717184,91
5595,259,21,9,0.0442432525,0.955756748,1678.141134,1801.308982,2958.423771,2259.474903,5854,150.7597219,11708,-2864640,132608,-2732032,91
5573,265,20,10,0.0453922576,0.954607742,1673.114674,1788.174347,2952.424009,2227.101887,5838,116.970547,11676,-2853376,135680,-2717696,91
5574,255,21,9,0.0437467833,0.956253217,1673.851894,1759.666614,2942.695551,2309.607843,5829,126.4973958,11658,-2853888,130560,-2723328,91
5644,262,20,10,0.0443616661,0.955638334,1697.712337,1801.778562,2973.192062,2529.293893,5906,156.2433862,11812,-2889728,134144,-2755584,91
5551,241,21,9,0.041609116,0.958390884,1663.049414,1783.610099,2919.872095,2358.165975,5792,150.4415584,11584,-2842112,123392,-2718720,91
5551,260,21,9,0.0447427293,0.955257271,1664.901598,1808.557922,2936.417402,2256.588462,5811,157.7361564,11622,-2842112,133120,-2708992,91
5556,276,20,10,0.0473251029,0.952674897,1670.302559,1778.382709,2952.988301,2181.974638,5832,126.452732,11664,-2844672,141312,-2703360,91
5551,231,20,10,0.0399515738,0.960048426,1661.797504,1779.657618,2909.955143,2448.017316,5782,144.2254926,11564,-2842112,118272,-2723840,91
5554,269,21,9,0.0461961188,0.953803881,1667.655023,1789.996243,2946.794202,2193.609665,5823,133.2494279,11646,-2843648,137728,-2705920,91
5558,258,21,9,0.0443603851,0.955639615,1666.448677,1813.155731,2938.29543,2266.627907,5816,143.8535741,11632,-2845696,132096,-2713600,91
5601,286,21,9,0.0485816205,0.951418379,1688.264638,1843.86629,2967.835029,2477.216783,5887,141.6847172,11774,-2867712,146432,-2721280,91
5563,271,20,10,0.0464518341,0.953548166,1669.271371,1851.659901,2948.712925,2276.771218,5834,101.7085077,11668,-2848256,138752,-2709504,91
5545,255,20,10,0.0439655172,0.956034483,1665.757783,1746.136385,2928.068711,2301.015686,5800,139.1220916,11600,-2839040,130560,-2708480,91
9633,354,20,10,0.0354460799,0.96455392,2876.034197,3042.14679,5007.905118,4615.615819,9987,944.8438978,19974,-4932096,181248,-4750848,91
9609,378,20,10,0.037849204,0.962150796,2870.926607,3127.583709,5014.980747,4460.656085,9987,769.4144838,19974,-4919808,193536,-4726272,91
9627,360,20,10,0.0360468609,0.963953139,2875.47909,3024.533647,5014.827568,4437.036111,9987,605.6397817,19974,-4929024,184320,-4744704,91
9598,385,20,10,0.0385655615,0.961434439,2864.2583,3280.478163,5001.841529,4746.651948,9983,813.6104319,19966,-4914176,197120,-4717056,91
9645,344,21,9,0.0344378817,0.965562118,2876.388538,3030.31517,5013.968481,4463.165698,9989,870.880558,19978,-4938240,176128,-4762112,91
9644,345,20,10,0.0345379918,0.965462008,2875.393288,3055.148824,5014.199502,4458.304348,9989,966.9893514,19978,-4937728,176640,-4761088,91
9616,371,21,9,0.0371482928,0.962851707,2874.990154,3050.185331,5011.067284,4551.630728,9987,826.0545906,19974,-4923392,189952,-4733440,91
9631,358,20,10,0.0358394234,0.964160577,2870.516823,3127.774638,5022.156059,4264.441341,9989,697.5558659,19978,-4931072,183296,-4747776,91
9610,373,20,10,0.037363518,0.962636482,2864.372894,3260.444067,5011.456504,4490.72118,9983,1352.710027,19966,-4920320,190976,-4729344,91
9631,358,20,10,0.0358394234,0.964160577,2871.425003,3114.934987,5020.638667,4305.26257,9989,1192.004773,19978,-4931072,183296,-4747776,91
9624,365,20,10,0.0365401942,0.963459806,2867.680123,3156.028308,5027.559954,4136.487671,9989,278.7887245,19978,-4927488,186880,-4740608,91
9591,392,20,10,0.0392667535,0.960733247,2874.204257,3005.344708,5015.660828,4413.094388,9983,831.9166667,19966,-4910592,200704,-4709888,91
9638,351,20,10,0.0351386525,0.964861347,2872.541019,3100.610849,5018.872691,4339.487179,9989,987.055336,19978,-4934656,179712,-4754944,91
9613,374,20,10,0.0374486833,0.962551317,2870.015389,3092.574986,5025.185166,4192.441176,9987,907.9090909,19974,-4921856,191488,-4730368,91
9608,379,20,10,0.0379493341,0.962050666,2874.873395,3032.829331,5015.178809,4457.097625,9987,894.8924731,19974,-4919296,194048,-4725248,91
9622,365,21,9,0.0365475118,0.963452488,2875.159857,3030.36364,5015.011744,4440.09589,9987,777.1984436,19974,-4926464,186880,-4739584,91
9638,349,20,10,0.0349454291,0.965054571,2876.821264,3007.25482,5011.810438,4502.146132,9987,618.7732342,19974,-4934656,178688,-4755968,91
9620,367,21,9,0.0367477721,0.963252228,2872.186061,3077.0708,5019.790748,4317.959128,9987,924.7222222,19974,-4925440,187904,-4737536,91
9584,399,20,10,0.0399679455,0.960032054,2871.968757,3021.513489,5021.98341,4271.796992,9983,505.4683544,19966,-4907008,204288,-4702720,91
9627,362,20,10,0.0362398639,0.963760136,2869.585535,3129.358452,5025.049756,4195.859116,9989,551.5737162,19978,-4929024,185344,-4743680,91
3761,237,22,8,0.0592796398,0.94072036,1154.989215,1132.942553,2007.399628,1874.139241,3998,80.58859101,7996,-1925632,121344,-1804288,91
3238,186,21,9,0.0543224299,0.94567757,987.1885644,997.3006477,1721.305744,1559.204301,3424,66.88806408,6848,-1657856,95232,-1562624,91
3508,216,21,9,0.0580021482,0.941997852,1075.861403,1040.393373,1875.047891,1658.712963,3724,68.15519766,7448,-1796096,110592,-1685504,91
3752,210,22,8,0.0530035336,0.946996466,1144.277732,1099.742776,1996.547974,1712.642857,3962,70.86388839,7924,-1921024,107520,-1813504,91
3344,204,20,10,0.0574971815,0.942502818,1023.757846,1014.358427,1785.673744,1591.338235,3548,63.51593269,7096,-1712128,104448,-1607680,91
2919,196,20,10,0.0629213483,0.937078652,897.4298904,917.0167414,1566.134293,1436.857143,3115,55.43691048,6230,-1494528,100352,-1394176,91
3117,195,21,9,0.0588768116,0.941123188,956.2254105,929.9089918,1669.417709,1450.015385,3312,58.89046942,6624,-1595904,99840,-1496064,91
2762,188,20,10,0.0637288136,0.936271186,847.3054425,911.2976569,1478.234975,1435.319149,2950,53.09575234,5900,-1414144,96256,-1317888,91
3388,191,22,8,0.0533668623,0.946633138,1032.337855,1010.675933,1805.160567,1521.078534,3579,63.72863248,7158,-1734656,97792,-1636864,91
3617,199,21,9,0.052148847,0.947851153,1102.52809,1052.187039,1922.527233,1653.542714,3816,71.90503109,7632,-1851904,101888,-1750016,91
3538,233,22,8,0.0617873243,0.938212676,1090.672652,1043.298169,1896.63143,1724.566524,3771,69.83333333,7542,-1811456,119296,-1692160,91
3359,197,22,8,0.0553993251,0.944600675,1026.440979,1013.709368,1788.244716,1612.345178,3556,67.33573187,7112,-1719808,100864,-1618944,91
2899,191,21,9,0.0618122977,0.938187702,890.8554363,901.3443258,1553.155571,1429.303665,3090,55.45585068,6180,-1484288,97792,-1386496,91
3647,220,22,8,0.0568916473,0.943108353,1116.958231,1079.539158,1947.939128,1702.927273,3867,68.18903192,7734,-1867264,112640,-1754624,91
4058,235,20,10,0.0547402749,0.945259725,1236.099686,1279.630796,2157.443815,1966.655319,4293,87.25609756,8586,-2077696,120320,-1957376,91
3155,191,22,8,0.0570830843,0.942916916,967.6251577,926.3526188,1681.80729,1536.277487,3346,59.51618641,6692,-1615360,97792,-1517568,91
3118,193,21,9,0.0582905467,0.941709453,953.226464,994.4467405,1659.850545,1593.792746,3311,59.41144805,6622,-1596416,98816,-1497600,91
3551,210,20,10,0.0558362138,0.944163786,1086.438426,1045.587174,1894.91608,1645.685714,3761,67.87583469,7522,-1818112,107520,-1710592,91
2495,190,21,9,0.0707635009,0.929236499,774.6699845,778.4038144,1347.317034,1286.310526,2685,50.56497175,5370,-1277440,97280,-1180160,91
793,63,21,9,0.0735981308,0.926401869,242.3054971,299.3660228,430.9331652,397.8730159,856,13.90965226,1712,-406016,32256,-373760,91
4277,222,22,8,0.0493442987,0.950655701,1284.864037,1535.621676,2257.1148,2112.927928,4499,396.7372134,8998,-2189824,113664,-2076160,91
51,22,21,9,0.301369863,0.698630137,22.10373641,18.4339899,37.33333333,36.22727273,73,4.481276857,146,-26112,11264,-14848,91
3737,205,20,10,0.0520040589,0.947995941,1123.856178,1369.749543,1972.1346,1959.931707,3942,430.349345,7884,-1913344,104960,-1808384,91
4423,230,22,8,0.049430475,0.950569525,1328.878677,1592.382758,2330.475695,2260.16087,4653,179.6525097,9306,-2264576,117760,-2146816,91
3618,202,21,9,0.0528795812,0.947120419,1088.631005,1327.090354,1915.537037,1820.282178,3820,309.8134631,7640,-1852416,103424,-1748992,91
4384,231,21,9,0.0500541712,0.949945829,1315.901804,1605.684558,2314.799042,2178.965368,4615,475.7731959,9230,-2244608,118272,-2126336,91
3621,210,22,8,0.0548159749,0.945184025,1092.815292,1310.998553,1914.264015,1945.933333,3831,254.7207447,7662,-1853952,107520,-1746432,91
3690,202,22,8,0.0519013361,0.948098664,1107.609392,1381.950324,1944.707588,1979.242574,3892,246.7977172,7784,-1889280,103424,-1785856,91
4073,216,22,8,0.0503613896,0.94963861,1222.548353,1500.105248,2141.161306,2217.384259,4289,207.2982117,8578,-2085376,110592,-1974784,91
4497,234,21,9,0.0494610019,0.950538998,1352.565592,1596.992212,2363.673115,2410.717949,4731,451.8624642,9462,-2302464,119808,-2182656,91
3501,209,20,10,0.0563342318,0.943665768,1057.174542,1280.321149,1854.898315,1865.578947,3710,100.8700381,7420,-1792512,107008,-1685504,91
4411,229,21,9,0.0493534483,0.950646552,1322.904272,1622.407801,2325.702335,2220.292576,4640,344.2136499,9280,-2258432,117248,-2141184,91
4414,226,21,9,0.0487068966,0.951293103,1322.203816,1640.188154,2321.712279,2296.823009,4640,83.54339215,9280,-2259968,115712,-2144256,91
4395,222,22,8,0.0480831709,0.951916829,1316.966977,1613.90176,2311.687372,2255.797297,4617,350.5694761,9234,-2250240,113664,-2136576,91
4405,227,22,8,0.0490069085,0.950993092,1323.888514,1565.565043,2323.852213,2173.828194,4632,302.1526419,9264,-2255360,116224,-2139136,91
4407,217,22,8,0.0469290657,0.953070934,1322.728178,1559.627674,2314.999773,2261.732719,4624,291.3673598,9248,-2256384,111104,-2145280,91
4428,228,22,8,0.0489690722,0.951030928,1328.052724,1622.318068,2332.359756,2253.539474,4656,440.0756144,9312,-2267136,116736,-2150400,91
4420,226,21,9,0.0486439948,0.951356005,1325.713448,1613.6931,2325.566063,2283.09292,4646,314.7696477,9292,-2263040,115712,-2147328,91
3479,195,22,8,0.0530756668,0.946924333,1048.551602,1252.950603,1842.396091,1750.148718,3674,68.89180574,7348,-1781248,99840,-1681408,91
4172,194,20,10,0.0444342648,0.955565735,1252.952038,1316.77517,2206.442953,1690.108247,4366,107.5634393,8732,-2136064,99328,-2036736,91
1825,242,22,8,0.117077891,0.882922109,583.2128105,673.8066651,1015.536438,1173.239669,2067,138.0761523,4134,-934400,123904,-810496,91
1773,212,21,9,0.106801008,0.893198992,566.0634562,617.7581492,980.1161873,1100.75,1985,181.1131387,3970,-907776,108544,-799232,91
1820,214,22,8,0.105211406,0.894788594,578.8424828,639.2435904,1002.305495,1146.724299,2034,156.7026194,4068,-931840,109568,-822272,91
1880,224,22,8,0.106463878,0.893536122,600.3178583,642.2450084,1033.678191,1210.46875,2104,133.6721728,4208,-962560,114688,-847872,91
1761,199,21,9,0.101530612,0.898469388,560.5204677,601.4426048,969.2385009,1080.155779,1960,183.6925961,3920,-901632,101888,-799744,91
1790,220,21,9,0.109452736,0.890547264,571.7960879,641.3968437,997.8027933,1068.127273,2010,146.9298246,4020,-916480,112640,-803840,91
1878,237,20,10,0.112056738,0.887943262,599.3558134,655.164696,1031.189563,1270.447257,2115,182.4849008,4230,-961536,121344,-840192,91
1809,207,21,9,0.102678571,0.897321429,575.2871566,629.0656534,997.371476,1105.753623,2016,181.4581458,4032,-926208,105984,-820224,91
1789,208,21,9,0.104156234,0.895843766,570.7130476,604.6195204,982.0542202,1144.75,1997,198.7064677,3994,-915968,106496,-809472,91
1803,209,20,10,0.10387674,0.89612326,576.7988491,600.4321366,992.2235164,1129.660287,2012,114.9057681,4024,-923136,107008,-816128,91
1797,203,22,8,0.1015,0.8985,572.1956971,603.8913284,984.9454647,1138.192118,2000,165.7000829,4000,-920064,103936,-816128,91
1795,207,22,8,0.103396603,0.896603397,569.6290946,635.8304309,989.3905292,1106.507246,2002,162.3682076,4004,-919040,105984,-813056,91
1877,235,21,9,0.111268939,0.888731061,601.6481075,655.3212225,1039.810868,1189.8,2112,137.8590078,4224,-961024,120320,-840704,91
1877,227,21,9,0.107889734,0.892110266,604.4008164,607.4054627,1032.802877,1215.370044,2104,118.4684685,4208,-961024,116224,-844800,91
1837,237,20,10,0.114271938,0.885728062,586.9179412,644.0317179,1009.79423,1252.248945,2074,174.7262005,4148,-940544,121344,-819200,91
1818,218,22,8,0.107072692,0.892927308,580.4495809,637.1062156,1006.842134,1115.720183,2036,135.7333333,4072,-930816,111616,-819200,91
1797,213,22,8,0.105970149,0.894029851,574.3583333,613.4777291,990.6388425,1130.877934,2010,122.4862888,4020,-920064,109056,-811008,91
1789,222,22,8,0.110392839,0.889607161,573.1280633,594.1956894,979.1274455,1222.554054,2011,44.78841871,4022,-915968,113664,-802304,91
1827,218,20,10,0.106601467,0.893398533,584.9162242,624.919636,1010.955665,1123.940367,2045,150.3676471,4090,-935424,111616,-823808,91
711,71,22,8,0.0907928389,0.909207161,218.0291317,277.87936,400.0309423,306.0704225,782,9.861286255,1564,-364032,36352,-327680,91
6795,252,20,10,0.0357598978,0.964240102,2027.207164,2153.77092,3543.12156,3008.400794,7047,287.6326531,14094,-3479040,129024,-3350016,91
6803,258,22,8,0.0365387339,0.963461266,2031.100249,2162.089868,3549.853153,3033.875969,7061,683.5430784,14122,-3483136,132096,-3351040,91
3328,166,22,8,0.0475100172,0.952489983,1000.670649,1065.688033,1769.395733,1308.53012,3494,61.01990919,6988,-1703936,84992,-1618944,91
5312,205,21,9,0.0371578757,0.962842124,1585.930434,1708.79056,2774.498494,2357.4,5517,511.3067655,11034,-2719744,104960,-2614784,91
6793,248,22,8,0.0352222696,0.96477773,2025.884099,2159.381959,3537.459591,3070.153226,7041,784.0757238,14082,-3478016,126976,-3351040,91
6807,255,22,8,0.0361087511,0.963891249,2030.226946,2192.604928,3550.271191,3030.419608,7062,716.2271805,14124,-3485184,130560,-3354624,91
6829,283,22,8,0.039791901,0.960208099,2042.896456,2277.70286,3563.698052,3382.805654,7112,876.9420469,14224,-3496448,144896,-3351552,91
5838,257,21,9,0.0421657096,0.95783429,1749.798067,1957.911688,3055.913669,2868.233463,6095,557.1297989,12190,-2989056,131584,-2857472,91
6800,253,22,8,0.0358712605,0.96412874,2027.888554,2203.372012,3542.471618,3111.162055,7053,756.7596567,14106,-3481600,129536,-3352064,91
5878,254,22,8,0.0414220483,0.958577952,1756.916746,2045.517054,3073.818816,2897.129921,6132,506.7768595,12264,-3009536,130048,-2879488,91
6797,254,22,8,0.0360232591,0.963976741,2027.09731,2191.737884,3544.242166,3037.84252,7051,785.1893096,14102,-3480064,130048,-3350016,91
6861,264,21,9,0.0370526316,0.962947368,2051.563666,2144.010796,3579.625711,3130.920455,7125,608.974359,14250,-3512832,135168,-3377664,91
6828,278,21,9,0.0391218688,0.960878131,2043.742003,2171.680744,3573.633275,3059.003597,7106,550.4260263,14212,-3495936,142336,-3353600,91
6799,253,22,8,0.0358763471,0.964123653,2027.960165,2176.690534,3544.969554,3030.158103,7052,660.2996255,14104,-3481088,129536,-3351552,91
6846,287,21,9,0.040235525,0.959764475,2045.083774,2358.358041,3576.387379,3343.076655,7133,1052.064897,14266,-3505152,146944,-3358208,91
6839,280,21,9,0.0393313668,0.960668633,2039.814532,2392.415328,3566.512648,3400.928571,7119,792.7616927,14238,-3501568,143360,-3358208,91
6810,269,20,10,0.0379997175,0.962000283,2031.842928,2231.852565,3564.526579,2919.085502,7079,737.3958333,14158,-3486720,137728,-3348992,91
6807,255,20,10,0.0361087511,0.963891249,2030.331751,2188.06189,3550.576465,3022.270588,7062,573.679935,14124,-3485184,130560,-3354624,91
6825,288,21,9,0.040489245,0.959510755,2040.177802,2313.289428,3572.596044,3187.40625,7113,667.8873239,14226,-3494400,147456,-3346944,91
6791,252,22,8,0.0357802073,0.964219793,2025.932025,2166.648501,3539.384479,3053.515873,7043,1068.740516,14086,-3476992,129024,-3347968,91
1935,213,22,8,0.0991620112,0.900837989,612.0943072,684.0025544,1066.437209,1147.746479,2148,165.2307692,4296,-990720,109056,-881664,91
1873,219,21,9,0.104684512,0.895315488,594.5917169,664.7352837,1031.521623,1174.60274,2092,159.0874525,4184,-958976,112128,-846848,91
1949,230,21,9,0.105553006,0.894446994,620.899924,676.3093944,1072.597229,1237.469565,2179,178.7530763,4358,-997888,117760,-880128,91
1899,220,20,10,0.103822558,0.896177442,604.4862944,668.2707276,1053.652449,1114.790909,2119,173.5462735,4238,-972288,112640,-859648,91
1896,249,21,9,0.116083916,0.883916084,604.9504669,705.7202971,1056.307489,1200.104418,2145,161.6428033,4290,-970752,127488,-843264,91
1879,207,22,8,0.0992329818,0.900767018,592.1729684,667.6642423,1026.872272,1194.434783,2086,153.0447542,4172,-962048,105984,-856064,91
737,62,22,8,0.0775969962,0.922403004,224.9793485,279.6080601,406.1207598,327.2419355,799,140.9171076,1598,-377344,31744,-345600,91
1883,211,22,8,0.100764088,0.899235912,595.9223038,668.239494,1036.5624,1145.109005,2094,193.1734317,4188,-964096,108032,-856064,91
1636,167,21,9,0.0926234054,0.907376595,525.6423217,464.2479942,906.844132,854.5449102,1803,80.38341507,3606,-837632,85504,-752128,91
1850,209,21,9,0.101505585,0.898494415,586.2289044,652.3732391,1017.836216,1137.669856,2059,153.0855019,4118,-947200,107008,-840192,91
1881,229,20,10,0.108530806,0.891469194,600.3764886,657.9074595,1037.370548,1204.414847,2110,116.8975069,4220,-963072,117248,-845824,91
1863,202,20,10,0.0978208232,0.902179177,591.0492804,628.8902787,1020.259796,1150.5,2065,83.90898009,4130,-953856,103424,-850432,91
1902,222,22,8,0.104519774,0.895480226,602.511508,692.2960174,1052.976866,1144.09009,2124,168.8394277,4248,-973824,113664,-860160,91
1868,212,22,8,0.101923077,0.898076923,596.127285,624.192036,1026.713062,1161.981132,2080,165.7370518,4160,-956416,108544,-847872,91
1877,214,22,8,0.102343376,0.897656624,597.808633,643.7887973,1034.605221,1145.943925,2091,128.9944479,4182,-961024,109568,-851456,91
1891,211,22,8,0.10038059,0.89961941,601.2976933,637.081001,1035.85669,1191.696682,2102,159.2424242,4204,-968192,108032,-860160,91
1943,223,22,8,0.102954755,0.897045245,618.2202858,681.4877685,1077.625322,1134.686099,2166,171.3607595,4332,-994816,114176,-880640,91
1899,231,20,10,0.108450704,0.891549296,605.6042039,684.6369493,1059.880463,1111.69697,2130,61.81079512,4260,-972288,118272,-854016,91
1901,250,20,10,0.116225012,0.883774988,611.2311773,685.2507923,1065.681746,1154.46,2151,44.36881188,4302,-973312,128000,-845312,91
699,72,21,9,0.093385214,0.906614786,215.5025337,250.1633355,398.7896996,261.8333333,771,9.469417833,1542,-357888,36864,-321024,91
9637,353,19,11,0.0353353353,0.964664665,2874.438443,3053.80004,5020.23773,4320.152975,9990,253.103623,19980,-4934144,180736,-4753408,91
9644,346,20,10,0.0346346346,0.965365365,2875.616523,3068.533903,5012.215574,4529.589595,9990,1000,19980,-4937728,177152,-4760576,91
9652,338,21,9,0.0338338338,0.966166166,2876.867067,3034.915681,5012.952756,4497.115385,9990,913.9981702,19980,-4941824,173056,-4768768,91
9649,341,20,10,0.0341341341,0.965865866,2876.255548,3060.010097,5010.766504,4563.516129,9990,1071.888412,19980,-4940288,174592,-4765696,91
9647,343,20,10,0.0343343343,0.965665666,2876.628808,3039.714113,5012.939048,4505.020408,9990,708.0085046,19980,-4939264,175616,-4763648,91
9645,345,20,10,0.0345345345,0.965465465,2875.072154,3067.917659,5015.38621,4439.550725,9990,1258.186398,19980,-4938240,176640,-4761600,91
9639,351,21,9,0.0351351351,0.964864865,2872.262597,3108.211102,5020.529412,4308.153846,9990,222.7921499,19980,-4935168,179712,-4755456,91
9639,351,20,10,0.0351351351,0.964864865,2873.707222,3083.232896,5018.580039,4361.68661,9990,1176.678445,19980,-4935168,179712,-4755456,91
9640,350,20,10,0.035035035,0.964964965,2872.214147,3122.480005,5018.443672,4363.565714,9990,889.5814782,19980,-4935680,179200,-4756480,91
9648,342,20,10,0.0342342342,0.965765766,2875.338752,3060.406653,5015.686049,4426.040936,9990,1126.26832,19980,-4939776,175104,-4764672,91
9616,372,20,10,0.0372446936,0.962755306,2876.887026,3028.545625,5006.152038,4693.301075,9988,531.8423855,19976,-4923392,190464,-4732928,91
9619,369,21,9,0.0369443332,0.963055667,2872.400505,3073.858567,5021.070901,4301.856369,9988,901.4440433,19976,-4924928,188928,-4736000,91
9642,348,20,10,0.0348348348,0.965165165,2873.702554,3089.456036,5017.729206,4379.597701,9990,1168.421053,19980,-4936704,178176,-4758528,91
9647,343,21,9,0.0343343343,0.965665666,2879.963818,2971.518869,5007.557997,4656.364431,9990,1176.678445,19980,-4939264,175616,-4763648,91
9649,341,21,9,0.0341341341,0.965865866,2876.006728,3056.449919,5013.055343,4498.750733,9990,897.574124,19980,-4940288,174592,-4765696,91
9643,347,21,9,0.0347347347,0.965265265,2872.704535,3106.152124,5019.316188,4333.657061,9990,315.0425733,19980,-4937216,177664,-4759552,91
9635,355,20,10,0.0355355355,0.964464464,2870.553586,3128.179793,5023.762532,4228.430986,9990,436.4351245,19980,-4933120,181760,-4751360,91
9640,350,20,10,0.035035035,0.964964965,2873.597772,3092.212863,5017.571473,4387.588571,9990,670.4697987,19980,-4935680,179200,-4756480,91
9653,337,20,10,0.0337337337,0.966266266,2876.620261,3047.205264,5011.834145,4527.626113,9990,799.2,19980,-4942336,172544,-4769792,91
290,37,21,9,0.113149847,0.886850153,91.23501529,78.02188264,174.3517241,82.86486486,327,5.367695338,654,-148480,18944,-129536,91
3660,262,21,9,0.0668026517,0.933197348,1120.709313,1268.751762,1948.893716,2137.603053,3922,93.62616376,7844,-1873920,134144,-1739776,91
3577,273,22,8,0.0709090909,0.929090909,1097.73332,1256.069312,1908.554096,2147.534799,3850,94.96793291,7700,-1831424,139776,-1691648,91
3826,290,20,10,0.0704567541,0.929543246,1177.270426,1308.916666,2044.031103,2249.389655,4116,85.25269263,8232,-1958912,148480,-1810432,91
3575,295,22,8,0.0762273902,0.92377261,1105.340354,1227.191146,1915.949091,2172.430508,3870,80.74274984,7740,-1830400,151040,-1679360,91
3778,299,21,9,0.0733382389,0.926661761,1161.414494,1336.874484,2020.922446,2267.41806,4077,91.41255605,8154,-1934336,153088,-1781248,91
1395,126,22,8,0.0828402367,0.917159763,431.9250053,509.5822854,757.074552,804.4603175,1521,27.10263721,3042,-714240,64512,-649728,91
4330,287,22,8,0.0621615768,0.937838423,1318.221699,1523.285998,2296.227714,2501.696864,4617,112.3357664,9234,-2216960,146944,-2070016,91
3729,236,20,10,0.0595208071,0.940479193,1145.411336,1112.552501,1995.706087,1782.233051,3965,112.6420455,7930,-1909248,120832,-1788416,91
4051,281,21,9,0.0648661127,0.935133887,1234.018856,1447.818021,2150.143668,2402.298932,4332,115.7669695,8664,-2074112,143872,-1930240,91
3688,281,20,10,0.0707986898,0.92920131,1134.832645,1272.012397,1974.217462,2126.516014,3969,90.24556617,7938,-1888256,143872,-1744384,91
3642,295,21,9,0.0749301499,0.92506985,1128.369402,1214.59482,1952.628775,2171.115254,3937,92.76625825,7874,-1864704,151040,-1713664,91
3697,271,22,8,0.068296371,0.931703629,1132.786158,1291.866058,1970.860427,2170.571956,3968,96.1706253,7936,-1892864,138752,-1754112,91
3699,261,21,9,0.0659090909,0.934090909,1132.607153,1272.723798,1969.268451,2139.678161,3960,97.72951629,7920,-1893888,133632,-1760256,91
3758,296,22,8,0.0730143069,0.926985693,1158.144938,1293.856487,2009.794572,2252.287162,4054,89.23618754,8108,-1924096,151552,-1772544,91
4117,346,22,8,0.0775263276,0.922473672,1279.314001,1372.74681,2213.64343,2450.421965,4463,93.87883887,8926,-2107904,177152,-1930752,91
3710,282,21,9,0.0706412826,0.929358717,1140.472042,1291.363484,1986.156873,2132.574468,3992,97.43714913,7984,-1899520,144384,-1755136,91
4036,290,22,8,0.0670365233,0.932963477,1237.424918,1394.983603,2157.515114,2246.793103,4326,97.85116489,8652,-2066432,148480,-1917952,91
3623,273,21,9,0.0700718686,0.929928131,1112.445839,1260.570026,1934.143803,2139.021978,3896,80.81310931,7792,-1854976,139776,-1715200,91
2669,165,20,10,0.0582215949,0.941778405,818.3204645,785.6473139,1430.417385,1208.551515,2834,74.91408935,5668,-1366528,84480,-1282048,91
81,18,20,10,0.181818182,0.818181818,28.40844558,27.3089322,52.14814815,40.33333333,99,1.876421531,198,-41472,9216,-32256,91
3912,281,21,9,0.067016456,0.932983544,1193.09109,1408.232223,2079.772495,2336.836299,4193,108.4583549,8386,-2002944,143872,-1859072,91
3976,288,21,9,0.0675422139,0.932457786,1220.065012,1365.022461,2122.898642,2265.052083,4264,100.7799575,8528,-2035712,147456,-1888256,91
4463,337,20,10,0.0702083333,0.929791667,1373.93857,1505.974601,2379.944208,2672.727003,4800,113.7440758,9600,-2285056,172544,-2112512,91
3940,278,22,8,0.0659080133,0.934091987,1205.052347,1370.924915,2096.72132,2290.607914,4218,86.91531012,8436,-2017280,142336,-1874944,91
4316,289,22,8,0.0627578719,0.937242128,1315.717882,1506.713732,2290.796571,2485.249135,4605,100.065189,9210,-2209792,147968,-2061824,91
4025,298,21,9,0.0689336109,0.931066389,1235.73493,1395.566681,2152.081491,2295.966443,4323,94.595186,8646,-2060800,152576,-1908224,91
4380,299,22,8,0.0639025433,0.936097457,1337.951725,1516.936008,2329.37968,2495.575251,4679,113.1286267,9358,-2242560,153088,-2089472,91
3585,228,20,10,0.0597954367,0.940204563,1099.780561,1081.701571,1923.769317,1643.324561,3813,69.038566,7626,-1835520,116736,-1718784,91
4331,305,22,8,0.0657894737,0.934210526,1323.770398,1522.773016,2308.551374,2459.770492,4636,101.4886165,9272,-2217472,156160,-2061312,91
4296,287,22,8,0.0626227362,0.937377264,1310.527931,1492.892094,2284.575652,2403.132404,4583,113.1046397,9166,-2199552,146944,-2052608,91
4629,321,22,8,0.0648484848,0.935151515,1421.639267,1527.167356,2468.853532,2571.345794,4950,101.8728133,9900,-2370048,164352,-2205696,91
4341,294,21,9,0.0634304207,0.936569579,1327.842557,1476.732324,2311.540889,2413.370748,4635,111.6060679,9270,-2222592,150528,-2072064,91
4329,289,21,9,0.062581204,0.937418796,1318.246492,1528.247388,2298.010164,2481.608997,4618,112.2508508,9236,-2216448,147968,-2068480,91
4076,287,22,8,0.0657804263,0.934219574,1245.934536,1424.165415,2168.323111,2376.240418,4363,99.11403907,8726,-2086912,146944,-1939968,91
3974,294,21,9,0.0688847235,0.931115276,1217.731511,1397.924428,2120.502768,2323.70068,4268,105.1231527,8536,-2034688,150528,-1884160,91
4546,311,21,9,0.064031295,0.935968705,1390.309062,1558.161657,2419.857677,2562.636656,4857,107.1003308,9714,-2327552,159232,-2168320,91
4001,334,20,10,0.0770472895,0.92295271,1232.658218,1415.123346,2140.063984,2502.646707,4335,99.56361966,8670,-2048512,171008,-1877504,91
4419,360,21,9,0.0753295669,0.924670433,1385.60787,1293.762876,2377.673456,2541.308333,4779,93.32161687,9558,-2262528,184320,-2078208,91
792,65,21,9,0.0758459743,0.924154026,242.3591602,298.9611085,432.415404,387.3846154,857,13.47484277,1714,-405504,33280,-372224,91
815,65,22,8,0.0738636364,0.926136364,249.5891281,304.1797483,441.1668712,432.1384615,880,14.03061224,1760,-417280,33280,-384000,91
147,27,21,9,0.155172414,0.844827586,49.49272124,44.42391501,92.70068027,59.18518519,174,46.4,348,-75264,13824,-61440,92
144,25,20,10,0.147928994,0.852071006,47.71101955,40.83919686,90.79861111,51.6,169,71.00840336,338,-73728,12800,-60928,92
142,27,20,10,0.159763314,0.840236686,47.73068001,44.07170862,90.43661972,56.40740741,169,41.52334152,338,-72704,13824,-58880,92
142,26,20,10,0.154761905,0.845238095,47.36055551,40.68474555,90.54929577,51.46153846,168,37.00440529,336,-72704,13312,-59392,92
140,26,20,10,0.156626506,0.843373494,46.9281534,43.42258295,88.66428571,55.69230769,166,41.5,332,-71680,13312,-58368,92
144,24,21,9,0.142857143,0.857142857,47.39822593,42.15118293,89.86111111,52.33333333,168,28.66894198,336,-73728,12288,-61440,92
143,24,21,9,0.143712575,0.856287425,47.0496755,42.29211822,89.36363636,52.04166667,167,38.30275229,334,-73216,12288,-60928,92
143,24,21,9,0.143712575,0.856287425,47.40654292,40.57263719,89.23076923,52.83333333,167,28.89273356,334,-73216,12288,-60928,92
142,28,20,10,0.164705882,0.835294118,48.16575487,41.86689306,91.48591549,55.14285714,170,22.88021534,340,-72704,14336,-58368,92
146,28,21,9,0.16091954,0.83908046,49.13882749,44.24998559,93.40410959,56.71428571,174,46.4,348,-74752,14336,-60416,92
148,27,21,9,0.154285714,0.845714286,49.81414463,42.89640438,93.56081081,57.51851852,175,35.42510121,350,-75776,13824,-61952,92
163,35,20,10,0.176767677,0.823232323,55.92769201,52.64570839,106.0858896,68.82857143,198,32.89036545,396,-83456,17920,-65536,92
146,27,21,9,0.156069364,0.843930636,49.39670184,40.34810803,92.78082192,55.74074074,173,47.39726027,346,-74752,13824,-60928,92
149,27,23,7,0.153409091,0.846590909,50.25204614,45.11077662,93.37583893,61.59259259,176,9.832402235,352,-76288,13824,-62464,92
150,31,21,9,0.171270718,0.828729282,51.28596126,46.29199727,97.15333333,61.22580645,181,3.20808224,362,-76800,15872,-60928,92
144,26,21,9,0.152941176,0.847058824,48.27533587,44.28257835,90.42361111,58.23076923,170,30.19538188,340,-73728,13312,-60416,92
149,29,21,9,0.162921348,0.837078652,50.46108825,42.44319138,95.97315436,56.24137931,178,30.8492201,356,-76288,14848,-61440,92
152,29,23,7,0.160220994,0.839779006,51.00268811,51.77689264,95.70394737,66.34482759,181,2.925961849,362,-77824,14848,-62976,92
146,28,23,7,0.16091954,0.83908046,48.91362672,50.06000226,92.1369863,63.32142857,174,2.73929471,348,-74752,14336,-60416,92
149,29,23,7,0.162921348,0.837078652,50.16066255,50.58722938,94.27516779,64.96551724,178,2.833492518,356,-76288,14848,-61440,92
4435,257,21,9,0.0547740835,0.945225916,1338.679956,1558.904347,2325.575648,2707.587549,4692,368.288854,9384,-2270720,131584,-2139136,92
4163,239,22,8,0.054293503,0.945706497,1252.933811,1489.603646,2177.881576,2612.895397,4402,323.4386481,8804,-2131456,122368,-2009088,92
4172,243,22,8,0.0550396376,0.944960362,1254.437921,1550.594378,2190.909875,2501.415638,4415,282.8315183,8830,-2136064,124416,-2011648,92
4181,247,21,9,0.0557813911,0.944218609,1258.342555,1529.309309,2192.262138,2590.923077,4428,265.308568,8856,-2140672,126464,-2014208,92
4446,265,22,8,0.0562513267,0.943748673,1344.024603,1532.965162,2328.725371,2813.596226,4711,317.4528302,9422,-2276352,135680,-2140672,92
4126,236,22,8,0.0541036222,0.945896378,1240.334859,1497.118149,2158.653902,2580.919492,4362,308.9235127,8724,-2112512,120832,-1991680,92
108,33,20,10,0.234042553,0.765957447,41.26852579,37.09115666,74.03703704,61.06060606,141,23.15270936,282,-55296,16896,-38400,92
4420,252,22,8,0.0539383562,0.946061644,1335.669295,1489.185967,2310.825566,2786.821429,4672,333.0007128,9344,-2263040,129024,-2134016,92
4421,270,21,9,0.0575570241,0.942442976,1335.649902,1574.484729,2321.504637,2747.088889,4691,316.1051213,9382,-2263552,138240,-2125312,92
4415,262,21,9,0.0560188155,0.943981185,1332.395397,1585.973677,2319.93137,2660.328244,4677,344.9115044,9354,-2260480,134144,-2126336,92
4414,263,21,9,0.0562326278,0.943767372,1334.803284,1536.147023,2316.290213,2720.144487,4677,322.7743271,9354,-2259968,134656,-2125312,92
4452,280,21,9,0.0591715976,0.940828402,1345.933545,1600.434191,2341.323675,2766.803571,4732,293.366398,9464,-2279424,143360,-2136064,92
4438,258,21,9,0.0549403748,0.945059625,1340.566138,1530.527342,2323.653447,2775.899225,4696,395.9527825,9392,-2272256,132096,-2140160,92
4170,242,23,7,0.054850408,0.945149592,1254.69548,1487.815957,2179.227338,2676.446281,4412,332.9811321,8824,-2135040,123904,-2011136,92
4443,265,20,10,0.0562871708,0.943712829,1343.39786,1558.126952,2333.607698,2704.781132,4708,387.8088962,9416,-2274816,135680,-2139136,92
4150,244,21,9,0.0555302685,0.944469731,1248.22764,1531.890441,2177.108916,2544.315574,4394,300.752909,8788,-2124800,124928,-1999872,92
4492,275,22,8,0.0576882735,0.942311726,1359.214451,1545.157326,2353.623553,2880.185455,4767,308.9436163,9534,-2299904,140800,-2159104,92
2875,139,21,9,0.0461181155,0.953881885,859.4905578,1049.979187,1516.065739,1330.330935,3014,46.92511288,6028,-1472000,71168,-1400832,92
2829,135,21,9,0.0455465587,0.954453441,845.3764785,1029.198069,1491.642983,1290.903704,2964,46.4868256,5928,-1448448,69120,-1379328,92
2864,137,21,9,0.0456514495,0.95434855,855.723774,1048.61523,1509.378841,1325.839416,3001,46.4191802,6002,-1466368,70144,-1396224,92
9546,426,21,9,0.0427196149,0.957280385,2875.864783,2912.148662,5004.37775,4585.887324,9972,1295.064935,19944,-4887552,218112,-4669440,92
9551,424,23,7,0.0425062657,0.957493734,2875.291573,2909.436751,5014.668935,4387.257075,9975,1210.558252,19950,-4890112,217088,-4673024,92
9558,416,21,9,0.0417084419,0.958291558,2874.497394,2934.490595,5011.089768,4445.502404,9974,1578.164557,19948,-4893696,212992,-4680704,92
9562,412,21,9,0.0413073992,0.958692601,2875.255686,2888.21775,5016.763648,4308.32767,9974,1093.640351,19948,-4895744,210944,-4684800,92
5744,305,23,7,0.0504215573,0.949578443,1737.607793,1759.439411,3062.20578,2324.311475,6049,106.5339908,12098,-2940928,156160,-2784768,92
9487,479,21,9,0.0480634156,0.951936584,2865.526518,3016.410686,5017.477179,4310.553236,9966,197.8165939,19932,-4857344,245248,-4612096,92
4475,308,21,9,0.0643947313,0.935605269,1365.634878,1575.235575,2403.043352,2231.548701,4783,84.32651622,9566,-2291200,157696,-2133504,92
9549,426,23,7,0.0427067669,0.957293233,2879.623231,2820.269272,5012.934967,4429.070423,9975,578.2608696,19950,-4889088,218112,-4670976,92
9576,399,21,9,0.04,0.96,2874.890548,2917.96032,5014.412698,4354.095238,9975,1223.92638,19950,-4902912,204288,-4698624,92
9529,442,21,9,0.0443285528,0.955671447,2877.329368,2799.866145,5020.419142,4243.963801,9971,215.7758061,19942,-4878848,226304,-4652544,92
9574,401,21,9,0.0402005013,0.959799499,2868.464271,3132.128456,4989.092856,4961.907731,9975,976.9833497,19950,-4901888,205312,-4696576,92
9584,394,23,7,0.0394868711,0.960513129,2864.422551,3220.782351,5005.416319,4602.337563,9978,785.0511408,19956,-4907008,201728,-4705280,92
9544,429,21,9,0.0430161436,0.956983856,2875.896985,2867.444394,5016.756601,4325.002331,9973,702.3239437,19946,-4886528,219648,-4666880,92
9558,416,21,9,0.0417084419,0.958291558,2875.297034,2932.86912,5007.044361,4538.449519,9974,1128.280543,19948,-4893696,212992,-4680704,92
9554,419,20,10,0.0420134363,0.957986564,2877.962357,2836.884088,5013.147582,4390.785203,9973,1053.1151,19946,-4891648,214528,-4677120,92
9551,422,21,9,0.0423142485,0.957685752,2875.854498,2880.061507,5014.269501,4369.817536,9973,938.1937912,19946,-4890112,216064,-4674048,92
9631,351,21,9,0.0351632939,0.964836706,2873.107262,3041.669278,5013.727858,4381.595442,9982,688.8888889,19964,-4931072,179712,-4751360,92
9550,423,21,9,0.0424145192,0.957585481,2873.798717,2927.138757,5014.075707,4375.716312,9973,1305.366492,19946,-4889600,216576,-4673024,92
9531,441,21,9,0.0442238267,0.955776173,2874.074287,2862.448748,5023.369111,4189.675737,9972,192.1757564,19944,-4879872,225792,-4654080,92
9425,528,23,7,0.0530493319,0.946950668,2860.645729,3054.897879,5001.745676,4535.280303,9953,192.4400619,19906,-4825600,270336,-4555264,92
9554,419,21,9,0.0420134363,0.957986564,2871.905105,2946.635682,5018.26345,4274.133652,9973,1404.647887,19946,-4891648,214528,-4677120,92
9551,423,22,8,0.0424102667,0.957589733,2876.400838,2879.057707,5013.890901,4391.614657,9974,1097.249725,19948,-4890112,216576,-4673536,92
9547,426,21,9,0.0427153314,0.957284669,2875.338075,2866.271106,5019.069655,4268.293427,9973,1229.7164,19946,-4888064,218112,-4669952,92
9560,413,21,9,0.0414118119,0.958588188,2876.308475,2868.318623,5014.214854,4357.038741,9973,892.8379588,19946,-4894720,211456,-4683264,92
9542,431,21,9,0.043216685,0.956783315,2869.8117,2935.860249,5027.326347,4094.206497,9973,604.4242424,19946,-4885504,220672,-4664832,92
9541,431,21,9,0.0432210189,0.956778981,2875.962973,2864.801891,5015.281941,4349.357309,9972,777.8471139,19944,-4884992,220672,-4664320,92
9623,359,21,9,0.0359647365,0.964035263,2873.313459,3037.664332,5013.087083,4412.857939,9982,778.6271451,19964,-4926976,183808,-4743168,92
9531,437,21,9,0.0438402889,0.956159711,2868.675123,2987.952403,5014.905361,4321.356979,9968,1230.617284,19936,-4879872,223744,-4656128,92
9544,430,23,7,0.0431120914,0.956887909,2873.069563,2901.786392,5023.256915,4193.862791,9974,419.2517865,19948,-4886528,220160,-4666368,92
9544,426,21,9,0.0427281846,0.957271815,2876.013516,2859.705852,5012.183047,4387.699531,9970,837.8151261,19940,-4886528,218112,-4668416,92
9560,411,21,9,0.0412195367,0.958780463,2875.439544,2872.577296,5013.50387,4346.250608,9971,1075.62028,19942,-4894720,210432,-4684288,92
9520,452,21,9,0.0453269154,0.954673085,2873.161188,2919.435843,5016.948529,4345.19469,9972,909.8540146,19944,-4874240,231424,-4642816,92
9557,417,23,7,0.0418087026,0.958191297,2881.321171,2795.713766,5006.602909,4549.690647,9974,752.1870287,19948,-4893184,213504,-4679680,92
9552,422,21,9,0.042310006,0.957689994,2870.33435,2944.397674,5025.691792,4123.026066,9974,1153.063584,19948,-4890624,216064,-4674560,92
9548,424,21,9,0.0425190533,0.957480947,2876.562452,2836.355381,5017.675953,4284.45283,9972,810.7317073,19944,-4888576,217088,-4671488,92
9536,436,21,9,0.0437224228,0.956277577,2877.835497,2817.668301,5016.570994,4328.800459,9972,255.4957725,19944,-4882432,223232,-4659200,92
9558,414,21,9,0.0415162455,0.958483755,2878.220581,2862.667917,5002.999477,4605.577295,9972,852.3076923,19944,-4893696,211968,-4681728,92
9555,417,21,9,0.0418170878,0.958182912,2877.223143,2865.60203,5008.519309,4481.956835,9972,785.1968504,19944,-4892160,213504,-4678656,92
9507,460,21,9,0.0461523026,0.953847697,2870.476701,2937.971967,5015.643,4330.021739,9967,367.1086556,19934,-4867584,235520,-4632064,92
9543,430,21,9,0.0431164143,0.956883586,2872.368071,2939.656339,5017.785707,4303.772093,9973,1161.001164,19946,-4886016,220160,-4665856,92
1455,187,21,9,0.113885505,0.886114495,474.7484924,465.8408094,827.1491409,777.5454545,1642,117.8750897,3284,-744960,95744,-649216,92
1483,200,21,9,0.118835413,0.881164587,486.4698428,478.8525957,847.9393122,797.96,1683,119.0240453,3366,-759296,102400,-656896,92
1470,209,21,9,0.124478856,0.875521144,483.873817,479.2141771,853.8272109,742.7464115,1679,158.0979284,3358,-752640,107008,-645632,92
1473,203,21,9,0.121121718,0.878878282,483.108283,483.1523165,848.1982349,768.1280788,1676,149.9105546,3352,-754176,103936,-650240,92
1937,302,21,9,0.134881644,0.865118356,642.3163953,671.298463,1122.915849,1101.298013,2239,39.69858156,4478,-991744,154624,-837120,92
1967,269,21,9,0.120304114,0.879695886,642.2977311,667.9407667,1121.188104,1098.843866,2236,134.6987952,4472,-1007104,137728,-869376,92
1212,155,21,9,0.113386979,0.886613021,392.9435556,404.2717106,690.1460396,635.9419355,1367,50.22042616,2734,-620544,79360,-541184,92
1471,199,21,9,0.119161677,0.880838323,485.0768887,455.1983961,843.3575799,777.4170854,1670,129.4573643,3340,-753152,101888,-651264,92
1462,207,23,7,0.124026363,0.875973637,481.1018149,479.7237846,845.874829,758.1932367,1669,177.9317697,3338,-748544,105984,-642560,92
1470,214,21,9,0.127078385,0.872921615,486.4878768,479.667796,850.929932,784.5934579,1684,150.2230152,3368,-752640,109568,-643072,92
1491,207,23,7,0.121908127,0.878091873,493.7845484,460.0478889,856.6344735,798.1111111,1698,131.0185185,3396,-763392,105984,-657408,92
2311,301,23,7,0.115237366,0.884762634,745.7308501,800.5289432,1325.135872,1163.418605,2612,139.8286938,5224,-1183232,154112,-1029120,92
2339,294,21,9,0.111659704,0.888340296,750.6256049,817.1892627,1335.190252,1172.282313,2633,162.2304375,5266,-1197568,150528,-1047040,92
1208,172,21,9,0.124637681,0.875362319,396.2965727,411.2067618,695.0951987,658.2267442,1380,76.32743363,2760,-618496,88064,-530432,92
383,38,21,9,0.0902612827,0.909738717,117.779946,142.7098542,216.5613577,154.9473684,421,55.03267974,842,-196096,19456,-176640,92
1481,212,21,9,0.1252215,0.8747785,488.6895554,480.3304591,859.264686,761.3207547,1693,147.0894874,3386,-758272,108544,-649728,92
1196,175,21,9,0.127644055,0.872355945,392.0028078,420.1044549,688.8988294,666.1885714,1371,131.9538017,2742,-612352,89600,-522752,92
1211,183,21,9,0.131276901,0.868723099,399.4197932,420.6770542,701.6052849,670.3333333,1394,142.5357873,2788,-620032,93696,-526336,92
1475,195,21,9,0.116766467,0.883233533,482.9724738,473.2033942,841.0922034,793.2,1670,154.6296296,3340,-755200,99840,-655360,92
2348,296,21,9,0.111951589,0.888048411,754.2417886,818.6706899,1339.658007,1186.39527,2644,55.66315789,5288,-1202176,151552,-1050624,92
3547,308,21,9,0.0798962387,0.920103761,1096.474825,1285.668336,1931.650973,1885.954545,3855,340.5477032,7710,-1816064,157696,-1658368,92
3997,391,21,9,0.0891066545,0.910893345,1247.761332,1441.943279,2184.139855,2300.40665,4388,178.0844156,8776,-2046464,200192,-1846272,92
3511,318,21,9,0.0830504048,0.916949595,1088.452847,1274.715625,1921.621475,1841.893082,3829,185.7836002,7658,-1797632,162816,-1634816,92
3550,297,21,9,0.0772030153,0.922796985,1094.861974,1282.48533,1927.236056,1885.319865,3847,249.8051948,7694,-1817600,152064,-1665536,92
4040,363,21,9,0.0824437883,0.917556212,1254.656734,1434.201583,2190.126485,2334.146006,4403,243.7984496,8806,-2068480,185856,-1882624,92
3502,299,21,9,0.0786635096,0.92133649,1081.904246,1260.347928,1907.986294,1819.173913,3801,376.3366337,7602,-1793024,153088,-1639936,92
3495,317,21,9,0.083158447,0.916841553,1083.179003,1273.412514,1912.434907,1841.066246,3812,309.4155844,7624,-1789440,162304,-1627136,92
2737,226,21,9,0.0762740466,0.923725953,839.9143933,975.8243496,1506.610522,1183.951327,2963,52.19305971,5926,-1401344,115712,-1285632,92
3520,310,21,9,0.0809399478,0.919060052,1091.356578,1252.875727,1923.363352,1826.212903,3830,225.2941176,7660,-1802240,158720,-1643520,92
3482,299,21,9,0.0790796086,0.920920391,1081.15169,1205.127838,1892.504882,1873.474916,3781,199.4198312,7562,-1782784,153088,-1629696,92
3612,313,21,9,0.0797452229,0.920254777,1116.942411,1302.821817,1968.689092,1897.348243,3925,438.547486,7850,-1849344,160256,-1689088,92
3511,310,23,7,0.0811305941,0.918869406,1089.393519,1246.685729,1913.667046,1880.793548,3821,187.0288791,7642,-1797632,158720,-1638912,92
3496,291,21,9,0.0768418273,0.923158173,1079.649542,1238.32586,1883.973112,2014.460481,3787,336.9217082,7574,-1789952,148992,-1640960,92
3199,294,21,9,0.0841683367,0.915831663,986.5257253,1205.852474,1730.260706,1929.139456,3493,63.4975459,6986,-1637888,150528,-1487360,92
3547,293,21,9,0.0763020833,0.923697917,1097.955853,1220.350749,1932.147167,1779.501706,3840,299.2985191,7680,-1816064,150016,-1666048,92
3487,300,21,9,0.0792183787,0.920781621,1078.058848,1253.615247,1900.398337,1819.63,3787,206.039173,7574,-1785344,153600,-1631744,92
3499,296,23,7,0.077997365,0.922002635,1082.93075,1234.263797,1900.57645,1867.543919,3795,232.6793378,7590,-1791488,151552,-1639936,92
3508,315,21,9,0.0823960241,0.917603976,1087.24929,1271.570809,1912.885405,1902.139683,3823,377.7667984,7646,-1796096,161280,-1634816,92
3274,287,21,9,0.0805953384,0.919404662,1010.26974,1209.694812,1786.927611,1713.379791,3561,197.6137625,7122,-1676288,146944,-1529344,92
3542,295,21,9,0.0768829815,0.923117019,1088.990488,1299.984237,1932.618577,1755.484746,3837,388.7537994,7674,-1813504,151040,-1662464,92
3955,914,21,9,0.187718217,0.812281783,1304.590775,1467.274905,2226.012895,3339.315098,4869,100.2058037,9738,-2024960,467968,-1556992,92
2950,365,22,8,0.110105581,0.889894419,934.1703836,1107.858385,1635.635254,1838.756164,3315,71.24435848,6630,-1510400,186880,-1323520,92
2767,342,22,8,0.110003216,0.889996784,874.2600209,1054.44724,1535.969281,1708.97076,3109,64.23553719,6218,-1416704,175104,-1241600,92
2789,368,21,9,0.11656636,0.88343364,888.2626218,1057.558021,1558.631051,1733.372283,3157,61.86556927,6314,-1427968,188416,-1239552,92
3012,362,21,9,0.107291049,0.892708951,949.6224074,1139.930211,1665.010292,1874.624309,3374,73.33188437,6748,-1542144,185344,-1356800,92
2947,357,22,8,0.108050847,0.891949153,931.0105105,1112.386307,1633.839158,1806.543417,3304,68.56194231,6608,-1508864,182784,-1326080,92
2993,371,22,8,0.110285375,0.889714625,949.6731456,1114.189093,1661.037755,1855.644205,3364,73.95031875,6728,-1532416,189952,-1342464,92
3300,426,22,8,0.114331723,0.885668277,1047.050478,1232.543236,1823.712121,2171.715962,3726,79.70053476,7452,-1689600,218112,-1471488,92
4092,912,23,7,0.182254197,0.817745803,1346.53207,1494.172006,2292.918622,3442.858553,5004,102.122449,10008,-2095104,466944,-1628160,92
2998,367,21,9,0.109063893,0.890936107,946.4507301,1140.95028,1662.144096,1853.370572,3365,69.03980304,6730,-1534976,187904,-1347072,92
2699,340,21,9,0.111878908,0.888121092,855.2906076,1018.127961,1497.623935,1697.626471,3039,61.13458057,6078,-1381888,174080,-1207808,92
4069,912,21,9,0.183095764,0.816904236,1345.393502,1489.508607,2288.672893,3393.707237,4981,103.2331606,9962,-2083328,466944,-1616384,92
2648,343,21,9,0.114677365,0.885322635,844.6050359,980.108331,1473.83006,1667.154519,2991,61.39162562,5982,-1355776,175616,-1180160,92
2749,349,21,9,0.112653325,0.887346675,871.6027172,1034.452276,1523.951619,1750.739255,3098,66.3241276,6196,-1407488,178688,-1228800,92
2730,361,22,8,0.116790683,0.883209317,865.434187,1029.051504,1507.840293,1834.576177,3091,54.16155598,6182,-1397760,184832,-1212928,92
2727,343,22,8,0.111726384,0.888273616,867.0408465,996.4048354,1506.43711,1766.562682,3070,57.86993402,6140,-1396224,175616,-1220608,92
2795,350,22,8,0.111287758,0.888712242,885.8013229,1053.949806,1552.64186,1735.574286,3145,103.1824147,6290,-1431040,179200,-1251840,92
2977,365,21,9,0.109216038,0.890783962,939.9228882,1134.968119,1652.028216,1830.315068,3342,73.16112084,6684,-1524224,186880,-1337344,92
3119,370,22,8,0.106047578,0.893952422,985.2180727,1155.083758,1720.122796,1954.708108,3489,62.22578919,6978,-1596928,189440,-1407488,92
828,91,21,9,0.0990206746,0.900979325,254.9218088,324.8807556,472.307971,348.010989,919,14.704,1838,-423936,46592,-377344,92
2307,209,21,9,0.0830683625,0.916931638,716.905501,819.4877926,1265.064153,1186.043062,2516,168.9724647,5032,-1181184,107008,-1074176,92
2329,208,22,8,0.0819865983,0.918013402,724.6527076,809.0412117,1276.508373,1184.927885,2537,200.8709422,5074,-1192448,106496,-1085952,92
2308,208,21,9,0.0826709062,0.917329094,718.1389976,811.4294039,1258.79766,1255.197115,2516,142.1468927,5032,-1181696,106496,-1075200,92
2294,201,21,9,0.0805611222,0.919438878,712.0756724,806.0958673,1252.197036,1200.099502,2495,197.0774092,4990,-1174528,102912,-1071616,92
1799,167,20,10,0.0849440488,0.915055951,566.5152596,528.2389411,1004.423569,758.1017964,1966,49.91114496,3932,-921088,85504,-835584,92
2295,207,22,8,0.0827338129,0.917266187,712.4788574,817.5099838,1259.701525,1160.570048,2502,152.3751523,5004,-1175040,105984,-1069056,92
2081,188,21,9,0.0828558836,0.917144116,642.0420286,780.6974006,1141.495435,1063.101064,2269,144.9840256,4538,-1065472,96256,-969216,92
2310,216,22,8,0.0855106888,0.914489311,720.0953417,818.5694132,1268.129004,1213.99537,2526,165.4223969,5052,-1182720,110592,-1072128,92
2329,238,22,8,0.0927152318,0.907284768,727.7126464,860.5288854,1283.761271,1286.336134,2567,45.61933535,5134,-1192448,121856,-1070592,92
2036,176,21,9,0.0795660036,0.920433996,627.3877218,750.9973986,1113.539784,1025.0625,2212,153.0795848,4424,-1042432,90112,-952320,92
1403,71,22,8,0.0481682497,0.95183175,421.0886675,453.7559758,748.4376336,521.3661972,1474,167.3098751,2948,-718336,36352,-681984,92
2270,218,21,9,0.0876205788,0.912379421,713.9985484,741.1412153,1260.273128,1080.256881,2488,48.32006215,4976,-1162240,111616,-1050624,92
2325,235,21,9,0.091796875,0.908203125,728.7062894,825.7210675,1291.861935,1168.089362,2560,98.57527917,5120,-1190400,120320,-1070080,92
2065,192,22,8,0.0850686752,0.914931325,639.2811002,766.2540834,1136.725424,1045.911458,2257,183.9445803,4514,-1057280,98304,-958976,92
2313,208,21,9,0.0825069417,0.917493058,718.6747396,819.5158271,1266.437095,1200.538462,2521,163.5950681,5042,-1184256,106496,-1077760,92
2309,205,21,9,0.0815433572,0.918456643,716.8406271,816.2130305,1263.458207,1190.390244,2514,157.125,5028,-1182208,104960,-1077248,92
2392,209,22,8,0.0803537101,0.91964629,741.3694915,851.3242099,1303.402592,1273.502392,2601,171.9101124,5202,-1224704,107008,-1117696,92
2285,200,21,9,0.0804828974,0.919517103,708.0692013,813.529963,1248.333479,1182.065,2485,177.2467903,4970,-1169920,102400,-1067520,92
2016,173,22,8,0.0790315212,0.920968479,622.1437358,725.8179553,1105.15873,976.6184971,2189,143.6351706,4378,-1032192,88576,-943616,92
942,103,21,9,0.0985645933,0.901435407,298.760122,318.294252,530.7993631,451.6699029,1045,14.26815948,2090,-482304,52736,-429568,92
9521,444,21,9,0.0445559458,0.955444054,2865.20679,3026.479181,5016.003046,4275.292793,9965,1890.891841,19930,-4874752,227328,-4647424,92
9528,437,21,9,0.0438534872,0.956146513,2863.54645,3035.448035,5020.54492,4164.400458,9965,1113.407821,19930,-4878336,223744,-4654592,92
9519,447,21,9,0.0448524985,0.955147502,2866.496915,3002.808594,5017.122597,4267.496644,9966,389.296875,19932,-4873728,228864,-4644864,92
9509,455,23,7,0.0456643918,0.954335608,2858.083436,3092.71686,5026.814702,4056.371429,9964,1159.953434,19928,-4868608,232960,-4635648,92
9508,457,21,9,0.0458605118,0.954139488,2859.796946,3056.774397,5028.576041,4034.778993,9965,1355.782313,19930,-4868096,233984,-4634112,92
9528,435,21,9,0.0436615477,0.956338452,2860.705911,3068.208004,5021.645571,4113.625287,9963,789.4611727,19926,-4878336,222720,-4655616,92
9533,432,21,9,0.0433517311,0.956648269,2867.493716,2997.792236,5012.688975,4327.849537,9965,1060.106383,19930,-4880896,221184,-4659712,92
9522,443,21,9,0.0444555946,0.955544405,2861.493525,3060.332061,5023.127704,4120.480813,9965,887.3552983,19930,-4875264,226816,-4648448,92
9506,457,21,9,0.045869718,0.954130282,2860.552305,3067.847553,5021.619083,4157.888403,9963,1269.171975,19926,-4867072,233984,-4633088,92
9525,440,21,9,0.0441545409,0.955845459,2860.158986,3081.622474,5024.056483,4094.220455,9965,966.5373424,19930,-4876800,225280,-4651520,92
9502,463,21,9,0.0464626192,0.953537381,2858.193758,3102.947172,5026.053568,4099.425486,9965,1801.98915,19930,-4865024,237056,-4627968,92
9493,471,23,7,0.0472701726,0.952729827,2859.076877,3100.7953,5021.73275,4191.764331,9964,635.8647096,19928,-4860416,241152,-4619264,92
9502,460,21,9,0.0461754668,0.953824533,2859.38347,3095.556829,5019.036834,4206.119565,9962,1234.448575,19924,-4865024,235520,-4629504,92
9531,434,21,9,0.0435524335,0.956447566,2865.077641,3042.669172,5013.730039,4308.142857,9965,856.8357696,19930,-4879872,222208,-4657664,92
9536,431,21,9,0.0432427009,0.956757299,2860.845224,3071.427958,5026.502412,4043.62181,9967,823.7190083,19934,-4882432,220672,-4661760,92
9542,427,21,9,0.0428327816,0.957167218,2864.249437,3116.838191,5009.223014,4443.697892,9969,1281.362468,19938,-4885504,218624,-4666880,92
9524,442,23,7,0.0443507927,0.955649207,2862.29024,3066.791906,5020.98803,4175.726244,9966,1459.150805,19932,-4876288,226304,-4649984,92
9520,445,21,9,0.044656297,0.955343703,2859.756177,3074.819787,5026.187185,4059.085393,9965,1016.836735,19930,-4874240,227840,-4646400,92
9508,457,21,9,0.0458605118,0.954139488,2859.075203,3115.047109,5021.38883,4184.310722,9965,1742.132867,19930,-4868096,233984,-4634112,92
9555,418,21,9,0.0419131655,0.958086834,2863.191849,3060.816449,5029.586709,4013.516746,9973,1281.876607,19946,-4892160,214016,-4678144,92
8792,452,21,9,0.0488965816,0.951103418,2645.927614,3060.74632,4637.33121,4334.013274,9244,248.6282948,18488,-4501504,231424,-4270080,92
2535,169,21,9,0.0625,0.9375,771.0004372,773.7661172,1383.690335,884.6449704,2704,48.83510926,5408,-1297920,86528,-1211392,92
9278,552,23,7,0.0561546287,0.943845371,2802.847396,3369.027714,4919.1856,4853.552536,9830,173.0024639,19660,-4750336,282624,-4467712,92
8513,437,21,9,0.0488268156,0.951173184,2564.158193,2898.403331,4499.425584,4009.416476,8950,253.9007092,17900,-4358656,223744,-4134912,92
8784,461,21,9,0.0498647918,0.950135208,2645.446869,3027.915135,4651.89811,4072.368764,9245,272.2320377,18490,-4497408,236032,-4261376,92
43,26,23,7,0.376811594,0.623188406,14.1821573,21.73471714,27.48837209,47.42307692,69,1.526211015,138,-22016,13312,-8704,92
8808,451,21,9,0.0487093639,0.951290636,2651.751385,3023.202725,4652.201862,4196.399113,9259,246.5778961,18518,-4509696,230912,-4278784,92
9285,542,21,9,0.0551541671,0.944845833,2802.850112,3365.675582,4915.54378,4887.553506,9827,289.1995291,19654,-4753920,277504,-4476416,92
8516,429,23,7,0.0479597541,0.952040246,2565.745384,2834.822533,4500.497064,3927.160839,8945,268.2963407,17890,-4360192,219648,-4140544,92
791,84,21,9,0.096,0.904,247.1361549,229.9988696,457.3084703,256.1785714,875,19.45741606,1750,-404992,43008,-361984,92
8793,464,21,9,0.0501242303,0.94987577,2648.286588,3059.445204,4651.915728,4194.737069,9257,270.6725146,18514,-4502016,237568,-4264448,92
8325,417,21,9,0.047700755,0.952299245,2506.91608,2678.637529,4417.061622,3461.906475,8742,248.3522727,17484,-4262400,213504,-4048896,92
8474,450,21,9,0.050425818,0.949574182,2553.627388,2924.929071,4488.665447,3969.775556,8924,261.5474795,17848,-4338688,230400,-4108288,92
8783,459,21,9,0.0496645748,0.950335425,2644.696996,3042.556612,4645.56393,4161.034858,9242,276.2104005,18484,-4496896,235008,-4261888,92
8818,465,21,9,0.0500915652,0.949908435,2655.38701,3081.398288,4662.115559,4260.539785,9283,277.6847143,18566,-4514816,238080,-4276736,92
9273,553,22,8,0.0562792591,0.943720741,2796.726421,3435.152957,4917.475898,4846.830018,9826,290.7100592,19652,-4747776,283136,-4464640,92
8520,435,21,9,0.0485762144,0.951423786,2561.02749,2940.208034,4511.877465,3814.468966,8955,271.8579235,17910,-4362240,222720,-4139520,92
8790,472,21,9,0.0509609156,0.949039084,2648.64231,3057.69523,4659.366553,4112.544492,9262,262.1568072,18524,-4500480,241664,-4258816,92
8777,445,21,9,0.0482541748,0.951745825,2640.62385,2965.904556,4647.954768,3892.480899,9222,269.9648712,18444,-4493824,227840,-4265984,92
8294,394,21,9,0.0453499079,0.954650092,2485.210424,2795.873185,4387.78382,3433.34264,8688,123.8135956,17376,-4246528,201728,-4044800,92
2340,103,23,7,0.0421612771,0.957838723,698.8426298,816.6621199,1229.974786,1040.825243,2443,107.1021482,4886,-1198080,52736,-1145344,93
2332,98,23,7,0.0403292181,0.959670782,697.4832613,754.8241438,1225.18825,984.9591837,2430,84.25797503,4860,-1193984,50176,-1143808,93
2401,105,23,7,0.0418994413,0.958100559,719.9153917,754.1713247,1264.843399,994.1142857,2506,91.22679286,5012,-1229312,53760,-1175552,93
2353,99,23,7,0.0403752039,0.959624796,702.7399428,787.2308456,1235.897578,1003.141414,2452,113.1518228,4904,-1204736,50688,-1154048,93
2451,111,23,7,0.0433255269,0.956674473,733.4819154,796.4457249,1296.27091,955.3423423,2562,101.5457788,5124,-1254912,56832,-1198080,93
2523,102,23,7,0.0388571429,0.961142857,753.3129104,828.0470677,1322.314705,1082.598039,2625,108.2920792,5250,-1291776,52224,-1239552,93
2335,104,23,7,0.0426404264,0.957359574,697.1550316,809.6854669,1230.491221,984.4519231,2439,121.5852443,4878,-1195520,53248,-1142272,93
2338,107,23,7,0.0437627812,0.956237219,698.3106653,829.0019188,1232.065013,1024.925234,2445,112.2589532,4890,-1197056,54784,-1142272,93
2340,100,23,7,0.0409836066,0.959016393,699.6430464,761.7879295,1231.652991,959.52,2440,91.66040571,4880,-1198080,51200,-1146880,93
2371,104,23,7,0.042020202,0.957979798,708.2418076,815.9101807,1247.287642,1026.259615,2475,78.49666984,4950,-1213952,53248,-1160704,93
2355,98,23,7,0.0399510803,0.96004892,703.687257,789.5494263,1233.875584,1061.77551,2453,114.9484536,4906,-1205760,50176,-1155584,93
2363,104,23,7,0.0421564653,0.957843535,706.7016486,805.2256455,1242.035548,1051.423077,2467,127.8238342,4934,-1209856,53248,-1156608,93
2332,98,23,7,0.0403292181,0.959670782,696.7011696,771.0790059,1225.287736,982.5918367,2430,102.3157895,4860,-1193984,50176,-1143808,93
2334,96,23,7,0.0395061728,0.960493827,697.5787203,773.4534903,1222.069837,1055.770833,2430,109.2134831,4860,-1195008,49152,-1145856,93
2333,99,23,7,0.0407072368,0.959292763,696.127584,804.5681978,1224.910844,1018.292929,2432,107.1837814,4864,-1194496,50688,-1143808,93
2356,108,23,7,0.0438311688,0.956168831,705.7054375,770.3947937,1245.586163,947.0277778,2464,102.8810021,4928,-1206272,55296,-1150976,93
2339,107,23,7,0.0437448896,0.95625511,698.9836497,817.9966674,1233.302266,1009.224299,2446,101.7470882,4892,-1197568,54784,-1142784,93
2462,101,23,7,0.039406945,0.960593055,735.9853787,793.0028966,1291.722177,1045.009901,2563,97.97400612,5126,-1260544,51712,-1208832,93
2371,107,23,7,0.0431799839,0.956820016,710.0877452,774.3837086,1251.81569,966.5981308,2478,107.4588031,4956,-1213952,54784,-1159168,93
1888,85,23,7,0.0430816016,0.956918398,563.7274728,646.5600324,997.1456568,761.6470588,1973,29.63797506,3946,-966656,43520,-923136,93
1609,115,23,7,0.0667053364,0.933294664,488.5629296,485.6546381,888.1100062,504.1826087,1724,143.7864887,3448,-823808,58880,-764928,93
1609,116,23,7,0.0672463768,0.932753623,489.2056327,484.122323,888.4431324,510.0862069,1725,179.8748697,3450,-823808,59392,-764416,93
1341,113,23,7,0.0777166437,0.922283356,408.4525278,407.5649055,755.6428039,393.5221239,1454,103.7830121,2908,-686592,57856,-628736,93
1356,119,23,7,0.0806779661,0.919322034,414.4936255,409.1201256,767.4070796,402.907563,1475,116.9706582,2950,-694272,60928,-633344,93
1354,108,23,7,0.073871409,0.926128591,412.4117174,404.7855247,757.5339734,405.1111111,1462,117.5241158,2924,-693248,55296,-637952,93
1444,119,23,7,0.0761356366,0.923864363,438.7734312,446.0997335,811.5069252,423.9495798,1563,127.6960784,3126,-739328,60928,-678400,93
1349,103,23,7,0.0709366391,0.929063361,409.8039007,420.4060307,749.8295033,420.9514563,1452,113.7039937,2904,-690688,52736,-637952,93
1366,110,23,7,0.0745257453,0.925474255,417.8759255,400.9757583,763.8162518,424.1181818,1476,53.75091042,2952,-699392,56320,-643072,93
1333,103,23,7,0.0717270195,0.928272981,405.2546637,419.1906385,741.3983496,422.1553398,1436,140.6464251,2872,-682496,52736,-629760,93
1600,127,23,7,0.073537927,0.926462073,488.1024955,484.3557717,892.9625,499.1181102,1727,126.1504748,3454,-819200,65024,-754176,93
1351,109,23,7,0.0746575342,0.925342466,411.1288622,405.608171,757.3612139,397.5688073,1460,121.3632585,2920,-691712,55808,-635904,93
1361,108,23,7,0.073519401,0.926480599,414.2521193,407.61736,761.1631154,405.2962963,1469,63.75868056,2938,-696832,55296,-641536,93
1587,125,23,7,0.0730140187,0.926985981,484.2108927,478.650365,884.8109641,497.064,1712,174.3380855,3424,-812544,64000,-748544,93
1368,98,23,7,0.0668485675,0.933151432,414.3916152,428.4602534,755.2163743,430.3571429,1466,112.8560431,2932,-700416,50176,-650240,93
47,9,22,8,0.160714286,0.839285714,16.05011391,12.64130014,30.42553191,18.44444444,56,4.111600587,112,-24064,4608,-19456,93
1384,113,23,7,0.0754843019,0.924515698,421.7461556,426.6208943,775.4501445,425.0442478,1497,92.75092937,2994,-708608,57856,-650752,93
1361,108,23,7,0.073519401,0.926480599,413.6167138,419.671641,760.7876561,410.0277778,1469,126.9662921,2938,-696832,55296,-641536,93
1370,107,23,7,0.0724441435,0.927555856,416.3300687,445.9578048,761.7255474,448.0280374,1477,81.96448391,2954,-701440,54784,-646656,93
1359,100,23,7,0.068540096,0.931459904,412.9781401,414.158512,752.3230316,426.63,1459,140.0191939,2918,-695808,51200,-644608,93
367,74,23,7,0.167800454,0.832199546,119.843875,154.4034049,228.1525886,185.527027,441,6.601796407,882,-187904,37888,-150016,93
1499,117,23,7,0.0724009901,0.92759901,454.3243682,458.0605913,837.7531688,433.7094017,1616,145.5855856,3232,-767488,59904,-707584,93
1494,118,23,7,0.0732009926,0.926799007,454.3306029,454.4170179,834.7764391,448.4915254,1612,172.5910064,3224,-764928,60416,-704512,93
1708,127,23,7,0.0692098093,0.930790191,519.0336891,528.808026,945.9379391,542.2677165,1835,152.7893422,3670,-874496,65024,-809472,93
1492,115,23,7,0.0715619166,0.928438083,451.8411511,455.370524,832.8713137,429.426087,1607,135.0420168,3214,-763904,58880,-705024,93
1751,128,23,7,0.0681213411,0.931878659,530.8423824,551.4005786,968.2415762,553.6640625,1879,123.0517354,3758,-896512,65536,-830976,93
1517,113,23,7,0.0693251534,0.930674847,460.8188049,459.6358627,841.5781147,465.4070796,1630,154.7958215,3260,-776704,57856,-718848,93
1720,129,23,7,0.0697674419,0.930232558,521.2010054,565.2994117,952.2581395,561.5581395,1849,181.4524043,3698,-880640,66048,-814592,93
1548,128,23,7,0.076372315,0.923627685,473.3864954,460.361307,868.5426357,475.171875,1676,56.33613445,3352,-792576,65536,-727040,93
1497,110,23,7,0.0684505289,0.931549471,453.6539119,459.7276327,829.748163,453.5909091,1607,154.9662488,3214,-766464,56320,-710144,93
1720,126,23,7,0.068255688,0.931744312,523.476771,522.8926657,950.5523256,554.2142857,1846,140.7012195,3692,-880640,64512,-816128,93
1502,109,23,7,0.0676598386,0.932340161,455.3356201,487.1665143,828.4034621,497.2844037,1611,144.6140036,3222,-769024,55808,-713216,93
1471,91,23,7,0.0582586428,0.941741357,441.3138647,474.3820272,802.0074779,450,1562,119.4189602,3124,-753152,46592,-706560,93
1577,123,23,7,0.0723529412,0.927647059,478.2549936,487.8306038,880.3658846,467.5853659,1700,133.3333333,3400,-807424,62976,-744448,93
194,54,23,7,0.217741935,0.782258065,73.17383308,49.52205381,135.0876289,86.46296296,248,7.324276432,496,-99328,27648,-71680,93
1508,116,23,7,0.0714285714,0.928571429,458.0234939,457.0304874,840.3189655,450.8534483,1624,149.4020239,3248,-772096,59392,-712704,93
1496,114,23,7,0.0708074534,0.929192547,455.0069115,452.7171614,831.8683155,459.4736842,1610,164.6216769,3220,-765952,58368,-707584,93
1714,128,23,7,0.0694896851,0.930510315,520.3379607,512.3992241,952.1324387,511.3125,1842,171.1895911,3684,-877568,65536,-812032,93
1529,110,23,7,0.067114094,0.932885906,464.7546932,475.3749295,842.7482014,503.8,1639,107.7580539,3278,-782848,56320,-726528,93
1499,104,23,7,0.0648783531,0.935121647,453.4467375,459.0618769,825.8338893,458.4711538,1603,146.2591241,3206,-767488,53248,-714240,93
379,76,23,7,0.167032967,0.832967033,125.2542918,151.9222008,236.1187335,187.5131579,455,6.791044776,910,-194048,38912,-155136,93
1440,115,23,7,0.0739549839,0.926045016,437.4973136,449.1610515,805.3013889,436.1391304,1555,103.0483764,3110,-737280,58880,-678400,93
1455,122,23,7,0.0773620799,0.92263792,444.6103038,427.1838396,819.0103093,431.0901639,1577,155.2165354,3154,-744960,62464,-682496,93
1439,103,23,7,0.0667963684,0.933203632,434.8146034,461.1522443,794.6803336,447.6504854,1542,154.045954,3084,-736768,52736,-684032,93
1440,113,23,7,0.0727623954,0.927237605,436.4215899,447.385178,804.7527778,423.3362832,1553,139.1577061,3106,-737280,57856,-679424,93
1445,110,23,7,0.0707395498,0.92926045,438.0359008,430.5136971,805.7128028,413.9545455,1555,141.3636364,3110,-739840,56320,-683520,93
1439,110,23,7,0.0710135571,0.928986443,435.8956297,454.26442,800.9124392,436.0181818,1549,101.8408941,3098,-736768,56320,-680448,93
1471,127,23,7,0.0794743429,0.920525657,450.9985945,421.5466209,830.9313392,435.4409449,1598,75.3418199,3196,-753152,65024,-688128,93
1449,121,23,7,0.0770700637,0.922929936,441.5527895,435.3748108,815.6100759,424.9256198,1570,152.7237354,3140,-741888,61952,-679936,93
1440,103,23,7,0.0667530784,0.933246922,435.1855721,459.9318799,795.2215278,447.3495146,1543,143.5348837,3086,-737280,52736,-684544,93
1439,113,23,7,0.0728092784,0.927190722,437.0469944,426.3269137,805.0625434,412.7699115,1552,74.79518072,3104,-736768,57856,-678912,93
607,92,23,7,0.131616595,0.868383405,197.7019165,173.2302094,370.693575,213.4673913,699,91.015625,1398,-310784,47104,-263680,93
1458,117,23,7,0.0742857143,0.925714286,443.5066726,437.1922701,816.9355281,427.4188034,1575,155.3254438,3150,-746496,59904,-686592,93
1459,124,23,7,0.0783322805,0.92166772,445.2966223,429.2442063,823.4455106,422.0080645,1583,126.538769,3166,-747008,63488,-683520,93
1467,115,23,7,0.0726927939,0.927307206,446.3894275,436.8220157,819.3735515,435.9304348,1582,158.6760281,3164,-751104,58880,-692224,93
1435,109,23,7,0.0705958549,0.929404145,434.6020263,445.4384868,798.8041812,426.2018349,1544,155.6451613,3088,-734720,55808,-678912,93
1453,119,23,7,0.0756997455,0.924300254,442.8494424,442.4428552,814.8933242,439.8151261,1572,128.5363859,3144,-743936,60928,-683008,93
1464,118,23,7,0.0745891277,0.925410872,445.120811,448.5371643,820.1728142,435.7627119,1582,172.7074236,3164,-749568,60416,-689152,93
1457,107,23,7,0.0684143223,0.931585678,441.7534562,455.3296518,806.5284832,455.3084112,1564,158.6206897,3128,-745984,54784,-691200,93
1455,106,23,7,0.067905189,0.932094811,440.5028633,451.921524,805.6274914,442.9528302,1561,149.3779904,3122,-744960,54272,-690688,93
1451,112,23,7,0.0716570697,0.92834293,441.7491707,443.0005067,807.4011027,452.9196429,1563,127.6960784,3126,-742912,57344,-685568,93
1541,117,23,7,0.0705669481,0.929433052,468.3893743,458.1484396,857.5476963,460.0854701,1658,128.12983,3316,-788992,59904,-729088,93
1801,139,23,7,0.0716494845,0.928350515,548.3114249,538.9209453,1003.039978,548.8848921,1940,177.6556777,3880,-922112,71168,-850944,93
1527,115,23,7,0.0700365408,0.929963459,462.8204885,493.4236642,846.6935167,486.973913,1642,128.5826155,3284,-781824,58880,-722944,93
1543,110,23,7,0.0665456745,0.933454325,467.8116374,471.6897801,851.7757615,479.4636364,1653,152.4907749,3306,-790016,56320,-733696,93
1805,130,23,7,0.0671834625,0.932816537,548.002673,531.0815447,998.5263158,544.1538462,1935,147.0364742,3870,-924160,66560,-857600,93
1810,138,22,8,0.0708418891,0.929158111,551.4517137,551.3073428,1004.920442,575.5072464,1948,58.46338535,3896,-926720,70656,-856064,93
1552,109,23,7,0.0656231186,0.934376881,470.2194259,489.0135196,854.1346649,501.5963303,1661,165.438247,3322,-794624,55808,-738816,93
1798,130,23,7,0.0674273859,0.932572614,546.6262128,558.8155202,991.4649611,591.5538462,1928,123.9871383,3856,-920576,66560,-854016,93
1556,120,23,7,0.0715990453,0.928400955,472.6203546,480.2719192,866.5321337,475.0166667,1676,130.1242236,3352,-796672,61440,-735232,93
1558,107,23,7,0.0642642643,0.935735736,471.6916786,478.1848542,856.6283697,488.953271,1665,146.5669014,3330,-797696,54784,-742912,93
1519,115,23,7,0.070379437,0.929620563,462.087331,455.8903546,844.1369322,465.6608696,1634,38.15082886,3268,-777728,58880,-718848,93
1806,128,23,7,0.0661840745,0.933815926,547.6567598,567.6896567,994.5049834,586.4765625,1934,152.2834646,3868,-924672,65536,-859136,93
1525,110,23,7,0.0672782875,0.932721713,462.0722075,495.0914613,840.6806557,503.5636364,1635,132.174616,3270,-780800,56320,-724480,93
1543,109,23,7,0.0659806295,0.93401937,467.5104054,493.1530388,849.1056384,506.4954128,1652,54.0929928,3304,-790016,55808,-734208,93
1527,123,23,7,0.0745454545,0.925454545,464.0825167,465.5319551,855.805501,449.2682927,1650,162.5615764,3300,-781824,62976,-718848,93
1525,115,23,7,0.0701219512,0.929878049,462.2389243,463.2980802,848.5042623,449.1391304,1640,104.3256997,3280,-780800,58880,-721920,93
1536,117,23,7,0.0707803993,0.929219601,465.1558826,464.2915257,856.4518229,440.3504274,1653,99.39867709,3306,-786432,59904,-726528,93
1530,122,23,7,0.0738498789,0.926150121,464.9695984,489.6931234,854.0019608,481.5983607,1652,108.4701248,3304,-783360,62464,-720896,93
1565,117,23,7,0.0695600476,0.930439952,474.9273625,481.2085828,868.5488818,479.6923077,1682,140.2835696,3364,-801280,59904,-741376,93
1527,122,23,7,0.0739842329,0.926015767,463.9196792,466.073265,854.9541585,450.0819672,1649,168.0937819,3298,-781824,62464,-719360,93
1790,125,23,7,0.0652741514,0.934725849,540.5421079,564.606744,986.5597765,549.024,1915,148.6801242,3830,-916480,64000,-852480,93
1803,125,23,7,0.0648340249,0.935165975,546.4112932,567.8602377,990.3660566,591.408,1928,91.41773352,3856,-923136,64000,-859136,93
1782,128,23,7,0.0670157068,0.932984293,538.1149059,578.3646562,984.1520763,556.609375,1910,136.4285714,3820,-912384,65536,-846848,93
2087,150,23,7,0.0670540903,0.93294591,634.4613084,619.6082822,1152.615237,651.3,2237,55.70219124,4474,-1068544,76800,-991744,93
1803,128,23,7,0.066286898,0.933713102,546.0673296,546.904238,995.765391,546.7265625,1931,148.7673344,3862,-923136,65536,-857600,93
1837,129,23,7,0.0656154629,0.934384537,554.4219395,622.3824576,1009.280893,616.372093,1966,186.5275142,3932,-940544,66048,-874496,93
1768,125,23,7,0.0660327522,0.933967248,534.8248845,550.2599884,975.4858597,544.096,1893,133.4978843,3786,-905216,64000,-841216,93
1773,113,23,7,0.0599151644,0.940084836,534.0458127,566.3419727,967.5589397,566.0088496,1886,156.9051581,3772,-907776,57856,-849920,93
1774,120,23,7,0.0633579725,0.936642027,534.9352814,558.3403283,974.9746336,541.3333333,1894,116.196319,3788,-908288,61440,-846848,93
2076,143,23,7,0.064443443,0.935556557,627.3097851,673.9444494,1139.811175,677.2167832,2219,150.0338066,4438,-1062912,73216,-989696,93
1787,129,23,7,0.0673277662,0.932672234,540.9332842,542.4813252,989.3682149,530.8914729,1916,122.428115,3832,-914944,66048,-848896,93
1787,127,23,7,0.066353187,0.933646813,539.6789955,565.3671712,986.8802462,544.0944882,1914,143.9097744,3828,-914944,65024,-849920,93
1775,131,23,7,0.0687303253,0.931269675,537.4730844,547.8997843,984.5712676,532.4961832,1906,124.5751634,3812,-908800,67072,-841728,93
1790,124,23,7,0.0647857889,0.935214211,542.1586193,556.6841186,984.2284916,571.6612903,1914,103.0694669,3828,-916480,63488,-852992,93
2075,140,23,7,0.0632054176,0.936794582,628.338292,650.1464583,1136.78506,681.3642857,2215,137.9202989,4430,-1062400,71680,-990720,93
2095,135,23,7,0.0605381166,0.939461883,633.7292277,655.3865877,1142.251074,700.362963,2230,117.6160338,4460,-1072640,69120,-1003520,93
1774,119,23,7,0.0628631801,0.93713682,536.1654862,564.2843313,971.8449831,576.6218487,1893,124.0498034,3786,-908288,60928,-847360,93
1810,130,23,7,0.0670103093,0.932989691,547.4421284,588.7000615,998.3502762,582.7384615,1940,148.8871834,3880,-926720,66560,-860160,93
1774,115,23,7,0.0608787718,0.939121228,534.5120926,576.0104523,968.9537768,575.4869565,1889,150.8785942,3778,-908288,58880,-849408,93
1795,122,23,7,0.0636411059,0.936358894,541.6243002,571.8332171,986.021727,561.4262295,1917,148.489543,3834,-919040,62464,-856576,93
2259,148,23,7,0.0614873286,0.938512671,690.705343,656.8038033,1227.652501,842.9797297,2407,120.35,4814,-1156608,75776,-1080832,93
2010,131,23,7,0.0611863615,0.938813638,604.7400667,709.7882757,1093.590547,724.3816794,2141,64.7806354,4282,-1029120,67072,-962048,93
2236,150,23,7,0.0628667225,0.937133277,685.1570734,639.6672977,1217.748211,832.04,2386,94.4950495,4772,-1144832,76800,-1068032,93
1986,133,23,7,0.0627654554,0.937234545,597.7638668,685.5949651,1085.596677,677.7819549,2119,105.8970515,4238,-1016832,68096,-948736,93
2009,125,23,7,0.0585754452,0.941424555,613.2894182,570.2580163,1087.385764,747.896,2134,79.56748695,4268,-1028608,64000,-964608,93
2222,146,23,7,0.0616554054,0.938344595,679.3158911,651.1716615,1207.60396,832.8767123,2368,121.001533,4736,-1137664,74752,-1062912,93
391,74,23,7,0.159139785,0.840860215,130.5794215,141.0823192,223.140665,285.0945946,465,27.38515901,930,-200192,37888,-162304,93
2230,147,23,7,0.0618426588,0.938157341,681.9341643,632.304058,1214.473094,802.5714286,2377,129.5367847,4754,-1141760,75264,-1066496,93
2254,139,23,7,0.0580860844,0.941913916,687.2026943,668.659251,1216.892635,874.4244604,2393,110.9925788,4786,-1154048,71168,-1082880,93
2004,139,22,8,0.0648623425,0.935137657,602.9428823,719.74706,1097.182635,708.9352518,2143,47.06786734,4286,-1026048,71168,-954880,93
2231,139,23,7,0.058649789,0.941350211,677.1952376,678.790916,1209.641865,798.0143885,2370,119.4556452,4740,-1142272,71168,-1071104,93
1988,126,23,7,0.059602649,0.940397351,601.090881,629.7184255,1081.391348,680.547619,2114,103.4246575,4228,-1017856,64512,-953344,93
2026,133,23,7,0.0616025938,0.938397406,619.1260973,590.2175232,1101.855874,747.0676692,2159,74.75761773,4318,-1037312,68096,-969216,93
1988,128,23,7,0.0604914934,0.939508507,607.2284907,572.7072581,1079.514588,732.1171875,2116,108.5684967,4232,-1017856,65536,-952320,93
1969,131,23,7,0.0623809524,0.937619048,601.102039,600.8671019,1070.799898,745.3816794,2100,112.4799143,4200,-1008128,67072,-941056,93
1990,126,23,7,0.0595463138,0.940453686,607.6661021,572.5300704,1078.523618,742.2539683,2116,112.3142251,4232,-1018880,64512,-954368,93
1969,132,23,7,0.0628272251,0.937172775,602.8108849,570.1784148,1072.466734,730.7878788,2101,115.885273,4202,-1008128,67584,-940544,93
623,83,23,7,0.117563739,0.882436261,200.1637292,229.2906206,353.3515249,354.6144578,706,9.375830013,1412,-318976,42496,-276480,93
621,87,23,7,0.122881356,0.877118644,202.224484,218.7638013,352.7616747,366.908046,708,8.372753075,1416,-317952,44544,-273408,93
1986,125,23,7,0.0592136428,0.940786357,606.2454347,569.6999266,1076.025176,737.84,2111,94.62124608,4222,-1016832,64000,-952832,93
783,54,23,7,0.064516129,0.935483871,237.5764039,276.3681567,425.7049808,321.7777778,837,39.70588235,1674,-400896,27648,-373248,93
776,50,23,7,0.0605326877,0.939467312,235.6642732,258.4564056,419.9059278,314.08,826,34.27385892,1652,-397312,25600,-371712,93
844,57,23,7,0.0632630411,0.936736959,256.9936088,293.1651904,455.8293839,379.4912281,901,32.23613596,1802,-432128,29184,-402944,93
812,53,23,7,0.0612716763,0.938728324,246.2337432,289.5960507,437.4051724,365.509434,865,37.59235115,1730,-415744,27136,-388608,93
802,50,23,7,0.058685446,0.941314554,243.0822545,264.9112765,433.3478803,316.66,852,34.39644732,1704,-410624,25600,-385024,93
774,50,23,7,0.0606796117,0.939320388,234.8877291,255.996875,419.5994832,302.6,824,34.7972973,1648,-396288,25600,-370688,93
829,54,23,7,0.0611551529,0.938844847,250.7868905,303.3784776,446.4028951,374.4074074,883,39.3143366,1766,-424448,27648,-396800,93
824,55,23,7,0.0625711035,0.937428896,250.4839515,278.0056685,447.0012136,335.1090909,879,35.64476886,1758,-421888,28160,-393728,93
778,52,23,7,0.0626506024,0.937349398,236.3542268,264.7701268,422.1053985,316.6730769,830,34.26919901,1660,-398336,26624,-371712,93
834,53,23,7,0.0597519729,0.940248027,253.5325674,276.0525551,450.0323741,349.0754717,887,40.0994575,1774,-427008,27136,-399872,93
820,55,23,7,0.0628571429,0.937142857,249.2140412,276.110542,445.3536585,328.3636364,875,39.55696203,1750,-419840,28160,-391680,93
772,48,23,7,0.0585365854,0.941463415,233.2298554,258.2303558,418.0544041,289,820,36.85393258,1640,-395264,24576,-370688,93
775,51,23,7,0.0617433414,0.938256659,234.6121369,254.4894989,422.4348387,277.7254902,826,35.26900085,1652,-396800,26112,-370688,93
787,50,23,7,0.0597371565,0.940262843,238.2678817,281.5188122,423.111817,354.28,837,38.60701107,1674,-402944,25600,-377344,93
773,47,23,7,0.0573170732,0.942682927,233.8455949,249.7732516,417.9301423,288.2978723,820,35.16295026,1640,-395776,24064,-371712,93
799,53,23,7,0.0622065728,0.937793427,242.719182,268.8633724,433.5406758,320.3584906,852,37.6824414,1704,-409088,27136,-381952,93
821,53,23,7,0.0606407323,0.939359268,249.5802108,277.3506968,443.0584653,351.3962264,874,34.53180561,1748,-420352,27136,-393216,93
775,50,23,7,0.0606060606,0.939393939,234.5655207,267.9890117,419.6219355,310.36,825,38.91509434,1650,-396800,25600,-371200,93
815,55,23,7,0.0632183908,0.936781609,248.1799668,271.7688456,442.403681,333.2,870,36.92699491,1740,-417280,28160,-389120,93
442,39,23,7,0.0810810811,0.918918919,136.1706623,153.9953294,246.2986425,180.9487179,481,7.303370787,962,-226304,19968,-206336,93
2085,141,23,7,0.0633423181,0.936657682,632.1331521,653.4901131,1141.497842,699.4893617,2226,111.1888112,4452,-1067520,72192,-995328,93
1770,117,23,7,0.0620031797,0.93799682,533.2178586,575.189156,969.0920904,564.4017094,1887,172.0145852,3774,-906240,59904,-846336,93
1829,128,23,7,0.065406234,0.934593766,552.8255815,573.4212403,1008.004374,564.5546875,1957,180.7017544,3914,-936448,65536,-870912,93
1788,133,23,7,0.0692347736,0.930765226,541.6452038,568.9364857,990.9289709,558.6466165,1921,74.65993004,3842,-915456,68096,-847360,93
1773,128,23,7,0.0673329826,0.932667017,534.9769277,565.6837331,981.248731,532.0078125,1901,166.0262009,3802,-907776,65536,-842240,93
1793,126,23,7,0.0656591975,0.934340803,541.6867813,584.5513319,986.8851088,577.4206349,1919,118.3837138,3838,-918016,64512,-853504,93
1777,126,23,7,0.0662112454,0.933788755,537.1546379,553.90756,981.2166573,539.952381,1903,148.3242401,3806,-909824,64512,-845312,93
2076,131,23,7,0.0593565927,0.940643407,626.9482438,633.223666,1131.939306,661.2366412,2207,163.7240356,4414,-1062912,67072,-995840,93
1770,123,23,7,0.0649762282,0.935023772,534.7067272,565.2307366,974.0480226,557.7723577,1893,170.6943192,3786,-906240,62976,-843264,93
1779,122,23,7,0.0641767491,0.935823251,536.4984013,573.0075272,978.1135469,555.6311475,1901,177.3320896,3802,-910848,62464,-848384,93
1787,127,23,7,0.066353187,0.933646813,540.2557953,549.3875473,987.5976497,534,1914,161.3827993,3828,-914944,65024,-849920,93
1778,128,23,7,0.0671563484,0.932843652,538.4472327,546.826509,983.136108,541.8359375,1906,49.89528796,3812,-910336,65536,-844800,93
2075,135,23,7,0.0610859729,0.938914027,625.93121,672.1253164,1132.919036,684.0592593,2210,194.7136564,4420,-1062400,69120,-993280,93
1797,119,23,7,0.0621085595,0.937891441,543.9764047,566.9390933,982.1224263,601.7815126,1916,94.89846459,3832,-920064,60928,-859136,93
1791,131,23,7,0.0681581686,0.931841831,541.6763833,599.8364675,988.4120603,593.5648855,1922,114.8834429,3844,-916992,67072,-849920,93
1779,120,23,7,0.0631911532,0.936808847,536.8759621,551.4158874,977.5851602,541.05,1899,136.815562,3798,-910848,61440,-849408,93
1767,122,23,7,0.0645844362,0.935415564,533.6446047,582.9569587,969.9654782,583.4098361,1889,33.1345378,3778,-904704,62464,-842240,93
2092,131,23,7,0.0589293747,0.941070625,631.213351,672.2210244,1137.310707,707.8015267,2223,127.3925501,4446,-1071104,67072,-1004032,93
1766,114,23,7,0.0606382979,0.939361702,532.3757974,568.5953139,964.1862967,573.5701754,1880,177.5259679,3760,-904192,58368,-845824,93
386,80,23,7,0.17167382,0.82832618,127.2655369,157.6909081,242.7331606,188.95,466,6.731185902,932,-197632,40960,-156672,93
1505,117,23,7,0.0721331689,0.927866831,456.8218651,463.2963964,839.5548173,450.6239316,1622,74.54044118,3244,-770560,59904,-710656,93
39,11,24,6,0.22,0.78,13.94584246,15.91921756,25.97435897,23.81818182,50,2.030044661,100,-19968,5632,-14336,93
1723,136,23,7,0.0731576116,0.926842388,525.8602853,503.792554,962.1845618,522.25,1859,43.61801971,3718,-882176,69632,-812544,93
1705,130,22,8,0.0708446866,0.929155313,518.9947724,513.8335575,947.7706745,527.5461538,1835,136.3298663,3670,-872960,66560,-806400,93
1499,112,23,7,0.069522036,0.930477964,453.5337308,480.9908399,831.6417612,462.8125,1611,169.9367089,3222,-767488,57344,-710144,93
1689,128,23,7,0.0704457898,0.92955421,513.8392178,499.0402231,939.3433985,508.609375,1817,174.0421456,3634,-864768,65536,-799232,93
1485,116,23,7,0.0724547158,0.927545284,450.3055154,472.8894019,827.9737374,455.6896552,1601,28.11731647,3202,-760320,59392,-700928,93
1493,114,23,7,0.0709396391,0.929060361,452.5522834,483.7403118,829.2183523,473.7280702,1607,159.9004975,3214,-764416,58368,-706048,93
1491,116,23,7,0.0721841942,0.927815806,453.3987507,434.9713943,833.0073776,431.1551724,1607,130.8631922,3214,-763392,59392,-704000,93
1494,112,23,7,0.0697384807,0.930261519,452.9136168,476.4707968,828.4123159,471.1875,1606,127.4603175,3212,-764928,57344,-707584,93
1485,117,22,8,0.0730337079,0.926966292,450.8551272,490.8487456,826.362963,485.9316239,1602,120.6325301,3204,-760320,59904,-700416,93
1548,123,23,7,0.0736086176,0.926391382,471.8439455,475.3038905,863.9173127,484.6504065,1671,95.21367521,3342,-792576,62976,-729600,93
1544,113,23,7,0.0681955341,0.931804466,468.2948594,474.83692,854.7830311,476.7079646,1657,124.4928625,3314,-790528,57856,-732672,93
1495,114,23,7,0.0708514605,0.929148539,453.4543783,461.6229264,832.0414716,450.377193,1609,152.9467681,3218,-765440,58368,-707072,93
1704,126,23,7,0.068852459,0.931147541,517.7949796,522.1104916,943.5680751,535.9126984,1830,149.0228013,3660,-872448,64512,-807936,93
1707,126,23,7,0.0687397709,0.931260229,518.5194404,505.3428406,946.8306971,512.8650794,1833,166.7879891,3666,-873984,64512,-809472,93
1527,116,23,7,0.0706025563,0.929397444,463.3131362,468.1019155,849.5343811,459.5431034,1643,139.1193903,3286,-781824,59392,-722432,93
1485,118,23,7,0.0736119775,0.926388022,451.8745774,445.8220906,830.6686869,441.2118644,1603,123.6882716,3206,-760320,60416,-699904,93
1524,112,23,7,0.0684596577,0.931540342,461.4678842,499.6805574,842.0931759,497.4642857,1636,28.8485276,3272,-780288,57344,-722944,93
377,73,23,7,0.162222222,0.837777778,121.7930273,162.5121316,231.1246684,196.4520548,450,6.729475101,900,-193024,37376,-155648,93
9390,560,23,7,0.056281407,0.943718593,2867.504091,2862.910736,5017.166028,4276.85,9950,481.3739719,19900,-4807680,286720,-4520960,94
9391,559,22,8,0.0561809045,0.943819095,2864.778343,2955.516824,5003.934405,4497.812165,9950,300.7859734,19900,-4808192,286208,-4521984,94
9312,624,22,8,0.0628019324,0.937198068,2864.656091,2875.424968,5002.123711,4466.730769,9936,692.8870293,19872,-4767744,319488,-4448256,94
3559,306,22,8,0.0791720569,0.920827943,1111.418088,1164.146096,1930.034279,1967.493464,3865,67.17066389,7730,-1822208,156672,-1665536,94
9415,539,23,7,0.0541490858,0.945850914,2867.18286,2895.542727,5017.001487,4287.506494,9954,1281.081081,19908,-4820480,275968,-4544512,94
9433,523,23,7,0.052531137,0.947468863,2870.019148,2844.829942,5019.765716,4234.217973,9956,949.0943756,19912,-4829696,267776,-4561920,94
9418,534,21,9,0.0536575563,0.946342444,2866.509079,2923.451148,5009.288065,4398.226592,9952,521.3200629,19904,-4822016,273408,-4548608,94
9441,514,22,8,0.0516323456,0.948367654,2861.827078,3057.75432,4999.593158,4581.383268,9955,621.7988757,19910,-4833792,263168,-4570624,94
9418,533,22,8,0.053562456,0.946437544,2868.758664,2855.321187,5014.514122,4295.463415,9951,539.9348888,19902,-4822016,272896,-4549120,94
9356,593,23,7,0.0596039803,0.94039602,2854.916466,3119.158655,4990.744335,4726.595278,9949,593.9701493,19898,-4790272,303616,-4486656,94
9359,591,22,8,0.0593969849,0.940603015,2855.411221,3118.440759,4990.376322,4739.920474,9950,956.7307692,19900,-4791808,302592,-4489216,94
9396,555,21,9,0.0557732891,0.944226711,2862.158465,3012.224635,5001.197424,4549.414414,9951,771.9937936,19902,-4810752,284160,-4526592,94
9403,553,23,7,0.0555443953,0.944455605,2867.41027,2900.671836,5018.688716,4295.146474,9956,762.3277182,19912,-4814336,283136,-4531200,94
9427,528,22,8,0.053038674,0.946961326,2868.117735,2876.436282,5018.901029,4247.746212,9955,646.848603,19910,-4826624,270336,-4556288,94
7017,388,22,8,0.052397029,0.947602971,2136.605113,2062.651353,3736.825709,3091.260309,7405,201.3870003,14810,-3592704,198656,-3394048,94
9389,561,22,8,0.0563819095,0.94361809,2849.448981,3230.180644,4970.985302,5051.058824,9950,566.6287016,19900,-4807168,287232,-4519936,94
9362,581,22,8,0.0584330685,0.941566932,2862.685808,2943.977927,5003.561739,4463.42685,9943,725.2370532,19886,-4793344,297472,-4495872,94
9452,506,22,8,0.0508134163,0.949186584,2858.207643,3130.481148,5004.068028,4520.573123,9958,582.6799298,19916,-4839424,259072,-4580352,94
9311,621,22,8,0.0625251712,0.937474829,2839.958628,3246.362784,4971.426055,4892.640902,9932,544.816237,19864,-4767232,317952,-4449280,94
7301,404,23,7,0.0524334848,0.947566515,2219.301096,2183.558945,3893.883304,3114.165842,7705,189.8718581,15410,-3738112,206848,-3531264,94
7572,409,22,8,0.0512467109,0.948753289,2298.523664,2305.292505,4026.416535,3335.317848,7981,207.4603587,15962,-3876864,209408,-3667456,94
8454,466,23,7,0.0522421525,0.947757848,2563.851583,2661.860163,4501.463449,3717.356223,8920,242.91939,17840,-4328448,238592,-4089856,94
8130,464,23,7,0.0539911566,0.946008843,2474.235515,2505.530156,4334.878967,3642.5625,8594,223.6855804,17188,-4162560,237568,-3924992,94
7579,439,23,7,0.0547518084,0.945248192,2308.507634,2318.75007,4047.975854,3345.243736,8018,206.012333,16036,-3880448,224768,-3655680,94
8431,450,23,7,0.0506699696,0.94933003,2557.805536,2559.78137,4480.880797,3693.811111,8881,241.5284199,17762,-4316672,230400,-4086272,94
8309,442,23,7,0.0505085133,0.949491487,2517.997595,2548.048583,4418.31833,3580.472851,8751,185.0496934,17502,-4254208,226304,-4027904,94
8695,445,23,7,0.0486870897,0.95131291,2630.992895,2697.950886,4604.159517,3912.81573,9140,249.931638,18280,-4451840,227840,-4224000,94
9388,566,23,7,0.0568615632,0.943138437,2865.03616,2970.514702,5005.934917,4505.862191,9954,185.1906977,19908,-4806656,289792,-4516864,94
7739,476,22,8,0.0579427876,0.942057212,2365.195639,2336.540396,4156.03127,3327.088235,8215,188.0292973,16430,-3962368,243712,-3718656,94
4983,373,22,8,0.0696415235,0.930358476,1552.604957,1389.679568,2710.127634,2255.978552,5356,96.94117647,10712,-2551296,190976,-2360320,94
8190,451,23,7,0.0521930332,0.947806967,2487.639317,2522.316789,4357.972039,3649.600887,8641,221.7346677,17282,-4193280,230912,-3962368,94
9283,653,23,7,0.0657206119,0.934279388,2868.230872,2848.27797,4991.857374,4636.453292,9936,489.4581281,19872,-4752896,334336,-4418560,94
8523,472,22,8,0.0524735964,0.947526404,2588.598714,2670.982975,4530.370761,3913.474576,8995,234.4279385,17990,-4363776,241664,-4122112,94
8215,431,23,7,0.0498496415,0.950150359,2489.598559,2532.618114,4356.352648,3697.317865,8646,239.2363033,17292,-4206080,220672,-3985408,94
2159,173,22,8,0.0741852487,0.925814751,659.899226,806.4048634,1154.551644,1315.612717,2332,348.5799701,4664,-1105408,88576,-1016832,94
9458,505,23,7,0.0506875439,0.949312456,2865.800681,2945.423472,5025.54557,4166.447525,9963,795.131684,19926,-4842496,258560,-4583936,94
8429,427,22,8,0.0482158988,0.951784101,2547.716825,2645.233171,4460.686796,3793.131148,8856,226.0913965,17712,-4315648,218624,-4097024,94
9466,501,23,7,0.0502658774,0.949734123,2860.271211,3113.812581,5017.446229,4352.05988,9967,512.4421594,19934,-4846592,256512,-4590080,94
9427,533,22,8,0.0535140562,0.946485944,2868.097051,2901.872492,5021.95184,4247.354597,9960,597.4805039,19920,-4826624,272896,-4553728,94
7848,447,22,8,0.0538878843,0.946112116,2391.276275,2278.062202,4198.176733,3267.044743,8295,211.2299465,16590,-4018176,228864,-3789312,94
9517,449,23,7,0.0450531808,0.954946819,2872.292232,2952.118147,4999.975202,4634.291759,9966,1299.34811,19932,-4872704,229888,-4642816,94
9382,567,22,8,0.0569906523,0.943009348,2872.92273,2848.47469,4988.093264,4758.349206,9949,491.0661402,19898,-4803584,290304,-4513280,94
9460,502,22,8,0.0503914877,0.949608512,2875.175484,2830.395825,5010.965222,4426.239044,9962,221.9202495,19924,-4843520,257024,-4586496,94
9457,505,23,7,0.050692632,0.949307368,2869.631239,2977.171691,4995.098446,4726.845545,9962,191.7982287,19924,-4841984,258560,-4583424,94
9502,464,23,7,0.0465582982,0.953441702,2877.174745,2862.640493,4994.57651,4756.670259,9966,792.2098569,19932,-4865024,237568,-4627456,94
9498,466,23,7,0.0467683661,0.953231634,2876.902401,2840.659872,5000.447252,4616.699571,9964,829.641965,19928,-4862976,238592,-4624384,94
9538,434,23,7,0.0435218612,0.956478139,2873.197248,2977.136344,5001.59069,4654.852535,9972,963.4782609,19944,-4883456,222208,-4661248,94
9553,420,23,7,0.042113707,0.957886293,2882.253675,2797.167097,4994.729404,4811.192857,9973,1133.295455,19946,-4891136,215040,-4676096,94
9536,437,22,8,0.0438183094,0.956181691,2878.500983,2873.527437,5000.333788,4696.036613,9973,1129.445074,19946,-4882432,223744,-4658688,94
9500,466,23,7,0.0467589805,0.953241019,2875.380713,2885.775104,5000.866737,4629.457082,9966,938.4180791,19932,-4864000,238592,-4625408,94
9507,458,22,8,0.045960863,0.954039137,2874.47277,2902.980247,4998.424424,4662.825328,9965,1131.101022,19930,-4867584,234496,-4633088,94
9495,473,22,8,0.0474518459,0.952548154,2877.689734,2851.939463,5001.771353,4637.794926,9968,499.6491228,19936,-4861440,242176,-4619264,94
9527,439,23,7,0.0440497692,0.955950231,2872.834743,2947.336456,4997.872573,4671.592255,9966,421.5736041,19932,-4877824,224768,-4653056,94
9522,445,23,7,0.0446473362,0.955352664,2877.799538,2860.955034,4990.869355,4837.011236,9967,995.7042957,19934,-4875264,227840,-4647424,94
9556,422,23,7,0.0422930447,0.957706955,2879.769693,2835.087715,5014.746233,4417.810427,9978,805.9773829,19956,-4892672,216064,-4676608,94
9525,443,23,7,0.0444422151,0.955557785,2873.931521,2934.423434,4999.730709,4657.022573,9968,1253.836478,19936,-4876800,226816,-4649984,94
9510,459,23,7,0.0460427325,0.953957268,2878.228824,2862.27771,4994.22061,4793.958606,9969,1006.969697,19938,-4869120,235008,-4634112,94
9475,487,23,7,0.0488857659,0.951114234,2873.460392,2902.598169,4997.719156,4665.942505,9962,521.2977499,19924,-4851200,249344,-4601856,94
9517,452,23,7,0.0453405557,0.954659444,2878.028783,2857.487467,4998.849848,4693.387168,9969,1352.645862,19938,-4872704,231424,-4641280,94
9532,441,23,7,0.0442193924,0.955780608,2872.762961,3000.340773,4997.742551,4754.804989,9973,1084.021739,19946,-4880384,225792,-4654592,94
7669,403,23,7,0.049925669,0.950074331,2321.266044,2429.393825,4065.354153,3487.411911,8072,220.2455662,16144,-3926528,206336,-3720192,94
8307,443,23,7,0.0506285714,0.949371429,2514.822427,2642.553445,4410.1583,3725.598194,8750,222.9299363,17500,-4253184,226816,-4026368,94
8261,451,23,7,0.0517676768,0.948232323,2508.719896,2527.736319,4394.376589,3662.711752,8712,239.3406593,17424,-4229632,230912,-3998720,94
7949,417,23,7,0.0498446091,0.950155391,2406.187961,2506.387872,4214.416405,3594.160671,8366,210.7304786,16732,-4069888,213504,-3856384,94
7390,406,23,7,0.0520779887,0.947922011,2247.075615,2230.075578,3931.160487,3304.014778,7796,208.3934777,15592,-3783680,207872,-3575808,94
8213,438,23,7,0.050629985,0.949370015,2489.009472,2566.432708,4359.99099,3688.630137,8651,222.3335903,17302,-4205056,224256,-3980800,94
8482,448,23,7,0.0501679731,0.949832027,2571.140826,2555.468837,4510.695826,3609.805804,8930,327.8267254,17860,-4342784,229376,-4113408,94
7031,414,23,7,0.0556077905,0.94439221,2144.071809,2105.816663,3765.723226,2997.427536,7445,134.9220732,14890,-3599872,211968,-3387904,94
9278,653,23,7,0.0657537005,0.934246299,2864.332794,2875.551469,4992.653266,4587.303216,9931,541.7894163,19862,-4750336,334336,-4416000,94
8284,436,22,8,0.05,0.95,2509.127457,2561.059782,4398.646065,3635.724771,8720,235.6756757,17440,-4241408,223232,-4018176,94
8359,448,22,8,0.0508686272,0.949131373,2534.199254,2609.851047,4438.057543,3768.537946,8807,241.7513039,17614,-4279808,229376,-4050432,94
8314,484,22,8,0.0550125028,0.944987497,2530.876328,2598.394296,4438.414963,3731.030992,8798,209.1276444,17596,-4256768,247808,-4008960,94
8302,442,23,7,0.0505489478,0.949451052,2517.244376,2534.824834,4412.765237,3616.205882,8744,234.8643567,17488,-4250624,226304,-4024320,94
9462,499,23,7,0.050095372,0.949904628,2856.255309,3204.97366,4996.199958,4692.779559,9961,621.7852684,19922,-4844544,255488,-4589056,94
7499,426,23,7,0.0537539432,0.946246057,2280.832536,2350.311714,3991.510335,3461.124413,7925,178.4507994,15850,-3839488,218112,-3621376,94
9489,473,23,7,0.0474804256,0.952519574,2858.676337,3166.093486,5003.993888,4530.243129,9962,580.5361305,19924,-4858368,242176,-4616192,94
2163,160,23,7,0.0688764529,0.931123547,659.4568486,794.8697235,1152.397596,1291.8125,2323,197.5340136,4646,-1107456,81920,-1025536,94
8409,460,23,7,0.0518660503,0.94813395,2553.303224,2599.986367,4470.54406,3785.23913,8869,245.6786704,17738,-4305408,235520,-4069888,94
7362,473,23,7,0.060370134,0.939629866,2256.543547,2234.890337,3961.524042,3240.570825,7835,171.8955682,15670,-3769344,242176,-3527168,94
1110,81,23,7,0.0680100756,0.931989924,338.137422,404.3152656,602.2081081,510.9259259,1191,17.85339529,2382,-568320,41472,-526848,94
9517,452,23,7,0.0453405557,0.954659444,2879.187645,2826.454348,5001.405905,4639.568584,9969,1352.645862,19938,-4872704,231424,-4641280,94
9531,442,23,7,0.0443196631,0.955680337,2875.543121,2941.444181,4998.098311,4747.683258,9973,868.728223,19946,-4879872,226304,-4653568,94
9518,450,23,7,0.0451444623,0.954855538,2873.12956,2957.787208,4996.263816,4735.682222,9968,893.9910314,19936,-4873216,230400,-4642816,94
9556,420,23,7,0.0421010425,0.957898957,2876.770716,2911.35042,5008.548242,4532.354762,9976,1330.133333,19952,-4892672,215040,-4677632,94
9525,443,22,8,0.0444422151,0.955557785,2868.996038,3039.691088,4998.348136,4686.749436,9968,775.7198444,19936,-4876800,226816,-4649984,94
9529,442,23,7,0.0443285528,0.955671447,2874.447726,2946.889291,4999.49575,4695.047511,9971,686.707989,19942,-4878848,226304,-4652544,94
836,69,22,8,0.0762430939,0.923756906,260.3837521,230.8536345,464.3409091,315.5942029,905,23.26478149,1810,-428032,35328,-392704,94
232,27,23,7,0.104247104,0.895752896,72.86376565,89.44945159,130.1637931,128.5925926,259,14.24642464,518,-118784,13824,-104960,94
9510,454,23,7,0.0455640305,0.954435969,2862.526673,3152.115035,4983.482545,4961.918502,9964,817.3913043,19928,-4869120,232448,-4636672,94
9492,474,23,7,0.0475617098,0.95243829,2873.798082,2891.6997,5009.114412,4470.563291,9966,834.6733668,19932,-4859904,242688,-4617216,94
9454,502,22,8,0.0504218562,0.949578144,2864.585984,3044.014352,4985.22858,4851.782869,9956,951.8164436,19912,-4840448,257024,-4583424,94
9516,451,22,8,0.0452493228,0.954750677,2868.766665,3042.739604,4993.894073,4775.237251,9967,1260.050569,19934,-4872192,230912,-4641280,94
9526,441,23,7,0.0442460118,0.955753988,2875.80938,2886.64408,4999.78459,4643.038549,9967,1075.188781,19934,-4877312,225792,-4651520,94
9547,426,23,7,0.0427153314,0.957284669,2876.689565,2888.697788,5008.222688,4511.382629,9973,1430.846485,19946,-4888064,218112,-4669952,94
9377,564,22,8,0.0567347349,0.943265265,2862.44712,2984.876898,4979.025488,4837.569149,9941,327.3296016,19882,-4801024,288768,-4512256,94
9490,477,22,8,0.0478579312,0.952142069,2871.814916,2976.429647,4993.572392,4793.555556,9967,684.5467033,19934,-4858880,244224,-4614656,94
9544,431,23,7,0.0432080201,0.95679198,2881.26004,2810.402082,5006.385268,4580.87935,9975,1188.915375,19950,-4886528,220672,-4665856,94
9562,414,23,7,0.041499599,0.958500401,2876.0964,2918.0485,5010.680715,4476.200483,9976,999.5991984,19952,-4895744,211968,-4683776,94
9536,435,23,7,0.0436265169,0.956373483,2876.804818,2885.766641,5003.626573,4599.593103,9971,1035.410177,19942,-4882432,222720,-4659712,94
9483,477,22,8,0.0478915663,0.952108434,2871.576332,2943.472153,4986.949278,4852.285115,9960,654.8323471,19920,-4855296,244224,-4611072,94
4141,352,22,8,0.0783440908,0.921655909,1299.970891,1261.584749,2248.677856,2227.261364,4493,83.41997772,8986,-2120192,180224,-1939968,94
9442,521,23,7,0.0522934859,0.947706514,2858.666288,3125.170519,5012.095319,4436.587332,9963,920.7948244,19926,-4834304,266752,-4567552,94
8492,462,23,7,0.0515970516,0.948402948,2575.90894,2661.892759,4512.589378,3832.52381,8954,218.9242054,17908,-4347904,236544,-4111360,94
9400,558,22,8,0.0560353485,0.943964652,2869.435503,2838.321504,5028.089149,4160.973118,9958,776.7550702,19916,-4812800,285696,-4527104,94
8418,477,23,7,0.0536256324,0.946374368,2562.439213,2561.622986,4487.509503,3750.744235,8895,244.6369637,17790,-4310016,244224,-4065792,94
7460,460,23,7,0.0580808081,0.941919192,2286.49575,2184.705478,4000.208579,3316.530435,7920,195.1219512,15840,-3819520,235520,-3584000,94
3852,295,23,7,0.0711357608,0.928864239,1205.893159,1057.405029,2088.806075,1880.667797,4147,74.10650465,8294,-1972224,151040,-1821184,94
9410,544,23,7,0.0546513964,0.945348604,2866.626286,2936.450527,5008.989373,4432.803309,9954,206.8148764,19908,-4817920,278528,-4539392,94
8632,489,23,7,0.0536125425,0.946387458,2626.98831,2606.280701,4607.067655,3747.797546,9121,232.2638146,18242,-4419584,250368,-4169216,94
5990,379,23,7,0.059506987,0.940493013,1842.640302,1685.992336,3218.668781,2652.873351,6369,145.9106529,12738,-3066880,194048,-2872832,94
8328,471,23,7,0.0535288101,0.94647119,2536.176118,2473.387053,4445.443684,3596.4862,8799,232.59318,17598,-4263936,241152,-4022784,94
8388,437,23,7,0.0495184136,0.950481586,2539.775544,2621.72165,4444.169051,3814.7254,8825,226.2820513,17650,-4294656,223744,-4070912,94
9461,501,23,7,0.0502911062,0.949708894,2862.59182,3055.135545,5012.702463,4392.265469,9962,758.7204874,19924,-4844032,256512,-4587520,94
9450,508,23,7,0.0510142599,0.94898574,2869.196654,2886.246959,5017.017989,4281.576772,9958,776.1496493,19916,-4838400,260096,-4578304,94
7922,462,23,7,0.0551049618,0.944895038,2416.455189,2365.910216,4235.486872,3455.396104,8384,207.3194857,16768,-4056064,236544,-3819520,94
8482,447,22,8,0.050061597,0.949938403,2571.438655,2587.177749,4503.109526,3741.856823,8929,238.4882479,17858,-4342784,228864,-4113920,94
9440,520,22,8,0.0522088353,0.947791165,2867.27901,2876.085779,5029.095233,4098.309615,9960,680.7928913,19920,-4833280,266240,-4567040,94
8394,473,23,7,0.0533438593,0.946656141,2550.525007,2625.027714,4472.443412,3751.77167,8867,233.8343882,17734,-4297728,242176,-4055552,94
8025,426,23,7,0.0504082357,0.949591764,2433.229849,2477.311077,4258.662928,3610.694836,8451,207.7944431,16902,-4108800,218112,-3890688,94
8419,464,23,7,0.0522346054,0.947765395,2556.686244,2595.078992,4481.746763,3720.818966,8883,233.0272823,17766,-4310528,237568,-4072960,94
9152,762,23,7,0.0768610046,0.923138995,2878.803336,2644.9493,4971.615166,4787.969816,9914,541.1572052,19828,-4685824,390144,-4295680,94
9169,750,23,7,0.0756124609,0.924387539,2877.681625,2667.192752,4982.297851,4687.401333,9919,514.4709544,19838,-4694528,384000,-4310528,94
7531,512,23,7,0.0636578391,0.936342161,2314.890055,2421.356911,4021.415615,4030.595703,8043,146.8236583,16086,-3855872,262144,-3593728,94
8033,531,23,7,0.0620037366,0.937996263,2479.284484,2353.214873,4296.017677,4078.003766,8564,189.3852278,17128,-4112896,271872,-3841024,94
9384,566,23,7,0.0568844221,0.943115578,2885.03755,2587.544026,5009.68734,4408.690813,9950,374.623494,19900,-4804608,289792,-4514816,94
9381,572,23,7,0.0574701095,0.94252989,2882.831143,2623.45515,5017.233131,4317.162587,9953,467.7161654,19906,-4803072,292864,-4510208,94
6619,484,23,7,0.0681402224,0.931859778,2043.317828,2141.986581,3543.043058,3674.491736,7103,157.8093757,14206,-3388928,247808,-3141120,94
6661,487,23,7,0.0681309457,0.931869054,2057.483606,2139.73141,3565.668218,3695.297741,7148,160.8098988,14296,-3410432,249344,-3161088,94
7949,526,23,7,0.0620648968,0.937935103,2448.733779,2401.090082,4253.245565,4007.606464,8475,167.3247779,16950,-4069888,269312,-3800576,94
9368,583,22,8,0.0585870767,0.941412923,2882.930029,2645.948334,5008.854184,4448.078902,9951,449.255079,19902,-4796416,298496,-4497920,94
9375,576,23,7,0.0578836298,0.94211637,2883.487762,2618.344863,5012.601067,4380.279514,9951,648.696219,19902,-4800000,294912,-4505088,94
6323,477,23,7,0.0701470588,0.929852941,1949.516703,2125.633551,3387.11988,3577.863732,6800,150.5423954,13600,-3237376,244224,-2993152,94
9379,574,23,7,0.057671054,0.942328946,2882.160781,2631.396289,5018.447169,4299.764808,9953,560.4166667,19906,-4802048,293888,-4508160,94
9387,566,23,7,0.0568672762,0.943132724,2882.383357,2631.624905,5016.349526,4324.39576,9953,688.3125864,19906,-4806144,289792,-4516352,94
9387,565,22,8,0.056772508,0.943227492,2877.249042,2735.686781,5011.259401,4399.00177,9952,291.0792629,19904,-4806144,289280,-4516864,94
6786,557,22,8,0.0758545554,0.924145445,2107.260069,2238.909859,3644.286472,4009.637343,7343,166.3570458,14686,-3474432,285184,-3189248,94
6601,482,23,7,0.0680502612,0.931949739,2034.005163,2181.339349,3532.256779,3675.43361,7083,160.6122449,14166,-3379712,246784,-3132928,94
9375,576,23,7,0.0578836298,0.94211637,2881.3657,2660.42768,5011.46432,4398.78125,9951,487.3163565,19902,-4800000,294912,-4505088,94
7454,589,23,7,0.0732313813,0.926768619,2312.607274,2426.380804,4006.138315,4222.735144,8043,167.8072189,16086,-3816448,301568,-3514880,94
1377,81,22,8,0.0555555556,0.944444444,412.0916014,487.7672599,743.9389978,484.037037,1458,24.00395127,2916,-705024,41472,-663552,94
9505,463,22,8,0.0464486356,0.953551364,2872.683311,2940.508492,5005.968753,4543.764579,9968,1235.192069,19936,-4866560,237056,-4629504,94
9377,536,23,7,0.0540704126,0.945929587,2857.742574,2922.636377,4967.662685,4770.462687,9913,175.9183673,19826,-4801024,274432,-4526592,94
1885,107,22,8,0.0537148594,0.946285141,571.1589795,557.4194923,1013.815915,691.4485981,1992,36.59746463,3984,-965120,54784,-910336,94
9575,400,23,7,0.0401002506,0.959899749,2872.203754,3023.811147,5004.248042,4599.0625,9975,1383.495146,19950,-4902400,204800,-4697600,94
9560,415,23,7,0.04160401,0.95839599,2876.184568,2955.334015,4989.842364,4945.559036,9975,1061.170213,19950,-4894720,212480,-4682240,94
9571,403,23,7,0.0404050531,0.959594947,2873.153218,3011.686716,4996.918399,4763.818859,9974,1044.397906,19948,-4900352,206336,-4694016,94
9551,423,22,8,0.0424102667,0.957589733,2870.955247,3049.288489,4998.826092,4731.765957,9974,1420.797721,19948,-4890112,216576,-4673536,94
9527,440,22,8,0.0441456807,0.955854319,2871.437352,2985.916042,4997.019104,4702.106818,9967,1187.961859,19934,-4877824,225280,-4652544,94
9550,424,23,7,0.0425105274,0.957489473,2870.806425,3063.10877,4988.386806,4967.525943,9974,1364.432285,19948,-4889600,217088,-4672512,94
9533,438,22,8,0.0439273894,0.956072611,2873.719795,2965.282491,4998.349628,4717.212329,9971,856.6151203,19942,-4880896,224256,-4656640,94
9514,451,23,7,0.0452584044,0.954741596,2873.874005,2919.292466,4996.842127,4690.995565,9965,739.7921307,19930,-4871168,230912,-4640256,94
1807,131,22,8,0.0675954592,0.932404541,546.5178076,714.3090658,968.8981738,977.8015267,1938,93.1283037,3876,-925184,67072,-858112,94
9494,472,22,8,0.0473610275,0.952638973,2869.053137,3002.560982,5003.654308,4578.108051,9966,1108.565072,19932,-4860928,241664,-4619264,94
9481,485,22,8,0.0486654626,0.951334537,2874.545568,2883.803979,5007.389199,4516.503093,9966,925.3481894,19932,-4854272,248320,-4605952,94
9503,463,22,8,0.0464579571,0.953542043,2873.627653,2914.400979,5003.32032,4576.691145,9966,532.3717949,19932,-4865536,237056,-4628480,94
9531,437,22,8,0.0438402889,0.956159711,2871.486625,2989.063252,4998.769699,4673.276888,9968,717.6385889,19936,-4879872,223744,-4656128,94
691,73,21,9,0.0955497382,0.904450262,217.7578262,241.52203,386.8596237,341.2328767,764,13.59188756,1528,-353792,37376,-316416,94
9519,451,22,8,0.0452357071,0.954764293,2875.950315,2899.232707,5002.688308,4622.716186,9970,1522.137405,19940,-4873728,230912,-4642816,94
1800,109,22,8,0.057097957,0.942902043,542.9724081,636.8776473,967.4138889,750,1909,30.35458737,3818,-921600,55808,-865792,94
4860,204,22,8,0.0402843602,0.95971564,1452.955918,1598.500746,2550.865844,2094.960784,5064,80.77843356,10128,-2488320,104448,-2383872,94
9488,475,23,7,0.0476764027,0.952323597,2877.710095,2807.101057,5004.039524,4541.766316,9963,599.8193859,19926,-4857856,243200,-4614656,94
9469,492,23,7,0.0493926313,0.950607369,2873.167479,2900.522462,4998.008449,4653.656504,9961,781.8681319,19922,-4848128,251904,-4596224,94
9513,453,23,7,0.0454545455,0.954545455,2870.340549,2957.503265,5010.063913,4425.657837,9966,1206.53753,19932,-4870656,231936,-4638720,94
9491,474,23,7,0.0475664827,0.952433517,2877.70643,2817.4656,5005.599831,4530.478903,9965,1216.727717,19930,-4859392,242688,-4616704,94
9520,450,22,8,0.0451354062,0.954864594,2877.321635,2843.07012,5010.546954,4455.617778,9970,959.5765159,19940,-4874240,230400,-4643840,94
78,16,23,7,0.170212766,0.829787234,25.23310131,34.66440673,46.66666667,51.5625,94,2.333085133,188,-39936,8192,-31744,94
9509,457,22,8,0.0458559101,0.95414409,2869.080605,3001.514184,5004.854033,4539.177243,9966,696.4360587,19932,-4868608,233984,-4634624,94
9390,559,23,7,0.0561865514,0.943813449,2872.81037,2858.611101,4972.77508,5012.373882,9949,506.8262863,19898,-4807680,286208,-4521472,94
9497,469,22,8,0.047060004,0.952939996,2874.857613,2874.966269,5007.769611,4492.053305,9966,1112.276786,19932,-4862464,240128,-4622336,94
9501,466,23,7,0.0467542892,0.953245711,2876.833527,2859.361452,5002.447953,4607.875536,9967,851.1528608,19934,-4864512,238592,-4625920,94
9540,430,23,7,0.0431293882,0.956870612,2872.734847,2941.902849,5010.127987,4439.102326,9970,766.3335895,19940,-4884480,220160,-4664320,94
9492,471,23,7,0.0472749172,0.952725083,2870.24176,2957.523326,5003.650126,4545.687898,9963,421.6250529,19926,-4859904,241152,-4618752,94
9508,458,22,8,0.0459562513,0.954043749,2874.344988,2896.442525,5004.371582,4550.209607,9966,1104.878049,19932,-4868096,234496,-4633600,94
9513,454,22,8,0.045550316,0.954449684,2877.437898,2828.704393,5007.367707,4494.359031,9967,1631.260229,19934,-4870656,232448,-4638208,94
9415,535,23,7,0.0537688442,0.946231156,2871.569682,2875.713822,4988.589485,4745.149533,9950,568.2467162,19900,-4820480,273920,-4546560,94
9506,459,23,7,0.0460612142,0.953938786,2876.378475,2859.492737,5000.035241,4630.196078,9965,742.5484352,19930,-4867072,235008,-4632064,94
9509,458,23,7,0.0459516404,0.95404836,2878.114482,2817.491003,5006.752024,4511.622271,9967,1199.398315,19934,-4868608,234496,-4634112,94
9509,458,23,7,0.0459516404,0.95404836,2869.711018,2950.930033,5016.149332,4316.515284,9967,1020.163767,19934,-4868608,234496,-4634112,94
9480,482,22,8,0.0483838587,0.951616141,2872.650903,2896.844401,5005.409388,4511.248963,9962,763.3716475,19924,-4853760,246784,-4606976,94
9500,466,23,7,0.0467589805,0.953241019,2875.063797,2873.770396,5006.853895,4507.401288,9966,805.0080775,19932,-4864000,238592,-4625408,94
9253,620,23,7,0.0627975286,0.937202471,2828.694965,3151.967114,4939.370799,4901.617742,9873,192.7191099,19746,-4737536,317440,-4420096,94
9289,645,21,9,0.0649285283,0.935071472,2839.726368,3242.054022,4960.146087,5073.407752,9934,231.7778815,19868,-4755968,330240,-4425728,94
9223,592,23,7,0.0603158431,0.939684157,2807.336399,3205.321661,4895.636019,5100.623311,9815,215.1940364,19630,-4722176,303104,-4419072,94
9269,599,23,7,0.0607012566,0.939298743,2823.046912,3206.391242,4916.724242,5209.564274,9868,195.7548106,19736,-4745728,306688,-4439040,94
9285,598,23,7,0.0605079429,0.939492057,2837.121248,3086.033186,4933.944642,5067.073579,9883,185.8405416,19766,-4753920,306176,-4447744,94
9301,627,23,7,0.0631547139,0.936845286,2838.087486,3228.001354,4938.99742,5342.808612,9928,220.8676307,19856,-4762112,321024,-4441088,94
8938,601,23,7,0.0630045078,0.936995492,2729.634265,3077.597435,4752.617812,5028.505824,9539,209.1427319,19078,-4576256,307712,-4268544,94
9221,628,22,8,0.0637628186,0.936237181,2817.349939,3197.802996,4921.44236,4977.237261,9849,196.7439073,19698,-4721152,321536,-4399616,94
7203,405,23,7,0.0532334385,0.946766562,2191.507253,2249.553226,3824.402749,3450.525926,7608,184.6153846,15216,-3687936,207360,-3480576,94
9279,634,22,8,0.0639564209,0.936043579,2833.491756,3232.289037,4937.479685,5242.692429,9913,237.5509226,19826,-4750848,324608,-4426240,94
9189,736,21,9,0.0741561713,0.925843829,2830.413291,3231.180295,4925.650996,5429.304348,9925,357.5288184,19850,-4704768,376832,-4327936,94
9318,627,23,7,0.0630467572,0.936953243,2842.678126,3251.56427,4956.600987,5216.709729,9945,502.2727273,19890,-4770816,321024,-4449792,94
9347,602,23,7,0.0605085938,0.939491406,2846.862694,3231.677449,4962.602439,5167.491694,9949,525.0131926,19898,-4785664,308224,-4477440,94
9202,724,23,7,0.0729397542,0.927060246,2830.700232,3227.877541,4921.824386,5493.194751,9926,619.9875078,19852,-4711424,370688,-4340736,94
9328,620,23,7,0.0623240852,0.937675915,2847.755052,3210.523119,4970.761042,5030.753226,9948,431.9583152,19896,-4775936,317440,-4458496,94
8815,619,23,7,0.0656137375,0.934386262,2698.463332,3053.116218,4708.505615,4845.58643,9434,214.8485539,18868,-4513280,316928,-4196352,94
9404,552,23,7,0.0554439534,0.944556047,2863.806259,3010.091146,5004.064653,4542.974638,9956,638.2051282,19912,-4814848,282624,-4532224,94
9373,579,22,8,0.0581792605,0.94182074,2857.611288,3102.381602,4989.437,4767.072539,9952,666.577361,19904,-4798976,296448,-4502528,94
9236,690,23,7,0.0695144066,0.930485593,2844.328152,3116.574388,4939.918796,5279.146377,9926,498.5434455,19852,-4728832,353280,-4375552,94
9168,757,23,7,0.0762720403,0.92372796,2825.280155,3269.9543,4922.498146,5453.516513,9925,721.2936047,19850,-4694016,387584,-4306432,94
