unmon_N_in_packets,unmon_N_out_packets,unmon_in_first_thirty,unmon_out_first_thirty,unmon_out_fraction,unmon_in_fraction,unmon_out_std,unmon_in_std,unmon_out_mean,unmon_in_mean,unmon_N_packets,unmon_time_fraction,unmon_sum_N,unmon_incoming_packets_size,unmon_outgoing_packets_size,unmon_total_packets_size,y
101,29,17,13,0.223076923,0.776923077,36.30469635,27.05378445,73.46534653,37.75862069,130,23.38129496,260,-51712,14848,-36864,-1
9189,738,18,12,0.0743427017,0.925657298,2845.096286,2885.461055,5053.770595,3846.246612,9927,835.6060606,19854,-4704768,377856,-4326912,-1
285,74,17,13,0.206128134,0.793871866,100.730751,111.1450439,185.9964912,156.9054054,359,20.15721505,718,-145920,37888,-108032,-1
9407,541,21,9,0.0543827905,0.945617209,2855.784563,3120.454082,4992.069735,4668.994455,9948,1084.841876,19896,-4816384,276992,-4539392,-1
2215,293,27,3,0.116826156,0.883173844,716.3742414,778.7153762,1257.969752,1228.269625,2508,46.79977608,5016,-1134080,150016,-984064,-1
5189,241,27,3,0.0443830571,0.955616943,1560.981276,1685.439927,2726.231451,2484.439834,5430,428.2334385,10860,-2656768,123392,-2533376,-1
1258,70,18,12,0.0527108434,0.947289157,376.9259352,477.9582289,668.845787,586.4,1328,52.28346457,2656,-644096,35840,-608256,-1
4269,194,19,11,0.0434685189,0.956531481,1273.239363,1449.558564,2260.486765,1605.14433,4463,316.5248227,8926,-2185728,99328,-2086400,-1
4147,323,20,10,0.0722595078,0.927740492,1298.674082,1157.546945,2252.17169,2021.452012,4470,106.759016,8940,-2123264,165376,-1957888,-1
9543,428,17,13,0.042924481,0.957075519,2865.70623,3056.790204,5018.958713,4251.128505,9971,1024.768756,19942,-4886016,219136,-4666880,-1
9618,363,20,10,0.0363691013,0.963630899,2866.094477,3148.028145,5022.04242,4168.504132,9981,808.1781377,19962,-4924416,185856,-4738560,-1
8648,762,22,8,0.0809776833,0.919022317,2727.293373,2534.650366,4750.482771,4194.986877,9410,375.4988029,18820,-4427776,390144,-4037632,-1
1365,154,26,4,0.101382488,0.898617512,433.8056054,476.9458308,763.5128205,728.8636364,1519,128.6198137,3038,-698880,78848,-620032,-1
9295,661,21,9,0.0663921254,0.933607875,2836.579944,3175.100146,5053.387843,3925.425113,9956,251.160444,19912,-4759040,338432,-4420608,-1
6529,406,21,9,0.0585436193,0.941456381,1977.495525,2200.041456,3519.671313,2637.059113,6935,141.5595019,13870,-3342848,207872,-3134976,-1
912,142,21,9,0.134724858,0.865275142,301.5640878,269.1956573,552.8410088,364.7464789,1054,30.97267117,2108,-466944,72704,-394240,-1
3491,215,20,10,0.0580140313,0.941985969,1067.184254,1078.549719,1869.657978,1591.139535,3706,222.7163462,7412,-1787392,110080,-1677312,-1
9391,557,25,5,0.055991154,0.944008846,2853.069839,3105.045563,5011.293898,4354.156194,9948,729.3255132,19896,-4808192,285184,-4523008,-1
516,81,18,12,0.135678392,0.864321608,169.9261806,151.4063293,315.0116279,197,597,65.38882804,1194,-264192,41472,-222720,-1
43,12,22,8,0.218181818,0.781818182,16.00165621,13.97095201,29.60465116,22.25,55,11.24744376,110,-22016,6144,-15872,-1
4471,349,21,9,0.072406639,0.927593361,1360.162151,1660.537402,2450.301499,1900.60745,4820,90.49943673,9640,-2289152,178688,-2110464,-1
3488,175,20,10,0.0477750478,0.952224952,1046.981231,1178.907179,1851.948681,1434.394286,3663,251.2345679,7326,-1785856,89600,-1696256,-1
4533,339,22,8,0.0695812808,0.930418719,1405.766289,1382.917404,2458.182881,2146.563422,4872,122.7513228,9744,-2320896,173568,-2147328,-1
248,56,18,12,0.184210526,0.815789474,83.93970731,86.45983607,163.9072581,101.9821429,304,54.97287523,608,-126976,28672,-98304,-1
5595,501,20,10,0.0821850394,0.917814961,1743.617162,1892.520705,3081.37462,2681.367265,6096,224.4477172,12192,-2864640,256512,-2608128,-1
3011,224,20,10,0.0692426584,0.930757342,934.1347838,908.2793584,1632.413816,1424.25,3235,89.7862892,6470,-1541632,114688,-1426944,-1
71,23,19,11,0.244680851,0.755319149,27.76905495,17.04691625,52.67605634,31.52173913,94,22.38095238,188,-36352,11776,-24576,-1
4848,213,18,12,0.0420865442,0.957913456,1444.761805,1634.504453,2562.476279,1814.58216,5061,605.3827751,10122,-2482176,109056,-2373120,-1
9411,545,20,10,0.0547408598,0.94525914,2849.628914,3071.441664,5041.198279,3895.833028,9956,1036.004162,19912,-4818432,279040,-4539392,-1
2909,231,21,9,0.073566879,0.926433121,891.5819367,1018.704303,1597.009625,1236.662338,3140,107.4238796,6280,-1489408,118272,-1371136,-1
136,30,18,12,0.180722892,0.819277108,44.84594871,55.08986598,88.19852941,62.2,166,30.74074074,332,-69632,15360,-54272,-1
362,79,19,11,0.179138322,0.820861678,122.3885431,133.9565274,233.3287293,164.5063291,441,19.65240642,882,-185344,40448,-144896,-1
280,68,18,12,0.195402299,0.804597701,94.90617171,119.0329365,170.2,192.2058824,348,12.7988231,696,-143360,34816,-108544,-1
418,68,24,6,0.139917695,0.860082305,141.010792,135.8149589,243.3588517,244.3676471,486,35.14099783,972,-214016,34816,-179200,-1
4086,270,16,14,0.0619834711,0.938016529,1245.246459,1387.729603,2200.516887,1845.311111,4356,87.76949426,8712,-2092032,138240,-1953792,-1
1020,90,17,13,0.0810810811,0.918918919,315.0319871,366.2822591,562.7676471,473.1333333,1110,130.8962264,2220,-522240,46080,-476160,-1
7474,485,19,11,0.0609373037,0.939062696,2269.86171,2601.955,3937.416644,4636.22268,7959,193.1796117,15918,-3826688,248320,-3578368,-1
6806,297,20,10,0.0418133183,0.958186682,2051.741423,2009.257298,3561.236703,3340.333333,7103,304.7190047,14206,-3484672,152064,-3332608,-1
2387,285,16,14,0.106661677,0.893338323,758.5567113,860.9100651,1351.470046,1211.119298,2672,70.98831031,5344,-1222144,145920,-1076224,-1
8479,464,22,8,0.0518841552,0.948115845,2571.869341,2744.391514,4484.092228,4251.030172,8943,220.2166954,17886,-4341248,237568,-4103680,-1
9536,438,21,9,0.0439141769,0.956085823,2865.69605,3115.051295,5011.318792,4468.924658,9974,652.7486911,19948,-4882432,224256,-4658176,-1
8537,1308,21,9,0.132859319,0.867140681,2871.298918,2473.207609,4790.07813,5790.54893,9845,424.9028917,19690,-4370944,669696,-3701248,-1
2799,312,22,8,0.100289296,0.899710704,878.7881982,1055.372969,1555.266881,1562.576923,3111,80.20108275,6222,-1433088,159744,-1273344,-1
9347,605,20,10,0.0607918006,0.939208199,2850.996291,2850.599314,5066.62266,3584.142149,9952,646.6536712,19904,-4785664,309760,-4475904,-1
36,21,19,11,0.368421053,0.631578947,15.32132682,18.07730941,27.91666667,30.85714286,57,1.046639736,114,-18432,10752,-7680,-1
2939,508,16,14,0.147374529,0.852625471,977.2492351,1091.979054,1729.050357,1694.781496,3447,121.0323034,6894,-1504768,260096,-1244672,-1
2440,144,20,10,0.0557275542,0.944272446,734.3739397,797.076176,1318.85,846.0138889,2584,78.70849832,5168,-1249280,73728,-1175552,-1
8581,883,16,14,0.0933009298,0.90669907,2729.639291,2743.889382,4708.210815,4968.542469,9464,203.9215686,18928,-4393472,452096,-3941376,-1
8650,1198,20,10,0.121649066,0.878350934,2795.697976,3135.038958,4870.346821,5315.505843,9848,411.5336398,19696,-4428800,613376,-3815424,-1
340,42,21,9,0.109947644,0.890052356,107.4591328,125.7641676,195.7088235,157.4285714,382,13.53170386,764,-174080,21504,-152576,-1
6643,510,20,10,0.0712987558,0.928701244,2036.174709,2403.343385,3566.070751,3719.358824,7153,161.5037254,14306,-3401216,261120,-3140096,-1
7403,412,19,11,0.0527191299,0.94728087,2226.42928,2671.50416,3939.30258,3345.541262,7815,477.1062271,15630,-3790336,210944,-3579392,-1
3933,378,21,9,0.0876826722,0.912317328,1255.625014,1114.469174,2144.126112,2279.544974,4311,281.5806662,8622,-2013696,193536,-1820160,-1
4609,213,22,8,0.0441725425,0.955827457,1377.75538,1647.065815,2424.120851,2138.403756,4822,377.0132916,9644,-2359808,109056,-2250752,-1
9330,620,21,9,0.0623115578,0.937688442,2848.988515,3075.998802,5032.946731,4111.019355,9950,555.2455357,19900,-4776960,317440,-4459520,-1
1069,145,19,11,0.119439868,0.880560132,344.6577706,384.5398557,598.8334892,671.3931034,1214,122.7502528,2428,-547328,74240,-473088,-1
9604,372,24,6,0.0372894948,0.962710505,2875.03951,2955.346423,5008.249063,4478.634409,9976,487.5855327,19952,-4917248,190464,-4726784,-1
3420,443,22,8,0.114677712,0.885322288,1091.508344,1266.181574,1906.687719,2127.413093,3863,254.9834983,7726,-1751040,226816,-1524224,-1
9600,389,19,11,0.0389428371,0.961057163,2857.183575,3259.266458,5042.524688,3822.154242,9989,1300.651042,19978,-4915200,199168,-4716032,-1
2190,319,17,13,0.127142288,0.872857712,718.3916,763.0981085,1251.531507,1278.811912,2509,104.3243243,5018,-1121280,163328,-957952,-1
9537,440,20,10,0.0441014333,0.955898567,2864.19443,3026.301743,5036.702527,3955.047727,9977,483.8506305,19954,-4882944,225280,-4657664,-1
7315,256,16,14,0.0338132347,0.966186765,2176.221019,2397.593699,3801.077239,3355.179688,7571,1045.718232,15142,-3745280,131072,-3614208,-1
2880,178,22,8,0.0582079791,0.941792021,873.2731523,1024.104039,1530.497917,1513.353933,3058,283.9368617,6116,-1474560,91136,-1383424,-1
4066,309,21,9,0.0706285714,0.929371429,1246.043494,1256.916449,2243.482046,1457.935275,4375,275.851198,8750,-2081792,158208,-1923584,-1
9563,421,21,9,0.0421674679,0.957832532,2856.578983,3188.130826,5044.801318,3804.477435,9984,1013.604061,19968,-4896256,215552,-4680704,-1
6616,871,19,11,0.116334981,0.883665019,2077.347058,2546.776811,3627.346584,4630.083812,7487,213.1833713,14974,-3387392,445952,-2941440,-1
1593,95,25,5,0.0562796209,0.943720379,480.3700359,527.4231229,859.9855618,584.8315789,1688,134.2879873,3376,-815616,48640,-766976,-1
69,10,21,9,0.126582278,0.873417722,21.69014771,20.65066585,42.82608696,20.5,79,10.92669433,158,-35328,5120,-30208,-1
4161,252,19,11,0.0571040109,0.942895989,1261.917961,1336.351619,2241.276857,1641.02381,4413,147.1490497,8826,-2130432,129024,-2001408,-1
3404,352,21,9,0.0937167199,0.90628328,1076.616439,1082.51027,1838.681845,2263.559659,3756,263.0252101,7512,-1742848,180224,-1562624,-1
9584,401,19,11,0.0401602404,0.95983976,2855.060848,3226.607846,5045.642216,3734.837905,9985,534.8152116,19970,-4907008,205312,-4701696,-1
1798,251,22,8,0.12249878,0.87750122,580.1014333,630.6367032,1053.586763,820.2231076,2049,144.397463,4098,-920576,128512,-792064,-1
5135,196,20,10,0.0367660852,0.963233915,1530.145514,1703.169243,2681.608763,2257.066327,5331,726.2942779,10662,-2629120,100352,-2528768,-1
4113,307,27,3,0.0694570136,0.930542986,1255.814593,1439.930896,2175.417457,2680.514658,4420,200.7266122,8840,-2105856,157184,-1948672,-1
7606,463,21,9,0.0573800967,0.942619903,2318.528125,2385.450312,4079.200237,3308.894168,8069,759.0780809,16138,-3894272,237056,-3657216,-1
8914,980,19,11,0.0990499293,0.900950071,2851.585547,2723.91107,4844.461185,5884.732653,9894,336.8743616,19788,-4563968,501760,-4062208,-1
5175,259,27,3,0.0476628635,0.952337137,1555.901623,1793.549423,2707.678841,2913.733591,5434,251.3413506,10868,-2649600,132608,-2516992,-1
3766,346,19,11,0.0841439689,0.915856031,1174.345738,1308.429333,2069.870685,1910.968208,4112,149.7450838,8224,-1928192,177152,-1751040,-1
60,26,17,13,0.302325581,0.697674419,23.04567325,27.50287774,46.21666667,37.23076923,86,9.783845279,172,-30720,13312,-17408,-1
1678,106,19,11,0.0594170404,0.94058296,507.5711374,616.9548002,896.7371871,825.4245283,1784,173.0358875,3568,-859136,54272,-804864,-1
5622,502,24,6,0.0819725669,0.918027433,1752.160273,1852.127147,3014.614372,3598.780876,6124,201.4473684,12248,-2878464,257024,-2621440,-1
298,63,16,14,0.174515235,0.825484765,99.82541272,110.7550758,191.2114094,132.6984127,361,25.63920455,722,-152576,32256,-120320,-1
9431,530,16,14,0.0532075093,0.946792491,2862.9822,2931.966243,5034.284699,4032.833962,9961,1093.413831,19922,-4828672,271360,-4557312,-1
9433,521,22,8,0.0523407675,0.947659232,2856.117333,3149.134018,4997.628856,4613.055662,9954,872.392638,19908,-4829696,266752,-4562944,-1
4739,373,20,10,0.0729655712,0.927034429,1445.046802,1789.668664,2581.92509,2233.47185,5112,128.2167043,10224,-2426368,190976,-2235392,-1
353,37,27,3,0.0948717949,0.905128205,114.1400827,92.26778445,192.6912181,222.2972973,390,36.48269411,780,-180736,18944,-161792,-1
6394,308,22,8,0.0459564309,0.954043569,1932.701231,1915.579284,3374.267438,2878.853896,6702,320.2102246,13404,-3273728,157696,-3116032,-1
100,29,19,11,0.224806202,0.775193798,37.70169625,25.30841861,71.39,42.96551724,129,30.14018692,258,-51200,14848,-36352,-1
1404,84,20,10,0.0564516129,0.943548387,427.4445568,416.5370116,756.2884615,547.4642857,1488,66.756393,2976,-718848,43008,-675840,-1
9522,445,21,9,0.0446473362,0.955352664,2862.592218,3045.216986,5024.914199,4108.52809,9967,1106.215316,19934,-4875264,227840,-4647424,-1
4786,354,19,11,0.0688715953,0.931128405,1477.574146,1499.545606,2602.567697,2136.951977,5140,229.2595897,10280,-2450432,181248,-2269184,-1
9601,383,17,13,0.0383613782,0.961638622,2869.694465,3066.395497,5025.166233,4173.626632,9984,211.2121853,19968,-4915712,196096,-4719616,-1
1766,75,21,9,0.040738729,0.959261271,527.5215709,593.7840481,927.9399773,757.5866667,1841,236.3286264,3682,-904192,38400,-865792,-1
3132,293,19,11,0.0855474453,0.914452555,987.4796491,994.444197,1702.164112,1828.829352,3425,162.4762808,6850,-1603584,150016,-1453568,-1
7898,295,21,9,0.0360063469,0.963993653,2355.979276,2577.057574,4109.013928,3775.352542,8193,302.659771,16386,-4043776,151040,-3892736,-1
678,102,20,10,0.130769231,0.869230769,211.5173528,289.3289863,379.0988201,466.2843137,780,21.10960758,1560,-347136,52224,-294912,-1
6136,501,19,11,0.0754859123,0.924514088,1911.024668,1972.762116,3311.444915,3411.530938,6637,249.4175122,13274,-3141632,256512,-2885120,-1
328,45,17,13,0.120643432,0.879356568,101.3353899,141.0430177,191.7439024,152.4222222,373,45.71078431,746,-167936,23040,-144896,-1
6959,787,21,9,0.101600826,0.898399174,2200.966056,2457.807751,3811.291709,4423.573062,7746,211.4660115,15492,-3563008,402944,-3160064,-1
2532,265,19,11,0.094744369,0.905255631,802.6749179,828.6809099,1418.484597,1212.830189,2797,146.7471144,5594,-1296384,135680,-1160704,-1
1428,182,21,9,0.113043478,0.886956522,460.9474808,493.6314942,804.442577,813.7967033,1610,93.22524609,3220,-731136,93184,-637952,-1
449,98,20,10,0.179159049,0.820840951,151.6546078,167.0294387,289.1893096,204.4081633,547,45.73578595,1094,-229888,50176,-179712,-1
911,111,20,10,0.108610568,0.891389432,283.5200234,359.7936375,524.2173436,407.1261261,1022,77.60060744,2044,-466432,56832,-409600,-1
7674,463,20,10,0.0569005776,0.943099422,2306.000286,2894.81741,4108.360698,3416.615551,8137,224.8411163,16274,-3929088,237056,-3692032,-1
2649,319,16,14,0.107479784,0.892520216,829.5733815,1054.63434,1490.661004,1433.338558,2968,150.278481,5936,-1356288,163328,-1192960,-1
3133,166,22,8,0.0503182783,0.949681722,944.2967131,1059.437073,1663.896585,1387.722892,3299,126.4953988,6598,-1604096,84992,-1519104,-1
6901,822,21,9,0.106435323,0.893564677,2207.138477,2349.001568,3802.083321,4365.023114,7723,372.0134875,15446,-3533312,420864,-3112448,-1
9589,391,21,9,0.0391783567,0.960821643,2870.651531,3066.32715,5014.288977,4407.092072,9980,939.7363465,19960,-4909568,200192,-4709376,-1
58,29,21,9,0.333333333,0.666666667,25.09348159,25.06694959,44.84482759,42.31034483,87,20.3271028,174,-29696,14848,-14848,-1
2995,138,18,12,0.0440472391,0.955952761,892.5290164,1020.024499,1589.126544,1086.789855,3133,137.5933245,6266,-1533440,70656,-1462784,-1
114,11,21,9,0.088,0.912,35.02884534,33.22873396,65.87719298,33.18181818,125,36.44314869,250,-58368,5632,-52736,-1
8113,381,20,10,0.0448551919,0.955144808,2439.628729,2560.270076,4287.158758,3403.007874,8494,163.5348479,16988,-4153856,195072,-3958784,-1
6012,615,21,9,0.0928021729,0.907197827,1839.526447,2271.810889,3207.456088,4355.531707,6627,173.3908948,13254,-3078144,314880,-2763264,-1
1363,86,27,3,0.0593512767,0.940648723,415.3525622,433.9657961,734.7630227,570.2674419,1449,154.313099,2898,-697856,44032,-653824,-1
1847,138,20,10,0.0695214106,0.930478589,565.3787135,651.0270552,1003.429886,853.4057971,1985,46.64003759,3970,-945664,70656,-875008,-1
3697,816,20,10,0.18081099,0.81918901,1233.097825,1491.234182,2152.391398,2730.943627,4513,109.3795444,9026,-1892864,417792,-1475072,-1
6415,809,21,9,0.111987818,0.888012182,2060.078269,2275.544733,3606.26251,3661.960445,7224,158.5949506,14448,-3284480,414208,-2870272,-1
2985,326,19,11,0.0984596799,0.90154032,941.2855403,1063.649337,1675.230821,1479.91411,3311,125.8456861,6622,-1528320,166912,-1361408,-1
4997,261,25,5,0.0496386459,0.950361354,1513.112812,1604.931641,2626.622173,2684.597701,5258,235.6790677,10516,-2558464,133632,-2424832,-1
9220,751,19,11,0.0753184234,0.924681577,2871.660233,2929.725822,5018.871475,4582.438083,9971,1229.46979,19942,-4720640,384512,-4336128,-1
840,123,21,9,0.127725857,0.872274143,275.9034233,289.6343733,477.0678571,515.6829268,963,81.54106689,1926,-430080,62976,-367104,-1
137,23,18,12,0.14375,0.85625,43.63043911,37.70530442,87.58394161,38.30434783,160,40,320,-70144,11776,-58368,-1
5172,1755,17,13,0.253356431,0.746643569,1681.971074,1902.659799,2890.53577,5154.003989,6927,373.8262277,13854,-2648064,898560,-1749504,-1
3309,230,16,14,0.0649901102,0.93500989,994.7926737,1325.344716,1787.197341,1522.582609,3539,322.6071103,7078,-1694208,117760,-1576448,-1
9505,464,21,9,0.0465442873,0.953455713,2883.780496,2715.962122,5006.302788,4548.614224,9969,254.1167474,19938,-4866560,237568,-4628992,-1
68,12,21,9,0.15,0.85,22.19103516,25.11252454,42.38235294,29.83333333,80,5.983545251,160,-34816,6144,-28672,-1
3236,343,21,9,0.0958368259,0.904163174,1021.649875,1130.234262,1801.624536,1680.329446,3579,90.08306066,7158,-1656832,175616,-1481216,-1
6963,1047,20,10,0.13071161,0.86928839,2267.414169,2541.414913,3934.760448,4475.948424,8010,178.0791463,16020,-3565056,536064,-3028992,-1
8012,749,22,8,0.0854925237,0.914507476,2522.704509,2594.507048,4389.699451,4287.94259,8761,205.1276048,17522,-4102144,383488,-3718656,-1
174,25,21,9,0.125628141,0.874371859,56.6774654,41.61814989,106.2701149,56.36,199,37.40601504,398,-89088,12800,-76288,-1
127,34,22,8,0.211180124,0.788819876,45.77219062,45.89023311,85.09448819,65.70588235,161,8.582089552,322,-65024,17408,-47616,-1
512,60,16,14,0.104895105,0.895104895,157.8223871,189.6470662,298.3457031,185.4166667,572,94.07894737,1144,-262144,30720,-231424,-1
4131,889,19,11,0.177091633,0.822908367,1316.503784,1415.136226,2248.433067,3728.271091,5020,94.94987706,10040,-2115072,455168,-1659904,-1
9232,696,20,10,0.0701047542,0.929895246,2865.782226,2802.396653,5008.981369,4374.482759,9928,788.5623511,19856,-4726784,356352,-4370432,-1
200,35,18,12,0.14893617,0.85106383,67.69121066,44.08711228,126.5,69.42857143,235,14.56912585,470,-102400,17920,-84480,-1
5147,304,22,8,0.0557695836,0.944230416,1562.840276,1678.78749,2753.37245,2262.559211,5451,131.2861272,10902,-2635264,155648,-2479616,-1
1375,144,27,3,0.09479921,0.90520079,439.435753,335.6330643,786.6923636,505.125,1519,53.20490368,3038,-704000,73728,-630272,-1
2088,148,27,3,0.0661896243,0.933810376,635.2490393,748.5945122,1132.379789,922.6824324,2236,45.08973583,4472,-1069056,75776,-993280,-1
73,27,18,12,0.27,0.73,27.77155961,31.29118959,51.97260274,46.51851852,100,1.853568119,200,-37376,13824,-23552,-1
1109,123,19,11,0.0998376623,0.900162338,345.4670881,373.0108018,640.4274121,400.7642276,1232,55.0737595,2464,-567808,62976,-504832,-1
1378,101,20,10,0.0682893847,0.931710615,415.9098163,545.9597667,747.4796807,637.950495,1479,75.07614213,2958,-705536,51712,-653824,-1
9429,535,27,3,0.0536932959,0.946306704,2849.998591,3257.885354,5013.7233,4432.211215,9964,799.0376905,19928,-4827648,273920,-4553728,-1
5816,296,27,3,0.0484293194,0.951570681,1755.096226,1916.614549,3070.699278,2777.503378,6112,494.0986257,12224,-2977792,151552,-2826240,-1
1575,308,22,8,0.163568773,0.836431227,535.4903391,569.5957951,919.6285714,1056.399351,1883,76.29659643,3766,-806400,157696,-648704,-1
282,81,20,10,0.223140496,0.776859504,97.36542981,126.2599359,177.8900709,196.308642,363,15.63307494,726,-144384,41472,-102912,-1
3807,220,21,9,0.0546312391,0.945368761,1151.398112,1336.835923,2008.794852,2104.072727,4027,331.1677632,8054,-1949184,112640,-1836544,-1
2979,240,22,8,0.0745573159,0.925442684,917.2021482,900.9520689,1654.372944,1059.220833,3219,61.13960114,6438,-1525248,122880,-1402368,-1
9428,496,19,11,0.0499798468,0.950020153,2865.752205,2751.439301,4999.982499,4250.030242,9924,472.3465017,19848,-4827136,253952,-4573184,-1
2797,182,20,10,0.061094327,0.938905673,851.9979707,878.7592759,1516.51734,1082.478022,2979,216.0261059,5958,-1432064,93184,-1338880,-1
428,60,19,11,0.12295082,0.87704918,133.2142207,185.1561323,247.5420561,222.8,488,12.23364252,976,-219136,30720,-188416,-1
1952,117,20,10,0.0565490575,0.943450942,586.1098192,725.8950914,1048.033811,817.5470085,2069,60.18033741,4138,-999424,59904,-939520,-1
3889,525,22,8,0.118939737,0.881060263,1272.359673,1272.17055,2182.112625,2395.56,4414,143.4980494,8828,-1991168,268800,-1722368,-1
4391,240,21,9,0.0518246599,0.94817534,1316.846013,1639.457064,2301.83785,2575.108333,4631,99.42035208,9262,-2248192,122880,-2125312,-1
4616,404,22,8,0.0804780876,0.919521912,1440.377708,1473.948061,2471.395581,2957.29703,5020,205.8220582,10040,-2363392,206848,-2156544,-1
3962,237,21,9,0.05644201,0.94355799,1193.909941,1475.372572,2090.610045,2256.974684,4199,96.39577594,8398,-2028544,121344,-1907200,-1
372,85,19,11,0.185995624,0.814004376,126.8126421,151.0451112,233.0053763,211.4705882,457,23.86422977,914,-190464,43520,-146944,-1
9477,481,26,4,0.0483028721,0.951697128,2873.524368,2881.10041,4994.155957,4690.738046,9958,1580.634921,19916,-4852224,246272,-4605952,-1
3277,648,21,9,0.165095541,0.834904459,1103.745076,1231.905819,1906.52487,2248.600309,3925,101.2380707,7850,-1677824,331776,-1346048,-1
2663,313,18,12,0.105174731,0.894825269,855.4920315,825.8496729,1451.858055,1800.249201,2976,235.07109,5952,-1363456,160256,-1203200,-1
9512,453,25,5,0.0454591069,0.954540893,2857.522958,3046.912005,5035.93156,3871.554084,9965,466.5262172,19930,-4870144,231936,-4638208,-1
2082,118,19,11,0.0536363636,0.946363636,622.1753276,780.3941125,1116.162824,824.1440678,2200,208.3333333,4400,-1065984,60416,-1005568,-1
1369,135,22,8,0.0897606383,0.910239362,431.2733674,442.9157741,765.0255661,625.4814815,1504,232.8173375,3008,-700928,69120,-631808,-1
4725,653,20,10,0.121420602,0.878579398,1550.46222,1560.975554,2707.464974,2559.508423,5378,107.1101374,10756,-2419200,334336,-2084864,-1
5776,451,21,9,0.0724265296,0.92757347,1770.591666,2112.643264,3116.757791,3078.68071,6227,172.159248,12454,-2957312,230912,-2726400,-1
353,88,18,12,0.199546485,0.800453515,124.7843819,135.2213439,216.1586402,240.4204545,441,15.7275321,882,-180736,45056,-135680,-1
9430,521,21,9,0.0523565471,0.947643453,2832.283588,3523.153942,4978.879639,4923.879079,9951,829.941618,19902,-4828160,266752,-4561408,-1
4454,551,19,11,0.11008991,0.88991009,1437.570235,1490.126661,2480.882353,2681.787659,5005,238.2198953,10010,-2280448,282112,-1998336,-1
1777,110,16,14,0.0582935877,0.941706412,536.4993057,575.9592777,963.8109173,623.9636364,1887,118.6792453,3774,-909824,56320,-853504,-1
3207,365,16,14,0.102183651,0.897816349,1020.355744,1116.746372,1775.362332,1884.358904,3572,120.9207854,7144,-1641984,186880,-1455104,-1
9554,421,17,13,0.0422055138,0.957794486,2859.150179,3183.828068,5026.803956,4107.39905,9975,1166.666667,19950,-4891648,215552,-4676096,-1
2270,150,17,13,0.0619834711,0.938016529,685.2289529,791.1083582,1234.622026,845.4533333,2420,133.7755666,4840,-1162240,76800,-1085440,-1
7133,650,20,10,0.083515354,0.916484646,2221.733503,2474.761322,3925.857003,3520.458462,7783,353.9336062,15566,-3652096,332800,-3319296,-1
2753,202,17,13,0.068358714,0.931641286,827.6664347,1138.582172,1485.881947,1370.579208,2955,435.840708,5910,-1409536,103424,-1306112,-1
9324,622,25,5,0.0625377036,0.937462296,2856.482747,3066.670391,4953.122265,5278.969453,9946,853.0017153,19892,-4773888,318464,-4455424,-1
9357,594,19,11,0.0596924932,0.940307507,2848.36498,3168.358555,5014.834669,4364.255892,9951,1023.765432,19902,-4790784,304128,-4486656,-1
97,12,26,4,0.110091743,0.889908257,30.76348428,35.95212867,55.82474227,48.33333333,109,11.97802198,218,-49664,6144,-43520,-1
34,22,17,13,0.392857143,0.607142857,16.20841765,15.9912166,29.41176471,27.09090909,56,13.08411215,112,-17408,11264,-6144,-1
2386,240,20,10,0.0913937548,0.908606245,748.8773056,765.8738432,1347.49036,975.5791667,2626,274.6861925,5252,-1221632,122880,-1098752,-1
5792,385,22,8,0.0623279909,0.937672009,1763.371212,1775.47494,3155.965124,2081.566234,6177,806.3968668,12354,-2965504,197120,-2768384,-1
3408,241,22,8,0.0660454919,0.933954508,1041.575635,1205.109913,1819.331279,1905.161826,3649,149.6718622,7298,-1744896,123392,-1621504,-1
350,27,26,4,0.0716180371,0.928381963,107.5530216,109.4989837,193.3571429,132.5185185,377,35.46566322,754,-179200,13824,-165376,-1
8044,626,20,10,0.0722029988,0.927797001,2469.034077,2714.334097,4412.476877,3346.359425,8670,243.0613961,17340,-4118528,320512,-3798016,-1
1453,148,20,10,0.0924422236,0.907557776,455.4997142,521.2796043,796.7136958,843.0810811,1601,117.1177762,3202,-743936,75776,-668160,-1
734,206,18,12,0.219148936,0.780851064,268.9106118,279.8477034,469.3106267,474.7378641,940,18.28082458,1880,-375808,105472,-270336,-1
2701,218,25,5,0.0746831107,0.925316889,834.5198977,780.978131,1500.260644,961.1743119,2919,149.6923077,5838,-1382912,111616,-1271296,-1
8297,668,21,9,0.0745119911,0.925488009,2553.208233,2969.388313,4507.526696,4178.362275,8965,334.889802,17930,-4248064,342016,-3906048,-1
9458,503,20,10,0.0504969381,0.949503062,2851.578968,3042.438595,5046.289173,3753.355865,9961,1298.696219,19922,-4842496,257536,-4584960,-1
1750,307,21,9,0.149246475,0.850753525,579.5306169,628.6911743,991.8114286,1240.986971,2057,39.4666155,4114,-896000,157184,-738816,-1
5460,252,20,10,0.0441176471,0.955882353,1634.778047,1772.058578,2890.99359,2109.138889,5712,228.2061526,11424,-2795520,129024,-2666496,-1
5093,346,21,9,0.063614635,0.936385365,1556.853661,1671.366073,2754.888474,2206.453757,5439,161.3467814,10878,-2607616,177152,-2430464,-1
9447,510,21,9,0.0512202471,0.948779753,2856.403047,3004.804909,5035.067641,3940.429412,9957,860.5877269,19914,-4836864,261120,-4575744,-1
2711,277,22,8,0.0927041499,0.90729585,841.2728661,1006.558732,1523.015492,1215.418773,2988,300,5976,-1388032,141824,-1246208,-1
510,71,20,10,0.122203098,0.877796902,160.2832933,195.8583852,302.1372549,211,581,99.82817869,1162,-261120,36352,-224768,-1
9325,629,20,10,0.0631906771,0.936809323,2863.415576,2950.566909,5019.116139,4360.535771,9954,553,19908,-4774400,322048,-4452352,-1
7654,309,21,9,0.0388044707,0.961195529,2282.440831,2638.510708,3998.304155,3578.142395,7963,557.6330532,15926,-3918848,158208,-3760640,-1
9530,440,27,3,0.0441323972,0.955867603,2857.858615,3042.578811,5041.511647,3772.338636,9970,1349.120433,19940,-4879360,225280,-4654080,-1
609,92,21,9,0.131241084,0.868758916,196.5203142,236.7101162,353.5977011,333.8043478,701,62.09034544,1402,-311808,47104,-264704,-1
9328,622,17,13,0.0625125628,0.937487437,2841.764672,3070.676576,5052.95744,3813.88746,9950,779.7805643,19900,-4775936,318464,-4457472,-1
4429,638,20,10,0.125912769,0.874087231,1482.83974,1313.264685,2526.143825,2588.537618,5067,229.1723202,10134,-2267648,326656,-1940992,-1
6140,661,17,13,0.0971915895,0.902808411,1918.564159,2326.719051,3377.405537,3620.167927,6801,130.8891455,13602,-3143680,338432,-2805248,-1
3152,653,16,14,0.171616294,0.828383706,969.8632229,1221.710956,1714.702094,2811.905054,3805,71.3615904,7610,-1613824,334336,-1279488,-1
2075,319,20,10,0.133249791,0.866750209,678.2686959,767.4752806,1189.965301,1246.510972,2394,152.3870146,4788,-1062400,163328,-899072,-1
3020,506,21,9,0.143505389,0.856494611,996.8047282,1123.498991,1737.981126,1915.806324,3526,382.0151679,7052,-1546240,259072,-1287168,-1
9533,431,18,12,0.0432557206,0.956744279,2854.376933,3238.661931,5015.911885,4243.484919,9964,1285.677419,19928,-4880896,220672,-4660224,-1
9591,383,27,3,0.0383998396,0.96160016,2871.270831,2987.65205,5015.531123,4285.550914,9974,960.8863198,19948,-4910592,196096,-4714496,-1
1041,89,17,13,0.0787610619,0.921238938,316.4953358,422.2619,568.1940442,533.988764,1130,177.672956,2260,-532992,45568,-487424,-1
2120,155,25,5,0.0681318681,0.931868132,652.3499563,710.984245,1142.645755,1074.458065,2275,42.05175601,4550,-1085440,79360,-1006080,-1
4028,1280,19,11,0.241145441,0.758854559,1326.599692,1437.355156,2250.264896,3926.577344,5308,101.9005567,10616,-2062336,655360,-1406976,-1
2290,364,21,9,0.137151469,0.862848531,746.7112238,876.905017,1319.458079,1378.093407,2654,49.92475546,5308,-1172480,186368,-986112,-1
524,79,22,8,0.131011609,0.868988391,172.9879999,179.460127,305.4064885,279.4050633,603,54.03225806,1206,-268288,40448,-227840,-1
1532,154,20,10,0.0913404508,0.908659549,465.8340992,628.7778211,862.4967363,654.5194805,1686,119.7443182,3372,-784384,78848,-705536,-1
69,12,22,8,0.148148148,0.851851852,22.93890226,19.70758455,43.66666667,25.66666667,81,10.99050204,162,-35328,6144,-29184,-1
8828,1056,19,11,0.106839336,0.893160664,2789.26719,3286.795361,4874.961373,5507.112689,9884,822.9808493,19768,-4519936,540672,-3979264,-1
1950,181,20,10,0.0849366495,0.915063351,608.1434078,650.5928355,1085.39641,857.0331492,2131,124.8388987,4262,-998400,92672,-905728,-1
44,21,20,10,0.323076923,0.676923077,18.11948121,20.02175687,33.34090909,32.28571429,65,15.22248244,130,-22528,10752,-11776,-1
703,113,16,14,0.138480392,0.861519608,229.1870768,256.6522473,421.8776671,325.2743363,816,52.81553398,1632,-359936,57856,-302080,-1
4355,362,20,10,0.076743693,0.923256307,1337.66175,1619.611766,2350.614696,2459.878453,4717,127.4176121,9434,-2229760,185344,-2044416,-1
1100,110,27,3,0.0909090909,0.909090909,343.3996105,383.9264226,617.3545455,486.9545455,1210,138.4439359,2420,-563200,56320,-506880,-1
222,34,18,12,0.1328125,0.8671875,70.24828442,61.15698926,138.7432432,61.61764706,256,16.71018277,512,-113664,17408,-96256,-1
1827,81,22,8,0.0424528302,0.95754717,543.936406,621.8308082,967.2211275,667.5679012,1908,271.7948718,3816,-935424,41472,-893952,-1
7466,930,21,9,0.110767032,0.889232968,2339.35695,2830.483368,4075.95004,5182.325806,8396,262.7856025,16792,-3822592,476160,-3346432,-1
5759,652,20,10,0.101700203,0.898299797,1836.065497,1971.599003,3193.160445,3319.409509,6411,211.6540112,12822,-2948608,333824,-2614784,-1
3247,157,17,13,0.0461222092,0.953877791,971.56109,1184.868283,1707.190022,1605.503185,3404,114.5742174,6808,-1662464,80384,-1582080,-1
436,96,17,13,0.180451128,0.819548872,144.9222788,167.3098083,283.5573394,189.03125,532,82.22565688,1064,-223232,49152,-174080,-1
5062,479,21,9,0.0864464898,0.91355351,1569.081804,1871.108432,2745.785855,3037.45929,5541,258.4421642,11082,-2591744,245248,-2346496,-1
3233,214,17,13,0.0620829707,0.937917029,984.0883497,1141.950368,1731.651407,1608.406542,3447,263.9356815,6894,-1655296,109568,-1545728,-1
6362,299,21,9,0.0448881549,0.955111845,1901.603454,2329.717194,3331.028607,3330.391304,6661,248.8233097,13322,-3257344,153088,-3104256,-1
6281,514,20,10,0.0756438558,0.924356144,1937.977526,2219.812449,3381.637797,3597.94358,6795,205.6598063,13590,-3215872,263168,-2952704,-1
2767,401,26,4,0.126578283,0.873421717,891.7397275,1007.173271,1540.421756,1888.650873,3168,124.1865935,6336,-1416704,205312,-1211392,-1
1003,127,20,10,0.112389381,0.887610619,324.9677363,333.9357866,561.2881356,598.7637795,1130,40.47277937,2260,-513536,65024,-448512,-1
9599,382,21,9,0.0382727182,0.961727282,2872.401198,3003.655858,5020.24388,4256.151832,9981,1007.16448,19962,-4914688,195584,-4719104,-1
8072,824,17,13,0.0926258993,0.907374101,2544.237156,2772.863705,4479.078295,4148.951456,8896,201.4036676,17792,-4132864,421888,-3710976,-1
1477,93,17,13,0.0592356688,0.940764331,448.3902177,512.7557977,792.0907244,680.827957,1570,115.4411765,3140,-756224,47616,-708608,-1
7740,1192,19,11,0.133452754,0.866547246,2584.633046,2369.881203,4336.314599,5311.831376,8932,167.0781893,17864,-3962880,610304,-3352576,-1
9635,352,20,10,0.0352458196,0.96475418,2872.883902,3108.126676,5011.754437,4508.022727,9987,761.784897,19974,-4933120,180224,-4752896,-1
6056,451,22,8,0.0693099739,0.930690026,1839.655062,2017.601655,3338.780548,2115.572062,6507,122.2660654,13014,-3100672,230912,-2869760,-1
4078,682,22,8,0.143277311,0.856722689,1369.501839,1400.662192,2386.706964,2343.38563,4760,99.10472621,9520,-2087936,349184,-1738752,-1
6238,466,20,10,0.0695107399,0.93048926,1928.960153,1754.420818,3424.348189,2390.72103,6704,165.4491609,13408,-3193856,238592,-2955264,-1
1830,207,20,10,0.101620029,0.898379971,580.1886204,653.1436363,1020.438251,1006.285024,2037,60.37344398,4074,-936960,105984,-830976,-1
6589,352,19,11,0.0507131537,0.949286846,1983.003917,2337.993783,3486.838974,3174.514205,6941,140.1372905,13882,-3373568,180224,-3193344,-1
9157,794,27,3,0.0797909758,0.920209024,2866.901122,2833.452985,5040.485858,4232.301008,9951,686.7494824,19902,-4688384,406528,-4281856,-1
9630,356,19,11,0.0356499099,0.96435009,2869.879144,3176.563038,5010.374559,4537.033708,9986,858.6414445,19972,-4930560,182272,-4748288,-1
3771,812,20,10,0.177176522,0.822823478,1286.007293,1325.438465,2162.182445,2894.884236,4583,104.7303473,9166,-1930752,415744,-1515008,-1
284,28,22,8,0.0897435897,0.91025641,87.75454339,94.48644083,161.9471831,101.25,312,27.20139494,624,-145408,14336,-131072,-1
9277,660,19,11,0.0664184361,0.933581564,2871.893718,2722.500488,5019.888865,4253.70303,9937,456.6636029,19874,-4749824,337920,-4411904,-1
2220,157,20,10,0.0660496424,0.933950358,676.4734876,745.1311334,1210.898649,879.3503185,2377,204.7372954,4754,-1136640,80384,-1056256,-1
9543,432,22,8,0.0433082707,0.956691729,2877.510865,2885.298535,5008.961647,4524.951389,9975,280.1966292,19950,-4886016,221184,-4664832,-1
3789,170,20,10,0.0429401364,0.957059864,1134.550229,1279.003669,1993.337556,1682.729412,3959,436.9757174,7918,-1939968,87040,-1852928,-1
5802,269,25,5,0.04430901,0.95569099,1748.361161,1789.527946,3055.498104,2615.449814,6071,204.4107744,12142,-2970624,137728,-2832896,-1
2791,149,19,11,0.0506802721,0.949319728,835.4468674,1066.510042,1468.772841,1502.852349,2940,238.4428224,5880,-1428992,76288,-1352704,-1
5347,175,20,10,0.0316914162,0.968308584,1590.171325,1694.527358,2768.581635,2545.125714,5522,539.7849462,11044,-2737664,89600,-2648064,-1
7594,542,16,14,0.0666175025,0.933382498,2346.450456,2353.066591,4092.849091,3727.343173,8136,459.9208592,16272,-3888128,277504,-3610624,-1
37,14,20,10,0.274509804,0.725490196,13.84285171,15.99425917,27.67567568,21.57142857,51,13.78378378,102,-18944,7168,-11776,-1
1117,88,19,11,0.0730290456,0.926970954,339.9247461,385.1230388,618.52641,405.9204545,1205,132.8555678,2410,-571904,45056,-526848,-1
5034,440,27,3,0.0803799781,0.919620022,1577.174467,1608.412993,2725.755463,2871.868182,5474,155.7768924,10948,-2577408,225280,-2352128,-1
9621,362,24,6,0.0362616448,0.963738355,2869.197792,3146.605763,5013.436961,4422.262431,9983,720.2741703,19966,-4925952,185344,-4740608,-1
9239,694,20,10,0.0698681164,0.930131884,2833.663112,3218.768562,5014.108562,4339.85879,9933,1046.680717,19866,-4730368,355328,-4375040,-1
464,39,24,6,0.0775347913,0.922465209,144.0650781,144.8484256,257.1185345,191.1025641,503,37.56534727,1006,-237568,19968,-217600,-1
72,19,20,10,0.208791209,0.791208791,24.07578297,32.06814075,48.09722222,38.05263158,91,8.625592417,182,-36864,9728,-27136,-1
9450,513,21,9,0.0514905149,0.948509485,2859.39018,3006.574109,5034.726878,4010.7154,9963,793.2324841,19926,-4838400,262656,-4575744,-1
267,38,21,9,0.124590164,0.875409836,84.65788097,105.566238,156.5692884,127.9210526,305,15.47437849,610,-136704,19456,-117248,-1
5419,473,21,9,0.0802783435,0.919721656,1679.515128,1906.088248,2921.812327,3229.338266,5892,159.4155844,11784,-2774528,242176,-2532352,-1
2139,165,18,12,0.0716145833,0.928385417,648.1048157,783.0656313,1178.099579,820.6363636,2304,175.3424658,4608,-1095168,84480,-1010688,-1
3086,253,21,9,0.075771189,0.924228811,954.0792563,1076.338308,1669.861957,1671.683794,3339,62.7749577,6678,-1580032,129536,-1450496,-1
9399,562,21,9,0.0564200381,0.943579962,2835.813923,3436.445241,4951.997659,5466.040925,9961,597.1822542,19922,-4812288,287744,-4524544,-1
4045,298,22,8,0.0686161639,0.931383836,1249.805023,1288.675123,2186.918418,1969.5,4343,102.9390851,8686,-2071040,152576,-1918464,-1
2547,147,21,9,0.0545657016,0.945434298,777.4838438,757.1450524,1358.310561,1160.190476,2694,161.3173653,5388,-1304064,75264,-1228800,-1
4702,446,17,13,0.0866355866,0.913364413,1473.751173,1571.501987,2606.447256,2237.692825,5148,107.3842303,10296,-2407424,228352,-2179072,-1
672,73,15,15,0.0979865772,0.902013423,206.3482773,256.7004529,385.2782738,259.9726027,745,64.05846948,1490,-344064,37376,-306688,-1
5167,638,19,11,0.109905254,0.890094746,1668.141897,1710.221719,2868.130637,3185.398119,5805,131.8718764,11610,-2645504,326656,-2318848,-1
4408,701,22,8,0.137208847,0.862791153,1430.310654,1698.230788,2507.212795,2855.493581,5109,282.7338129,10218,-2256896,358912,-1897984,-1
9137,797,25,5,0.0802295148,0.919770485,2841.409989,2997.857139,4885.655795,5905.781681,9934,733.1365314,19868,-4678144,408064,-4270080,-1
7679,857,27,3,0.100398313,0.899601687,2436.280873,2615.017766,4196.980987,4909.333722,8536,208.7551969,17072,-3931648,438784,-3492864,-1
8877,996,22,8,0.100881191,0.899118809,2798.781536,3174.637477,4852.698659,5688.348394,9873,503.9816233,19746,-4545024,509952,-4035072,-1
4804,550,20,10,0.102726933,0.897273067,1541.434185,1577.919848,2666.45587,2773.965455,5354,100.4314388,10708,-2459648,281600,-2178048,-1
2900,232,21,9,0.0740740741,0.925925926,883.1492129,1128.678355,1575.030345,1459.87069,3132,94.19548872,6264,-1484800,118784,-1366016,-1
8557,1287,23,7,0.130739537,0.869260463,2875.915234,2602.894725,4920.153442,4938.101787,9844,625.4129606,19688,-4381184,658944,-3722240,-1
312,81,19,11,0.20610687,0.79389313,107.5116364,132.2068544,201.8814103,178.1975309,393,8.881355932,786,-159744,41472,-118272,-1
964,71,17,13,0.0685990338,0.931400966,290.2865912,315.1772106,535.096473,285.8732394,1035,147.6462197,2070,-493568,36352,-457216,-1
1952,242,18,12,0.11030082,0.88969918,638.7974993,587.2776896,1095.234631,1115.772727,2194,104.725537,4388,-999424,123904,-875520,-1
9627,357,21,9,0.0357572115,0.964242788,2877.125357,2995.424287,5004.673834,4664.215686,9984,806.4620355,19968,-4929024,182784,-4746240,-1
291,67,16,14,0.187150838,0.812849162,98.88675247,114.7546668,187.3436426,145.4328358,358,35.55114201,716,-148992,34304,-114688,-1
4625,337,17,13,0.0679161628,0.932083837,1421.562854,1467.466597,2521.482378,1932.780415,4962,155.9886828,9924,-2368000,172544,-2195456,-1
6042,369,22,8,0.0575573234,0.942442677,1835.292794,2071.694203,3220.860808,2962.669377,6411,116.7334304,12822,-3093504,188928,-2904576,-1
2395,346,27,3,0.126231302,0.873768698,775.1786173,886.4370575,1354.643424,1484.219653,2741,132.0963855,5482,-1226240,177152,-1049088,-1
9431,527,27,3,0.0529222735,0.947077726,2882.382504,2711.742537,4997.61107,4655.390892,9958,1212.911084,19916,-4828672,269824,-4558848,-1
3994,402,21,9,0.0914467698,0.90855323,1255.510035,1384.960637,2215.402103,2030.572139,4396,287.1325931,8792,-2044928,205824,-1839104,-1
4345,438,21,9,0.0915743257,0.908425674,1372.925659,1409.064229,2356.798389,2741.203196,4783,154.041868,9566,-2224640,224256,-2000384,-1
584,62,18,12,0.0959752322,0.904024768,178.4713069,247.7268393,320.385274,352.8387097,646,23.90821614,1292,-299008,31744,-267264,-1
3949,201,20,10,0.0484337349,0.951566265,1199.709949,1152.323864,2083.641935,1915.537313,4150,86.01036269,8300,-2021888,102912,-1918976,-1
3941,452,21,9,0.102890963,0.897109037,1260.660689,1331.52549,2194.909668,2215.225664,4393,240.4488232,8786,-2017792,231424,-1786368,-1
6436,294,26,4,0.0436849926,0.956315007,1924.168932,2189.127311,3398.866532,2635.068027,6730,294.9167397,13460,-3295232,150528,-3144704,-1
8078,731,19,11,0.0829833125,0.917016687,2460.868916,3317.318849,4404.544565,4410.032832,8809,250.6829824,17618,-4135936,374272,-3761664,-1
2574,216,18,12,0.0774193548,0.922580645,789.4434176,953.658355,1378.876068,1593.601852,2790,182.7111984,5580,-1317888,110592,-1207296,-1
9591,391,20,10,0.0391705069,0.960829493,2870.774761,3089.985513,5012.512043,4476.086957,9982,1523.969466,19964,-4910592,200192,-4710400,-1
905,102,21,9,0.101290963,0.898709037,290.1724696,263.5598933,518.2298343,377.745098,1007,67.13333333,2014,-463360,52224,-411136,-1
1077,121,21,9,0.101001669,0.898998331,343.2928819,367.5356915,598.454039,608.8099174,1198,32.43975088,2396,-551424,61952,-489472,-1
9649,340,21,9,0.0340374412,0.965962559,2875.548298,3062.932101,5012.159187,4508.032353,9989,756.1695685,19978,-4940288,174080,-4766208,-1
5217,526,27,3,0.0915897614,0.908410239,1648.189572,1741.068265,2854.196856,3048.576046,5743,253.1070956,11486,-2671104,269312,-2401792,-1
149,22,25,5,0.128654971,0.871345029,48.3432085,51.8552499,88.83221477,66.81818182,171,13.61464968,342,-76288,11264,-65024,-1
214,12,25,5,0.0530973451,0.946902655,63.80365225,81.30856863,115.182243,83.5,226,61.74863388,452,-109568,6144,-103424,-1
3650,281,18,12,0.0714830832,0.928516917,1133.296937,1150.94961,1959.885479,2045.423488,3931,254.7634478,7862,-1868800,143872,-1724928,-1
7022,388,20,10,0.0523616734,0.947638327,2123.851497,2276.666444,3746.022643,2972.123711,7410,171.4087439,14820,-3595264,198656,-3396608,-1
9520,450,22,8,0.0451354062,0.954864594,2867.720652,2906.807422,5033.822269,3963.215556,9970,317.6170755,19940,-4874240,230400,-4643840,-1
3459,196,25,5,0.053625171,0.946374829,1050.073326,1105.640127,1843.379879,1556.576531,3655,129.1063229,7310,-1771008,100352,-1670656,-1
5521,473,22,8,0.0789122456,0.921087754,1685.406568,2187.273119,2995.737185,3018.07611,5994,292.9618768,11988,-2826752,242176,-2584576,-1
857,119,19,11,0.12192623,0.87807377,276.9305381,310.6997674,494.6371062,444.302521,976,21.1027027,1952,-438784,60928,-377856,-1
863,64,18,12,0.0690399137,0.930960086,260.6134672,341.5548114,468.9188876,397.671875,927,104.3918919,1854,-441856,32768,-409088,-1
108,37,20,10,0.255172414,0.744827586,40.94894086,42.0526471,77.21296296,60.7027027,145,26.70349908,290,-55296,18944,-36352,-1
1116,342,16,14,0.234567901,0.765432099,395.0499404,469.3595796,686.5654122,869.6023392,1458,71.89349112,2916,-571392,175104,-396288,-1
86,26,19,11,0.232142857,0.767857143,32.44997815,22.98481619,62.37209302,37.07692308,112,20.4007286,224,-44032,13312,-30720,-1
4198,450,21,9,0.0968158348,0.903184165,1310.245334,1596.097063,2306.126012,2495.908889,4648,107.3937153,9296,-2149376,230400,-1918976,-1
2137,190,20,10,0.0816501934,0.918349807,664.4025469,711.4714892,1184.058961,938.3894737,2327,58.80717715,4654,-1094144,97280,-996864,-1
826,92,18,12,0.100217865,0.899782135,255.598498,334.9112775,464.2506053,416.8478261,918,90.35433071,1836,-422912,47104,-375808,-1
9346,605,21,9,0.0607979098,0.93920209,2842.578975,3192.664687,5028.853948,4159.515702,9951,497.55,19902,-4785152,309760,-4475392,-1
3848,499,26,4,0.11479181,0.88520819,1241.59464,1332.54974,2145.492204,2393.835671,4347,83.83799421,8694,-1970176,255488,-1714688,-1
4317,712,23,7,0.141578843,0.858421157,1461.769528,1384.040011,2496.311791,2628.310393,5029,156.6178761,10058,-2210304,364544,-1845760,-1
2753,313,19,11,0.10208741,0.89791259,879.6237736,929.2494859,1526.26117,1597.169329,3066,62.75071633,6132,-1409536,160256,-1249280,-1
9199,729,23,7,0.0734286865,0.926571313,2837.08995,3075.815582,4894.951299,5842.111111,9928,863.3043478,19856,-4709888,373248,-4336640,-1
9419,538,23,7,0.0540323391,0.945967661,2860.026699,3031.204688,5018.689776,4284.133829,9957,971.4146341,19914,-4822528,275456,-4547072,-1
508,99,16,14,0.163097199,0.836902801,165.7070708,210.4862247,313.8484252,253.4646465,607,11.33520075,1214,-260096,50688,-209408,-1
5404,286,22,8,0.0502636204,0.94973638,1623.611321,1812.799181,2884.822539,2102.496503,5690,562.8090999,11380,-2766848,146432,-2620416,-1
1474,69,21,9,0.0447180817,0.955281918,442.0747068,480.174731,780.1031208,598.8985507,1543,233.4341906,3086,-754688,35328,-719360,-1
9383,578,20,10,0.0580263026,0.941973697,2852.92187,3211.090093,4995.18704,4750.693772,9961,505.1217039,19922,-4804096,295936,-4508160,-1
5502,362,23,7,0.0617326057,0.938267394,1658.661862,2117.021426,2910.217557,3271.168508,5864,194.687915,11728,-2817024,185344,-2631680,-1
7760,1831,22,8,0.190908143,0.809091857,2783.999517,2544.945857,4602.825129,5614.698525,9591,200.1460768,19182,-3973120,937472,-3035648,-1
9321,618,20,10,0.0621792937,0.937820706,2850.840283,2966.060271,5034.636198,3995.122977,9939,771.0628394,19878,-4772352,316416,-4455936,-1
1338,103,21,9,0.0714781402,0.92852186,408.7450211,496.726832,725.5859492,661.4271845,1441,79.04552935,2882,-685056,52736,-632320,-1
3161,212,21,9,0.0628520605,0.93714794,953.1588917,1215.265784,1670.911104,1926.891509,3373,201.7344498,6746,-1618432,108544,-1509888,-1
870,87,22,8,0.0909090909,0.909090909,264.0253802,354.2300548,491.4149425,354.8505747,957,23.2563791,1914,-445440,44544,-400896,-1
440,74,21,9,0.143968872,0.856031128,140.2227547,182.3593688,249.3295455,306.0810811,514,50.69033531,1028,-225280,37888,-187392,-1
9372,582,21,9,0.0584689572,0.941531043,2859.494045,2974.24515,5027.956359,4164.996564,9954,1203.62757,19908,-4798464,297984,-4500480,-1
98,26,20,10,0.209677419,0.790322581,34.89345358,26.04990659,69.34693878,36.69230769,124,18.90243902,248,-50176,13312,-36864,-1
1896,446,22,8,0.190435525,0.809564475,645.1373139,766.2101668,1127.214662,1359.762332,2342,64.14680909,4684,-970752,228352,-742400,-1
3199,175,25,5,0.0518672199,0.94813278,961.6261125,1137.568488,1703.662082,1392.057143,3374,65.75716235,6748,-1637888,89600,-1548288,-1
73,22,21,9,0.231578947,0.768421053,26.38002651,30.44290822,48.89041096,45.04545455,95,11.84538653,190,-37376,11264,-26112,-1
4280,328,25,5,0.0711805556,0.928819444,1316.298312,1427.441905,2338.54486,1860.256098,4608,364.2687747,9216,-2191360,167936,-2023424,-1
9126,672,21,9,0.0685854256,0.931414574,2795.167918,3199.786995,4860.422967,5430.18006,9798,231.7407758,19596,-4672512,344064,-4328448,-1
1282,127,17,13,0.0901348474,0.909865153,404.1041941,341.2593269,730.1045242,451.5826772,1409,105.1492537,2818,-656384,65024,-591360,-1
2091,276,18,12,0.116603295,0.883396705,648.2385542,787.5352258,1128.475371,1604.65942,2367,214.7912886,4734,-1070592,141312,-929280,-1
9550,426,22,8,0.042702486,0.957297514,2865.94639,3097.96318,5018.845864,4308.211268,9976,1146.666667,19952,-4889600,218112,-4671488,-1
3238,235,18,12,0.0676648431,0.932335157,980.9371098,1253.782356,1747.939469,1586.268085,3473,143.4531185,6946,-1657856,120320,-1537536,-1
7107,463,22,8,0.0611624835,0.938837517,2160.576955,2507.91281,3808.52596,3432.053996,7570,260.6749311,15140,-3638784,237056,-3401728,-1
7350,478,21,9,0.0610628513,0.938937149,2238.017683,2536.99549,3940.715238,3511.399582,7828,370.8195168,15656,-3763200,244736,-3518464,-1
9555,413,21,9,0.0414325843,0.958567416,2859.949734,3257.211463,4986.437677,4939.670702,9968,618.3622829,19936,-4892160,211456,-4680704,-1
9550,426,19,11,0.042702486,0.957297514,2874.241827,2979.435646,5004.61288,4627.284038,9976,443.5749222,19952,-4889600,218112,-4671488,-1
844,140,21,9,0.142276423,0.857723577,278.1489989,316.7365076,495.5225118,474.2785714,984,56.94444444,1968,-432128,71680,-360448,-1
70,26,20,10,0.270833333,0.729166667,28.84214957,22.1421243,51.75714286,39.73076923,96,20.60085837,192,-35840,13312,-22528,-1
6027,506,22,8,0.0774529313,0.922547069,1865.989725,2056.67363,3304.581052,2819.369565,6533,225.5091474,13066,-3085824,259072,-2826752,-1
3574,211,20,10,0.0557463672,0.944253633,1085.350769,1121.260916,1918.997762,1452.63981,3785,297.7970102,7570,-1829888,108032,-1721856,-1
6759,523,21,9,0.0718209283,0.928179072,2096.554233,2099.675952,3683.206687,3102.502868,7282,333.4249084,14564,-3460608,267776,-3192832,-1
136,31,17,13,0.185628743,0.814371257,45.57912622,45.10187336,91.61764706,50.58064516,167,34.6473029,334,-69632,15872,-53760,-1
6612,609,20,10,0.0843373494,0.915662651,2040.121234,2477.616962,3572.075318,4033.610837,7221,187.6559252,14442,-3385344,311808,-3073536,-1
112,32,20,10,0.222222222,0.777777778,39.66643443,47.18182913,74.14285714,66.75,144,23.1511254,288,-57344,16384,-40960,-1
1140,113,22,8,0.0901835595,0.909816441,355.4254172,400.6347288,638.8815789,507.1327434,1253,121.6504854,2506,-583680,57856,-525824,-1
7432,1910,20,10,0.204453008,0.795546992,2696.919236,2310.082665,4352.735872,5911.842932,9342,183.2483327,18684,-3805184,977920,-2827264,-1
224,52,25,5,0.188405797,0.811594203,78.67128686,81.38236828,142.7276786,120.2884615,276,20.23460411,552,-114688,26624,-88064,-1
313,51,27,3,0.14010989,0.85989011,105.3698588,98.56448308,187.1533546,153.9411765,364,12.85764747,728,-160256,26112,-134144,-1
7914,332,20,10,0.0402619452,0.959738055,2368.935287,2623.293092,4135.4372,3838.948795,8246,161.0232376,16492,-4051968,169984,-3881984,-1
9472,506,19,11,0.0507115654,0.949288435,2839.462397,3242.805601,5066.070524,3556.148221,9978,888.5129118,19956,-4849664,259072,-4590592,-1
2686,134,21,9,0.0475177305,0.95248227,811.6285499,841.1860461,1419.538719,1229.320896,2820,86.29130967,5640,-1375232,68608,-1306624,-1
2827,308,18,12,0.098245614,0.901754386,894.1414965,999.0926356,1567.035727,1576.850649,3135,62.5,6270,-1447424,157696,-1289728,-1
3596,201,25,5,0.0529365288,0.947063471,1081.833061,1146.067478,1935.239433,1250.656716,3797,232.374541,7594,-1841152,102912,-1738240,-1
2705,255,21,9,0.0861486486,0.913851351,844.1089801,944.6402981,1494.642144,1330.482353,2960,226.2996942,5920,-1384960,130560,-1254400,-1
393,72,18,12,0.15483871,0.84516129,130.150994,139.7269714,244.1552163,172.1111111,465,45.9486166,930,-201216,36864,-164352,-1
9328,631,20,10,0.0633597751,0.936640225,2844.944504,3163.389915,5038.2753,4118.522979,9959,706.3120567,19918,-4775936,323072,-4452864,-1
476,61,26,4,0.113594041,0.886405959,147.6477974,196.4480821,262.5630252,319.2295082,537,14.82606295,1074,-243712,31232,-212480,-1
2917,204,19,11,0.0653636655,0.934636335,902.3342811,880.1681861,1558.416524,1597.941176,3121,172.4309392,6242,-1493504,104448,-1389056,-1
3842,152,21,9,0.0380570856,0.961942914,1143.565979,1304.250335,2013.688704,1588.309211,3994,156.7503925,7988,-1967104,77824,-1889280,-1
1800,198,21,9,0.0990990991,0.900900901,569.9468178,604.6416134,979.0844444,1185.09596,1998,103.9542144,3996,-921600,101376,-820224,-1
6471,266,20,10,0.0394834496,0.96051655,1929.673989,2245.265882,3385.471025,2968.308271,6737,126.6115392,13474,-3313152,136192,-3176960,-1
2314,372,22,8,0.138495905,0.861504095,756.6424973,872.5171641,1323.200086,1469.774194,2686,80.46734572,5372,-1184768,190464,-994304,-1
9645,340,18,12,0.0340510766,0.965948923,2870.07966,3147.515202,5015.331363,4359.511765,9985,363.7522769,19970,-4938240,174080,-4764160,-1
5335,298,20,10,0.0529025386,0.947097461,1614.119403,1793.800835,2835.978444,2477.234899,5633,242.0713365,11266,-2731520,152576,-2578944,-1
107,14,18,12,0.115702479,0.884297521,33.31472506,33.67408317,64.74766355,32.35714286,121,26.30434783,242,-54784,7168,-47616,-1
2051,531,22,8,0.205654531,0.794345469,667.4595293,692.994797,1128.269625,1921.981168,2582,197.551645,5164,-1050112,271872,-778240,-1
657,89,20,10,0.119302949,0.880697051,204.3114859,268.2204444,361.6864536,460.7078652,746,30.44897959,1492,-336384,45568,-290816,-1
7249,849,21,9,0.104840701,0.895159299,2351.660547,2207.116641,4069.967996,3874.738516,8098,197.3677797,16196,-3711488,434688,-3276800,-1
9517,449,21,9,0.0450531808,0.954946819,2864.736589,2967.840808,5028.516759,4029.325167,9966,983.810464,19932,-4872704,229888,-4642816,-1
6021,438,18,12,0.0678123549,0.932187645,1835.201136,2190.116548,3200.809168,3631.273973,6459,304.5261669,12918,-3082752,224256,-2858496,-1
9586,391,19,11,0.0391901373,0.960809863,2871.015378,3088.534156,4996.853119,4796.468031,9977,1335.609103,19954,-4908032,200192,-4707840,-1
4248,281,21,9,0.0620446015,0.937955399,1279.756857,1668.264424,2270.640301,2179.733096,4529,244.9432125,9058,-2174976,143872,-2031104,-1
8664,604,20,10,0.0651704791,0.934829521,2664.063158,2831.442065,4642,4526.917219,9268,423.196347,18536,-4435968,309248,-4126720,-1
920,123,22,8,0.117929051,0.882070949,300.1833918,261.3251138,542.4141304,369.3089431,1043,19.64218456,2086,-471040,62976,-408064,-1
9390,564,25,5,0.0566606389,0.943339361,2855.246689,2819.258601,5060.963898,3587.914894,9954,582.7868852,19908,-4807680,288768,-4518912,-1
3071,222,20,10,0.0674157303,0.93258427,937.074228,1112.02195,1656.982091,1508.914414,3293,91.62493044,6586,-1572352,113664,-1458688,-1
9570,413,21,9,0.0413703296,0.95862967,2852.040243,3229.561976,5049.234692,3665.762712,9983,460.4704797,19966,-4899840,211456,-4688384,-1
9423,544,20,10,0.0545801144,0.945419886,2869.260518,2710.411731,5057.722594,3707,9967,552.1883657,19934,-4824576,278528,-4546048,-1
9483,481,20,10,0.0482737856,0.951726214,2859.670801,3111.421941,5016.77254,4306.810811,9964,1332.085561,19928,-4855296,246272,-4609024,-1
1584,122,22,8,0.0715123095,0.928487691,494.6644094,438.9593644,864.4703283,711.0655738,1706,148.9956332,3412,-811008,62464,-748544,-1
2911,342,27,3,0.105133723,0.894866277,939.7626741,932.6844626,1629.938853,1601.98538,3253,80.83996024,6506,-1490432,175104,-1315328,-1
913,67,21,9,0.0683673469,0.931632653,277.3779153,295.1379333,503.769989,309.6716418,980,129.1172596,1960,-467456,34304,-433152,-1
38,15,22,8,0.283018868,0.716981132,14.37796097,17.40676752,26.89473684,27.26666667,53,13.21695761,106,-19456,7680,-11776,-1
1893,282,20,10,0.129655172,0.870344828,617.4533874,683.9490583,1104.1458,979.6170213,2175,46.94582344,4350,-969216,144384,-824832,-1
5435,405,21,9,0.0693493151,0.930650685,1676.407955,1604.317589,2980.425575,2116.31358,5840,151.570205,11680,-2782720,207360,-2575360,-1
3775,177,20,10,0.0447874494,0.955212551,1141.109232,1082.892947,1992.105166,1643.677966,3952,348.8084731,7904,-1932800,90624,-1842176,-1
9462,500,19,11,0.0501907248,0.949809275,2864.730742,2862.908651,5039.63718,3881.312,9962,535.3036002,19924,-4844544,256000,-4588544,-1
7845,772,27,3,0.0895903447,0.910409655,2461.231758,2598.672401,4227.343276,5138.78886,8617,216.6708574,17234,-4016640,395264,-3621376,-1
38,16,18,12,0.296296296,0.703703704,14.58884805,17.33448514,28.81578947,24.375,54,18.75,108,-19456,8192,-11264,-1
9596,382,20,10,0.0382842253,0.961715775,2869.110283,3090.430342,5013.456961,4387.691099,9978,908.7431694,19956,-4913152,195584,-4717568,-1
7895,505,17,13,0.0601190476,0.939880952,2403.845124,2732.551223,4201.781001,4180.473267,8400,195.5762515,16800,-4042240,258560,-3783680,-1
189,83,20,10,0.305147059,0.694852941,76.17275918,81.77502249,142.8888889,121.9518072,272,5.931094636,544,-96768,42496,-54272,-1
9484,475,21,9,0.0476955518,0.952304448,2884.046322,2677.310324,4990.624842,4767.861053,9959,940.4154863,19918,-4855808,243200,-4612608,-1
2719,172,22,8,0.0594949844,0.940505016,826.2157177,888.2725878,1467.821626,1101.040698,2891,143.2606541,5782,-1392128,88064,-1304064,-1
9462,507,20,10,0.0508576587,0.949142341,2846.518921,3214.363388,5044.329,3877.759369,9969,1066.203209,19938,-4844544,259584,-4584960,-1
443,95,18,12,0.176579926,0.823420074,147.5412089,171.390638,284.2076749,200.9157895,538,84.99210111,1076,-226816,48640,-178176,-1
8591,808,21,9,0.0859665922,0.914033408,2690.012317,2949.095337,4700.57083,4693.930693,9399,347.5961538,18798,-4398592,413696,-3984896,-1
8003,459,23,7,0.0542424959,0.945757504,2414.181663,2577.616793,4305.156691,2947.24183,8462,361.1609048,16924,-4097536,235008,-3862528,-1
6445,704,19,11,0.0984753112,0.901524689,2039.740418,2234.958365,3532.806517,3961.274148,7149,211.1964549,14298,-3299840,360448,-2939392,-1
3990,272,21,9,0.0638198029,0.936180197,1212.980085,1437.064729,2149.017043,1874.540441,4262,304.4285714,8524,-2042880,139264,-1903616,-1
3201,182,20,10,0.0537984038,0.946201596,972.2975695,987.3883103,1711.620119,1346.923077,3383,244.2599278,6766,-1638912,93184,-1545728,-1
7368,363,17,13,0.0469538223,0.953046178,2211.331565,2457.239077,3908.582383,3001.683196,7731,294.8512586,15462,-3772416,185856,-3586560,-1
1270,152,22,8,0.106891702,0.893108298,399.1213935,464.2065945,731.0787402,547.9144737,1422,88.10408922,2844,-650240,77824,-572416,-1
4836,279,20,10,0.0545454545,0.945454545,1454.465447,1750.844402,2530.633375,3032.354839,5115,132.2388831,10230,-2476032,142848,-2333184,-1
4496,433,22,8,0.0878474336,0.912152566,1432.623578,1315.652646,2471.33363,2399.235566,4929,206.0618729,9858,-2301952,221696,-2080256,-1
9440,521,17,13,0.0523039855,0.947696014,2853.305948,2989.117325,5049.735169,3735.587332,9961,703.9575972,19922,-4833280,266752,-4566528,-1
3008,339,20,10,0.101284733,0.898715267,947.6299525,1117.236462,1671.398271,1697.085546,3347,129.2277992,6694,-1540096,173568,-1366528,-1
9264,684,20,10,0.0687575392,0.931242461,2856.175652,3073.731214,4980.261226,4896.47076,9948,489.326119,19896,-4743168,350208,-4392960,-1
6081,801,21,9,0.116390584,0.883609416,1964.92689,2124.738921,3405.536589,3714.525593,6882,163.1192226,13764,-3113472,410112,-2703360,-1
1511,102,18,12,0.0632362058,0.936763794,455.4158112,593.0274558,811.4003971,741.8137255,1613,30.37664783,3226,-773632,52224,-721408,-1
9385,577,20,10,0.0579200964,0.942079904,2842.116697,2991.547374,5074.936921,3461.733102,9962,859.5340811,19924,-4805120,295424,-4509696,-1
5762,298,19,11,0.0491749175,0.950825083,1738.257138,1924.766353,3046.84606,2714.439597,6060,126.5135699,12120,-2950144,152576,-2797568,-1
3837,295,25,5,0.0713939981,0.928606002,1180.011086,1292.999969,2094.790461,1698.532203,4132,78.96044334,8264,-1964544,151040,-1813504,-1
78,22,24,6,0.22,0.78,28.44551408,30.18715725,51.17948718,48.09090909,100,22.77904328,200,-39936,11264,-28672,-1
5741,550,21,9,0.0874264823,0.912573518,1800.128591,1845.8738,3081.807699,3816.050909,6291,149.0405117,12582,-2939392,281600,-2657792,-1
2713,273,21,9,0.0914266577,0.908573342,849.5274365,974.7552861,1500.099889,1427.912088,2986,126.4182896,5972,-1389056,139776,-1249280,-1
233,51,19,11,0.179577465,0.820422535,78.27732876,88.56480087,150.4077253,106.372549,284,19.9859254,568,-119296,26112,-93184,-1
4393,432,18,12,0.0895336788,0.910466321,1364.153853,1601.432145,2373.167767,2818.053241,4825,414.8753224,9650,-2249216,221184,-2028032,-1
2913,250,22,8,0.0790388871,0.920961113,903.8957334,964.4982595,1556.23172,1882.252,3163,215.6100886,6326,-1491456,128000,-1363456,-1
2974,349,27,3,0.105025579,0.894974421,932.3276316,1153.856257,1678.857767,1518.346705,3323,136.3561756,6646,-1522688,178688,-1344000,-1
539,30,21,9,0.0527240773,0.947275923,161.6470403,196.5995394,288.2523191,226.5666667,569,28.11264822,1138,-275968,15360,-260608,-1
9218,705,16,14,0.0710470624,0.928952938,2850.3477,3018.864358,4933.336949,5336.774468,9923,504.2174797,19846,-4719616,360960,-4358656,-1
8831,1056,20,10,0.106806918,0.893193082,2809.524259,3051.009482,4833.841241,5865.223485,9887,496.8341709,19774,-4521472,540672,-3980800,-1
352,59,18,12,0.143552311,0.856447689,114.4613138,110.4646815,219.6051136,124.8305085,411,43.67693943,822,-180224,30208,-150016,-1
3943,349,20,10,0.0813140727,0.918685927,1236.616457,1207.174125,2178.729394,1782.372493,4292,180.9443508,8584,-2018816,178688,-1840128,-1
547,70,20,10,0.113452188,0.886547812,169.7841438,212.6622065,320.5191956,218.9857143,617,26.58336924,1234,-280064,35840,-244224,-1
8029,514,21,9,0.060166218,0.939833782,2446.083488,2733.106426,4296.18894,3894.153696,8543,239.7698569,17086,-4110848,263168,-3847680,-1
672,50,23,7,0.0692520776,0.930747922,203.8638269,225.3588924,371.108631,232.36,722,41.04604889,1444,-344064,25600,-318464,-1
7323,402,17,13,0.052038835,0.947961165,2205.30871,2406.984789,3920.95084,2807.343284,7725,514.6568954,15450,-3749376,205824,-3543552,-1
243,57,20,10,0.19,0.81,85.12177059,89.00016427,155.9341564,127.3333333,300,13.67989056,600,-124416,29184,-95232,-1
1520,138,20,10,0.0832328106,0.916767189,470.6281378,554.6961132,823.3618421,897.1086957,1658,154.953271,3316,-778240,70656,-707584,-1
5868,274,27,3,0.0446108759,0.955389124,1768.217665,1852.287922,3084.298569,2797.405109,6142,416.6892809,12284,-3004416,140288,-2864128,-1
9545,426,18,12,0.0427238993,0.957276101,2862.935767,3093.175819,5022.640021,4165.039906,9971,1068.703108,19942,-4887040,218112,-4668928,-1
2318,275,21,9,0.106054763,0.893945237,742.6416438,768.7937474,1320.349008,1100.189091,2593,83.2423756,5186,-1186816,140800,-1046016,-1
47,18,22,8,0.276923077,0.723076923,18.55714383,19.12499496,33.80851064,30.88888889,65,8.322663252,130,-24064,9216,-14848,-1
6551,492,20,10,0.0698565952,0.930143405,1991.38347,2512.881757,3504.765227,3751.481707,7043,131.3257505,14086,-3354112,251904,-3102208,-1
4580,418,21,9,0.0836334534,0.916366547,1414.750574,1712.204606,2514.170306,2338.758373,4998,116.4220825,9996,-2344960,214016,-2130944,-1
447,47,21,9,0.0951417004,0.9048583,139.2904674,169.8480961,249.4362416,229.0851064,494,42.114237,988,-228864,24064,-204800,-1
7234,809,21,9,0.100584359,0.899415641,2310.518532,2394.16444,4059.748963,3684.45241,8043,286.8402282,16086,-3703808,414208,-3289600,-1
9241,698,20,10,0.0702283932,0.929771607,2838.834383,3103.912877,5038.634239,4061.333811,9939,618.4816428,19878,-4731392,357376,-4374016,-1
6078,536,18,12,0.0810402177,0.918959782,1893.97917,2052.985097,3281.955907,3597.158582,6614,190.4405413,13228,-3111936,274432,-2837504,-1
2064,236,21,9,0.102608696,0.897391304,649.929757,768.1303205,1138.661337,1254.038136,2300,69.27710843,4600,-1056768,120832,-935936,-1
4487,277,18,12,0.0581444165,0.941855584,1373.693194,1367.998677,2400.387118,2092.754513,4764,350.0367377,9528,-2297344,141824,-2155520,-1
738,69,16,14,0.0855018587,0.914498141,227.7008404,246.2872113,416.4945799,270.3623188,807,55.77055978,1614,-377856,35328,-342528,-1
257,38,26,4,0.128813559,0.871186441,84.13448632,87.59041628,151.7859922,122.3947368,295,29.35323383,590,-131584,19456,-112128,-1
898,106,22,8,0.105577689,0.894422311,285.4402349,305.1629958,514.8652561,397.745283,1004,66.05263158,2008,-459776,54272,-405504,-1
9589,387,22,8,0.0387931034,0.961206897,2865.908301,3061.186568,5026.111065,4056.581395,9976,1177.804014,19952,-4909568,198144,-4711424,-1
6553,662,22,8,0.0917532918,0.908246708,2067.347935,2207.591819,3638.289944,3308.166163,7215,211.9565217,14430,-3355136,338944,-3016192,-1
2578,763,21,9,0.228374738,0.771625262,891.0573186,987.4521299,1503.449185,2237.115334,3341,105.4941585,6682,-1319936,390656,-929280,-1
7439,668,20,10,0.0823979277,0.917602072,2267.391368,2319.637212,4222.489582,2177.661677,8107,258.0203692,16214,-3808768,342016,-3466752,-1
4959,686,19,11,0.121523472,0.878476528,1621.732954,1635.185899,2770.191168,3204.747813,5645,117.7022519,11290,-2539008,351232,-2187776,-1
7772,1052,21,9,0.119220308,0.880779692,2492.45492,2916.434337,4432.130082,4267.476236,8824,165.2434457,17648,-3979264,538624,-3440640,-1
5025,194,25,5,0.037171872,0.962828128,1496.090724,1675.974314,2629.972338,2092.675258,5219,569.1384951,10438,-2572800,99328,-2473472,-1
9267,693,20,10,0.0695783133,0.930421687,2877.046396,2790.742442,5022.365922,4420.656566,9960,565.9090909,19920,-4744704,354816,-4389888,-1
7580,666,18,12,0.0807664322,0.919233568,2384.699786,2309.435544,4096.792876,4427.463964,8246,187.281399,16492,-3880960,340992,-3539968,-1
4060,520,21,9,0.113537118,0.886462882,1292.066264,1335.188096,2198.74335,3006.907692,4580,226.3964409,9160,-2078720,266240,-1812480,-1
4106,345,24,6,0.0775106718,0.922489328,1266.066249,1484.801661,2236.795908,2097.513043,4451,88.68300458,8902,-2102272,176640,-1925632,-1
3202,184,20,10,0.0543414058,0.945658594,974.4940091,1025.557589,1697.118051,1630.538043,3386,345.8631256,6772,-1639424,94208,-1545216,-1
9549,429,19,11,0.0429945881,0.957005412,2866.404311,3057.729696,5027.238978,4149.477855,9978,1126.185102,19956,-4889088,219648,-4669440,-1
3394,354,18,12,0.0944503735,0.905549626,1067.719134,1162.875986,1907.677372,1556.409605,3748,130.5013928,7496,-1737728,181248,-1556480,-1
2258,161,27,3,0.0665564283,0.933443572,692.3566926,758.1527616,1221.701063,1045.89441,2419,225.6529851,4838,-1156096,82432,-1073664,-1
75,50,17,13,0.4,0.6,36.77002161,34.76460269,65.21333333,59.68,125,21.96836555,250,-38400,25600,-12800,-1
4162,1173,21,9,0.219868791,0.780131209,1477.659922,1473.106125,2435.786881,3491.930946,5335,102.0466718,10670,-2130944,600576,-1530368,-1
2753,644,27,3,0.18957904,0.81042096,993.7260097,919.7370274,1683.841264,1763.801242,3397,67.26732673,6794,-1409536,329728,-1079808,-1
9397,468,20,10,0.047440446,0.952559554,2832.478649,3111.679485,4953.188677,4527.630342,9865,399.5544755,19730,-4811264,239616,-4571648,-1
8931,965,21,9,0.0975141471,0.902485853,2825.403262,3130.130713,4959.03695,4850.981347,9896,616.1892902,19792,-4572672,494080,-4078592,-1
6684,638,21,9,0.0871346627,0.912865337,2087.635066,2368.043507,3668.766457,3585.373041,7322,160.8170437,14644,-3422208,326656,-3095552,-1
2056,252,18,12,0.109185442,0.890814558,659.1913611,721.221639,1156.169261,1140.880952,2308,43.17246539,4616,-1052672,129024,-923648,-1
1350,181,27,3,0.118223383,0.881776617,431.4593432,495.7774274,782.8681481,640.1878453,1531,91.34844869,3062,-691200,92672,-598528,-1
3656,368,22,8,0.0914512922,0.908548708,1148.735778,1249.420685,1984.649891,2289.184783,4024,190.9824395,8048,-1871872,188416,-1683456,-1
2294,196,21,9,0.0787148594,0.921285141,709.6374442,811.6834179,1236.880558,1346.382653,2490,96.96261682,4980,-1174528,100352,-1074176,-1
116,39,19,11,0.251612903,0.748387097,43.51444315,45.10257139,82.95689655,63.25641026,155,28.86405959,310,-59392,19968,-39424,-1
2463,187,20,10,0.0705660377,0.929433962,762.4478861,700.4966508,1353.433212,957.5882353,2650,122.9698376,5300,-1261056,95744,-1165312,-1
9504,461,22,8,0.0462619167,0.953738083,2864.483641,3043.347853,5014.878262,4325.796095,9965,811.4820847,19930,-4866048,236032,-4630016,-1
63,25,19,11,0.284090909,0.715909091,25.82708944,23.03472162,47.0952381,37.96,88,16.79389313,176,-32256,12800,-19456,-1
8998,914,20,10,0.0922114609,0.907788539,2854.17961,2921.086692,4933.210825,5185.773523,9912,541.6393443,19824,-4606976,467968,-4139008,-1
7179,531,22,8,0.0688715953,0.931128405,2200.888602,2339.344729,3925.617774,2907.52354,7710,314.9509804,15420,-3675648,271872,-3403776,-1
5017,337,20,10,0.0629435936,0.937056406,1517.277689,1744.84074,2729.282639,1906.599407,5354,611.1872146,10708,-2568704,172544,-2396160,-1
2196,163,20,10,0.069097075,0.930902925,671.6702864,734.2516073,1201.998179,883.6319018,2359,231.2745098,4718,-1124352,83456,-1040896,-1
307,21,21,9,0.0640243902,0.93597561,92.14934744,97.93688096,169.752443,87.71428571,328,43.32892999,656,-157184,10752,-146432,-1
388,23,18,12,0.0559610706,0.944038929,115.553963,138.6074273,210.8453608,124.2608696,411,116.1016949,822,-198656,11776,-186880,-1
469,63,27,3,0.118421053,0.881578947,150.4385053,173.0860365,269.8955224,241.2222222,532,24.50483648,1064,-240128,32256,-207872,-1
5851,248,20,10,0.0406624037,0.959337596,1749.272851,1995.423982,3060.044095,2813.032258,6099,377.8810409,12198,-2995712,126976,-2868736,-1
9581,399,20,10,0.0399799599,0.96002004,2881.263618,2826.238702,5011.814529,4478.684211,9980,738.7120651,19960,-4905472,204288,-4701184,-1
9525,441,21,9,0.0442504515,0.955749548,2852.814256,3087.866041,5042.984147,3698.723356,9966,1160.186263,19932,-4876800,225792,-4651008,-1
3418,278,21,9,0.0752164502,0.92478355,1058.077483,1027.535445,1892.340843,1309.478417,3696,199.4603346,7392,-1750016,142336,-1607680,-1
2366,161,24,6,0.0637119114,0.936288089,721.6801131,824.6379238,1272.955199,1132.397516,2527,164.4111906,5054,-1211392,82432,-1128960,-1
5455,428,27,3,0.0727519973,0.927248003,1695.035131,1641.096702,2985.473511,2387.915888,5883,248.5424588,11766,-2792960,219136,-2573824,-1
7021,543,21,9,0.0717874141,0.928212586,2156.261319,2508.692106,3787.736932,3714.786372,7564,430.261661,15128,-3594752,278016,-3316736,-1
6384,567,20,10,0.081570997,0.918429003,1953.431597,2426.478863,3415.31485,4159.269841,6951,153.1057269,13902,-3268608,290304,-2978304,-1
2742,1234,18,12,0.310362173,0.689637827,877.2299343,871.8199976,1490.630926,3094.786062,3976,95.34772182,7952,-1403904,631808,-772096,-1
6481,373,22,8,0.0544207762,0.945579224,1966.315046,2155.337139,3446.056473,3105.075067,6854,456.6289141,13708,-3318272,190976,-3127296,-1
7091,837,21,9,0.105575177,0.894424823,2239.41937,2663.176147,3944.370329,4135.037037,7928,149.078601,15856,-3630592,428544,-3202048,-1
1010,68,17,13,0.0630797774,0.936920223,303.5759345,374.1561336,550.0861386,382.2647059,1078,46.82884448,2156,-517120,34816,-482304,-1
9332,609,20,10,0.0612614425,0.938738557,2838.1548,3035.231478,5055.439456,3677.093596,9941,614.4004944,19882,-4777984,311808,-4466176,-1
9181,741,21,9,0.0746825237,0.925317476,2883.827402,2607.345921,4969.349199,4864.248313,9922,1008.333333,19844,-4700672,379392,-4321280,-1
3125,165,21,9,0.0501519757,0.949848024,946.1930851,973.7107379,1660.17248,1367.612121,3290,254.2503864,6580,-1600000,84480,-1515520,-1
9520,458,20,10,0.0459009822,0.954099018,2844.154751,3160.579835,5065.568487,3408.338428,9978,1171.126761,19956,-4874240,234496,-4639744,-1
3737,387,20,10,0.0938409311,0.906159069,1173.442768,1344.019878,2061.21247,2074.932817,4124,176.4655541,8248,-1913344,198144,-1715200,-1
5089,445,22,8,0.0804119986,0.919588001,1605.106856,1472.874118,2794.693456,2456.516854,5534,237.0021413,11068,-2605568,227840,-2377728,-1
719,130,25,5,0.153121319,0.846878681,240.27595,267.8611161,419.1724618,457.2307692,849,15.92273068,1698,-368128,66560,-301568,-1
1466,182,19,11,0.110436893,0.889563107,460.4705665,556.7607003,845.2701228,657.1978022,1648,135.5263158,3296,-750592,93184,-657408,-1
4573,559,21,9,0.108924396,0.891075604,1466.950818,1574.87745,2537.078723,2807.186047,5132,137.6978803,10264,-2341376,286208,-2055168,-1
707,69,17,13,0.0889175258,0.911082474,217.6969598,270.0290703,395.6223479,315.5217391,776,122.2047244,1552,-361984,35328,-326656,-1
5791,352,17,13,0.057300993,0.942699007,1750.188382,1793.198163,3138.526679,1977.522727,6143,375.030525,12286,-2964992,180224,-2784768,-1
1003,130,20,10,0.114739629,0.885260371,318.6254576,385.5414144,569.4227318,548.3076923,1133,44.55367676,2266,-513536,66560,-446976,-1
252,59,19,11,0.189710611,0.810289389,88.75424566,88.53504006,162.6706349,127.5084746,311,24.70214456,622,-129024,30208,-98816,-1
1784,159,18,12,0.0818322182,0.918167782,542.8342084,728.6219895,964.6597534,1054.358491,1943,168.9565217,3886,-913408,81408,-832000,-1
1427,94,19,11,0.0618014464,0.938198554,427.2541275,474.6519856,783.3728101,421.3617021,1521,126.6444629,3042,-730624,48128,-682496,-1
8728,335,22,8,0.0369634779,0.963036522,2610.797183,2704.567573,4551.733158,4017.877612,9063,676.8483943,18126,-4468736,171520,-4297216,-1
6320,1060,21,9,0.143631436,0.856368564,2128.844734,1998.94502,3571.99193,4397.076415,7380,164.0729213,14760,-3235840,542720,-2693120,-1
1361,132,27,3,0.0884125921,0.911587408,421.2847303,513.8973385,739.2718589,826.6818182,1493,101.5646259,2986,-696832,67584,-629248,-1
5844,329,22,8,0.0532966143,0.946703386,1771.504669,1931.996798,3104.734428,2771.984802,6173,486.4460205,12346,-2992128,168448,-2823680,-1
9585,393,22,8,0.0393866506,0.960613349,2866.809745,3058.526555,5026.487324,4087.40458,9978,964.9903288,19956,-4907520,201216,-4706304,-1
1914,172,21,9,0.0824544583,0.917545542,592.6153768,683.5186064,1056.422153,899.7034884,2086,196.2370649,4172,-979968,88064,-891904,-1
8107,556,21,9,0.0641809997,0.935819,2491.311622,2504.66775,4386.335389,3539.739209,8663,227.0773263,17326,-4150784,284672,-3866112,-1
4404,321,17,13,0.0679365079,0.932063492,1330.696184,1653.948703,2404.974114,1787.130841,4725,341.64859,9450,-2254848,164352,-2090496,-1
2962,205,21,9,0.0647300284,0.935269972,896.0569026,1051.695324,1614.320729,1145.902439,3167,60.58924813,6334,-1516544,104960,-1411584,-1
2926,233,21,9,0.0737575182,0.926242482,904.6705178,997.0870511,1584.135338,1528.06867,3159,108.6687307,6318,-1498112,119296,-1378816,-1
4106,274,18,12,0.0625570776,0.937442922,1252.992128,1251.580466,2234.439357,1532.051095,4380,120.1316511,8760,-2102272,140288,-1961984,-1
75,13,25,5,0.147727273,0.852272727,25.33503152,24.82697521,45.61333333,38.07692308,88,5.204021289,176,-38400,6656,-31744,-1
9287,643,25,5,0.0647532729,0.935246727,2860.224028,2926.603517,4937.504361,5369.847589,9930,523.1822972,19860,-4754944,329216,-4425728,-1
7634,423,19,11,0.0525009309,0.947499069,2308.013178,2573.338581,4057.523186,3514.234043,8057,150.9084098,16114,-3908608,216576,-3692032,-1
1860,168,22,8,0.0828402367,0.917159763,568.881064,731.9236255,1026.282258,884.0535714,2028,124.1886099,4056,-952320,86016,-866304,-1
5812,660,21,9,0.10197775,0.89802225,1882.279339,1714.921292,3204.562113,3517.74697,6472,163.9726374,12944,-2975744,337920,-2637824,-1
9553,419,21,9,0.0420176494,0.957982351,2856.573954,3215.215314,5025.803413,4090.400955,9972,688.1987578,19944,-4891136,214528,-4676608,-1
893,82,20,10,0.0841025641,0.915897436,275.4376184,337.9524678,491.4255319,450.695122,975,85.07853403,1950,-457216,41984,-415232,-1
8847,719,21,9,0.0751620322,0.924837968,2739.270376,2924.911526,4724.342828,5511.404729,9566,281.4357164,19132,-4529664,368128,-4161536,-1
5807,737,19,11,0.112622249,0.887377751,1872.746155,1998.640174,3243.57379,3500.416554,6544,162.5434675,13088,-2973184,377344,-2595840,-1
9515,450,27,3,0.0451580532,0.954841947,2861.788035,3092.351562,5016.179821,4281.431111,9965,538.3576445,19930,-4871680,230400,-4641280,-1
1915,224,20,10,0.104721833,0.895278167,603.2793719,640.2170027,1108.269452,742.8303571,2139,179.1457286,4278,-980480,114688,-865792,-1
9526,446,25,5,0.0447252306,0.955274769,2880.119053,2783.645992,5013.941633,4400.381166,9972,540.7809111,19944,-4877312,228352,-4648960,-1
1399,247,24,6,0.150060753,0.849939247,470.5384436,485.6160869,803.7626876,935.291498,1646,97.62752076,3292,-716288,126464,-589824,-1
3833,286,25,5,0.0694343287,0.930565671,1180.640306,1165.611333,2100.867467,1512.29021,4119,285.2493075,8238,-1962496,146432,-1816064,-1
9423,543,22,8,0.0544852498,0.94551475,2878.042523,2857.271254,4986.183487,4936.93186,9966,504.3522267,19932,-4824576,278016,-4546560,-1
42,12,25,5,0.222222222,0.777777778,14.62092822,18.18347846,26.54761905,30.83333333,54,10.44487427,108,-21504,6144,-15360,-1
73,18,24,6,0.197802198,0.802197802,25.44918662,29.22185255,46.61643836,43.5,91,13.16931983,182,-37376,9216,-28160,-1
62,22,21,9,0.261904762,0.738095238,23.26270031,26.82730969,42.5,42.5,84,21.9895288,168,-31744,11264,-20480,-1
1870,280,25,5,0.130232558,0.869767442,616.9675305,624.9764975,1053.393048,1223.142857,2150,105.6511057,4300,-957440,143360,-814080,-1
7451,587,21,9,0.0730281164,0.926971884,2291.629299,2521.049426,4083.457657,3207.662692,8038,217.7729613,16076,-3814912,300544,-3514368,-1
3026,224,19,11,0.0689230769,0.931076923,934.4201161,949.63343,1644.914408,1363.232143,3250,254.1047694,6500,-1549312,114688,-1434624,-1
3349,253,21,9,0.0702387562,0.929761244,1029.549346,1166.887349,1799.749179,1824.675889,3602,177.8765432,7204,-1714688,129536,-1585152,-1
3371,197,21,9,0.0552130045,0.944786996,1014.637681,1128.82131,1816.827054,1231.329949,3568,365.9487179,7136,-1725952,100864,-1625088,-1
123,16,18,12,0.115107914,0.884892086,37.74817148,37.35717593,74.95121951,31.9375,139,16.01382488,278,-62976,8192,-54784,-1
6751,439,18,12,0.0610570236,0.938942976,2043.535333,2351.974817,3652.059102,2725.726651,7190,392.4672489,14380,-3456512,224768,-3231744,-1
8090,1122,17,13,0.121797655,0.878202345,2644.919149,2637.755611,4500.669098,5369.576649,9212,239.5215809,18424,-4142080,574464,-3567616,-1
2577,144,20,10,0.05292172,0.94707828,774.9695237,925.0940547,1373.734575,1133.104167,2721,149.8348018,5442,-1319424,73728,-1245696,-1
5467,572,18,12,0.0947176685,0.905282332,1715.417688,1845.638051,2945.852936,3728.674825,6039,147.2926829,12078,-2799104,292864,-2506240,-1
4630,523,18,12,0.101494275,0.898505725,1489.014333,1454.906446,2602.621382,2350.179732,5153,144.9915588,10306,-2370560,267776,-2102784,-1
1302,140,23,7,0.0970873786,0.902912621,414.2293964,428.8739173,728.7995392,653.6142857,1442,73.83512545,2884,-666624,71680,-594944,-1
9376,580,17,13,0.0582563278,0.941743672,2865.42893,2824.515362,5040.947312,3969.006897,9956,908.3941606,19912,-4800512,296960,-4503552,-1
4756,565,22,8,0.106183048,0.893816952,1514.042736,1680.176789,2696.730446,2360.231858,5321,304.0571429,10642,-2435072,289280,-2145792,-1
6097,1337,24,6,0.179849341,0.820150659,2135.413597,2078.865255,3578.402329,4351.81451,7434,145.1953125,14868,-3121664,684544,-2437120,-1
5391,373,21,9,0.0647120056,0.935287994,1647.405606,1880.328732,2892.764422,2734.147453,5764,169.6791286,11528,-2760192,190976,-2569216,-1
2554,176,22,8,0.0644688645,0.935531136,784.3393505,828.527723,1374.935787,1228.573864,2730,55.07363325,5460,-1307648,90112,-1217536,-1
412,40,18,12,0.0884955752,0.911504425,126.2236789,131.7152967,236.1917476,126.675,452,15.45299145,904,-210944,20480,-190464,-1
5633,458,20,10,0.0751929076,0.924807092,1744.706867,1740.830572,3108.928102,2272.039301,6091,172.2080859,12182,-2884096,234496,-2649600,-1
9310,633,22,8,0.0636628784,0.936337122,2822.82022,3478.334732,4994.325242,4643.64613,9943,710.7219442,19886,-4766720,324096,-4442624,-1
230,31,21,9,0.118773946,0.881226054,73.03391242,70.74292837,138.173913,77.77419355,261,15.87591241,522,-117760,15872,-101888,-1
9597,380,20,10,0.0380876015,0.961912399,2872.504093,3049.406002,5001.368865,4676.621053,9977,1330.266667,19954,-4913664,194560,-4719104,-1
9583,392,20,10,0.0392982456,0.960701754,2855.197198,3193.557851,5037.183972,3785.627551,9975,961.9093539,19950,-4906496,200704,-4705792,-1
105,21,18,12,0.166666667,0.833333333,34.74761089,22.52738319,70.31428571,29.42857143,126,26.08695652,252,-53760,10752,-43008,-1
1489,253,20,10,0.145235362,0.854764638,497.3203982,513.3938046,848.2068502,1008.588933,1742,90.11898603,3484,-762368,129536,-632832,-1
9535,440,21,9,0.0441102757,0.955889724,2852.595257,3124.439731,5049.793603,3648.904545,9975,492.1065614,19950,-4881920,225280,-4656640,-1
63,21,18,12,0.25,0.75,24.27956142,21.5417119,45.65079365,33.04761905,84,16.86746988,168,-32256,10752,-21504,-1
67,26,16,14,0.279569892,0.720430108,27.33736004,22.18377386,51.1641791,36.26923077,93,19.45606695,186,-34304,13312,-20992,-1
3845,455,22,8,0.105813953,0.894186047,1196.187163,1571.625922,2149.23355,2161.202198,4300,84.72906404,8600,-1968640,232960,-1735680,-1
1724,84,21,9,0.046460177,0.953539823,513.9821521,594.433673,918.6073086,614.9642857,1808,146.8724614,3616,-882688,43008,-839680,-1
5796,487,21,9,0.0775107433,0.922489257,1810.822893,1833.160403,3123.024672,3367.833676,6283,208.8763298,12566,-2967552,249344,-2718208,-1
1819,82,17,13,0.043135192,0.956864808,541.9225621,617.2279109,963.9230346,664.3292683,1901,500.2631579,3802,-931328,41984,-889344,-1
9590,389,21,9,0.0389818619,0.961018138,2874.514029,2996.679595,5007.533681,4557.742931,9979,806.0581583,19958,-4910080,199168,-4710912,-1
1670,77,21,9,0.0440755581,0.955924442,498.015047,612.390221,879.7508982,749.2727273,1747,90.65905553,3494,-855040,39424,-815616,-1
6108,1202,21,9,0.164432285,0.835567715,2077.16978,2100.533504,3500.347413,4443.912646,7310,167.545267,14620,-3127296,615424,-2511872,-1
5154,274,21,9,0.0504789978,0.949521002,1552.815024,1791.660534,2728.539193,2450.419708,5428,352.0103761,10856,-2638848,140288,-2498560,-1
8995,618,21,9,0.0642879434,0.935712057,2750.579214,3107.143881,4814.653252,4695.606796,9613,275.6020642,19226,-4605440,316416,-4289024,-1
957,74,23,7,0.0717749758,0.928225024,289.7843716,384.1650371,514.2507837,538.6216216,1031,93.05054152,2062,-489984,37888,-452096,-1
8530,460,27,3,0.0511679644,0.948832036,2575.552676,2819.632697,4538.417702,3699.656522,8990,332.2246859,17980,-4367360,235520,-4131840,-1
3096,258,22,8,0.0769230769,0.923076923,948.340258,1180.486409,1680.055556,1646.833333,3354,205.6407112,6708,-1585152,132096,-1453056,-1
8557,631,21,9,0.0686765346,0.931323465,2637.930081,2824.103884,4572.718476,4889.879556,9188,297.828201,18376,-4381184,323072,-4058112,-1
3000,257,21,9,0.0789069696,0.92109303,927.9781308,1072.119352,1632.097333,1592.844358,3257,110.7823129,6514,-1536000,131584,-1404416,-1
2002,244,20,10,0.108637578,0.891362422,637.9412274,720.6502729,1135.592907,1024.278689,2246,218.2701652,4492,-1025024,124928,-900096,-1
852,103,23,7,0.107853403,0.892146597,272.4662295,300.7029123,479.5,465.592233,955,31.00649351,1910,-436224,52736,-383488,-1
1359,162,19,11,0.106508876,0.893491124,422.5587617,558.6505765,761.9852833,752.7345679,1521,111.4285714,3042,-695808,82944,-612864,-1
1709,182,20,10,0.0962453728,0.903754627,533.8352906,637.9187085,934.3622001,1055.28022,1891,58.87297634,3782,-875008,93184,-781824,-1
6185,371,19,11,0.0565893838,0.943410616,1886.887749,1956.577409,3259.124656,3601.509434,6556,266.0714286,13112,-3166720,189952,-2976768,-1
277,45,18,12,0.139751553,0.860248447,90.17638795,101.8530435,167.1299639,126.8444444,322,32.75686673,644,-141824,23040,-118784,-1
9413,543,18,12,0.0545399759,0.945460024,2867.310726,2977.692458,4992.7138,4732.101289,9956,1012.817904,19912,-4819456,278016,-4541440,-1
7438,2243,21,9,0.231690941,0.768309059,2671.188388,2423.971697,4301.06534,6631.474365,9681,189.0820313,19362,-3808256,1148416,-2659840,-1
77,12,26,4,0.134831461,0.865168539,25.92468691,23.67957395,45.67532468,40.66666667,89,9.222797927,178,-39424,6144,-33280,-1
59,16,24,6,0.213333333,0.786666667,22.4320225,17.30065028,39.55932203,32.25,75,2.224199288,150,-30208,8192,-22016,-1
110,29,20,10,0.208633094,0.791366906,39.79778328,40.46078238,71.99090909,62.44827586,139,6.387867647,278,-56320,14848,-41472,-1
6319,464,20,10,0.0684063099,0.93159369,1934.103083,2242.27249,3411.717993,3123.469828,6783,220.441989,13566,-3235328,237568,-2997760,-1
1277,176,22,8,0.121128699,0.878871301,416.7020953,400.6585881,750.1299922,559.1761364,1453,207.8683834,2906,-653824,90112,-563712,-1
6767,672,17,13,0.0903347224,0.909665278,2109.563235,2386.235025,3650.286833,4422.00744,7439,601.3742926,14878,-3464704,344064,-3120640,-1
1241,178,21,9,0.125440451,0.874559549,399.9211685,468.0534665,702.0419017,765.4831461,1419,65.57301294,2838,-635392,91136,-544256,-1
9178,743,16,14,0.074891644,0.925108356,2845.844682,2881.800193,5045.370887,3918.798116,9921,845.0596252,19842,-4699136,380416,-4318720,-1
2403,165,21,9,0.0642523364,0.935747664,737.8191707,781.1331584,1292.565959,1167.030303,2568,190.504451,5136,-1230336,84480,-1145856,-1
8526,1341,17,13,0.135907571,0.864092429,2850.798636,2658.865871,4791.113066,5842.466816,9867,598.362644,19734,-4365312,686592,-3678720,-1
4565,251,20,10,0.0521179402,0.94788206,1375.280645,1446.421855,2449.76035,1658.087649,4816,97.45042493,9632,-2337280,128512,-2208768,-1
94,29,21,9,0.235772358,0.764227642,36.94289973,25.54700035,66.43617021,47.62068966,123,41.97952218,246,-48128,14848,-33280,-1
3001,208,21,9,0.0648177002,0.9351823,915.6311126,1067.737073,1608.772409,1550.572115,3209,111.0380623,6418,-1536512,106496,-1430016,-1
3351,176,22,8,0.0499007655,0.950099234,1003.497003,1188.06309,1786.282602,1339.744318,3527,207.5927016,7054,-1715712,90112,-1625600,-1
984,107,27,3,0.0980751604,0.90192484,310.4712346,353.311051,545.0264228,554.953271,1091,46.17012273,2182,-503808,54784,-449024,-1
3447,441,21,9,0.113425926,0.886574074,1126.942946,1067.399106,1968.578474,1756.294785,3888,97.41919318,7776,-1764864,225792,-1539072,-1
96,25,18,12,0.20661157,0.79338843,34.66515797,24.05872815,67.1875,37.24,121,15.125,242,-49152,12800,-36352,-1
7289,686,24,6,0.0860188088,0.913981191,2237.932738,2739.095792,3902.787762,4893.411079,7975,171.2843643,15950,-3731968,351232,-3380736,-1
4412,299,19,11,0.063468478,0.936531522,1330.294514,1718.08898,2338.06301,2620.675585,4711,122.6184279,9422,-2258944,153088,-2105856,-1
284,22,20,10,0.0718954248,0.928104575,85.74006413,88.54461452,159.1795775,80.18181818,306,26.88927944,612,-145408,11264,-134144,-1
4932,351,25,5,0.066439523,0.933560477,1518.344439,1470.283825,2688.217153,1992.589744,5283,216.4276936,10566,-2525184,179712,-2345472,-1
7893,361,22,8,0.0437363702,0.95626363,2365.933456,2723.916708,4128.917268,4096.512465,8254,776.4816557,16508,-4041216,184832,-3856384,-1
6421,857,21,9,0.11775213,0.88224787,2032.80914,2217.3297,3480.486373,4830.896149,7278,150.3408387,14556,-3287552,438784,-2848768,-1
912,101,17,13,0.09970385,0.90029615,283.0446294,357.4575124,515.4692982,430.5247525,1013,73.94160584,2026,-466944,51712,-415232,-1
7018,289,26,4,0.0395511154,0.960448885,2106.359528,2134.10556,3672.093759,3214.615917,7307,898.7699877,14614,-3593216,147968,-3445248,-1
1608,213,21,9,0.116968699,0.883031301,515.3497214,587.0783041,925.1050995,804.5164319,1821,84.8555452,3642,-823296,109056,-714240,-1
4927,547,26,4,0.0999269273,0.900073073,1561.686911,1697.214552,2777.002436,2381.689214,5474,300.6040637,10948,-2522624,280064,-2242560,-1
2680,266,18,12,0.0902919212,0.909708079,831.1899719,951.1431676,1509.506343,1110.729323,2946,186.5737809,5892,-1372160,136192,-1235968,-1
1518,221,17,13,0.127084531,0.872915469,498.2230859,519.5742558,857.8017128,953.7873303,1739,137.1451104,3478,-777216,113152,-664064,-1
5245,227,22,8,0.0414839181,0.958516082,1568.734225,1767.802925,2753.593518,2341.54185,5472,527.6759884,10944,-2685440,116224,-2569216,-1
7810,909,16,14,0.104255075,0.895744925,2460.948701,2723.495829,4233.769654,5444.553355,8719,164.4473783,17438,-3998720,465408,-3533312,-1
61,32,17,13,0.344086022,0.655913978,24.33330327,31.0684099,46.70491803,47.5625,93,4.841228527,186,-31232,16384,-14848,-1
4499,200,20,10,0.0425622473,0.957437753,1347.789411,1452.495586,2372.147588,1851.79,4699,689.0029326,9398,-2303488,102400,-2201088,-1
5197,607,21,9,0.104583046,0.895416954,1664.20802,1746.512539,2871.449683,3168.345964,5804,129.0638203,11608,-2660864,310784,-2350080,-1
7991,633,20,10,0.0733998145,0.926600186,2456.482057,2838.436547,4277.992742,4748.120063,8624,220.1123022,17248,-4091392,324096,-3767296,-1
4914,293,20,10,0.0562704052,0.943729595,1482.725036,1808.46071,2610.00814,2503.235495,5207,100.6378044,10414,-2515968,150016,-2365952,-1
9637,348,22,8,0.0348522784,0.965147722,2876.188903,3001.693822,5012.171941,4462.08046,9985,902.8028933,19970,-4934144,178176,-4755968,-1
9089,856,20,10,0.0860734037,0.913926596,2858.964466,2743.036005,5081.126967,3824.908879,9945,934.6804511,19890,-4653568,438272,-4215296,-1
48,32,18,12,0.4,0.6,22.19843236,24.35381692,40.02083333,41.21875,80,18.01801802,160,-24576,16384,-8192,-1
2596,121,18,12,0.044534413,0.955465587,774.5327319,941.67621,1369.790832,1127.487603,2717,347.8873239,5434,-1329152,61952,-1267200,-1
9517,453,19,11,0.0454363089,0.954563691,2879.708233,2814.250248,5004.549228,4585.298013,9970,956.8138196,19940,-4872704,231936,-4640768,-1
39,17,21,9,0.303571429,0.696428571,15.32016414,17.91502433,28.1025641,29.41176471,56,6.837606838,112,-19968,8704,-11264,-1
7152,853,21,9,0.106558401,0.893441599,2280.166617,2551.042536,4015.892617,3894.901524,8005,150.4982139,16010,-3661824,436736,-3225088,-1
455,57,23,7,0.111328125,0.888671875,140.6143794,191.3315445,251.5120879,296.3157895,512,15.11662238,1024,-232960,29184,-203776,-1
463,67,23,7,0.126415094,0.873584906,144.4986131,194.7701148,258.1598272,316.2238806,530,15.40697674,1060,-237056,34304,-202752,-1
6462,321,19,11,0.0473241928,0.952675807,1942.673098,2242.92951,3386.374652,3505.242991,6783,271.4285714,13566,-3308544,164352,-3144192,-1
2871,180,27,3,0.0589970501,0.94100295,863.6850903,1072.360856,1545.281087,1218.466667,3051,57.74034822,6102,-1469952,92160,-1377792,-1
3064,216,20,10,0.0658536585,0.934146341,928.3366331,1105.168958,1668.402742,1244.694444,3280,234.4531808,6560,-1568768,110592,-1458176,-1
5544,266,20,10,0.0457831325,0.954216867,1665.667296,1825.169536,2930.540765,2383.597744,5810,377.2727273,11620,-2838528,136192,-2702336,-1
3683,113,27,3,0.029768177,0.970231823,1095.492131,1105.666562,1899.484116,1866.424779,3796,72.41510874,7592,-1885696,57856,-1827840,-1
2533,315,21,9,0.110603933,0.889396067,810.2569285,911.3984175,1420.189499,1459.161905,2848,95.79549277,5696,-1296896,161280,-1135616,-1
5363,610,20,10,0.102126235,0.897873765,1703.911947,1886.776877,3004.483871,2833.285246,5973,367.3431734,11946,-2745856,312320,-2433536,-1
2080,188,21,9,0.0828924162,0.917107584,641.8735884,779.6908039,1128.410577,1201.87234,2268,83.44370861,4536,-1064960,96256,-968704,-1
410,49,23,7,0.106753813,0.893246187,126.2915935,176.038493,229.5731707,233.5714286,459,12.85354243,918,-209920,25088,-184832,-1
5108,300,21,9,0.0554733728,0.944526627,1537.33974,1771.608012,2747.024471,1980.45,5408,135.3353353,10816,-2615296,153600,-2461696,-1
3888,544,22,8,0.122743682,0.877256318,1249.424608,1475.047371,2223.719393,2164.902574,4432,277.1732333,8864,-1990656,278528,-1712128,-1
2489,362,21,9,0.126972992,0.873027008,805.3002399,913.3021629,1398.304942,1616.422652,2851,61.01005778,5702,-1274368,185344,-1089024,-1
429,47,27,3,0.0987394958,0.901260504,134.8970865,141.6777118,245.8927739,171.0212766,476,41.21212121,952,-219648,24064,-195584,-1
6184,254,21,9,0.0394532463,0.960546754,1847.608223,2004.970769,3245.463616,2587.377953,6438,607.3584906,12876,-3166208,130048,-3036160,-1
5897,491,21,9,0.0768628679,0.923137132,1825.559408,1980.725481,3237.765983,2674.867617,6388,133.9203354,12776,-3019264,251392,-2767872,-1
812,85,17,13,0.0947603122,0.905239688,253.048123,306.4345685,453.4236453,406.7411765,897,130.9489051,1794,-415744,43520,-372224,-1
5077,554,21,9,0.098383946,0.901616054,1654.476653,1226.473147,2869.638763,2324.440433,5631,250.9358289,11262,-2599424,283648,-2315776,-1
126,30,19,11,0.192307692,0.807692308,43.82197388,31.21696476,86.8015873,43.63333333,156,44.44444444,312,-64512,15360,-49152,-1
5844,476,21,9,0.0753164557,0.924683544,1796.313788,1891.412306,3238.855065,2198.510504,6320,296.9924812,12640,-2992128,243712,-2748416,-1
981,78,23,7,0.0736543909,0.926345609,299.2009221,377.930133,530.8440367,519.3846154,1059,84.51715882,2118,-502272,39936,-462336,-1
2405,134,21,9,0.0527766837,0.947223316,723.8907901,872.1390555,1276.266112,1157.537313,2539,307.0133011,5078,-1231360,68608,-1162752,-1
344,49,15,15,0.124681934,0.875318066,109.4267147,95.78358311,210.3197674,103.4897959,393,41.67550371,786,-176128,25088,-151040,-1
2280,230,21,9,0.0916334661,0.908366534,700.6547082,917.2195487,1269.651316,1115.217391,2510,119.0702087,5020,-1167360,117760,-1049600,-1
9229,717,21,9,0.0720892821,0.927910718,2848.662537,3119.401254,5004.308267,4576.945607,9946,605.7247259,19892,-4725248,367104,-4358144,-1
9094,830,19,11,0.0836356308,0.916364369,2796.264618,3111.680718,4816.922916,6557.533735,9924,605.8608059,19848,-4656128,424960,-4231168,-1
1773,260,21,9,0.127889818,0.872110182,576.8633235,650.7141398,1019.929498,997.0230769,2033,48.7529976,4066,-907776,133120,-774656,-1
5150,741,27,3,0.125785096,0.874214904,1689.861208,1668.083282,2865.037087,3508.697706,5891,219.240789,11782,-2636800,379392,-2257408,-1
3858,403,25,5,0.0945787374,0.905421263,1209.863356,1393.842591,2151.273717,1936.915633,4261,96.66515426,8522,-1975296,206336,-1768960,-1
9500,471,21,9,0.0472369873,0.952763013,2869.847499,2944.618317,5023.595789,4227.698514,9971,547.8571429,19942,-4864000,241152,-4622848,-1
4616,333,20,10,0.0672863205,0.93271368,1415.438028,1413.631088,2527.308925,1749.900901,4949,264.7940075,9898,-2363392,170496,-2192896,-1
5449,329,21,9,0.0569401177,0.943059882,1653.657942,1808.858731,2921.465774,2360.072948,5778,439.7260274,11556,-2789888,168448,-2621440,-1
2826,158,22,8,0.0529490617,0.947050938,853.9886045,941.0076856,1508.280609,1210.246835,2984,228.1345566,5968,-1446912,80896,-1366016,-1
6228,510,22,8,0.0756901158,0.924309884,1899.112631,2314.501251,3309.284522,4104.837255,6738,148.2182138,13476,-3188736,261120,-2927616,-1
9551,419,21,9,0.0420260782,0.957973922,2866.83117,3121.569717,4990.533347,4870.76611,9970,1032.091097,19940,-4890112,214528,-4675584,-1
61,31,19,11,0.336956522,0.663043478,26.28373493,26.99269566,47.42622951,44.67741935,92,14.95934959,184,-31232,15872,-15360,-1
47,10,22,8,0.175438596,0.824561404,15.76488066,16.28649747,31.0212766,19.5,57,2.837232454,114,-24064,5120,-18944,-1
160,28,22,8,0.14893617,0.85106383,53.38697758,45.00663216,100.675,59.21428571,188,5.094850949,376,-81920,14336,-67584,-1
9400,547,27,3,0.0549914547,0.945008545,2865.55691,2884.540885,5014.231596,4282.634369,9947,1551.794072,19894,-4812800,280064,-4532736,-1
4187,379,20,10,0.0830048182,0.916995182,1291.520732,1523.990308,2246.641271,2690.69657,4566,86.65780983,9132,-2143744,194048,-1949696,-1
9540,427,27,3,0.0428413765,0.957158623,2872.813228,2973.648459,4981.76195,5034.002342,9967,1446.58926,19934,-4884480,218624,-4665856,-1
3103,284,21,9,0.0838500148,0.916149985,966.8221187,1089.744609,1695.877538,1673.485915,3387,87.29381443,6774,-1588736,145408,-1443328,-1
2358,211,21,9,0.0821331257,0.917866874,735.9624762,758.7045549,1307.279898,1036.014218,2569,148.9275362,5138,-1207296,108032,-1099264,-1
9445,516,20,10,0.0518020279,0.948197972,2860.17973,2966.647436,5036.161249,3971.313953,9961,548.5132159,19922,-4835840,264192,-4571648,-1
5991,614,21,9,0.0929598789,0.907040121,1912.350524,1798.616675,3260.466032,3718.017915,6605,152.4348027,13210,-3067392,314368,-2753024,-1
3500,282,22,8,0.0745637229,0.925436277,1093.622727,970.4056198,1926.163429,1461.280142,3782,125.6061109,7564,-1792000,144384,-1647616,-1
4794,437,22,8,0.083540432,0.916459568,1490.949505,1666.609904,2647.684606,2268.411899,5231,304.127907,10462,-2454528,223744,-2230784,-1
9502,463,21,9,0.0464626192,0.953537381,2867.344123,2976.799554,5016.996106,4285.308855,9965,612.4769514,19930,-4865024,237056,-4627968,-1
9599,360,27,3,0.0361482077,0.963851792,2865.225596,3070.03659,5000.929784,4421.930556,9959,268.4366577,19918,-4914688,184320,-4730368,-1
6105,328,22,8,0.0509870978,0.949012902,1829.079974,2269.599446,3241.344308,2763.884146,6433,384.0597015,12866,-3125760,167936,-2957824,-1
47,24,19,11,0.338028169,0.661971831,21.40816766,17.69867384,38.34042553,31.41666667,71,17.40196078,142,-24064,12288,-11776,-1
5276,434,22,8,0.0760070053,0.923992995,1634.070859,1723.100881,2810.972517,3396.806452,5710,326.4722699,11420,-2701312,222208,-2479104,-1
6520,282,19,11,0.0414583946,0.958541605,1955.898153,2068.209555,3423.632362,2889.787234,6802,527.2868217,13604,-3338240,144384,-3193856,-1
2055,175,27,3,0.0784753363,0.921524664,638.7379069,685.8193494,1126.908029,981.5371429,2230,66.13285884,4460,-1052160,89600,-962560,-1
9662,328,17,13,0.0328328328,0.967167167,2873.796489,3120.737038,5013.331608,4470.228659,9990,647.4400518,19980,-4946944,167936,-4779008,-1
3217,267,20,10,0.0766360505,0.923363949,999.7722854,1074.637579,1744.994094,1712.449438,3484,136.5738926,6968,-1647104,136704,-1510400,-1
2747,283,20,10,0.0933993399,0.90660066,865.9890149,918.6479711,1541.098289,1267.024735,3030,103.7671233,6060,-1406464,144896,-1261568,-1
3197,359,21,9,0.10095613,0.89904387,1017.214814,1105.807682,1776.203316,1798.952646,3556,237.8595318,7112,-1636864,183808,-1453056,-1
4370,382,16,14,0.0803872054,0.919612795,1348.385304,1607.022885,2362.624027,2535.23822,4752,288.1746513,9504,-2237440,195584,-2041856,-1
5845,418,17,13,0.0667411783,0.933258822,1782.187589,2031.364447,3177.65834,2493.547847,6263,585.3271028,12526,-2992640,214016,-2778624,-1
1377,157,18,12,0.102346806,0.897653194,433.9895361,470.9311739,789.7138707,572.6687898,1534,142.9636533,3068,-705024,80384,-624640,-1
6448,485,18,12,0.0699552863,0.930044714,1962.787076,2429.959426,3440.342742,3821.404124,6933,127.3044436,13866,-3301376,248320,-3053056,-1
8579,425,16,14,0.0472012439,0.952798756,2574.854873,2958.584743,4538.319385,3779.454118,9004,685.7578065,18008,-4392448,217600,-4174848,-1
7972,368,20,10,0.0441247002,0.9558753,2413.930049,2251.555929,4181.598721,3930.067935,8340,711.6040956,16680,-4081664,188416,-3893248,-1
2681,232,27,3,0.0796429797,0.92035702,833.6612522,829.8794856,1490.07348,1074.801724,2913,83.37149399,5826,-1372672,118784,-1253888,-1
1137,129,27,3,0.101895735,0.898104265,361.7020778,396.7327022,631.7396658,649.0155039,1266,143.7003405,2532,-582144,66048,-516096,-1
3566,132,27,3,0.0356949703,0.96430503,1065.041778,1116.825937,1856.310993,1665.5,3698,363.976378,7396,-1825792,67584,-1758208,-1
2150,307,20,10,0.124949125,0.875050875,686.241117,843.5306149,1211.770698,1349.661238,2457,76.49439601,4914,-1100800,157184,-943616,-1
65,24,20,10,0.269662921,0.730337079,26.68307976,19.28257525,48.83076923,34.625,89,16.39042357,178,-33280,12288,-20992,-1
5662,381,21,9,0.0630481549,0.936951845,1725.586078,1894.086417,3064.666019,2387.944882,6043,257.0395576,12086,-2898944,195072,-2703872,-1
6703,695,21,9,0.0939443093,0.906055691,2093.397092,2498.853985,3680.08623,3886.738129,7398,235.7552581,14796,-3431936,355840,-3076096,-1
2223,221,18,12,0.0904255319,0.909574468,695.2327784,744.8818479,1250.608187,939.7647059,2444,48.76296887,4888,-1138176,113152,-1025024,-1
6163,597,22,8,0.0883136095,0.911686391,1927.431938,2181.795253,3389.470712,3287.892797,6760,331.0479922,13520,-3155456,305664,-2849792,-1
9404,557,21,9,0.0559180805,0.944081919,2852.397441,2943.886435,5058.968737,3664.630162,9961,704.9539986,19922,-4814848,285184,-4529664,-1
2964,450,21,9,0.131810193,0.868189807,963.9292874,1108.016811,1728.016194,1572.366667,3414,263.6293436,6828,-1517568,230400,-1287168,-1
5228,366,16,14,0.0654272435,0.934572757,1609.71336,1636.749302,2825.01798,2404.428962,5594,118.7937991,11188,-2676736,187392,-2489344,-1
952,109,25,5,0.10273327,0.89726673,302.4882355,335.5154291,535.0903361,495.2752294,1061,124.9705536,2122,-487424,55808,-431616,-1
4789,416,24,6,0.0799231508,0.920076849,1494.383444,1578.557578,2621.201086,2393.46875,5205,155.6984744,10410,-2451968,212992,-2238976,-1
9085,828,20,10,0.0835266821,0.916473318,2806.672443,3254.099763,4868.958063,5923.0157,9913,592.8827751,19826,-4651520,423936,-4227584,-1
2599,265,20,10,0.092527933,0.907472067,816.2993882,906.4749773,1415.536745,1598.867925,2864,176.1377614,5728,-1330688,135680,-1195008,-1
7709,476,25,5,0.0581551619,0.941844838,2328.105825,2755.118139,4140.501881,3323.689076,8185,302.9237602,16370,-3947008,243712,-3703296,-1
9394,554,21,9,0.0556895858,0.944310414,2860.478422,2919.853658,5026.267618,4096.693141,9948,1346.143437,19896,-4809728,283648,-4526080,-1
3341,347,20,10,0.0940889371,0.905911063,1040.491072,1272.072292,1837.781503,1909.18732,3688,150.5920784,7376,-1710592,177664,-1532928,-1
6018,323,20,10,0.0509383378,0.949061662,1807.729829,1936.875,3226.87554,2129.950464,6341,604.4804576,12682,-3081216,165376,-2915840,-1
1616,143,19,11,0.081296191,0.918703809,506.8870026,459.5888215,900.2233911,651.4615385,1759,107.4526573,3518,-827392,73216,-754176,-1
1798,162,20,10,0.0826530612,0.917346939,562.2071537,575.358917,996.4393771,803.5925926,1960,99.74554707,3920,-920576,82944,-837632,-1
3867,415,21,9,0.0969173284,0.903082672,1218.764366,1360.567411,2113.84691,2399.173494,4282,147.4010327,8564,-1979904,212480,-1767424,-1
9440,517,18,12,0.0519232701,0.94807673,2865.01021,3031.753661,4990.663136,4766.040619,9957,739.7473997,19914,-4833280,264704,-4568576,-1
4479,204,22,8,0.0435618193,0.956438181,1335.779337,1526.376182,2371.779192,1688.171569,4683,573.1946144,9366,-2293248,104448,-2188800,-1
1261,75,21,9,0.0561377246,0.943862275,380.1218971,457.470587,674.5313243,567.0933333,1336,81.46341463,2672,-645632,38400,-607232,-1
8436,734,21,9,0.0800436205,0.919956379,2623.856344,2843.272333,4537.240161,5140.159401,9170,188.7996706,18340,-4319232,375808,-3943424,-1
4521,331,19,11,0.068219291,0.931780709,1375.633417,1613.486436,2387.330237,2961.504532,4852,150.8706468,9704,-2314752,169472,-2145280,-1
4113,231,25,5,0.0531767956,0.946823204,1247.759591,1305.635043,2193.383905,1800.658009,4344,481.0631229,8688,-2105856,118272,-1987584,-1
3066,242,21,9,0.0731559855,0.926844015,932.5660095,1166.80489,1676.712655,1373.078512,3308,221.1229947,6616,-1569792,123904,-1445888,-1
2436,199,17,13,0.0755218216,0.924478178,745.7300003,909.3424777,1330.90353,1160.045226,2635,48.40191036,5270,-1247232,101888,-1145344,-1
9266,665,20,10,0.0669620381,0.933037962,2851.720439,2939.110125,5027.402223,4110.431579,9931,671.0135135,19862,-4744192,340480,-4403712,-1
9499,461,21,9,0.0462851406,0.953714859,2870.972974,2867.211866,5015.549637,4258.295011,9960,1248.120301,19920,-4863488,236032,-4627456,-1
7434,617,22,8,0.0766364427,0.923363557,2296.063858,2619.844942,4000.785445,4329.800648,8051,159.4573183,16102,-3806208,315904,-3490304,-1
338,29,20,10,0.0790190736,0.920980926,103.0868807,119.2108016,189.1893491,123.5172414,367,25.53931802,734,-173056,14848,-158208,-1
632,132,22,8,0.172774869,0.827225131,212.2370372,256.598214,381.6693038,386.4772727,764,31.06954046,1528,-323584,67584,-256000,-1
8926,968,21,9,0.097837073,0.902162927,2836.811611,3008.223995,4911.307417,5281.234504,9894,553.6653609,19788,-4570112,495616,-4074496,-1
1330,135,17,13,0.0921501706,0.907849829,418.5327723,368.7905957,760.2045113,464.9851852,1465,129.1887125,2930,-680960,69120,-611840,-1
6213,399,27,3,0.0603448276,0.939655172,1894.903574,1997.95637,3349.164333,2642.155388,6612,223.8320921,13224,-3181056,204288,-2976768,-1
5418,331,20,10,0.0575752305,0.94242477,1647.885777,1829.044311,2862.747693,3075.55287,5749,175.5419847,11498,-2774016,169472,-2604544,-1
9637,348,20,10,0.0348522784,0.965147722,2878.938775,2956.863682,5005.336204,4651.37931,9985,818.442623,19970,-4934144,178176,-4755968,-1
1005,67,21,9,0.0625,0.9375,307.8692519,327.7002764,540.0965174,482.5522388,1072,34.05336722,2144,-514560,34304,-480256,-1
7858,513,20,10,0.0612830008,0.938716999,2380.421281,2898.305846,4205.001909,3894.933723,8371,201.6622501,16742,-4023296,262656,-3760640,-1
9420,538,22,8,0.054026913,0.945973087,2870.473806,2807.883725,5029.092144,4111.17658,9958,1263.705584,19916,-4823040,275456,-4547584,-1
188,33,16,14,0.149321267,0.850678733,59.87109734,76.94128562,115.8989362,83.09090909,221,11.17290192,442,-96256,16896,-79360,-1
6464,414,21,9,0.0601919163,0.939808084,1956.012975,2365.426999,3414.5,3829.838164,6878,553.784219,13756,-3309568,211968,-3097600,-1
5607,720,16,14,0.113798009,0.886201991,1755.730128,2131.060157,3058.115035,3988.579167,6327,155.1115469,12654,-2870784,368640,-2502144,-1
48,21,20,10,0.304347826,0.695652174,19.96142113,19.04023666,37,30.42857143,69,8.363636364,138,-24576,10752,-13824,-1
6444,357,20,10,0.0524922805,0.947507719,1943.562342,2206.366605,3434.10568,2803.428571,6801,217.7713737,13602,-3299328,182784,-3116544,-1
8769,1069,20,10,0.108660297,0.891339703,2798.796056,3157.381557,4914.759494,4958.386342,9838,230.6682298,19676,-4489728,547328,-3942400,-1
6815,451,22,8,0.0620699147,0.937930085,2081.301861,2328.714236,3632.308291,3651.507761,7266,483.1117021,14532,-3489280,230912,-3258368,-1
53,17,23,7,0.242857143,0.757142857,19.58156077,22.03064867,35.64150943,35.05882353,70,1.296776584,140,-27136,8704,-18432,-1
66,22,20,10,0.25,0.75,25.06808452,24.93350661,46.98484848,37.04545455,88,18.72340426,176,-33792,11264,-22528,-1
424,58,20,10,0.12033195,0.87966805,133.9872699,124.1481366,256.8089623,129.5862069,482,29.75308642,964,-217088,29696,-187392,-1
1087,91,20,10,0.0772495756,0.922750424,335.2798582,352.4193683,603.4277829,423.1318681,1178,50.95155709,2356,-556544,46592,-509952,-1
9600,379,19,11,0.0379797575,0.962020243,2866.321123,3204.751155,5003.386042,4650.934037,9979,700.7724719,19958,-4915200,194048,-4721152,-1
944,87,15,15,0.0843840931,0.915615907,289.9220573,363.1945525,522.6991525,443.3103448,1031,27.46403836,2062,-483328,44544,-438784,-1
9128,443,18,12,0.0462856546,0.953714345,2733.062615,3262.537383,4814.81135,4192.343115,9571,225.2530007,19142,-4673536,226816,-4446720,-1
3508,211,19,11,0.0567356816,0.943264318,1058.11229,1298.246616,1852.745724,1980.606635,3719,212.2716895,7438,-1796096,108032,-1688064,-1
62,35,21,9,0.360824742,0.639175258,26.88640013,28.92204865,45.62903226,54.97142857,97,6.154822335,194,-31744,17920,-13824,-1
9478,494,21,9,0.0495387084,0.950461292,2854.313624,3136.805992,5040.421291,3951.953441,9972,1065.384615,19944,-4852736,252928,-4599808,-1
6714,419,27,3,0.0587410627,0.941258937,2043.01028,2233.376639,3600.760054,3026.033413,7133,262.3390953,14266,-3437568,214528,-3223040,-1
4388,177,20,10,0.0387732749,0.961226725,1306.306322,1504.0024,2301.651094,1820.621469,4565,113.9825218,9130,-2246656,90624,-2156032,-1
2878,211,18,12,0.0683068954,0.931693105,875.4937219,1064.770636,1561.212648,1323.862559,3089,195.6301457,6178,-1473536,108032,-1365504,-1
4855,436,17,13,0.0824040824,0.917595918,1506.63476,1683.052969,2684.576931,2216.433486,5291,147.3816156,10582,-2485760,223232,-2262528,-1
9217,714,19,11,0.071896083,0.928103917,2884.577984,2591.097347,4998.311273,4548.894958,9931,515.8961039,19862,-4719104,365568,-4353536,-1
3799,294,21,9,0.0718299536,0.928170046,1167.806254,1335.755317,2059.687813,1883.05102,4093,108.8853418,8186,-1945088,150528,-1794560,-1
1114,116,20,10,0.0943089431,0.905691057,355.3922007,347.9876389,620.7280072,565.2931034,1230,66.66666667,2460,-570368,59392,-510976,-1
2552,163,25,5,0.0600368324,0.939963168,778.6485726,856.3845668,1362.689655,1284.576687,2715,221.2713936,5430,-1306624,83456,-1223168,-1
7177,855,22,8,0.106449203,0.893550797,2294.83583,2412.131935,3938.521248,4671.065497,8032,180.7787531,16064,-3674624,437760,-3236864,-1
50,27,19,11,0.350649351,0.649350649,21.9357334,22.65128987,39.94,37.25925926,77,1.440868263,154,-25600,13824,-11776,-1
1075,106,22,8,0.0897544454,0.910245555,334.547967,350.5341599,609.1060465,407.3773585,1181,89.33434191,2362,-550400,54272,-496128,-1
6921,535,22,8,0.0717542918,0.928245708,2129.392282,2356.358579,3772.719694,3156.454206,7456,416.7691448,14912,-3543552,273920,-3269632,-1
9305,641,19,11,0.0644480193,0.935551981,2838.506195,3171.403126,5036.447179,4059.734789,9946,658.6754967,19892,-4764160,328192,-4435968,-1
174,41,18,12,0.190697674,0.809302326,60.64388867,52.61548303,117.0517241,69.58536585,215,40.18691589,430,-89088,20992,-68096,-1
928,169,19,11,0.154056518,0.845943482,313.3071876,322.0164483,564.2090517,465.4852071,1097,114.5093946,2194,-475136,86528,-388608,-1
5591,666,17,13,0.106440786,0.893559214,1799.368858,1810.088069,3079.394384,3545.433934,6257,130.5717863,12514,-2862592,340992,-2521600,-1
6008,306,19,11,0.0484637314,0.951536269,1803.017772,2020.775015,3197.228529,2377.470588,6314,550,12628,-3076096,156672,-2919424,-1
9238,704,22,8,0.0708107021,0.929189298,2860.074489,2991.807715,4958.163997,5146.497159,9942,546.2637363,19884,-4729856,360448,-4369408,-1
4833,271,19,11,0.0530956113,0.946904389,1471.379424,1451.016514,2575.093317,2149.571956,5104,331.8595579,10208,-2474496,138752,-2335744,-1
266,65,20,10,0.196374622,0.803625378,94.66487182,79.61525232,178.924812,113.1076923,331,27.81512605,662,-136192,33280,-102912,-1
6416,462,20,10,0.0671706892,0.932829311,1984.475865,1905.336237,3481.735973,2852.950216,6878,146.1227958,13756,-3284992,236544,-3048448,-1
253,59,21,9,0.189102564,0.810897436,89.14272634,89.95864861,162.1699605,132.1864407,312,13.45987921,624,-129536,30208,-99328,-1
2833,260,22,8,0.0840607824,0.915939218,874.7289853,1060.262935,1533.824568,1690.561538,3093,95.66965667,6186,-1450496,133120,-1317376,-1
450,100,17,13,0.181818182,0.818181818,150.7958513,178.325573,289.0111111,214.7,550,55.83756345,1100,-230400,51200,-179200,-1
1989,176,17,13,0.0812933025,0.918706697,618.5224109,689.9905542,1089.166415,1013.3125,2165,82.31939163,4330,-1018368,90112,-928256,-1
3697,498,21,9,0.118712753,0.881287247,1188.881249,1360.085034,2111.017582,2001.361446,4195,82.30331568,8390,-1892864,254976,-1637888,-1
125,28,17,13,0.183006536,0.816993464,41.09267263,54.96752288,79.016,68,153,13.45646438,306,-64000,14336,-49664,-1
5499,608,18,12,0.0995578844,0.900442116,1774.140939,1642.510165,3077.868703,2838.121711,6107,324.6677299,12214,-2815488,311296,-2504192,-1
9671,313,27,3,0.0313501603,0.96864984,2882.45504,2870.980893,4995.109916,4911.859425,9984,1367.671233,19968,-4951552,160256,-4791296,-1
4684,700,18,12,0.130014859,0.869985141,1543.112109,1626.622368,2691.238898,2700.938571,5384,104.139265,10768,-2398208,358400,-2039808,-1
1083,109,21,9,0.091442953,0.908557047,343.4656688,347.1783958,591.989843,641.3119266,1192,23.04272182,2384,-554496,55808,-498688,-1
9243,682,21,9,0.0687153652,0.931284635,2817.508799,3303.036877,4893.086336,5910.524927,9925,515.0492994,19850,-4732416,349184,-4383232,-1
3747,1103,22,8,0.22742268,0.77257732,1266.87868,1248.41197,2097.357886,3540.231188,4850,128.9550651,9700,-1918464,564736,-1353728,-1
4038,235,17,13,0.0549964896,0.94500351,1223.845399,1266.59065,2169.26845,1582.531915,4273,457.0053476,8546,-2067456,120320,-1947136,-1
8471,830,22,8,0.0892377164,0.910762284,2624.546675,3237.320186,4656.077913,4599.174699,9301,186.5049128,18602,-4337152,424960,-3912192,-1
2453,156,24,6,0.0597930241,0.940206976,749.9067494,791.2484826,1313.249898,1175.275641,2609,253.7937743,5218,-1255936,79872,-1176064,-1
1484,162,27,3,0.0984204131,0.901579587,478.2098136,422.708239,838.3234501,687.7098765,1646,64.27176884,3292,-759808,82944,-676864,-1
98,35,20,10,0.263157895,0.736842105,38.97313228,35.55098667,69.81632653,59.11428571,133,19.94002999,266,-50176,17920,-32256,-1
9324,626,21,9,0.0629145729,0.937085427,2849.685098,3185.635211,4964.088481,5145.469649,9950,857.7586207,19900,-4773888,320512,-4453376,-1
868,165,17,13,0.159728945,0.840271055,296.9807985,304.5330325,516.6117512,519.0424242,1033,95.64814815,2066,-444416,84480,-359936,-1
9429,519,20,10,0.0521712907,0.947828709,2860.057833,2897.184882,5029.924913,3967.560694,9948,1109.0301,19896,-4827648,265728,-4561920,-1
1897,1430,21,9,0.429816652,0.570183348,641.713554,739.4434871,1079.895625,2438.857343,3327,68.52729145,6654,-971264,732160,-239104,-1
9472,492,23,7,0.0493777599,0.95062224,2858.234874,3170.721126,4958.696157,5440.772358,9964,810.0813008,19928,-4849664,251904,-4597760,-1
219,42,20,10,0.16091954,0.83908046,72.8539398,83.54181065,135.3789954,108.1666667,261,33.03797468,522,-112128,21504,-90624,-1
9511,458,17,13,0.0459424215,0.954057578,2864.452859,2966.677737,5033.709599,3973.478166,9969,923.9110287,19938,-4869632,234496,-4635136,-1
1256,115,27,3,0.0838803793,0.916119621,388.5632987,467.3224896,686.294586,682.7826087,1371,107.7830189,2742,-643072,58880,-584192,-1
6183,813,20,10,0.116209262,0.883790738,2004.898455,2113.216861,3467.703542,3732.712177,6996,269.0769231,13992,-3165696,416256,-2749440,-1
6853,1180,20,10,0.146894062,0.853105938,2153.622596,2835.66148,3813.939151,5196.301695,8033,155.377176,16066,-3508736,604160,-2904576,-1
9428,534,20,10,0.053603694,0.946396306,2850.35972,3167.679166,5030.968922,4108.104869,9962,772.8471683,19924,-4827136,273408,-4553728,-1
267,24,23,7,0.0824742268,0.917525773,82.33591283,80.57828104,151.2022472,88.125,291,28.22502425,582,-136704,12288,-124416,-1
422,37,21,9,0.0806100218,0.919389978,128.9950922,163.0518746,233.1777251,193.7567568,459,41.50090416,918,-216064,18944,-197120,-1
9193,711,21,9,0.0717891761,0.928210824,2854.93139,2790.150224,5014.51202,4150.704641,9904,679.2866941,19808,-4706816,364032,-4342784,-1
4436,796,20,10,0.152140673,0.847859327,1482.057262,1502.235212,2500.107529,3265.139447,5232,135.6846473,10464,-2271232,407552,-1863680,-1
9242,679,18,12,0.0684406814,0.931559319,2844.240033,3012.518432,5018.519476,4178.091311,9921,662.2830441,19842,-4731904,347648,-4384256,-1
4102,735,19,11,0.15195369,0.84804631,1368.74623,1204.38737,2260.327401,3304.544218,4837,103.6648093,9674,-2100224,376320,-1723904,-1
2378,148,27,3,0.0585906572,0.941409343,728.0383188,742.3375777,1258.200589,1348.648649,2526,229.6363636,5052,-1217536,75776,-1141760,-1
323,30,21,9,0.0849858357,0.915014164,99.16198898,102.2453531,183.8018576,103.7666667,353,7.35723218,706,-165376,15360,-150016,-1
910,54,21,9,0.0560165975,0.943983402,272.3930085,361.2342354,484.810989,443.5555556,964,37.55356447,1928,-465920,27648,-438272,-1
9193,752,24,6,0.0756158874,0.924384113,2807.271272,3512.152163,4928.397041,5518.259309,9945,762.0689655,19890,-4706816,385024,-4321792,-1
7130,296,20,10,0.0398599515,0.960140048,2129.45179,2322.498465,3746.752314,2912.523649,7426,687.5925926,14852,-3650560,151552,-3499008,-1
454,109,19,11,0.193605684,0.806394316,156.3089791,186.167159,281.3524229,284.6972477,563,57.74358974,1126,-232448,55808,-176640,-1
1337,133,22,8,0.0904761905,0.90952381,423.05066,351.2304796,760.2026926,487.1729323,1470,79.28802589,2940,-684544,68096,-616448,-1
4849,438,20,10,0.0828447134,0.917155287,1476.898394,1938.451478,2604.194267,3084.680365,5287,123.0107027,10574,-2482688,224256,-2258432,-1
9439,512,19,11,0.0514521154,0.948547885,2853.744591,2866.734697,5051.17523,3590.103516,9951,219.5234944,19902,-4832768,262144,-4570624,-1
3042,211,22,8,0.0648632032,0.935136797,931.1805043,1009.257245,1645.454306,1360.943128,3253,190.0116822,6506,-1557504,108032,-1449472,-1
2082,212,27,3,0.0924149956,0.907585004,658.7177283,683.8837972,1159.878002,1025.938679,2294,122.1512247,4588,-1065984,108544,-957440,-1
228,48,25,5,0.173913043,0.826086957,79.10011867,79.66463724,142.4868421,119.5625,276,17.99217731,552,-116736,24576,-92160,-1
6293,668,18,12,0.0959632237,0.904036776,1972.550046,2277.567446,3432.016844,3942.453593,6961,155.2754852,13922,-3222016,342016,-2880000,-1
2803,341,22,8,0.10846056,0.89153944,885.4616919,1032.535647,1539.245451,1845.85044,3144,118.3289424,6288,-1435136,174592,-1260544,-1
7780,392,23,7,0.0479686735,0.952031326,2338.6868,2718.238307,4099.980463,3818.954082,8172,282.2797927,16344,-3983360,200704,-3782656,-1
9579,397,21,9,0.0397955092,0.960204491,2862.784459,3138.948689,5024.853012,4111.357683,9976,1425.142857,19952,-4904448,203264,-4701184,-1
3307,329,26,4,0.0904840484,0.909515952,1044.306017,1066.282409,1844.76837,1554.458967,3636,71.67356594,7272,-1693184,168448,-1524736,-1
4470,303,26,4,0.0634820867,0.936517913,1363.406033,1533.548714,2410.711857,2037.191419,4773,279.6133568,9546,-2288640,155136,-2133504,-1
2907,340,21,9,0.104712042,0.895287958,922.0678792,1052.652215,1636.672171,1515.652941,3247,302.891791,6494,-1488384,174080,-1314304,-1
9505,465,17,13,0.0466399198,0.95336008,2851.849187,3255.912701,5027.033246,4136.524731,9970,941.4542021,19940,-4866560,238080,-4628480,-1
397,79,22,8,0.165966387,0.834033613,139.2177285,127.0619292,235.790932,252.1139241,476,44.77892756,952,-203264,40448,-162816,-1
882,97,16,14,0.0990806946,0.900919305,272.7840023,328.3859856,505.3662132,350.2783505,979,93.14938154,1958,-451584,49664,-401920,-1
8189,386,22,8,0.0450145773,0.954985423,2455.20416,2812.102162,4314.503358,3725.73057,8575,463.7641969,17150,-4192768,197632,-3995136,-1
9398,556,21,9,0.0558569419,0.944143058,2867.687113,2811.837295,5032.392424,4049.660072,9954,1064.59893,19908,-4811776,284672,-4527104,-1
9517,458,21,9,0.045914787,0.954085213,2870.307338,2923.78155,5031.227278,4089.759825,9975,871.9405594,19950,-4872704,234496,-4638208,-1
6327,456,16,14,0.0672268908,0.932773109,1929.535956,2294.166369,3415.165955,3070.572368,6783,190.2664797,13566,-3239424,233472,-3005952,-1
2045,97,19,11,0.0452847806,0.954715219,613.6185497,671.294832,1082.309046,843.6185567,2142,169.7305864,4284,-1047040,49664,-997376,-1
6621,712,21,9,0.0970953225,0.902904677,2086.751053,2249.722516,3588.075819,4400.928371,7333,203.4119279,14666,-3389952,364544,-3025408,-1
9518,461,17,13,0.0461970137,0.953802986,2847.699221,3380.795099,5031.516915,4132.824295,9979,919.7235023,19958,-4873216,236032,-4637184,-1
1277,173,20,10,0.119310345,0.880689655,410.4187923,438.0510589,748.6836335,554.3699422,1450,37.79979145,2900,-653824,88576,-565248,-1
9521,442,22,8,0.0443641473,0.955635853,2865.24298,3094.838778,4973.781325,5159.036199,9963,776.5393609,19926,-4874752,226304,-4648448,-1
5595,303,24,6,0.0513733469,0.948626653,1694.868713,1836.584371,2955.087757,2846.320132,5898,109.384273,11796,-2864640,155136,-2709504,-1
1909,281,21,9,0.128310502,0.871689498,622.1465582,666.5607711,1123.337349,906.3843416,2190,79.11849711,4380,-977408,143872,-833536,-1
9334,630,22,8,0.0632276194,0.936772381,2882.517989,2760.550568,5005.808121,4637.169841,9964,337.3053487,19928,-4779008,322560,-4456448,-1
1526,226,16,14,0.128995434,0.871004566,487.5741564,608.4620337,888.4967235,795.4955752,1752,161.1775529,3504,-781312,115712,-665600,-1
978,69,16,14,0.0659025788,0.934097421,294.2863012,360.0785994,535.605317,359.5072464,1047,64.62962963,2094,-500736,35328,-465408,-1
9408,540,20,10,0.0542822678,0.945717732,2840.212981,3262.729941,5022.481611,4138.553704,9948,983.0039526,19896,-4816896,276480,-4540416,-1
3030,311,21,9,0.0930859024,0.906914098,976.0888867,842.7448596,1669.692079,1683.742765,3341,137.6029654,6682,-1551360,159232,-1392128,-1
2797,327,21,9,0.104673496,0.895326504,884.0352372,1036.088928,1574.355738,1461.091743,3124,95.71078431,6248,-1432064,167424,-1264640,-1
9087,837,21,9,0.0843409915,0.915659008,2847.904745,2909.454564,5040.881259,4111.543608,9924,658.5268746,19848,-4652544,428544,-4224000,-1
9501,466,21,9,0.0467542892,0.953245711,2870.895435,2948.411992,5011.387538,4425.611588,9967,1098.897464,19934,-4864512,238592,-4625920,-1
5651,400,19,11,0.0661047761,0.933895224,1720.871957,2070.505709,3013.554238,3201.8275,6051,420.5003475,12102,-2893312,204800,-2688512,-1
58,16,23,7,0.216216216,0.783783784,22.12917433,16.85681891,39.24137931,31.1875,74,2.233625113,148,-29696,8192,-21504,-1
435,100,16,14,0.186915888,0.813084112,145.0265935,164.1960462,287.8344828,181.72,535,76.42857143,1070,-222720,51200,-171520,-1
1369,151,19,11,0.0993421053,0.900657895,443.3226766,391.3662029,766.3140979,707.7880795,1520,29.10204863,3040,-700928,77312,-623616,-1
9287,644,22,8,0.0648474474,0.935152553,2869.661953,2793.9378,4994.339184,4557.326087,9931,585.899705,19862,-4754944,329728,-4425216,-1
1784,278,19,11,0.134820563,0.865179437,578.5564864,666.1859044,1059.095852,854.4100719,2062,102.281746,4124,-913408,142336,-771072,-1
5848,224,19,11,0.0368906456,0.963109354,1745.735117,1875.029683,3053.528899,2591.924107,6072,592.96875,12144,-2994176,114688,-2879488,-1
3003,260,22,8,0.0796812749,0.920318725,916.4044908,1165.889354,1654.929071,1367.169231,3263,78.36215178,6526,-1537536,133120,-1404416,-1
2044,258,21,9,0.112076455,0.887923545,651.4377574,738.7577204,1130.112524,1320.94186,2302,42.92373671,4604,-1046528,132096,-914432,-1
4235,230,27,3,0.0515117581,0.948488242,1276.720043,1471.026484,2218.567178,2498.752174,4465,357.2,8930,-2168320,117760,-2050560,-1
1465,83,17,13,0.0536175711,0.946382429,443.1438594,444.5443165,788.0668942,535.0361446,1548,114.922049,3096,-750080,42496,-707584,-1
46,17,22,8,0.26984127,0.73015873,18.02299781,18.13368274,33.32608696,28.41176471,63,6.723585912,126,-23552,8704,-14848,-1
55,25,20,10,0.3125,0.6875,24.14563253,19.85749229,42.54545455,36,80,11.64483261,160,-28160,12800,-15360,-1
2449,362,20,10,0.128779794,0.871220206,789.5069836,916.7686955,1373.395672,1626.574586,2811,58.3074051,5622,-1253888,185344,-1068544,-1
2620,234,22,8,0.0819901892,0.918009811,799.4704404,1051.484705,1438.591985,1303.307692,2854,90.08838384,5708,-1341440,119808,-1221632,-1
1142,134,20,10,0.105015674,0.894984326,362.3813815,397.0533451,652.1838879,521.880597,1276,86.50847458,2552,-584704,68608,-516096,-1
1983,168,18,12,0.0781032078,0.921896792,602.495706,763.7411209,1097.308623,824.4821429,2151,219.4897959,4302,-1015296,86016,-929280,-1
9217,714,21,9,0.071896083,0.928103917,2883.984514,2620.330742,4987.015623,4694.710084,9931,586.5918488,19862,-4719104,365568,-4353536,-1
2894,432,21,9,0.129885749,0.870114251,946.4427642,1011.970257,1625.973048,1914.895833,3326,182.546652,6652,-1481728,221184,-1260544,-1
9304,639,22,8,0.064266318,0.935733682,2862.497252,2980.244939,4966.13865,5057.342723,9943,528.3209352,19886,-4763648,327168,-4436480,-1
8152,389,20,10,0.0455450181,0.954454982,2451.450846,2720.609932,4287.979637,3915.169666,8541,907.6514346,17082,-4173824,199168,-3974656,-1
1289,203,22,8,0.136058981,0.863941019,425.5070638,431.3248273,770.8688906,591.7635468,1492,42.45873648,2984,-659968,103936,-556032,-1
9563,416,25,5,0.0416875438,0.958312456,2864.496106,3135.307559,5023.173272,4227.413462,9979,400.2807862,19958,-4896256,212992,-4683264,-1
3661,449,26,4,0.109245742,0.890754258,1181.087707,1152.223308,2005.893745,2459.973274,4110,97.76403425,8220,-1874432,229888,-1644544,-1
7417,310,19,11,0.040119063,0.959880937,2214.264048,2463.209412,3896.877848,3077.370968,7727,508.0210388,15454,-3797504,158720,-3638784,-1
6801,482,22,8,0.0661815186,0.933818481,2077.619572,2192.422285,3713.049699,2639.491701,7283,336.5526802,14566,-3482112,246784,-3235328,-1
9647,337,27,3,0.0337540064,0.966245994,2877.213016,2998.433594,5004.744584,4641.985163,9984,1560,19968,-4939264,172544,-4766720,-1
1096,79,21,9,0.0672340426,0.932765957,338.0315582,348.0444962,583.1614964,655.1265823,1175,81.8815331,2350,-561152,40448,-520704,-1
6077,537,21,9,0.0811914122,0.918808588,1891.064057,2104.545869,3305.679283,3328.104283,6614,492.4795235,13228,-3111424,274944,-2836480,-1
4275,659,27,3,0.133563032,0.866436968,1416.522272,1472.253334,2477.571228,2402.16692,4934,103.4381551,9868,-2188800,337408,-1851392,-1
54,26,19,11,0.325,0.675,24.61752,17.93648393,43.57407407,34.11538462,80,22.98850575,160,-27648,13312,-14336,-1
107,28,20,10,0.207407407,0.792592593,38.04917726,42.02554799,69.13084112,63.67857143,135,7.281553398,270,-54784,14336,-40448,-1
229,36,19,11,0.135849057,0.864150943,73.58594231,55.08147725,143.9344978,63.44444444,265,60.50228311,530,-117248,18432,-98816,-1
4540,559,18,12,0.109629339,0.890370661,1467.132397,1501.476765,2530.795815,2705.969589,5099,346.8707483,10198,-2324480,286208,-2038272,-1
9592,391,21,9,0.0391665832,0.960833417,2873.917012,3010.011468,5016.111134,4400.506394,9983,783.5949765,19966,-4911104,200192,-4710912,-1
5424,635,22,8,0.104802773,0.895197227,1720.484579,1890.52687,2966.105826,3575.766929,6059,151.9307924,12118,-2777088,325120,-2451968,-1
9587,382,21,9,0.0383187882,0.961681212,2865.393785,3086.381583,5013.834046,4261.356021,9969,869.1368788,19938,-4908544,195584,-4712960,-1
971,89,21,9,0.0839622642,0.916037736,302.5034947,326.8331835,539.2708548,434.8089888,1060,60.81468732,2120,-497152,45568,-451584,-1
1939,174,25,5,0.0823473734,0.917652627,610.1794308,601.856038,1064.188241,976.8965517,2113,142.5775978,4226,-992768,89088,-903680,-1
5071,194,20,10,0.0368471035,0.963152896,1509.706368,1698.220623,2651.056596,2161.015464,5265,435.1239669,10530,-2596352,99328,-2497024,-1
9418,542,17,13,0.0544176707,0.945582329,2860.586302,3097.323168,5000.702697,4629.450185,9960,531.4834578,19920,-4822016,277504,-4544512,-1
6957,434,20,10,0.0587200649,0.941279935,2106.777707,2520.26473,3686.710939,3844.903226,7391,145.7216088,14782,-3561984,222208,-3339776,-1
1766,184,20,10,0.0943589744,0.905641026,560.8323597,565.4309191,989.3958097,842.1304348,1950,49.34210526,3900,-904192,94208,-809984,-1
8783,921,19,11,0.0949093157,0.905090684,2775.803758,2967.87828,4789.784015,5450.583062,9704,186.6512791,19408,-4496896,471552,-4025344,-1
326,31,17,13,0.0868347339,0.913165266,98.46605757,103.8214568,187.8895706,85.51612903,357,79.51002227,714,-166912,15872,-151040,-1
3206,183,18,12,0.0539982296,0.94600177,964.0396851,1130.868275,1717.495633,1300.896175,3389,351.5560166,6778,-1641472,93696,-1547776,-1
5164,326,21,9,0.0593806922,0.940619308,1572.573309,1757.206853,2733.764717,2931.392638,5490,171.0280374,10980,-2643968,166912,-2477056,-1
6575,613,21,9,0.0852810239,0.914718976,2021.006659,2575.380732,3575.58403,3797.391517,7188,229.5019157,14376,-3366400,313856,-3052544,-1
400,42,20,10,0.0950226244,0.904977376,123.7399733,146.6260689,227.8225,161.2857143,442,63.14285714,884,-204800,21504,-183296,-1
71,19,20,10,0.211111111,0.788888889,25.23295943,26.79593553,47.87323944,36.63157895,90,2.49031544,180,-36352,9728,-26624,-1
6844,828,18,12,0.107924922,0.892075078,2207.805472,2255.034626,3805.756867,4090.613527,7672,189.8539965,15344,-3504128,423936,-3080192,-1
5451,311,20,10,0.0539743145,0.946025686,1644.464862,1898.037092,2909.733443,2386.643087,5762,487.8916173,11524,-2790912,159232,-2631680,-1
2665,353,18,12,0.116964877,0.883035123,869.8614131,861.819382,1532.509193,1335.790368,3018,62.5233064,6036,-1364480,180736,-1183744,-1
1681,141,17,13,0.0773874863,0.922612514,512.1089689,668.4301496,908.5562165,946.5957447,1822,124.0299523,3644,-860672,72192,-788480,-1
9483,481,21,9,0.0482737856,0.951726214,2845.818037,3152.374522,5048.544764,3680.4158,9964,878.659612,19928,-4855296,246272,-4609024,-1
9626,360,22,8,0.0360504707,0.963949529,2874.561279,3073.320629,5006.1738,4654.616667,9986,1072.610097,19972,-4928512,184320,-4744192,-1
4597,371,21,9,0.0746779388,0.925322061,1395.551266,1769.491164,2443.524037,2992.226415,4968,102.1171634,9936,-2353664,189952,-2163712,-1
4248,388,21,9,0.0836928387,0.916307161,1322.636966,1441.09499,2282.394068,2713.804124,4636,300.843608,9272,-2174976,198656,-1976320,-1
6104,393,21,9,0.0604894567,0.939510543,1841.787141,2335.90377,3254.884174,3157.608142,6497,352.9060293,12994,-3125248,201216,-2924032,-1
4135,433,21,9,0.0947898424,0.905210158,1312.83584,1242.214789,2342.793712,1727.815242,4568,197.7489177,9136,-2117120,221696,-1895424,-1
5949,443,21,9,0.0693053817,0.930694618,1813.802909,2224.386487,3197.555051,3182.331828,6392,243.4120335,12784,-3045888,226816,-2819072,-1
4835,364,19,11,0.0700134641,0.929986536,1485.774828,1565.612181,2645.81696,1991.414835,5199,154.8243002,10398,-2475520,186368,-2289152,-1
9431,529,20,10,0.0531124498,0.94688755,2851.578535,3184.30055,5020.577669,4265.996219,9960,854.9356223,19920,-4828672,270848,-4557824,-1
982,116,17,13,0.10564663,0.89435337,310.1082622,367.7093937,544.9531568,587.9913793,1098,20.79151676,2196,-502784,59392,-443392,-1
2707,222,20,10,0.0757937863,0.924206214,832.2876149,975.1914624,1479.714444,1285.576577,2929,166.5150654,5858,-1385984,113664,-1272320,-1
809,43,21,9,0.0504694836,0.949530516,242.6876501,266.2276075,433.7540173,290.0232558,852,24.57456014,1704,-414208,22016,-392192,-1
8327,772,22,8,0.0848444884,0.915155512,2579.349432,2890.70839,4452.865258,5597.721503,9099,184.8638765,18198,-4263424,395264,-3868160,-1
3734,634,18,12,0.14514652,0.85485348,1235.712512,1391.42424,2159.809052,2329.919558,4368,82.53968254,8736,-1911808,324608,-1587200,-1
4787,931,19,11,0.162819168,0.837180832,1655.484812,1592.993362,2801.916231,3155.583244,5718,104.8597103,11436,-2450944,476672,-1974272,-1
1985,168,20,10,0.0780306549,0.921969345,612.2409219,718.1203698,1070.802519,1150.22619,2153,39.87775514,4306,-1016320,86016,-930304,-1
9456,505,19,11,0.0506977211,0.949302279,2843.852188,3081.373688,5057.511316,3548.344554,9961,1019.549642,19922,-4841472,258560,-4582912,-1
7036,457,20,10,0.0609902576,0.939009742,2143.997023,2146.710267,3819.676805,2628.063457,7493,310.9128631,14986,-3602432,233984,-3368448,-1
3083,206,21,9,0.0626330192,0.937366981,924.99299,1257.974932,1640.370743,1714.281553,3289,64.30107527,6578,-1578496,105472,-1473024,-1
500,37,17,13,0.0689013035,0.931098696,150.165843,163.4177115,278.402,141.9459459,537,91.17147708,1074,-256000,18944,-237056,-1
9552,421,21,9,0.0422139777,0.957786022,2857.155378,3228.754725,5023.112856,4167.64133,9973,1133.295455,19946,-4890624,215552,-4675072,-1
6366,733,20,10,0.103253979,0.896746021,1999.35067,2075.191454,3409.952089,4766.296044,7099,201.1618022,14198,-3259392,375296,-2884096,-1
8993,738,21,9,0.0758400987,0.924159901,2829.261012,2533.924743,4888.986323,4585.897019,9731,237.2835894,19462,-4604416,377856,-4226560,-1
424,55,18,12,0.114822547,0.885177453,135.4045912,131.1939527,250.8915094,156.0363636,479,82.16123499,958,-217088,28160,-188928,-1
4245,317,21,9,0.0694870671,0.930512933,1293.702649,1446.648177,2330.023557,1631.712934,4562,212.4825338,9124,-2173440,162304,-2011136,-1
33,20,19,11,0.377358491,0.622641509,15.29111447,15.16336045,28,25.35,53,8.803986711,106,-16896,10240,-6656,-1
8376,1509,21,9,0.152655539,0.847344461,2726.202016,3365.981709,4798.691738,5744.011266,9885,320.1101036,19770,-4288512,772608,-3515904,-1
188,23,22,8,0.109004739,0.890995261,59.2709909,41.24471668,112.9468085,49.2173913,211,5.840022142,422,-96256,11776,-84480,-1
38,28,17,13,0.424242424,0.575757576,18.65180659,19.5746869,33.71052632,33.21428571,66,17.05426357,132,-19456,14336,-5120,-1
6875,595,21,9,0.0796519411,0.920348059,2135.921828,2319.652177,3691.168727,4247.731092,7470,189.7383795,14940,-3520000,304640,-3215360,-1
2263,113,27,3,0.0475589226,0.952441077,682.2777278,751.349624,1191.929739,1119.814159,2376,99.08256881,4752,-1158656,57856,-1100800,-1
3728,204,21,9,0.0518819939,0.948118006,1120.198135,1320.025565,1987.737661,1578.392157,3932,170.3639515,7864,-1908736,104448,-1804288,-1
3809,396,20,10,0.0941736029,0.905826397,1200.434317,1336.052701,2105.58493,2078.136364,4205,137.6432079,8410,-1950208,202752,-1747456,-1
9552,424,22,8,0.0425020048,0.957497995,2872.202308,2931.652721,5024.483668,4177.849057,9976,903.6231884,19952,-4890624,217088,-4673536,-1
6470,389,22,8,0.0567138067,0.943286193,1959.558544,2273.417958,3447.804791,3133.863753,6859,409.24821,13718,-3312640,199168,-3113472,-1
9513,454,20,10,0.045550316,0.954449684,2874.410941,2796.720151,5025.596132,4112.405286,9967,235.1816895,19934,-4870656,232448,-4638208,-1
2247,105,18,12,0.0446428571,0.955357143,669.781781,786.9918825,1191.416555,857.2857143,2352,414.8148148,4704,-1150464,53760,-1096704,-1
3241,233,25,5,0.0670696603,0.93293034,990.1131294,1124.859602,1758.756557,1441.824034,3474,112.7922078,6948,-1659392,119296,-1540096,-1
9466,499,27,3,0.0500752634,0.949924737,2872.837436,2924.357111,5002.142299,4619.871743,9965,808.1914031,19930,-4846592,255488,-4591104,-1
9287,576,27,3,0.0584000811,0.941599919,2825.179156,3055.931134,4985.223646,4073.861111,9863,340.6908463,19726,-4754944,294912,-4460032,-1
823,127,20,10,0.133684211,0.866315789,268.2392117,309.2898834,471.8444714,499.1889764,950,76.12179487,1900,-421376,65024,-356352,-1
9374,458,27,3,0.0465825875,0.953417413,2810.97927,3347.191329,4912.928206,4989.604803,9832,186.9912514,19664,-4799488,234496,-4564992,-1
3520,292,27,3,0.0766002099,0.92339979,1092.165785,1181.311311,1921.170739,1729.64726,3812,167.486819,7624,-1802240,149504,-1652736,-1
917,106,22,8,0.103616813,0.896383187,292.4052833,319.3182637,511.3249727,517.8396226,1023,109.7639485,2046,-469504,54272,-415232,-1
3683,332,21,9,0.0826899128,0.917310087,1128.145886,1441.300495,1988.766495,2221.364458,4015,111.8384401,8030,-1885696,169984,-1715712,-1
9270,672,20,10,0.0675920338,0.932407966,2848.33822,3074.135662,5020.799353,4291.433036,9942,810.2689487,19884,-4746240,344064,-4402176,-1
8657,1196,22,8,0.12138435,0.87861565,2874.048604,2618.632486,4933.119556,4882.704849,9853,501.9358125,19706,-4432384,612352,-3820032,-1
1725,165,21,9,0.0873015873,0.912698413,534.3174129,646.6783693,953.0446377,866.6242424,1890,35.5664283,3780,-883200,84480,-798720,-1
1732,185,18,12,0.0965049557,0.903495044,546.439621,612.7807813,963.8781755,913.3297297,1917,145.3373768,3834,-886784,94720,-792064,-1
1667,303,21,9,0.153807107,0.846192893,563.0407828,590.772604,969.1433713,1075.488449,1970,70.55873926,3940,-853504,155136,-698368,-1
5281,422,21,9,0.0739961424,0.926003858,1630.417813,1807.302416,2875.807233,2554.07109,5703,341.497006,11406,-2703872,216064,-2487808,-1
9346,602,17,13,0.0605146763,0.939485324,2846.162992,3108.308302,5032.256687,4077.832226,9948,762.2988506,19896,-4785152,308224,-4476928,-1
2534,135,20,10,0.0505807419,0.949419258,759.828513,932.0023356,1325.892265,1505.955556,2669,62.0409112,5338,-1297408,69120,-1228288,-1
4333,336,21,9,0.071964018,0.928035982,1324.205551,1578.160112,2307.059774,2695.3125,4669,266.039886,9338,-2218496,172032,-2046464,-1
9620,364,26,4,0.0364583333,0.963541667,2866.629834,3209.753825,5014.770062,4403.934066,9984,1046.540881,19968,-4925440,186368,-4739072,-1
4994,437,20,10,0.0804640029,0.919535997,1545.164786,1638.825086,2779.754505,1987.418764,5431,260.6046065,10862,-2556928,223744,-2333184,-1
3697,529,18,12,0.125177473,0.874822527,1202.563625,1304.401315,2075.411415,2379.688091,4226,145.4733219,8452,-1892864,270848,-1622016,-1
545,80,17,13,0.128,0.872,174.3038466,217.5687589,313.0458716,312.6875,625,48.79000781,1250,-279040,40960,-238080,-1
3032,159,21,9,0.0498276402,0.95017236,911.4695968,1084.067716,1601.615106,1488.924528,3191,349.1247265,6382,-1552384,81408,-1470976,-1
1331,107,20,10,0.0744089013,0.925591099,403.283554,507.6274742,733.985725,539.3084112,1438,86.21103118,2876,-681472,54784,-626688,-1
7256,376,20,10,0.0492662474,0.950733753,2182.7348,2449.557957,3855.082828,3071.933511,7632,160.6398653,15264,-3715072,192512,-3522560,-1
6917,769,21,9,0.100052043,0.899947957,2224.370336,2079.129489,3778.848634,4425.026008,7686,142.4388436,15372,-3541504,393728,-3147776,-1
4674,176,20,10,0.0362886598,0.96371134,1390.754757,1596.978017,2437.224433,2114.136364,4850,89.69853893,9700,-2393088,90112,-2302976,-1
3952,316,27,3,0.0740393627,0.925960637,1213.92524,1439.582731,2132.77581,2156.063291,4268,116.8354777,8536,-2023424,161792,-1861632,-1
9483,488,27,3,0.0489419316,0.951058068,2850.301003,3034.743146,5060.457028,3539.122951,9971,727.2793581,19942,-4855296,249856,-4605440,-1
3772,234,21,9,0.0584123814,0.941587619,1135.894762,1204.405204,2051.869565,1223.799145,4006,110.9080842,8012,-1931264,119808,-1811456,-1
9512,451,22,8,0.0452674897,0.95473251,2869.639832,3007.585031,4985.428827,4909.682927,9963,800.2409639,19926,-4870144,230912,-4639232,-1
984,130,21,9,0.116696589,0.883303411,318.7448463,280.3298439,581.8922764,372.8692308,1114,53.63505055,2228,-503808,66560,-437248,-1
6830,450,18,12,0.0618131868,0.938186813,2069.656922,2307.465511,3707.783602,2619.284444,7280,380.952381,14560,-3496960,230400,-3266560,-1
9437,533,21,9,0.0534603811,0.946539619,2849.784117,3115.968453,5051.551023,3816.037523,9970,921.4417745,19940,-4831744,272896,-4558848,-1
5507,483,18,12,0.0806343907,0.919365609,1706.006677,1968.850092,3007.579808,2857.770186,5990,183.5171569,11980,-2819584,247296,-2572288,-1
7267,774,20,10,0.0962566845,0.903743316,2315.125931,2345.63632,3981.506674,4391.79845,8041,187.3922163,16082,-3720704,396288,-3324416,-1
6149,272,19,11,0.042361003,0.957638997,1843.371831,2070.74168,3212.502846,3177.025735,6421,400.3117207,12842,-3148288,139264,-3009024,-1
1697,86,21,9,0.0482333146,0.951766685,508.402927,621.6343773,895.7583972,817.8372093,1783,182.3108384,3566,-868864,44032,-824832,-1
335,86,20,10,0.204275534,0.795724466,115.995776,141.0335698,211.3104478,209.7906977,421,55.24934383,842,-171520,44032,-127488,-1
9585,398,19,11,0.0398677752,0.960132225,2866.276451,3117.485471,5027.031716,4148.334171,9983,1178.63046,19966,-4907520,203776,-4703744,-1
3055,576,22,8,0.158633985,0.841366015,1019.778005,1152.922831,1766.792471,2076.987847,3631,115.6369427,7262,-1564160,294912,-1269248,-1
8975,944,21,9,0.0951708842,0.904829116,2890.500227,2417.50581,5053.33883,4072.588983,9919,803.808752,19838,-4595200,483328,-4111872,-1
9321,618,21,9,0.0621792937,0.937820706,2854.797371,2969.939406,5021.759468,4189.33657,9939,723.8892935,19878,-4772352,316416,-4455936,-1
9192,766,22,8,0.0769230769,0.923076923,2854.017855,3057.506116,4933.375544,5532.993473,9958,654.2706965,19916,-4706304,392192,-4314112,-1
9222,713,21,9,0.0717664821,0.928233518,2837.441471,2887.326118,5077.040121,3557.666199,9935,749.2458522,19870,-4721664,365056,-4356608,-1
4443,564,20,10,0.112642301,0.887357699,1444.946379,1430.197651,2476.225073,2722.801418,5007,123.8436804,10014,-2274816,288768,-1986048,-1
4513,365,23,7,0.0748257483,0.925174252,1377.944537,1671.26293,2402.145801,2901.361644,4878,97.01670644,9756,-2310656,186880,-2123776,-1
3489,218,21,9,0.0588076612,0.941192339,1054.62585,1284.770424,1862.859845,1712.201835,3707,202.2367703,7414,-1786368,111616,-1674752,-1
2494,202,23,7,0.074925816,0.925074184,758.2242493,986.5311412,1339.722133,1456.876238,2696,216.1988773,5392,-1276928,103424,-1173504,-1
5797,300,18,12,0.0492045268,0.950795473,1737.752268,2108.266525,3069.199586,2658.676667,6097,307.3084677,12194,-2968064,153600,-2814464,-1
9289,652,21,9,0.0655869631,0.934413037,2836.452768,3120.778951,5045.339972,3911.883436,9941,1072.384035,19882,-4755968,333824,-4422144,-1
568,87,20,10,0.132824427,0.867175573,182.2280184,210.2469906,340.8873239,243.862069,655,39.64891041,1310,-290816,44544,-246272,-1
7382,342,21,9,0.0442775764,0.955722424,2222.284808,2240.549432,3899.482931,3064.230994,7724,283.1378299,15448,-3779584,175104,-3604480,-1
9154,590,19,11,0.0605500821,0.939449918,2784.693782,3217.842878,4875.893271,4819.852542,9744,180.4444444,19488,-4686848,302080,-4384768,-1
9556,418,22,8,0.0419089633,0.958091037,2880.735365,2799.969179,5009.081833,4494.11244,9974,806.305578,19948,-4892672,214016,-4678656,-1
6287,306,22,8,0.0464128621,0.953587138,1882.452866,2285.484389,3291.119771,3417.813725,6593,432.8956008,13186,-3218944,156672,-3062272,-1
983,60,19,11,0.0575263663,0.942473634,293.8247319,324.7401059,536.0213632,292.2833333,1043,167.6848875,2086,-503296,30720,-472576,-1
4405,414,22,8,0.0859099398,0.91409006,1368.637053,1523.900845,2363.024064,2909.828502,4819,159.4111809,9638,-2255360,211968,-2043392,-1
1066,130,20,10,0.108695652,0.891304348,337.8223276,398.7030812,603.4803002,557.6615385,1196,23.24135251,2392,-545792,66560,-479232,-1
5366,202,18,12,0.0362787356,0.963721264,1597.154921,1785.882909,2803.396012,2282.539604,5568,710.2040816,11136,-2747392,103424,-2643968,-1
81,30,19,11,0.27027027,0.72972973,32.9122836,26.63016251,60.0617284,45.03333333,111,30.08130081,222,-41472,15360,-26112,-1
75,26,20,10,0.257425743,0.742574257,28.43555208,29.86916738,53.62666667,43.42307692,101,29.10662824,202,-38400,13312,-25088,-1
105,29,18,12,0.21641791,0.78358209,39.08206843,29.28972906,73.1047619,47.20689655,134,26.07003891,268,-53760,14848,-38912,-1
8711,348,20,10,0.0384148361,0.961585164,2605.11905,2853.727734,4530.672483,4513.166667,9059,314.112344,18118,-4460032,178176,-4281856,-1
2522,287,17,13,0.102171591,0.897828409,798.1032422,911.1759734,1414.684774,1319.89547,2809,64.87297921,5618,-1291264,146944,-1144320,-1
2605,249,17,13,0.0872459706,0.912754029,800.0565008,955.4243564,1465.226104,1032.815261,2854,78.81800608,5708,-1333760,127488,-1206272,-1
7006,853,21,9,0.108537982,0.891462018,2249.520647,2317.584177,4010.259777,3270.797186,7859,225.8982466,15718,-3587072,436736,-3150336,-1
3929,257,21,9,0.0613951266,0.938604873,1201.597502,1250.886271,2117.706796,1723.428016,4186,250.5086774,8372,-2011648,131584,-1880064,-1
1969,167,22,8,0.0781835206,0.921816479,606.3438572,644.4772882,1095.859827,745.9161677,2136,172.9554656,4272,-1008128,85504,-922624,-1
1611,195,20,10,0.107973422,0.892026578,498.4134225,649.0440076,927.4140286,705.9333333,1806,168.3131407,3612,-824832,99840,-724992,-1
39,15,22,8,0.277777778,0.722222222,15.47363136,15.81419896,27.94871795,26.33333333,54,11.63793103,108,-19968,7680,-12288,-1
8562,476,19,11,0.0526665191,0.947333481,2584.063919,3017.206164,4509.068792,4707.130252,9038,238.8477801,18076,-4383744,243712,-4140032,-1
3294,237,27,3,0.0671197961,0.932880204,1008.672328,1110.575851,1788.572556,1452.270042,3531,314.1459075,7062,-1686528,121344,-1565184,-1
9392,568,20,10,0.0570281124,0.942971888,2833.5535,2905.470709,5094.326235,3098.359155,9960,246.8401487,19920,-4808704,290816,-4517888,-1
9269,671,22,8,0.0675050302,0.93249497,2878.946673,2681.502629,5007.986514,4452.672131,9940,671.1681296,19880,-4745728,343552,-4402176,-1
7744,1367,22,8,0.150038415,0.849961585,2625.082952,2640.420452,4505.671488,4841.108998,9111,193.7686091,18222,-3964928,699904,-3265024,-1
9575,400,19,11,0.0401002506,0.959899749,2860.416251,3277.740647,5005.120836,4578.17,9975,789.7862233,19950,-4902400,204800,-4697600,-1
6409,1174,22,8,0.154819992,0.845180008,2179.427602,2240.669848,3790.642066,3799.413118,7583,143.7263078,15166,-3281408,601088,-2680320,-1
3663,424,19,11,0.103743577,0.896256423,1152.043886,1394.561862,2035.0819,2121.044811,4087,203.2322228,8174,-1875456,217088,-1658368,-1
2820,318,17,13,0.101338432,0.898661568,894.1690954,989.1443691,1551.346809,1730.481132,3138,167.2707889,6276,-1443840,162816,-1281024,-1
5851,517,22,8,0.0811871859,0.918812814,1826.732328,1938.634686,3211.295505,2881.249516,6368,507.814992,12736,-2995712,264704,-2731008,-1
150,24,21,9,0.137931034,0.862068966,49.37595636,33.40136287,94.04,46.625,174,38.24175824,348,-76800,12288,-64512,-1
3092,177,21,9,0.0541449985,0.945855002,942.5184756,918.1275128,1651.308538,1350.107345,3269,99.75587428,6538,-1583104,90624,-1492480,-1
2510,207,18,12,0.0761869709,0.923813029,767.2447521,950.466386,1344.550199,1534.21256,2717,206.4589666,5434,-1285120,105984,-1179136,-1
6420,294,22,8,0.0437890974,0.956210903,1923.461669,2170.125021,3381.485358,2833.738095,6714,128.4730195,13428,-3287040,150528,-3136512,-1
1357,88,18,12,0.060899654,0.939100346,411.945991,482.0200429,728.6226971,636.2954545,1445,251.7421603,2890,-694784,45056,-649728,-1
5832,315,24,6,0.0512445095,0.94875549,1770.358219,1753.195109,3104.947016,2501.038095,6147,199.5131451,12294,-2985984,161280,-2824704,-1
5988,342,21,9,0.054028436,0.945971564,1816.964521,1873.281628,3204.394122,2484.511696,6330,166.9303797,12660,-3065856,175104,-2890752,-1
62,17,20,10,0.215189873,0.784810127,22.12686908,23.05807322,42.41935484,31.17647059,79,4.022403259,158,-31744,8704,-23040,-1
5991,523,17,13,0.0802886091,0.919711391,1862.161917,2034.358439,3221.923886,3665.026769,6514,174.2643125,13028,-3067392,267776,-2799616,-1
372,66,21,9,0.150684932,0.849315068,118.7980414,160.2533498,214.6827957,246.6515152,438,39.35309973,876,-190464,33792,-156672,-1
2682,309,22,8,0.10330993,0.89669007,849.9963981,957.5001889,1477.600671,1655.699029,2991,117.248138,5982,-1373184,158208,-1214976,-1
45,16,21,9,0.262295082,0.737704918,17.00797199,18.82889651,32.13333333,27.8125,61,8.122503329,122,-23040,8192,-14848,-1
2856,184,21,9,0.0605263158,0.939473684,859.0651944,1097.816644,1536.273459,1275.668478,3040,164.8590022,6080,-1462272,94208,-1368064,-1
9335,603,21,9,0.0606761924,0.939323808,2847.886031,3107.89383,5010.406856,4336.223881,9938,749.4720965,19876,-4779520,308736,-4470784,-1
2192,183,23,7,0.0770526316,0.922947368,683.2503706,701.9243118,1198.124544,1066.726776,2375,173.992674,4750,-1122304,93696,-1028608,-1
9350,591,21,9,0.0594507595,0.940549241,2848.851721,3048.822296,5026.777433,4088.565144,9941,1142.643678,19882,-4787200,302592,-4484608,-1
7746,667,21,9,0.0792820635,0.920717937,2416.677693,2331.303102,4118.95701,5229.46027,8413,190.3393665,16826,-3965952,341504,-3624448,-1
5544,269,20,10,0.0462755892,0.953724411,1665.932991,1897.624369,2896.267316,3128.197026,5813,107.0928519,11626,-2838528,137728,-2700800,-1
1050,137,17,13,0.115417018,0.884582982,338.2175863,374.8068138,595.2380952,584.5109489,1187,97.69547325,2374,-537600,70144,-467456,-1
9570,407,20,10,0.0407938258,0.959206174,2880.437072,2813.50856,5013.113584,4422.004914,9977,1024.332649,19954,-4899840,208384,-4691456,-1
9470,507,19,11,0.0508168788,0.949183121,2882.323248,2725.560015,5030.345723,4216.723866,9977,217.2691638,19954,-4848640,259584,-4589056,-1
2533,359,20,10,0.124135546,0.875864454,818.9996245,925.3487112,1425.259771,1596.364903,2892,142.7443238,5784,-1296896,183808,-1113088,-1
5929,371,16,14,0.0588888889,0.941111111,1799.182421,2027.847259,3184.897285,2600.792453,6300,118.510158,12600,-3035648,189952,-2845696,-1
8162,332,25,5,0.0390864139,0.960913586,2446.891452,2505.590214,4271.102916,3667.237952,8494,505.2944676,16988,-4178944,169984,-4008960,-1
9533,436,21,9,0.0437355803,0.95626442,2855.710646,3161.826942,5030.91734,3981.03211,9969,651.9947678,19938,-4880896,223232,-4657664,-1
1030,151,17,13,0.127857748,0.872142252,328.6069769,402.8953555,604.8019417,496.8543046,1181,87.74145617,2362,-527360,77312,-450048,-1
53,22,19,11,0.293333333,0.706666667,22.79557644,16.57464957,40.94339623,30.90909091,75,15.09054326,150,-27136,11264,-15872,-1
4541,313,20,10,0.0644829007,0.935517099,1385.466622,1611.907427,2430.808632,2379.498403,4854,151.8298405,9708,-2324992,160256,-2164736,-1
9448,522,21,9,0.0523570712,0.947642929,2848.097731,3090.435504,5058.479572,3664.597701,9970,1172.941176,19940,-4837376,267264,-4570112,-1
9467,508,20,10,0.0509273183,0.949072682,2855.46572,3074.729972,5050.07711,3831.141732,9975,857.6956148,19950,-4847104,260096,-4587008,-1
1662,132,22,8,0.0735785953,0.926421405,521.4523519,445.9500259,908.9981949,752.7272727,1794,98.086386,3588,-850944,67584,-783360,-1
335,40,17,13,0.106666667,0.893333333,104.6582871,97.81358546,198.441791,100.55,375,73.0994152,750,-171520,20480,-151040,-1
1601,99,22,8,0.0582352941,0.941764706,482.2134496,601.6199513,843.6139913,961.8585859,1700,144.6808511,3400,-819712,50688,-769024,-1
1161,128,27,3,0.0993017843,0.900698216,369.1324748,397.6452341,646.8242894,628.453125,1289,122.7619048,2578,-594432,65536,-528896,-1
1050,134,21,9,0.113175676,0.886824324,338.1251997,369.2455917,592.1104762,595.5522388,1184,77.89473684,2368,-537600,68608,-468992,-1
1818,284,16,14,0.13510942,0.86489058,579.645072,720.5659546,1085.628713,833.028169,2102,40.86314152,4204,-930816,145408,-785408,-1
92,28,20,10,0.233333333,0.766666667,35.31542314,20.33030813,67.19565217,38.5,120,22.42990654,240,-47104,14336,-32768,-1
2604,343,24,6,0.116389549,0.883610451,842.2149853,873.3272199,1506.856375,1224.559767,2947,169.0763052,5894,-1333248,175616,-1157632,-1
5970,568,19,11,0.0868767207,0.913123279,1874.45005,2008.426857,3287.3866,3081.501761,6538,410.4205901,13076,-3056640,290816,-2765824,-1
5242,197,27,3,0.0362198934,0.963780107,1559.729934,1771.433137,2736.133728,2290.695431,5439,407.7211394,10878,-2683904,100864,-2583040,-1
7362,767,20,10,0.094353549,0.905646451,2257.074374,2729.95373,3924.370551,5414.822686,8129,152.4568642,16258,-3769344,392704,-3376640,-1
1794,285,22,8,0.137085137,0.862914863,603.1088212,563.4732721,1018.965998,1172.403509,2079,160.6646059,4158,-918528,145920,-772608,-1
3963,474,27,3,0.106828938,0.893171062,1255.736266,1451.11131,2189.632854,2464.531646,4437,89.63636364,8874,-2029056,242688,-1786368,-1
2654,304,21,9,0.102772143,0.897227857,844.7654733,928.4714268,1484.995855,1431.519737,2958,97.52720079,5916,-1358848,155648,-1203200,-1
9187,723,24,6,0.0729566095,0.927043391,2841.956206,2812.305242,5052.486448,3723.114799,9910,826.5221018,19820,-4703744,370176,-4333568,-1
5326,797,17,13,0.130164952,0.869835048,1764.386301,1781.496094,3084.237702,2913.395232,6123,230.795326,12246,-2726912,408064,-2318848,-1
9521,452,20,10,0.0453223704,0.95467763,2869.898493,3024.648293,5009.574519,4511.486726,9973,313.9124961,19946,-4874752,231424,-4643328,-1
2351,178,25,5,0.0703835508,0.929616449,722.5281579,753.0422391,1289.255636,944.6348315,2529,174.5341615,5058,-1203712,91136,-1112576,-1
6785,600,20,10,0.0812457684,0.918754232,2103.689479,2270.232997,3620.062343,4517.803333,7385,151.2699713,14770,-3473920,307200,-3166720,-1
5301,307,20,10,0.054743224,0.945256776,1602.84211,1864.213011,2815.514431,2614.312704,5608,398.8620199,11216,-2714112,157184,-2556928,-1
5460,243,21,9,0.0426091531,0.957390847,1634.086963,1899.302656,2854.838095,2788.230453,5703,205.8844765,11406,-2795520,124416,-2671104,-1
2831,237,18,12,0.0772490222,0.922750978,861.0642133,1130.843839,1523.513246,1665.738397,3068,153.6304457,6136,-1449472,121344,-1328128,-1
5700,407,16,14,0.0666448338,0.933355166,1713.433838,2299.357025,3087.164737,2589.530713,6107,477.856025,12214,-2918400,208384,-2710016,-1
64,28,19,11,0.304347826,0.695652174,27.63934865,22.10676783,49.8125,38.92857143,92,20.30905077,184,-32768,14336,-18432,-1
3485,360,22,8,0.0936280884,0.906371912,1095.91733,1108.590893,1977.11736,1399.113889,3845,163.9658849,7690,-1784320,184320,-1600000,-1
839,107,18,12,0.113107822,0.886892178,267.0903334,308.0839291,482.0417163,406.5233645,946,32.19877468,1892,-429568,54784,-374784,-1
5654,389,20,10,0.0643720007,0.935627999,1727.549456,1889.919979,2984.064733,3573.377892,6043,205.4743285,12086,-2894848,199168,-2695680,-1
74,28,18,12,0.274509804,0.725490196,30.60251127,24.32255609,54.58108108,43.35714286,102,22.76785714,204,-37888,14336,-23552,-1
5414,707,25,5,0.115504003,0.884495997,1768.288543,1752.711376,3046.053565,3175.455446,6121,243.4765314,12242,-2771968,361984,-2409984,-1
228,35,19,11,0.133079848,0.866920152,72.19967074,63.72725044,142.3991228,64.25714286,263,44.42567568,526,-116736,17920,-98816,-1
929,146,25,5,0.135813953,0.864186047,306.4261615,332.2134674,532.8568353,570.7260274,1075,26.82805091,2150,-475648,74752,-400896,-1
5053,174,27,3,0.0332886933,0.966711307,1506.789486,1558.768843,2620.084306,2437.310345,5227,446.3706234,10454,-2587136,89088,-2498048,-1
3152,405,19,11,0.113859994,0.886140006,1024.253586,962.1474563,1828.804886,1391.382716,3557,221.3441195,7114,-1613824,207360,-1406464,-1
4745,390,20,10,0.0759493671,0.924050633,1480.87092,1463.102046,2594.19157,2249.335897,5135,187.2037915,10270,-2429440,199680,-2229760,-1
42,19,19,11,0.31147541,0.68852459,17.42520459,17.83100105,31.92857143,28.94736842,61,8.090185676,122,-21504,9728,-11776,-1
9032,875,21,9,0.0883213889,0.911678611,2840.171914,3054.03897,4964.516165,4845.449143,9907,313.6119025,19814,-4624384,448000,-4176384,-1
4222,312,21,9,0.0688134098,0.93118659,1289.2704,1541.477128,2278.871625,2113.61859,4534,88.74535134,9068,-2161664,159744,-2001920,-1
1607,176,18,12,0.0987100393,0.901289961,506.6342692,582.6465603,889.1792159,917.7556818,1783,32.97577215,3566,-822784,90112,-732672,-1
4089,371,20,10,0.0831838565,0.916816143,1286.340025,1253.301071,2260.534605,1899.471698,4460,219.2723697,8920,-2093568,189952,-1903616,-1
6079,409,20,10,0.0630394575,0.936960543,1868.628746,1825.970258,3286.330482,2622.770171,6488,167.8654592,12976,-3112448,209408,-2903040,-1
9670,321,21,9,0.032128916,0.967871084,2876.689762,3074.58408,5009.083971,4601.850467,9991,989.2079208,19982,-4951040,164352,-4786688,-1
405,69,16,14,0.14556962,0.85443038,130.8137337,158.205514,246.3358025,185.6376812,474,86.33879781,948,-207360,35328,-172032,-1
1433,126,17,13,0.0808210391,0.919178961,449.0043122,460.5956743,782.7013259,749.2777778,1559,84.77433388,3118,-733696,64512,-669184,-1
1042,81,27,3,0.072128228,0.927871772,318.8531203,369.8526707,570.3330134,454.8024691,1123,65.13921114,2246,-533504,41472,-492032,-1
6327,202,22,8,0.030938888,0.969061112,1881.936535,1964.594528,3270.047416,3106.905941,6529,123.1886792,13058,-3239424,103424,-3136000,-1
2555,181,16,14,0.0661549708,0.933845029,778.0161202,940.5666936,1367.370646,1384.441989,2736,71.21290994,5472,-1308160,92672,-1215488,-1
156,26,21,9,0.142857143,0.857142857,51.63586599,38.08308031,98.17948718,51.42307692,182,5.405405405,364,-79872,13312,-66560,-1
6528,234,25,5,0.0346051464,0.965394854,1941.838774,2157.553091,3399.509038,2879.094017,6762,594.7229551,13524,-3342336,119808,-3222528,-1
2364,116,20,10,0.0467741935,0.953225806,705.9088964,869.500348,1250.821489,1030.155172,2480,45.48789435,4960,-1210368,59392,-1150976,-1
9468,501,20,10,0.050255793,0.949744207,2880.044383,2784.057742,5012.617343,4463.081836,9969,564.4960362,19938,-4847616,256512,-4591104,-1
5844,402,18,12,0.0643611912,0.935638809,1775.285671,2159.52383,3111.493155,3298.047264,6246,285.2054795,12492,-2992128,205824,-2786304,-1
8718,1181,21,9,0.11930498,0.88069502,2756.892194,3151.392013,4752.713466,6406.34547,9899,458.287037,19798,-4463616,604672,-3858944,-1
199,13,24,6,0.0613207547,0.938679245,60.09641295,54.99736411,109.8291457,55.53846154,212,10.56829511,424,-101888,6656,-95232,-1
5760,267,17,13,0.0443006471,0.955699353,1722.384369,2075.773026,3020.778646,2867.764045,6027,501.8318068,12054,-2949120,136704,-2812416,-1
232,48,26,4,0.171428571,0.828571429,80.18781542,81.09187337,144.5215517,121.0625,280,31.74603175,560,-118784,24576,-94208,-1
1262,66,22,8,0.0496987952,0.950301205,378.421179,447.7731702,671.4175911,532.2272727,1328,24.87823155,2656,-646144,33792,-612352,-1
9111,774,23,7,0.0783004552,0.921699545,2842.250424,2944.748827,4982.035342,4483.502584,9885,456.3711911,19770,-4664832,396288,-4268544,-1
9256,679,21,9,0.0683442375,0.931655762,2839.013705,3030.325687,5048.624568,3868.94109,9935,1235.696517,19870,-4739072,347648,-4391424,-1
60,16,18,12,0.210526316,0.789473684,19.95784446,25.85989898,41.13333333,28.625,76,33.77777778,152,-30720,8192,-22528,-1
4347,318,20,10,0.0681672026,0.931832797,1318.900208,1633.957358,2360.851392,1952.27673,4665,176.838514,9330,-2225664,162816,-2062848,-1
1297,113,27,3,0.080141844,0.919858156,402.5148875,366.9851774,728.0717039,446.4247788,1410,259.6685083,2820,-664064,57856,-606208,-1
9590,396,22,8,0.0396555177,0.960344482,2866.602719,3109.249011,5031.572888,4071.482323,9986,933.271028,19972,-4910080,202752,-4707328,-1
5944,717,18,12,0.107641495,0.892358505,1823.042724,2477.385243,3238.438089,4098.34728,6661,130.7360157,13322,-3043328,367104,-2676224,-1
9584,389,22,8,0.0390053143,0.960994686,2862.924072,3119.710374,5023.116653,4097.174807,9973,856.7869416,19946,-4907008,199168,-4707840,-1
7232,694,20,10,0.0875599293,0.912440071,2290.285088,2259.960872,3950.361311,4100.414986,7926,178.99729,15852,-3702784,355328,-3347456,-1
9468,501,24,6,0.050255793,0.949744207,2849.831196,3227.298426,5033.757288,4063.57485,9969,574.9134948,19938,-4847616,256512,-4591104,-1
531,39,27,3,0.0684210526,0.931578947,161.1125436,204.2173044,287.2184557,262.1025641,570,45.49082203,1140,-271872,19968,-251904,-1
2990,237,22,8,0.0734428262,0.926557174,917.6132449,1067.800211,1631.538127,1392.738397,3227,65.66951567,6454,-1530880,121344,-1409536,-1
5238,397,21,9,0.0704525288,0.929547471,1611.178734,1766.682172,2849.628293,2400.697733,5635,302.1447721,11270,-2681856,203264,-2478592,-1
9559,414,22,8,0.0415120826,0.958487917,2861.89857,3199.740681,5010.654148,4440.84058,9973,884.9157054,19946,-4894208,211968,-4682240,-1
9293,645,18,12,0.0649023948,0.935097605,2844.617414,3110.729222,5019.218874,4253.162791,9938,896.122633,19876,-4758016,330240,-4427776,-1
9592,392,17,13,0.0392628205,0.960737179,2859.349561,3189.245618,5038.803482,3859.482143,9984,772.1577726,19968,-4911104,200704,-4710400,-1
6025,787,22,8,0.115531415,0.884468585,1936.779951,2079.598734,3326.04249,4022.454892,6812,127.3271028,13624,-3084800,402944,-2681856,-1
3331,370,17,13,0.0999729803,0.90002702,1065.135367,1096.72819,1854.472531,1819.737838,3701,92.27125405,7402,-1705472,189440,-1516032,-1
1630,150,21,9,0.0842696629,0.915730337,506.2992233,568.2386627,876.6460123,1041.046667,1780,65.8527562,3560,-834560,76800,-757760,-1
8561,1281,19,11,0.130156472,0.869843528,2827.761604,2828.696861,4815.454036,5630.211553,9842,452.0900322,19684,-4383232,655872,-3727360,-1
2442,186,20,10,0.0707762557,0.929223744,748.1182967,862.8805704,1299.986077,1505.053763,2628,74.89313195,5256,-1250304,95232,-1155072,-1
561,112,20,10,0.166419019,0.833580981,187.4714612,224.2359005,340.9839572,317.0446429,673,65.85127202,1346,-287232,57344,-229888,-1
9601,381,22,8,0.0381687037,0.961831296,2867.823841,3119.138032,5020.721487,4255.133858,9982,498.8505747,19964,-4915712,195072,-4720640,-1
9402,554,20,10,0.0556448373,0.944355163,2870.325861,2883.565148,5010.290683,4438.976534,9956,644.8186528,19912,-4813824,283648,-4530176,-1
3434,297,26,4,0.0796033235,0.920396676,1069.7618,1143.598831,1881.082702,1691.609428,3731,164.8696421,7462,-1758208,152064,-1606144,-1
2531,381,19,11,0.130837912,0.869162088,796.7348331,1050.830722,1416.864876,1719.7979,2912,58.80452342,5824,-1295872,195072,-1100800,-1
47,15,20,10,0.241935484,0.758064516,17.72272738,16.28905563,33.89361702,24,62,10.09771987,124,-24064,7680,-16384,-1
8643,405,22,8,0.0447612732,0.955238727,2592.331098,2791.925198,4574.759921,3451.916049,9048,628.3333333,18096,-4425216,207360,-4217856,-1
4248,313,20,10,0.0686253015,0.931374699,1292.472456,1585.856613,2261.56968,2544.70607,4561,236.8120457,9122,-2174976,160256,-2014720,-1
1286,164,20,10,0.113103448,0.886896552,412.927446,459.9776315,728.1236392,704.9268293,1450,96.60226516,2900,-658432,83968,-574464,-1
6868,988,22,8,0.125763747,0.874236253,2214.270091,2320.408972,3767.790332,5045.659919,7856,164.6960168,15712,-3516416,505856,-3010560,-1
7914,575,20,10,0.0677347155,0.932265284,2449.299236,2415.425748,4280.50973,3756.262609,8489,200.0707047,16978,-4051968,294400,-3757568,-1
9244,680,21,9,0.0685207578,0.931479242,2821.65071,3329.355268,5010.600498,4308.616176,9924,1016.803279,19848,-4732928,348160,-4384768,-1
61,26,16,14,0.298850575,0.701149425,25.2467213,19.37182881,49.52459016,31.03846154,87,13.06306306,174,-31232,13312,-17920,-1
1919,208,23,7,0.097790315,0.902209685,609.6534395,610.2369988,1040.114122,1284.370192,2127,68.54656784,4254,-982528,106496,-876032,-1
385,40,17,13,0.0941176471,0.905882353,118.8248067,106.4206248,224.1454545,105.725,425,95.07829978,850,-197120,20480,-176640,-1
384,67,17,13,0.148558758,0.851441242,124.5198114,138.236682,238.5963542,153.8059701,451,66.51917404,902,-196608,34304,-162304,-1
4586,401,22,8,0.0804090636,0.919590936,1419.944329,1636.880884,2477.939599,2677.673317,4987,130.6865828,9974,-2348032,205312,-2142720,-1
947,179,21,9,0.158969805,0.841030195,322.4084588,338.6442936,564.2344245,559.6145251,1126,70.90680101,2252,-484864,91648,-393216,-1
9633,354,21,9,0.0354460799,0.96455392,2876.16482,3037.343054,5008.309457,4604.612994,9987,734.8785872,19974,-4932096,181248,-4750848,-1
9416,542,19,11,0.0544286001,0.9455714,2863.097951,2985.370698,5019.088997,4291.732472,9958,1085.932388,19916,-4820992,277504,-4543488,-1
2876,295,16,14,0.0930305897,0.90696941,913.7368041,877.888838,1616.377955,1289.840678,3171,59.81890209,6342,-1472512,151040,-1321472,-1
2384,259,19,11,0.097994703,0.902005297,756.4010256,815.4368933,1331.804111,1231.756757,2643,90.8872077,5286,-1220608,132608,-1088000,-1
9436,520,18,12,0.0522298112,0.947770189,2857.184137,3091.522903,5014.754451,4320.621154,9956,1266.666667,19912,-4831232,266240,-4564992,-1
2380,208,22,8,0.0803709428,0.919629057,731.9501603,898.6400594,1301.427731,1215.230769,2588,57.84532857,5176,-1218560,106496,-1112064,-1
7210,507,21,9,0.0656991059,0.934300894,2201.044243,2511.111568,3898.409154,3298.566075,7717,360.1026598,15434,-3691520,259584,-3431936,-1
4495,618,20,10,0.120868375,0.879131625,1392.616595,1797.860654,2450.23426,3333.556634,5113,97.20532319,10226,-2301440,316416,-1985024,-1
310,102,20,10,0.247572816,0.752427184,112.1700586,134.745883,198.7387097,230.0882353,412,11.11710739,824,-158720,52224,-106496,-1
1319,130,17,13,0.0897170462,0.910282954,412.7212063,369.4377228,752.4859742,446.1230769,1449,112.5874126,2898,-675328,66560,-608768,-1
8701,1168,22,8,0.11835039,0.88164961,2837.803245,2747.269367,5063.571773,3977.206336,9869,725.1285819,19738,-4454912,598016,-3856896,-1
6215,515,21,9,0.0765230312,0.923476969,1950.057797,1789.375469,3327.243121,3827.182524,6730,176.6404199,13460,-3182080,263680,-2918400,-1
9609,370,22,8,0.0370778635,0.962922136,2864.309506,3135.228222,5026.094911,4052.605405,9979,735.9144543,19958,-4919808,189440,-4730368,-1
66,23,20,10,0.258426966,0.741573034,25.02139122,26.76283855,46.92424242,39.47826087,89,18.89596603,178,-33792,11776,-22016,-1
6751,438,21,9,0.0609264154,0.939073585,2050.657725,2100.762641,3670.96282,2424.166667,7189,217.5189107,14378,-3456512,224256,-3232256,-1
3373,395,19,11,0.104830149,0.895169851,1075.694314,1099.453211,1933.635339,1464.921519,3768,114.2857143,7536,-1726976,202240,-1524736,-1
193,25,17,13,0.114678899,0.885321101,60.32975107,49.84446208,117.1606218,50.36,218,32.24852071,436,-98816,12800,-86016,-1
7968,483,20,10,0.0571529996,0.942847,2420.090151,2732.980477,4213.37387,4434.291925,8451,207.9990155,16902,-4079616,247296,-3832320,-1
3196,230,19,11,0.0671336836,0.932866316,975.8703275,1131.585849,1729.96965,1484.643478,3426,265.1702786,6852,-1636352,117760,-1518592,-1
1381,111,19,11,0.0743967828,0.925603217,423.5961327,510.6959111,747.6828385,731.7837838,1492,161.2972973,2984,-707072,56832,-650240,-1
2807,250,22,8,0.0817795224,0.918220478,871.9698862,986.0011337,1538.955468,1417.22,3057,230.7169811,6114,-1437184,128000,-1309184,-1
6451,600,21,9,0.0850943129,0.914905687,1996.062611,2284.525545,3455.32088,4285.918333,7051,137.0989695,14102,-3302912,307200,-2995712,-1
360,62,22,8,0.146919431,0.853080569,120.1576233,124.1073234,218.2,172.5967742,422,28.30315225,844,-184320,31744,-152576,-1
2900,449,21,9,0.134069872,0.865930128,946.1280188,1035.623557,1625.675862,1993.57461,3349,88.41077086,6698,-1484800,229888,-1254912,-1
5062,655,21,9,0.114570579,0.885429421,1645.862408,1663.654071,2826.69597,3108.653435,5717,106.7002613,11434,-2591744,335360,-2256384,-1
9559,415,19,11,0.0416081813,0.958391819,2879.406133,2815.526446,5012.340726,4415.325301,9974,225.5540479,19948,-4894208,212480,-4681728,-1
9207,725,20,10,0.0729963754,0.927003625,2834.531367,2819.403949,5089.47844,3404.758621,9932,654.7132498,19864,-4713984,371200,-4342784,-1
121,23,17,13,0.159722222,0.840277778,38.23891834,51.32306217,76.36363636,52.17391304,144,7.903402854,288,-61952,11776,-50176,-1
134,21,24,6,0.135483871,0.864516129,44.1793339,40.29719526,81.85074627,53.42857143,155,11.07934239,310,-68608,10752,-57856,-1
2827,645,21,9,0.185771889,0.814228111,1009.914178,946.1628766,1694.30138,1921.454264,3472,71.36690647,6944,-1447424,330240,-1117184,-1
9179,752,20,10,0.0757224851,0.924277515,2846.016044,2841.13591,5065.574355,3750.583777,9931,413.7916667,19862,-4699648,385024,-4314624,-1
928,96,15,15,0.09375,0.90625,285.5418903,370.7883347,520.3900862,436.2291667,1024,121.6152019,2048,-475136,49152,-425984,-1
7064,458,23,7,0.0608880617,0.939111938,2144.691647,2531.466207,3743.112542,4045.100437,7522,294.8647589,15044,-3616768,234496,-3382272,-1
1347,106,18,12,0.072952512,0.927047488,407.9057545,541.5040396,731.8069785,665.9150943,1453,101.6083916,2906,-689664,54272,-635392,-1
1568,253,18,12,0.138934651,0.861065349,509.6328117,558.9302349,949.721301,671.0197628,1821,62.68502582,3642,-802816,129536,-673280,-1
5881,236,27,3,0.0385810038,0.961418996,1758.597442,1891.890027,3075.400612,2650.305085,6117,593.3074685,12234,-3011072,120832,-2890240,-1
2265,345,23,7,0.132183908,0.867816092,723.3731306,845.3503304,1251.543929,1659.733333,2610,149.6559633,5220,-1159680,176640,-983040,-1
71,27,21,9,0.275510204,0.724489796,26.01038964,33.33757175,48.28169014,52.7037037,98,2.649364693,196,-36352,13824,-22528,-1
9332,611,20,10,0.0614502665,0.938549733,2859.871131,3024.537582,4975.6003,4917.011457,9943,826.5170407,19886,-4777984,312832,-4465152,-1
4805,365,21,9,0.0705996132,0.929400387,1475.392346,1699.85205,2580.660562,2649.208219,5170,94.91463191,10340,-2460160,186880,-2273280,-1
611,105,16,14,0.146648045,0.853351955,200.5395326,233.649103,366.7594108,310.4380952,716,62.26086957,1432,-312832,53760,-259072,-1
464,102,17,13,0.180212014,0.819787986,160.8446691,171.5657221,289.8426724,254.6470588,566,56.71342685,1132,-237568,52224,-185344,-1
686,142,19,11,0.171497585,0.828502415,232.984481,266.1740269,415.8629738,407.915493,828,72.44094488,1656,-351232,72704,-278528,-1
133,21,24,6,0.136363636,0.863636364,44.22759248,34.42913126,81.94736842,49.33333333,154,9.512044472,308,-68096,10752,-57344,-1
7590,312,20,10,0.039483675,0.960516325,2271.701191,2479.764795,3964.009354,3647.185897,7902,213.9723802,15804,-3886080,159744,-3726336,-1
9119,792,21,9,0.0799112098,0.92008879,2847.15741,2754.18634,5058.500713,3775.818182,9911,569.5977011,19822,-4668928,405504,-4263424,-1
9359,587,20,10,0.059018701,0.940981299,2856.287695,2970.006705,5027.267977,4116.235094,9946,337.8396739,19892,-4791808,300544,-4491264,-1
3758,244,22,8,0.0609695152,0.939030485,1141.204415,1350.906627,2006.945184,1917.635246,4002,315.3664303,8004,-1924096,124928,-1799168,-1
9431,536,22,8,0.0537774656,0.946222534,2846.942121,3124.490874,5053.183119,3766.712687,9967,514.2930857,19934,-4828672,274432,-4554240,-1
1069,125,22,8,0.104690117,0.895309883,335.0765303,408.7881138,607.0888681,515.496,1194,44.83665039,2388,-547328,64000,-483328,-1
2935,263,22,8,0.0822388993,0.917761101,910.232734,1056.556345,1596.891312,1628.612167,3198,93.12754805,6396,-1502720,134656,-1368064,-1
6741,335,22,8,0.0473431317,0.952656868,2029.846208,2259.682846,3555.078327,3204.904478,7076,248.9795918,14152,-3451392,171520,-3279872,-1
6617,301,21,9,0.0435096849,0.956490315,1978.205089,2373.128392,3456.780112,3519.292359,6918,485.4736842,13836,-3387904,154112,-3233792,-1
2020,218,17,13,0.0974084004,0.9025916,632.8728032,753.1638444,1111.331683,1195.188073,2238,63.16680779,4476,-1034240,111616,-922624,-1
78,28,17,13,0.264150943,0.735849057,29.7298045,28.49102526,58.56410256,39.39285714,106,2.819898909,212,-39936,14336,-25600,-1
2601,173,27,3,0.0623648161,0.937635184,795.8071806,820.5680947,1406.54133,1101.219653,2774,237.9073756,5548,-1331712,88576,-1243136,-1
7653,628,21,9,0.0758362517,0.924163748,2358.74292,2732.449984,4117.684437,4425.130573,8281,213.208033,16562,-3918336,321536,-3596800,-1
7195,561,20,10,0.0723310985,0.927668901,2198.740094,2640.816363,3835.463516,4430.456328,7756,263.451087,15512,-3683840,287232,-3396608,-1
418,40,27,3,0.0873362445,0.912663755,129.6638217,155.347576,231.1435407,212.325,458,11.99895206,916,-214016,20480,-193536,-1
3493,344,21,9,0.089653375,0.910346625,1103.452441,1110.589872,1891.183796,2201.447674,3837,112.8529412,7674,-1788416,176128,-1612288,-1
9468,481,21,9,0.0483465675,0.951653433,2841.303055,3376.684296,5002.235953,4438.887734,9949,878.8869258,19898,-4847616,246272,-4601344,-1
2539,190,18,12,0.0696225724,0.930377428,774.8815968,902.8090008,1384.794407,1100.484211,2729,108.7250996,5458,-1299968,97280,-1202688,-1
4671,692,22,8,0.129032258,0.870967742,1524.824143,1686.227427,2655.191394,2862.958092,5363,130.1699029,10726,-2391552,354304,-2037248,-1
1036,147,21,9,0.124260355,0.875739645,322.0253287,449.7774149,582.2374517,660.8027211,1183,90.0990099,2366,-530432,75264,-455168,-1
9624,360,23,7,0.0360576923,0.963942308,2869.46093,3110.499667,5020.466126,4244.872222,9984,1536,19968,-4927488,184320,-4743168,-1
4551,345,21,9,0.0704656863,0.929534314,1399.310633,1463.365366,2493.38541,1856.402899,4896,171.7292178,9792,-2330112,176640,-2153472,-1
9499,472,17,13,0.0473372781,0.952662722,2857.478769,3059.327351,5042.10559,3856.875,9971,867.0434783,19942,-4863488,241664,-4621824,-1
8826,1061,22,8,0.107312633,0.892687367,2864.915721,2743.777692,4907.253002,5249.682375,9887,570.5135603,19774,-4518912,543232,-3975680,-1
9615,368,20,10,0.0368626665,0.963137333,2874.542414,3011.535176,5013.702132,4424.972826,9983,741.679049,19966,-4922880,188416,-4734464,-1
9552,419,22,8,0.0420218634,0.957978137,2869.85701,3064.275859,4990.728957,4878.193317,9971,864.0381282,19942,-4890624,214528,-4676096,-1
395,52,21,9,0.116331096,0.883668904,129.0070552,95.8832423,234.7291139,142.5,447,34.49074074,894,-202240,26624,-175616,-1
9057,871,21,9,0.087731668,0.912268332,2831.525282,3039.546324,4871.942144,5926.952928,9928,620.888055,19856,-4637184,445952,-4191232,-1
2219,211,19,11,0.0868312757,0.913168724,685.3920442,849.7568611,1209.309599,1280.601896,2430,122.7272727,4860,-1136128,108032,-1028096,-1
831,96,20,10,0.103559871,0.896440129,263.7455344,291.4646019,471.2515042,401.2291667,927,109.8341232,1854,-425472,49152,-376320,-1
1713,204,18,12,0.106416275,0.893583725,535.1935733,683.8380232,951.0881494,1025.436275,1917,130.1425662,3834,-877056,104448,-772608,-1
930,116,21,9,0.110898662,0.889101338,287.9155028,391.8513658,516.044086,583.2758621,1046,127.7167277,2092,-476160,59392,-416768,-1
9537,440,20,10,0.0441014333,0.955898567,2854.536655,3114.142293,5049.114921,3686.009091,9977,786.829653,19954,-4882944,225280,-4657664,-1
9441,516,22,8,0.0518228382,0.948177162,2879.068848,2779.510497,4968.602267,5169.242248,9957,793.3864542,19914,-4833792,264192,-4569600,-1
9560,417,22,8,0.0417961311,0.958203869,2873.794949,2876.899442,5028.406381,4085.582734,9977,708.0908446,19954,-4894720,213504,-4681216,-1
3272,435,20,10,0.117345562,0.882654438,1064.384329,1111.593754,1858.96577,1816.648276,3707,84.13527009,7414,-1675264,222720,-1452544,-1
9634,353,20,10,0.0353459497,0.96465405,2873.319268,3120.376233,5005.124247,4690.399433,9987,898.1115108,19974,-4932608,180736,-4751872,-1
6987,611,20,10,0.0804158989,0.919584101,2184.458461,2169.428766,3861.673393,3088.525368,7598,290.999617,15196,-3577344,312832,-3264512,-1
3268,265,25,5,0.0750070761,0.924992924,1019.89467,1019.173205,1764.163709,1801.977358,3533,187.7258236,7066,-1673216,135680,-1537536,-1
8922,976,20,10,0.0986057789,0.901394221,2837.174272,2997.316909,4899.877158,5403.121926,9898,320.8427877,19796,-4568064,499712,-4068352,-1
697,60,18,12,0.0792602378,0.920739762,212.2677259,218.8010131,393.5911047,209.5,757,129.1808874,1514,-356864,30720,-326144,-1
3535,324,21,9,0.083959575,0.916040425,1084.727113,1393.619077,1927.248939,1960.015432,3859,96.18644068,7718,-1809920,165888,-1644032,-1
642,75,18,12,0.10460251,0.89539749,201.4383621,206.6957554,374.4330218,226.8933333,717,31.65562914,1434,-328704,38400,-290304,-1
784,108,25,5,0.121076233,0.878923767,251.273325,287.4967291,457.0242347,370.1018519,892,58.26257348,1784,-401408,55296,-346112,-1
38,15,21,9,0.283018868,0.716981132,15.08601837,15.45257979,28.13157895,24.13333333,53,7.28021978,106,-19456,7680,-11776,-1
3833,332,23,7,0.0797118848,0.920288115,1192.936124,1222.250731,2121.216541,1641.783133,4165,252.7305825,8330,-1962496,169984,-1792512,-1
7682,407,22,8,0.0503152429,0.949684757,2331.247215,2385.155017,4061.524212,3733.110565,8089,151.5645494,16178,-3933184,208384,-3724800,-1
1250,146,16,14,0.104584527,0.895415473,389.8894367,476.1878441,715.828,550.1438356,1396,219.8425197,2792,-640000,74752,-565248,-1
6834,861,17,13,0.111890838,0.888109162,2193.513333,2386.255986,3903.159789,3410.181185,7695,180.2107728,15390,-3499008,440832,-3058176,-1
4626,413,20,10,0.0819607065,0.918039294,1421.762338,1778.204312,2510.238651,2629.336562,5039,308.007335,10078,-2368512,211456,-2157056,-1
8722,441,25,5,0.0481283422,0.951871658,2646.159529,2587.822679,4603.625086,4154.303855,9163,325.8534851,18326,-4465664,225792,-4239872,-1
38,16,20,10,0.296296296,0.703703704,15.35013783,15.9760563,28.28947368,25.625,54,11.13402062,108,-19456,8192,-11264,-1
3403,318,20,10,0.0854608976,0.914539102,1065.256887,1155.605803,1874.324126,1718.415094,3721,89.27543186,7442,-1742336,162816,-1579520,-1
1345,129,21,9,0.0875169607,0.912483039,407.5295109,529.9574655,759.2475836,510.751938,1474,56.8234387,2948,-688640,66048,-622592,-1
3565,945,24,6,0.209534368,0.790465632,1300.048672,1184.80137,2124.351473,2750.256085,4510,94.54926625,9020,-1825280,483840,-1341440,-1
2378,243,21,9,0.0927127051,0.907287295,760.2409451,688.5312853,1331.557611,1109.823045,2621,72.80555556,5242,-1217536,124416,-1093120,-1
88,24,20,10,0.214285714,0.785714286,31.99764123,24.39998719,62.05681818,36.125,112,5.431619787,224,-45056,12288,-32768,-1
4896,911,17,13,0.156879628,0.843120372,1600.720945,1902.792247,2780.651757,3566.912184,5807,133.4635716,11614,-2506752,466432,-2040320,-1
1406,210,22,8,0.129950495,0.870049505,460.1404824,500.6261081,819.6827881,733.6285714,1616,80.43802887,3232,-719872,107520,-612352,-1
3927,281,22,8,0.0667775665,0.933222433,1192.142372,1490.519788,2096.255157,2219.72242,4208,232.1014892,8416,-2010624,143872,-1866752,-1
4368,629,20,10,0.125875525,0.874124475,1357.349108,1746.763526,2387.534341,3273.057234,4997,175.3948754,9994,-2236416,322048,-1914368,-1
4558,455,20,10,0.0907640136,0.909235986,1442.97328,1487.494108,2511.084028,2466.087912,5013,107.8528399,10026,-2333696,232960,-2100736,-1
2637,139,20,10,0.0500720461,0.949927954,789.3656852,929.7055192,1407.712931,1024.007194,2776,132.001902,5552,-1350144,71168,-1278976,-1
6967,440,21,9,0.0594032672,0.940596733,2120.987956,2379.239345,3720.561217,3441.768182,7407,594.939759,14814,-3567104,225280,-3341824,-1
1052,156,21,9,0.129139073,0.870860927,333.8362232,435.5704979,601.769962,622.9102564,1208,53.0989011,2416,-538624,79872,-458752,-1
238,57,20,10,0.193220339,0.806779661,83.89145297,85.78282183,154.0378151,122.7894737,295,19.14341337,590,-121856,29184,-92672,-1
6540,361,17,13,0.0523112592,0.947688741,1977.287446,2218.538326,3469.247859,3120.415512,6901,263.095692,13802,-3348480,184832,-3163648,-1
9333,603,25,5,0.0606884058,0.939311594,2873.906658,2778.052091,4974.446802,4876.457711,9936,526.2711864,19872,-4778496,308736,-4469760,-1
4057,350,19,11,0.079419106,0.920580894,1252.942375,1412.663163,2168.27582,2618.094286,4407,207.5836081,8814,-2077184,179200,-1897984,-1
307,52,27,3,0.144846797,0.855153203,103.2696729,105.7403177,180.3127036,178.1538462,359,38.02966102,718,-157184,26624,-130560,-1
175,28,17,13,0.137931034,0.862068966,57.10914548,53.4141859,108.0514286,64.17857143,203,18.1736795,406,-89600,14336,-75264,-1
3781,209,16,14,0.0523809524,0.947619048,1131.290941,1309.837773,2031.942079,1336.229665,3990,606.3829787,7980,-1935872,107008,-1828864,-1
922,58,19,11,0.0591836735,0.940816327,278.6787594,332.3773861,495.697397,407.8793103,980,76.80250784,1960,-472064,29696,-442368,-1
553,49,20,10,0.0813953488,0.918604651,168.5503245,219.7480364,305.4141049,257.3265306,602,24.63175123,1204,-283136,25088,-258048,-1
2888,231,17,13,0.0740621994,0.925937801,887.3495937,949.0438692,1594.522161,1128.398268,3119,93.32734889,6238,-1478656,118272,-1360384,-1
814,90,27,3,0.0995575221,0.900442478,263.8338963,231.0533998,455.955774,421.2444444,904,45.13230155,1808,-416768,46080,-370688,-1
5511,1119,21,9,0.168778281,0.831221719,1776.549894,1972.387264,3036.620214,4688.964254,6630,124.9058026,13260,-2821632,572928,-2248704,-1
1087,149,17,13,0.120550162,0.879449838,354.6010486,369.2916759,624.7396504,572.9798658,1236,96.71361502,2472,-556544,76288,-480256,-1
3888,420,21,9,0.0974930362,0.902506964,1205.816496,1500.701336,2114.558385,2524.245238,4308,257.9640719,8616,-1990656,215040,-1775616,-1
358,44,18,12,0.109452736,0.890547264,109.61664,149.1040598,207.896648,149.4545455,402,41.70124481,804,-183296,22528,-160768,-1
93,23,20,10,0.198275862,0.801724138,33.14254453,24.62205813,63.95698925,36.43478261,116,18.04043546,232,-47616,11776,-35840,-1
4169,262,21,9,0.0591288648,0.940871135,1266.843474,1458.291442,2221.047973,2135.675573,4431,150,8862,-2134528,134144,-2000384,-1
9412,551,27,3,0.0553046271,0.944695373,2883.687346,2701.742882,5008.86751,4523.058076,9963,558.4641256,19926,-4818944,282112,-4536832,-1
8437,746,20,10,0.0812370685,0.918762932,2630.90472,2789.384724,4535.700249,5228.730563,9183,297.6661264,18366,-4319744,381952,-3937792,-1
4096,320,22,8,0.0724637681,0.927536232,1262.180416,1221.069298,2263.971191,1498.46875,4416,238.831801,8832,-2097152,163840,-1933312,-1
9424,529,22,8,0.0531498041,0.946850196,2858.363233,3040.335628,5016.568973,4272.088847,9953,1264.675985,19906,-4825088,270848,-4554240,-1
46,24,19,11,0.342857143,0.657142857,18.77275557,22.69850705,35.41304348,35.66666667,70,9.56284153,140,-23552,12288,-11264,-1
9010,891,20,10,0.08999091,0.91000909,2849.292629,2883.263328,5008.261487,4371.958474,9901,227.7138914,19802,-4613120,456192,-4156928,-1
8145,555,22,8,0.0637931034,0.936206897,2463.548746,3074.151703,4311.152241,4927.954955,8700,205.722393,17400,-4170240,284160,-3886080,-1
579,71,19,11,0.109230769,0.890769231,183.6299821,211.4449575,331.4421416,277.0422535,650,51.26182965,1300,-296448,36352,-260096,-1
1809,103,19,11,0.0538702929,0.946129707,544.6033895,639.2606274,967.2128248,768.3495146,1912,277.5036284,3824,-926208,52736,-873472,-1
7436,417,21,9,0.0531007258,0.946899274,2240.90465,2599.054226,3964.766407,3253.544365,7853,520.7559682,15706,-3807232,213504,-3593728,-1
3192,429,20,10,0.118475559,0.881524441,1025.912979,1168.679696,1790.856516,1960.878788,3621,117.2224021,7242,-1634304,219648,-1414656,-1
8315,534,19,11,0.0603458018,0.939654198,2532.096729,2864.499741,4444.023572,4128.780899,8849,182.3408201,17698,-4257280,273408,-3983872,-1
7941,702,22,8,0.081221798,0.918778202,2503.96478,2265.598704,4386.883768,3588.037037,8643,376.9297863,17286,-4065792,359424,-3706368,-1
4214,283,22,8,0.0629308428,0.937069157,1287.304853,1436.182912,2235.835785,2445.021201,4497,193.0871619,8994,-2157568,144896,-2012672,-1
2254,200,20,10,0.0814995925,0.918500407,694.6874798,834.6220772,1240.176575,1084.635,2454,57.55159475,4908,-1154048,102400,-1051648,-1
2423,212,25,5,0.080455408,0.919544592,753.1703082,837.892974,1324.55551,1243.075472,2635,95.22949042,5270,-1240576,108544,-1132032,-1
8422,482,24,6,0.0541329739,0.945867026,2547.578771,2700.441842,4517.217526,3321.688797,8904,252.9545455,17808,-4312064,246784,-4065280,-1
4086,422,19,11,0.0936113576,0.906388642,1293.064538,1376.967349,2261.815957,2183.663507,4508,95.4478086,9016,-2092032,216064,-1875968,-1
83,22,21,9,0.20952381,0.79047619,30.22702602,28.95026371,55.34939759,44.13636364,105,21.60493827,210,-42496,11264,-31232,-1
2461,384,22,8,0.134973638,0.865026362,819.785012,824.0795924,1407.692808,1521.101563,2845,141.6832669,5690,-1260032,196608,-1063424,-1
9516,455,21,9,0.0456323338,0.954367666,2859.519916,3046.894434,5038.531421,3887.342857,9971,852.2222222,19942,-4872192,232960,-4639232,-1
1782,135,24,6,0.0704225352,0.929577465,548.2674939,609.7213328,952.0808081,1050.333333,1917,148.8354037,3834,-912384,69120,-843264,-1
2873,243,20,10,0.0779845956,0.922015404,892.0256531,979.2946618,1566.06126,1469.102881,3116,70.59356593,6232,-1470976,124416,-1346560,-1
325,31,17,13,0.0870786517,0.912921348,98.220344,103.3100161,187.3692308,85.51612903,356,117.8807947,712,-166400,15872,-150528,-1
51,17,17,13,0.25,0.75,19.64823291,16.64175763,37.47058824,25.58823529,68,14.19624217,136,-26112,8704,-17408,-1
9453,506,16,14,0.0508083141,0.949191686,2840.5128,3301.062914,5033.220882,3985.737154,9959,606.5164434,19918,-4839936,259072,-4580864,-1
1335,104,22,8,0.0722724114,0.927727589,403.7074479,540.7332447,724.2082397,665.9807692,1439,130.3442029,2878,-683520,53248,-630272,-1
645,87,21,9,0.118852459,0.881147541,200.0196131,270.8577632,356.9255814,437.4827586,732,29.58771221,1464,-330240,44544,-285696,-1
78,10,20,10,0.113636364,0.886363636,24.4690529,7.697402159,48.21794872,15.5,88,4.641350211,176,-39936,5120,-34816,-1
7308,757,21,9,0.0938623683,0.906137632,2233.721356,2914.167856,3930.183361,5025.581242,8065,270.4560698,16130,-3741696,387584,-3354112,-1
4460,324,17,13,0.0677257525,0.932274247,1360.794784,1458.023128,2444.27287,1679.824074,4784,321.5053763,9568,-2283520,165888,-2117632,-1
137,34,19,11,0.198830409,0.801169591,48.77491112,38.24562078,93.71532847,54.91176471,171,44.41558442,342,-70144,17408,-52736,-1
1133,162,20,10,0.125096525,0.874903475,365.9973005,416.1246964,659.3027361,568.9506173,1295,54.38891222,2590,-580096,82944,-497152,-1
1242,106,21,9,0.0786350148,0.921364985,382.0919896,463.4269903,675.9074074,658.009434,1348,101.6591252,2696,-635904,54272,-581632,-1
5783,433,20,10,0.0696589447,0.930341055,1765.908687,2054.798045,3151.389244,2535.685912,6216,196.1502051,12432,-2960896,221696,-2739200,-1
8353,506,20,10,0.0571170561,0.942882944,2540.369898,2740.997722,4469.805818,3772.889328,8859,313.1495228,17718,-4276736,259072,-4017664,-1
2483,211,21,9,0.0783221975,0.921677803,776.1390279,792.6512706,1353.199356,1280.43128,2694,103.3371692,5388,-1271296,108032,-1163264,-1
3459,171,27,3,0.047107438,0.952892562,1044.824643,1089.762938,1825.185603,1619.578947,3630,221.8826406,7260,-1771008,87552,-1683456,-1
2125,246,27,3,0.10375369,0.89624631,672.0447702,777.6122181,1175.525647,1276.479675,2371,201.1026293,4742,-1088000,125952,-962048,-1
2427,257,21,9,0.095752608,0.904247392,763.6136068,872.7253635,1346.05686,1308.910506,2684,56.04510336,5368,-1242624,131584,-1111040,-1
9529,441,21,9,0.0442326981,0.955767302,2863.839874,3070.840044,5021.168643,4214.782313,9970,806.6343042,19940,-4878848,225792,-4653056,-1
4619,358,22,8,0.0719308821,0.928069118,1424.387958,1585.791015,2494.440139,2418.810056,4977,257.2093023,9954,-2364928,183296,-2181632,-1
2008,177,23,7,0.081006865,0.918993135,616.4939266,774.3380607,1093.549303,1086.768362,2185,41.41394996,4370,-1028096,90624,-937472,-1
159,28,20,10,0.14973262,0.85026738,52.52772205,47.88666467,100.2893082,58.28571429,187,41.46341463,374,-81408,14336,-67072,-1
5240,229,27,3,0.0418723715,0.958127628,1570.752102,1721.480276,2748.954962,2415.681223,5469,535.6513222,10938,-2682880,117248,-2565632,-1
3316,288,18,12,0.0799112098,0.92008879,1028.308768,1170.450198,1803.29614,1793.333333,3604,75.82579424,7208,-1697792,147456,-1550336,-1
2353,149,18,12,0.0595523581,0.940447642,714.7679538,827.1213969,1246.120272,1336.456376,2502,70.43918919,5004,-1204736,76288,-1128448,-1
7116,495,22,8,0.0650374458,0.934962554,2175.782899,2419.997231,3843.5319,3266.450505,7611,383.2326284,15222,-3643392,253440,-3389952,-1
9525,449,17,13,0.0450170443,0.954982956,2857.047744,3305.69153,4999.127244,4740.841871,9974,897.749775,19948,-4876800,229888,-4646912,-1
8973,933,17,13,0.0941853422,0.905814658,2871.073624,2743.833918,4966.514098,4828.338692,9906,769.6969697,19812,-4594176,477696,-4116480,-1
2047,263,18,12,0.113852814,0.886147186,648.2777779,796.6615441,1155.645823,1154.365019,2310,42.35423542,4620,-1048064,134656,-913408,-1
2295,110,26,4,0.0457380457,0.954261954,689.866856,754.1517415,1212.39085,1007.072727,2405,189.072327,4810,-1175040,56320,-1118720,-1
2513,437,22,8,0.148135593,0.851864407,828.0990579,974.9175744,1482.044568,1437.864989,2950,89.47528056,5900,-1286656,223744,-1062912,-1
457,60,23,7,0.116054159,0.883945841,141.6368142,193.6946588,254.0437637,296.75,517,14.82649842,1034,-233984,30720,-203264,-1
9368,561,22,8,0.0565011582,0.943498842,2849.499002,3050.941595,5006.39795,4273.705882,9929,615.1796778,19858,-4796416,287232,-4509184,-1
9473,492,27,3,0.0493728048,0.950627195,2858.483068,2966.819678,5044.581864,3797.29878,9965,658.6252479,19930,-4850176,251904,-4598272,-1
9392,564,20,10,0.0566492567,0.943350743,2855.285401,3114.092562,5013.145443,4401.567376,9956,1029.576008,19912,-4808704,288768,-4519936,-1
1545,412,21,9,0.210526316,0.789473684,530.6553092,632.941708,921.2601942,1195.524272,1957,40.1683087,3914,-791040,210944,-580096,-1
653,89,18,12,0.119946092,0.880053908,203.1546896,264.5009254,358.8866769,464.0449438,742,28.984375,1484,-334336,45568,-288768,-1
7360,1250,21,9,0.145180023,0.854819977,2378.776399,2411.968881,4015.256793,6014.452,8610,177.892562,17220,-3768320,640000,-3128320,-1
1632,156,25,5,0.0872483221,0.912751678,514.051466,535.7497735,898.5968137,851.6410256,1788,90.6693712,3576,-835584,79872,-755712,-1
4179,286,20,10,0.0640537514,0.935946249,1279.669981,1416.412067,2236.530988,2181.405594,4465,404.4384058,8930,-2139648,146432,-1993216,-1
9608,374,21,9,0.0374674414,0.962532559,2868.774889,3064.105823,5025.713052,4112.572193,9982,250.1754386,19964,-4919296,191488,-4727808,-1
2711,185,22,8,0.0638812155,0.936118785,830.6860346,909.1619261,1451.58945,1403.227027,2896,232.0512821,5792,-1388032,94720,-1293312,-1
393,78,18,12,0.165605096,0.834394904,130.7069352,156.6810691,241.7430025,207.0641026,471,51.02925244,942,-201216,39936,-161280,-1
449,58,26,4,0.114398422,0.885601578,139.1882324,188.9268877,249.1737194,291.362069,507,14.56059736,1014,-229888,29696,-200192,-1
225,37,18,12,0.141221374,0.858778626,70.68439275,87.30670186,139.12,85.16216216,262,75.28735632,524,-115200,18944,-96256,-1
511,85,18,12,0.14261745,0.85738255,166.0784478,192.612954,308.9921722,235.4235294,596,60.8784474,1192,-261632,43520,-218112,-1
453,71,21,9,0.135496183,0.864503817,143.3090106,189.0217206,255.812362,305.1690141,524,51.6765286,1048,-231936,36352,-195584,-1
6987,314,19,11,0.0430078071,0.956992193,2095.424234,2287.669505,3676.97023,3073.121019,7301,453.7600994,14602,-3577344,160768,-3416576,-1
9499,469,20,10,0.0470505618,0.952949438,2867.216186,2914.430531,5032.31877,4015.991471,9968,1036.174636,19936,-4863488,240128,-4623360,-1
4729,368,20,10,0.0721993329,0.927800667,1473.883749,1302.566495,2594.802918,1960.407609,5097,159.5305164,10194,-2421248,188416,-2232832,-1
5719,864,19,11,0.131247152,0.868752848,1818.453071,2262.723699,3191.705893,3955.868056,6583,174.4765439,13166,-2928128,442368,-2485760,-1
813,108,17,13,0.117263844,0.882736156,259.0905172,301.6169881,471.0651907,385.2314815,921,90.11741683,1842,-416256,55296,-360960,-1
8250,845,20,10,0.0929081913,0.907091809,2575.810705,3060.145847,4525.733818,4765.391716,9095,180.2775025,18190,-4224000,432640,-3791360,-1
1525,192,19,11,0.111822947,0.888177053,481.1758456,562.0788995,883.3403279,665.671875,1717,103.1231231,3434,-780800,98304,-682496,-1
7655,514,21,9,0.0629207981,0.937079202,2350.141187,2474.791445,4083.347485,4109.610895,8169,260.8237548,16338,-3919360,263168,-3656192,-1
3313,172,21,9,0.0493543759,0.950645624,997.2318992,1160.07824,1746.892545,1668.023256,3485,380.0436205,6970,-1696256,88064,-1608192,-1
1838,115,20,10,0.0588837686,0.941116231,551.0379705,735.8134599,973.4053319,1034.452174,1953,35.88754135,3906,-941056,58880,-882176,-1
3793,229,16,14,0.0569368473,0.943063153,1151.556767,1307.542196,2008.839705,2055.563319,4022,99.01526342,8044,-1942016,117248,-1824768,-1
2595,224,24,6,0.0794608017,0.920539198,803.3505919,851.7078876,1440.103276,1061.258929,2819,59.18538736,5638,-1328640,114688,-1213952,-1
4314,538,23,7,0.11088211,0.88911789,1390.964457,1475.993728,2425.236439,2436.63197,4852,145.2694611,9704,-2208768,275456,-1933312,-1
9531,439,21,9,0.0440320963,0.955967904,2868.67127,3033.45999,5008.321687,4490.025057,9970,977.4509804,19940,-4879872,224768,-4655104,-1
8935,563,21,9,0.059275637,0.940724363,2728.908811,2898.038552,4779.53005,4272.912966,9498,328.0829016,18996,-4574720,288256,-4286464,-1
2252,255,21,9,0.101715197,0.898284803,720.6827813,745.8727032,1245.670515,1327.560784,2507,87.56549074,5014,-1153024,130560,-1022464,-1
474,23,27,3,0.046277666,0.953722334,142.6551353,144.7567414,252.1582278,183.9130435,497,85.98615917,994,-242688,11776,-230912,-1
6044,562,20,10,0.085074175,0.914925825,1871.610477,2200.82093,3260.78822,3762.841637,6606,172.6156258,13212,-3094528,287744,-2806784,-1
7890,353,20,10,0.0428242145,0.957175786,2369.966648,2483.102307,4153.37275,3420.779037,8243,217.378692,16486,-4039680,180736,-3858944,-1
2368,274,21,9,0.103709311,0.896290689,769.0531362,704.6128586,1318.343328,1348.781022,2642,58.78949711,5284,-1212416,140288,-1072128,-1
125,66,22,8,0.345549738,0.654450262,56.17157488,53.11738305,95.776,96.42424242,191,13.12714777,382,-64000,33792,-30208,-1
7715,597,22,8,0.0718238691,0.928176131,2388.899475,2507.87874,4182.534154,3820.061977,8312,191.8301408,16624,-3950080,305664,-3644416,-1
3863,356,20,10,0.0843801849,0.915619815,1212.900144,1236.48753,2135.987316,1828.008427,4219,329.609375,8438,-1977856,182272,-1795584,-1
8432,488,21,9,0.0547085202,0.94529148,2540.572936,2929.064931,4519.315583,3444.243852,8920,334.4581927,17840,-4317184,249856,-4067328,-1
2016,147,20,10,0.067961165,0.932038835,609.3800835,800.2357722,1086.293155,1023.122449,2163,66.53337435,4326,-1032192,75264,-956928,-1
1990,116,21,9,0.0550807217,0.944919278,597.041743,764.1482452,1059.488442,950.7672414,2106,162.1247113,4212,-1018880,59392,-959488,-1
9565,411,21,9,0.0411988773,0.958801123,2877.466116,2901.365183,5006.901098,4560.260341,9976,825.8278146,19952,-4897280,210432,-4686848,-1
3284,196,19,11,0.0563218391,0.943678161,991.1489525,1192.794453,1751.481425,1556.505102,3480,202.7972028,6960,-1681408,100352,-1581056,-1
310,87,23,7,0.219143577,0.780856423,109.7840561,130.1381077,197.2193548,205.3448276,397,25.9646828,794,-158720,44544,-114176,-1
9616,365,27,3,0.036569482,0.963430518,2870.923817,3094.576421,5011.155054,4460.010959,9981,1537.904468,19962,-4923392,186880,-4736512,-1
4559,302,27,3,0.0621271343,0.937872866,1386.72855,1566.077038,2460.561965,1984.731788,4861,114.7003303,9722,-2334208,154624,-2179584,-1
2033,214,20,10,0.0952380952,0.904761905,624.8801967,816.9152008,1144.277914,931.3598131,2247,55.44041451,4494,-1040896,109568,-931328,-1
656,91,17,13,0.121820616,0.878179384,209.8096331,243.9357808,383.0792683,308.5494505,747,19.6889826,1494,-335872,46592,-289280,-1
2116,221,27,3,0.0945656825,0.905434318,678.6773913,634.4028796,1170.626654,1153.425339,2337,81.91377497,4674,-1083392,113152,-970240,-1
206,50,19,11,0.1953125,0.8046875,71.944894,69.83856814,137.631068,90.88,256,21.63989856,512,-105472,25600,-79872,-1
2069,201,19,11,0.0885462555,0.911453744,646.1875108,741.8970536,1138.395843,1105.691542,2270,161.4509246,4540,-1059328,102912,-956416,-1
891,62,19,11,0.0650577125,0.934942288,268.0591795,307.6985193,489.7699214,293.483871,953,124.4125326,1906,-456192,31744,-424448,-1
1614,155,22,8,0.0876201244,0.912379876,499.5997009,606.2964526,893.9888476,791.4,1769,173.9429695,3538,-826368,79360,-747008,-1
2153,270,22,8,0.111432109,0.888567891,678.8278458,809.6035222,1182.913144,1443.940741,2423,47.33346357,4846,-1102336,138240,-964096,-1
9253,690,20,10,0.0693955547,0.930604445,2852.077626,2857.663858,5059.232141,3802.204348,9943,511.9979403,19886,-4737536,353280,-4384256,-1
9495,475,17,13,0.0476429288,0.952357071,2860.426496,3126.623828,5021.173249,4272.410526,9970,1626.427406,19940,-4861440,243200,-4618240,-1
9562,414,22,8,0.041499599,0.958500401,2868.68789,3009.289991,5024.367601,4160.07971,9976,315.3967752,19952,-4895744,211968,-4683776,-1
2721,391,19,11,0.125642674,0.874357326,889.4495483,958.0229506,1555.468945,1563.675192,3112,65.15912898,6224,-1393152,200192,-1192960,-1
570,29,20,10,0.0484140234,0.951585977,169.7211136,208.8842166,304.3789474,213.9310345,599,48.26752619,1198,-291840,14848,-276992,-1
127,40,21,9,0.239520958,0.760479042,46.73455142,52.25068779,85.69291339,78.625,167,22.06076618,334,-65024,20480,-44544,-1
3358,322,21,9,0.0875,0.9125,1055.583092,1128.765808,1845.774568,1785.493789,3680,223.7082067,7360,-1719296,164864,-1554432,-1
2157,167,20,10,0.071858864,0.928141136,660.0832794,797.2518804,1163.219286,1153.209581,2324,128.1853282,4648,-1104384,85504,-1018880,-1
465,55,19,11,0.105769231,0.894230769,145.3813117,165.2669566,269.8817204,181.1818182,520,89.34707904,1040,-238080,28160,-209920,-1
2938,173,27,3,0.0556091289,0.944390871,898.0187809,890.995147,1562.810415,1440.34104,3111,154.3920596,6222,-1504256,88576,-1415680,-1
6722,1193,22,8,0.150726469,0.849273531,2182.680312,1910.993847,3625.176436,5833.305951,7915,167.4069374,15830,-3441664,610816,-2830848,-1
1918,232,20,10,0.107906977,0.892093023,605.384781,704.2173512,1099.472367,877.3146552,2150,95.4283178,4300,-982016,118784,-863232,-1
5210,2093,20,10,0.28659455,0.71340545,1806.328188,1487.388474,2880.214395,5573.167224,7303,330.7518116,14606,-2667520,1071616,-1595904,-1
3919,252,21,9,0.0604171661,0.939582834,1194.456773,1250.753335,2116.772136,1607.444444,4171,85.24422645,8342,-2006528,129024,-1877504,-1
7376,862,25,5,0.104637048,0.895362952,2388.58661,2140.686171,4208.335412,3359.349188,8238,197.3173653,16476,-3776512,441344,-3335168,-1
2815,241,26,4,0.0788612565,0.921138743,877.0562302,930.1299515,1539.717229,1397.477178,3056,111.0061751,6112,-1441280,123392,-1317888,-1
2735,242,16,14,0.0812898892,0.918710111,835.4653084,1093.88366,1487.957952,1500.77686,2977,65.05681818,5954,-1400320,123904,-1276416,-1
325,28,18,12,0.0793201133,0.920679887,97.84616952,106.2730407,184.6184615,88.57142857,353,83.6492891,706,-166400,14336,-152064,-1
3427,414,21,9,0.107784431,0.892215569,1104.821284,1099.602104,1886.156113,2209.429952,3841,242.1815889,7682,-1754624,211968,-1542656,-1
9618,368,20,10,0.0368515922,0.963148408,2870.305721,3169.121066,5007.131108,4637.23913,9986,1088.985823,19972,-4924416,188416,-4736000,-1
9027,660,20,10,0.0681325488,0.931867451,2747.625799,3299.823303,4899.980614,4078.337879,9687,726.161919,19374,-4621824,337920,-4283904,-1
8206,547,22,8,0.0624928596,0.93750714,2503.186332,2845.937257,4393.464538,4130.001828,8753,498.7464387,17506,-4201472,280064,-3921408,-1
421,50,22,8,0.106157113,0.893842887,132.2536727,113.8469587,249.2422803,124.5,471,20.08528785,942,-215552,25600,-189952,-1
627,36,26,4,0.0542986425,0.945701357,188.3538936,222.4948536,336.7432217,249.3888889,663,62.13683224,1326,-321024,18432,-302592,-1
9408,565,20,10,0.056652963,0.943347037,2840.777356,2965.46636,5090.20642,3268.476106,9973,442.8507993,19946,-4816896,289280,-4527616,-1
221,46,20,10,0.172284644,0.827715356,75.57027406,65.90693803,143.841629,86.7173913,267,23.54497354,534,-113152,23552,-89600,-1
665,68,19,11,0.0927694407,0.907230559,204.32919,257.7320984,375.6661654,282.25,733,13.83802152,1466,-340480,34816,-305664,-1
3433,242,21,9,0.0658503401,0.93414966,1056.650757,1116.019992,1843.718031,1756.884298,3675,132.8153235,7350,-1757696,123904,-1633792,-1
301,51,19,11,0.144886364,0.855113636,96.04082719,124.861963,182.0066445,144,352,22.63665595,704,-154112,26112,-128000,-1
9320,621,22,8,0.0624685645,0.937531435,2846.672347,2949.626725,5050.337876,3780.293076,9941,301.8827817,19882,-4771840,317952,-4453888,-1
1268,167,19,11,0.116376307,0.883623693,406.4810328,468.3904835,714.9227129,741.3652695,1435,79.94428969,2870,-649216,85504,-563712,-1
7127,580,22,8,0.0752562605,0.924743739,2191.013835,2568.813102,3820.307843,4268.006897,7707,160.8977035,15414,-3649024,296960,-3352064,-1
6341,578,17,13,0.0835380835,0.916461916,1978.438248,2161.84447,3492.695001,3101.316609,6919,348.9157842,13838,-3246592,295936,-2950656,-1
484,77,24,6,0.137254902,0.862745098,160.337499,164.0300675,288.5061983,233.8181818,561,13.84159882,1122,-247808,39424,-208384,-1
2870,128,19,11,0.0426951301,0.95730487,860.4246069,912.7076128,1513.996167,1174.46875,2998,227.8115502,5996,-1469440,65536,-1403904,-1
3748,290,16,14,0.0718177316,0.928182268,1158.134537,1110.589296,2063.707844,1448.151724,4038,390.9002904,8076,-1918976,148480,-1770496,-1
3120,319,21,9,0.0927595231,0.907240477,990.6066744,935.491506,1757.976282,1348.570533,3439,66.54411765,6878,-1597440,163328,-1434112,-1
207,25,21,9,0.107758621,0.892241379,65.28692589,74.17963063,119.7826087,89.32,232,40.41811847,464,-105984,12800,-93184,-1
2574,121,17,13,0.0448979592,0.955102041,767.3793804,871.4249154,1368.252525,917.1735537,2695,192.3625981,5390,-1317888,61952,-1255936,-1
3947,437,20,10,0.0996806569,0.900319343,1276.629825,1135.502538,2217.776539,1964.201373,4384,107.5300466,8768,-2020864,223744,-1797120,-1
6229,684,21,9,0.0989440185,0.901055981,1966.846868,2162.728239,3395.950714,4012.959064,6913,153.1457687,13826,-3189248,350208,-2839040,-1
68,24,20,10,0.260869565,0.739130435,25.52061298,28.75830194,48.19117647,41.70833333,92,12.15323646,184,-34816,12288,-22528,-1
9534,446,21,9,0.0446893788,0.955310621,2866.503918,3123.489723,5016.451017,4435.753363,9980,296.2303354,19960,-4881408,228352,-4653056,-1
7349,354,21,9,0.045956121,0.954043879,2210.420934,2427.63101,3876.465097,3344.107345,7703,546.6997871,15406,-3762688,181248,-3581440,-1
7488,852,22,8,0.102158273,0.897841727,2390.202422,2494.908457,4111.130208,4692.285211,8340,190.367496,16680,-3833856,436224,-3397632,-1
8998,507,25,5,0.0533403472,0.946659653,2733.02327,2926.938206,4746.319515,4871.56213,9505,214.4146176,19010,-4606976,259584,-4347392,-1
4369,842,19,11,0.16158127,0.83841873,1500.904063,1428.442036,2513.432364,3086.31829,5211,129.7882939,10422,-2236928,431104,-1805824,-1
2753,143,23,7,0.049378453,0.950621547,826.8071814,928.5294617,1466.838358,1095.454545,2896,291.0552764,5792,-1409536,73216,-1336320,-1
2189,282,26,4,0.114123837,0.885876163,695.8771975,823.7164309,1218.398812,1372.62766,2471,47.92474787,4942,-1120768,144384,-976384,-1
2475,407,21,9,0.141221374,0.858778626,827.7995676,850.1815946,1425.257374,1540.272727,2882,117.4409128,5764,-1267200,208384,-1058816,-1
891,101,21,9,0.101814516,0.898185484,284.3392272,288.7278979,506.6026936,407.3762376,992,66.66666667,1984,-456192,51712,-404480,-1
1356,136,21,9,0.091152815,0.908847185,426.9749879,462.7898759,751.9196165,692.4632353,1492,31.68400934,2984,-694272,69632,-624640,-1
3453,338,16,14,0.0891585334,0.910841467,1092.04529,1110.033977,1908.298871,1770.35503,3791,139.9926145,7582,-1767936,173056,-1594880,-1
4874,1022,20,10,0.173337856,0.826662144,1706.045636,1505.08092,2805.027493,3632.731898,5896,114.6189736,11792,-2495488,523264,-1972224,-1
9088,811,20,10,0.0819274674,0.918072533,2851.268269,2916.420266,4971.815031,4705.54254,9899,691.7540182,19798,-4653056,415232,-4237824,-1
9512,456,22,8,0.0457463884,0.954253612,2866.576439,2997.686717,5020.909062,4225.019737,9968,941.2653447,19936,-4870144,233472,-4636672,-1
7540,503,27,3,0.0625388537,0.937461146,2279.576704,2875.368639,4034.324005,3837.262425,8043,232.4566474,16086,-3860480,257536,-3602944,-1
134,21,22,8,0.135483871,0.864516129,43.76647321,43.2940167,81.79850746,53.76190476,155,17.43532058,310,-68608,10752,-57856,-1
2886,174,21,9,0.0568627451,0.943137255,873.2864092,956.9557791,1553.746362,1144.931034,3060,99.609375,6120,-1477632,89088,-1388544,-1
9520,450,20,10,0.0451354062,0.954864594,2866.674941,3013.339352,5020.998319,4234.513333,9970,601.3268999,19940,-4874240,230400,-4643840,-1
6770,1077,20,10,0.137249904,0.862750096,2269.77153,2231.192847,3901.249778,4067.007428,7847,151.7208043,15694,-3466240,551424,-2914816,-1
8027,362,27,3,0.0431517463,0.956848254,2403.084435,2751.913182,4218.455463,3674.89779,8389,560.7620321,16778,-4109824,185344,-3924480,-1
1275,83,22,8,0.0611192931,0.938880707,388.9823097,398.2781729,690.6964706,507.5060241,1358,77.11527541,2716,-652800,42496,-610304,-1
92,23,17,13,0.2,0.8,32.30387969,23.49186401,64.26086957,32.95652174,115,35.49382716,230,-47104,11776,-35328,-1
7056,445,22,8,0.0593254233,0.940674577,2146.663799,2335.333335,3794.799178,3056.51236,7501,308.1758422,15002,-3612672,227840,-3384832,-1
360,81,27,3,0.183673469,0.816326531,125.6426247,134.3666827,221.9444444,216.8024691,441,67.63803681,882,-184320,41472,-142848,-1
5348,466,18,12,0.0801513588,0.919848641,1672.288439,1735.899902,2891.446896,3091.73176,5814,216.9402985,11628,-2738176,238592,-2499584,-1
9163,748,22,8,0.0754716981,0.924528302,2849.120226,2852.135378,5029.887155,4050.882353,9911,759.4636015,19822,-4691456,382976,-4308480,-1
9567,409,20,10,0.0409983962,0.959001604,2864.676342,3158.496051,5013.358733,4407.02445,9976,1287.225806,19952,-4898304,209408,-4688896,-1
301,57,20,10,0.159217877,0.840782123,98.70813616,123.504994,182.8604651,161.754386,358,30.03355705,716,-154112,29184,-124928,-1
8965,913,20,10,0.0924276169,0.907572383,2856.76681,2784.63788,4967.563413,4663.937568,9878,489.009901,19756,-4590080,467456,-4122624,-1
632,75,20,10,0.106082037,0.893917963,196.0328065,217.8371771,370.4050633,215.76,707,76.34989201,1414,-323584,38400,-285184,-1
6225,451,21,9,0.0675554224,0.932444578,1911.381638,2131.649149,3332.244498,3424.842572,6676,124.2046512,13352,-3187200,230912,-2956288,-1
4090,358,21,9,0.0804856115,0.919514388,1271.359899,1391.624272,2200.477751,2498.944134,4448,168.4210526,8896,-2094080,183296,-1910784,-1
9332,615,21,9,0.0618276867,0.938172313,2842.72586,3056.642581,5049.335405,3830.861789,9947,1186.99284,19894,-4777984,314880,-4463104,-1
8210,470,18,12,0.0541474654,0.945852535,2490.762786,2660.679746,4379.98782,3650.723404,8680,362.2704508,17360,-4203520,240640,-3962880,-1
43,13,23,7,0.232142857,0.767857143,16.51094004,14.56875152,29.39534884,25.53846154,56,2.390098165,112,-22016,6656,-15360,-1
8322,729,20,10,0.0805435863,0.919456414,2572.920067,3002.320149,4491.009012,4925.444444,9051,227.9848866,18102,-4260864,373248,-3887616,-1
7803,1369,20,10,0.149258613,0.850741387,2631.572183,2737.905705,4582.919518,4606.907962,9172,175.5742726,18344,-3995136,700928,-3294208,-1
139,20,21,9,0.125786164,0.874213836,44.43384225,39.70440782,85.12230216,44.4,159,6.524415265,318,-71168,10240,-60928,-1
321,81,18,12,0.201492537,0.798507463,109.8826794,137.7839284,201.1993769,202.691358,402,19.84205331,804,-164352,41472,-122880,-1
33,21,18,12,0.388888889,0.611111111,15.91696775,14.97026531,28.27272727,26.28571429,54,24.7706422,108,-16896,10752,-6144,-1
394,53,21,9,0.118568233,0.881431767,122.8821405,136.0313426,236.4213198,131.6603774,447,36.34146341,894,-201728,27136,-174592,-1
63,21,20,10,0.25,0.75,23.6095411,25.32133622,44.28571429,37.14285714,84,18.34061135,168,-32256,10752,-21504,-1
3863,360,17,13,0.0852474544,0.914752546,1197.558916,1273.221987,2169.969713,1489.952778,4223,219.1489362,8446,-1977856,184320,-1793536,-1
1630,131,25,5,0.0743895514,0.925610449,503.9433703,559.6057966,883.2662577,852.8015267,1761,48.97107898,3522,-834560,67072,-767488,-1
9549,425,22,8,0.042610788,0.957389212,2862.092382,3145.419805,5021.488638,4223.835294,9974,1110.690423,19948,-4889088,217600,-4671488,-1
33,20,18,12,0.377358491,0.622641509,15.54684263,14.54810984,28.48484848,24.55,53,10.55776892,106,-16896,10240,-6656,-1
724,52,22,8,0.0670103093,0.932989691,218.5849383,225.4004548,401.0676796,213.5192308,776,43.44904815,1552,-370688,26624,-344064,-1
5530,417,20,10,0.0701193879,0.929880612,1693.296714,2001.862004,2975.51085,2953.964029,5947,380.7298335,11894,-2831360,213504,-2617856,-1
6027,664,21,9,0.0992377821,0.900762218,1892.821104,2252.565973,3344.282396,3361.590361,6691,179.3352988,13382,-3085824,339968,-2745856,-1
9070,339,21,9,0.0360293336,0.963970666,2705.439692,2904.585707,4730.781367,4015.215339,9409,213.1626643,18818,-4643840,173568,-4470272,-1
202,56,20,10,0.217054264,0.782945736,70.98295547,85.90858187,129.6287129,129.0357143,258,20.9076175,516,-103424,28672,-74752,-1
8695,1158,23,7,0.117527657,0.882472343,2890.875023,2329.869191,5028.39678,4165.648532,9853,495.6237425,19706,-4451840,592896,-3858944,-1
9537,435,21,9,0.043622142,0.956377858,2864.485561,3061.973341,5023.736395,4170.124138,9972,365.4085746,19944,-4882944,222720,-4660224,-1
7021,527,20,10,0.0698198198,0.93018018,2149.11509,2540.120627,3783.078479,3660.212524,7548,160.9038585,15096,-3594752,269824,-3324928,-1
6143,698,17,13,0.102031867,0.897968133,1971.736239,1994.402228,3402.46378,3584.13467,6841,127.6067898,13682,-3145216,357376,-2787840,-1
7052,874,21,9,0.110269997,0.889730003,2249.678092,2570.930169,3943.264464,4126.773455,7926,162.3847572,15852,-3610624,447488,-3163136,-1
428,103,18,12,0.193973635,0.806026365,145.0178671,167.2558275,282.4135514,197.7961165,531,76.95652174,1062,-219136,52736,-166400,-1
4619,339,22,8,0.0683743445,0.931625656,1414.508378,1642.448588,2479.955185,2473.297935,4958,275.7508343,9916,-2364928,173568,-2191360,-1
3407,396,22,8,0.10412832,0.89587168,1096.818626,1105.198157,1907.920164,1851.065657,3803,163.9931005,7606,-1744384,202752,-1541632,-1
5412,209,20,10,0.0371819961,0.962818004,1616.695126,1741.67787,2822.88895,2503.138756,5621,693.9506173,11242,-2770944,107008,-2663936,-1
5094,469,25,5,0.0843070286,0.915692971,1592.935717,1467.446981,2864.456419,1886.407249,5563,671.0494572,11126,-2608128,240128,-2368000,-1
325,60,20,10,0.155844156,0.844155844,105.824277,132.721198,198.32,164.1833333,385,28.73134328,770,-166400,30720,-135680,-1
2114,258,23,7,0.108768971,0.891231029,673.0557949,747.4679332,1163.422422,1375.593023,2372,105.5629729,4744,-1082368,132096,-950272,-1
228,45,18,12,0.164835165,0.835164835,75.64091444,72.72340972,147.5175439,83.71111111,273,44.46254072,546,-116736,23040,-93696,-1
42,17,21,9,0.288135593,0.711864407,16.93814611,17.07929806,30.83333333,27.94117647,59,2.348726115,118,-21504,8704,-12800,-1
6020,375,22,8,0.0586395622,0.941360438,1838.103129,1969.215673,3200.578904,3156.6,6395,187.7017904,12790,-3082240,192000,-2890240,-1
9468,495,22,8,0.0496838302,0.95031617,2863.168706,3042.954668,5015.362273,4343.870707,9963,1158.488372,19926,-4847616,253440,-4594176,-1
2042,465,21,9,0.185480654,0.814519346,722.3934106,703.3893201,1214.282076,1428.417204,2507,90.44011544,5014,-1045504,238080,-807424,-1
9573,404,20,10,0.0404931342,0.959506866,2864.411304,3220.256879,4978.695498,5233.170792,9977,1098.788546,19954,-4901376,206848,-4694528,-1
3826,521,21,9,0.119852772,0.880147228,1173.665684,1315.553508,2028.774699,3240.472169,4347,96.3217372,8694,-1958912,266752,-1692160,-1
192,30,18,12,0.135135135,0.864864865,60.74968363,48.2906018,121.1822917,49.53333333,222,34.25925926,444,-98304,15360,-82944,-1
696,93,22,8,0.117870722,0.882129278,228.6484148,183.8880128,410.3922414,279.8064516,789,15.17015958,1578,-356352,47616,-308736,-1
1137,120,21,9,0.0954653938,0.904534606,354.5308381,432.2707549,632.8346526,592.6666667,1257,83.24503311,2514,-582144,61440,-520704,-1
77,9,27,3,0.104651163,0.895348837,24.62102022,26.13214283,43.98701299,39.33333333,86,13.06990881,172,-39424,4608,-34816,-1
1517,276,21,9,0.153931958,0.846068042,512.1350623,478.520074,852.7798286,1140.050725,1793,41.2183908,3586,-776704,141312,-635392,-1
3126,169,23,7,0.0512898331,0.948710167,938.7322114,1119.901247,1663.431542,1362.56213,3295,150.1138952,6590,-1600512,86528,-1513984,-1
9508,457,21,9,0.0458605118,0.954139488,2869.394118,2986.474857,5005.181952,4521.498906,9965,757.218845,19930,-4868096,233984,-4634112,-1
3590,355,22,8,0.0899873257,0.910012674,1121.415903,1298.859133,1964.686351,2057.073239,3945,264.7651007,7890,-1838080,181760,-1656320,-1
333,74,16,14,0.181818182,0.818181818,114.2188895,129.2554372,208.5315315,183.6081081,407,29.9926308,814,-170496,37888,-132608,-1
6292,313,24,6,0.0473883422,0.952611658,1896.208755,2105.443318,3306.284488,3236.974441,6605,121.5718756,13210,-3221504,160256,-3061248,-1
3351,209,19,11,0.0587078652,0.941292135,1011.916735,1196.640433,1803.123844,1417.760766,3560,139.6078431,7120,-1715712,107008,-1608704,-1
90,36,18,12,0.285714286,0.714285714,36.88831325,29.88634593,69.68888889,48.02777778,126,33.87096774,252,-46080,18432,-27648,-1
2562,191,18,12,0.0693788594,0.930621141,782.3198208,934.8469862,1387.173692,1240.534031,2753,51.22813547,5506,-1311744,97792,-1213952,-1
1053,69,17,13,0.0614973262,0.938502674,316.4896504,395.8733867,570.5992403,422.6376812,1122,236.2105263,2244,-539136,35328,-503808,-1
169,25,19,11,0.128865979,0.871134021,53.05779078,66.54903756,101.591716,69.84,194,5.808383234,388,-86528,12800,-73728,-1
8609,535,21,9,0.0585083115,0.941491689,2620.26951,2921.944528,4588.448136,4315.869159,9144,269.0203001,18288,-4407808,273920,-4133888,-1
627,136,23,7,0.178243775,0.821756225,215.6557398,238.6754176,376.4417863,407.625,763,36.78881389,1526,-321024,69632,-251392,-1
9266,677,19,11,0.0680881022,0.931911898,2851.39304,3109.987346,4956.712929,5181.231905,9943,515.7157676,19886,-4744192,346624,-4397568,-1
4371,585,21,9,0.118038741,0.881961259,1420.708145,1439.688735,2424.228094,2884.008547,4956,144.0278989,9912,-2237952,299520,-1938432,-1
494,56,23,7,0.101818182,0.898181818,153.7165,182.2399312,283.7732794,202.5178571,550,49.06333631,1100,-252928,28672,-224256,-1
3057,241,17,13,0.0730745907,0.926925409,954.5755646,831.3619882,1679.30193,1271.473029,3298,111.4565732,6596,-1565184,123392,-1441792,-1
8374,775,21,9,0.0847087113,0.915291289,2628.582029,2771.281339,4567.34213,4657.744516,9149,189.4987572,18298,-4287488,396800,-3890688,-1
2885,156,20,10,0.0512989148,0.948701085,863.4014892,1079.997664,1534.92201,1263.532051,3041,207.7185792,6082,-1477120,79872,-1397248,-1
6023,433,20,10,0.0670693928,0.932930607,1865.329653,1839.957211,3224.917317,3278.334873,6456,340.5063291,12912,-3083776,221696,-2862080,-1
9354,615,18,12,0.0616912429,0.938308757,2834.208403,3172.116285,5075.219906,3612.777236,9969,384.0138675,19938,-4789248,314880,-4474368,-1
246,55,23,7,0.182724252,0.817275748,86.4851464,79.23864989,159.0487805,115,301,23.71946414,602,-125952,28160,-97792,-1
8122,421,21,9,0.0492801124,0.950719888,2433.511807,2721.356006,4339.077321,2977.933492,8543,267.9736512,17086,-4158464,215552,-3942912,-1
7028,367,23,7,0.0496281271,0.950371873,2126.12136,2217.642214,3727.836227,3126.640327,7395,274.3970315,14790,-3598336,187904,-3410432,-1
4159,551,21,9,0.116985138,0.883014862,1334.293887,1536.824834,2349.101707,2403.794918,4710,86.86831428,9420,-2129408,282112,-1847296,-1
5056,847,19,11,0.143486363,0.856513637,1632.994642,1859.836341,2808.206092,3810.349469,5903,324.5189665,11806,-2588672,433664,-2155008,-1
2682,360,17,13,0.118343195,0.881656805,869.5138612,939.9644187,1522.420955,1514.638889,3042,82.61814231,6084,-1373184,184320,-1188864,-1
480,80,20,10,0.142857143,0.857142857,160.2354691,146.3340357,293.8333333,200.5,560,48.56895056,1120,-245760,40960,-204800,-1
3314,255,26,4,0.071448585,0.928551415,1015.423607,1180.41399,1803.627942,1542.909804,3569,297.1690258,7138,-1696768,130560,-1566208,-1
4171,285,21,9,0.0639587074,0.936041293,1268.258089,1524.24447,2234.120115,2146.249123,4456,242.173913,8912,-2135552,145920,-1989632,-1
2068,120,27,3,0.0548446069,0.945155393,627.6011787,645.1701636,1109.418762,837.4,2188,247.7916195,4376,-1058816,61440,-997376,-1
33,22,18,12,0.4,0.6,16.15131616,15.38567542,28.72727273,26.90909091,55,13.12649165,110,-16896,11264,-5632,-1
1924,127,18,12,0.0619210141,0.938078986,575.2192917,769.5983349,1041.169958,796.1811024,2051,262.9487179,4102,-985088,65024,-920064,-1
224,49,25,5,0.179487179,0.820512821,77.92181947,80.05187302,141.1428571,118.0612245,273,18.99791232,546,-114688,25088,-89600,-1
8128,362,20,10,0.0426383981,0.957361602,2430.623364,2735.234015,4283.044906,3402.502762,8490,612.5541126,16980,-4161536,185344,-3976192,-1
9372,575,21,9,0.0578063738,0.942193626,2856.904002,2746.607489,5059.46767,3580.951304,9947,766.3328197,19894,-4798464,294400,-4504064,-1
9631,350,21,9,0.0350666266,0.964933373,2868.42207,3148.285025,5014.194995,4352.74,9981,719.092219,19962,-4931072,179200,-4751872,-1
1911,122,22,8,0.0600098377,0.939990162,575.9166718,716.0085379,1027.963893,845.2622951,2033,115.3148043,4066,-978432,62464,-915968,-1
1672,91,21,9,0.0516165627,0.948383437,502.16152,606.8745924,888.8157895,756.7692308,1763,186.3636364,3526,-856064,46592,-809472,-1
8568,429,20,10,0.0476825609,0.952317439,2598.316123,2509.045349,4527.29902,3933.811189,8997,552.9809465,17994,-4386816,219648,-4167168,-1
4475,268,20,10,0.0565043222,0.943495678,1357.818716,1432.484865,2405.933184,1805.391791,4743,266.1616162,9486,-2291200,137216,-2153984,-1
123,23,18,12,0.157534247,0.842465753,40.59523085,28.50164987,80.47154472,36.2173913,146,45.34161491,292,-62976,11776,-51200,-1
2380,241,16,14,0.0919496375,0.908050362,740.474013,898.1774483,1304.584034,1374.360996,2621,97.32640178,5242,-1218560,123392,-1095168,-1
1132,60,21,9,0.0503355705,0.94966443,338.6940861,390.0142145,606.2924028,411.75,1192,98.67549669,2384,-579584,30720,-548864,-1
9113,372,27,3,0.0392198208,0.960780179,2723.054293,3033.090917,4765.210798,4198.895161,9485,222.6525822,18970,-4665856,190464,-4475392,-1
6008,434,20,10,0.0673703819,0.932629618,1844.146205,1838.249717,3286.710719,2318.767281,6442,466.4735699,12884,-3076096,222208,-2853888,-1
446,102,18,12,0.186131387,0.813868613,149.1763765,174.9844767,291.1659193,201.627451,548,68.84422111,1096,-228352,52224,-176128,-1
4458,265,23,7,0.0561084057,0.943891594,1338.335978,1722.913648,2372.037909,2193.135849,4723,560.9263658,9446,-2282496,135680,-2146816,-1
1772,130,17,13,0.0683491062,0.931650894,534.5747529,713.2280016,945.6901806,1030.692308,1902,34.84154607,3804,-907264,66560,-840704,-1
59,16,24,6,0.213333333,0.786666667,22.4320225,17.30065028,39.55932203,32.25,75,2.126453076,150,-30208,8192,-22016,-1
5090,489,17,13,0.0876501165,0.912349883,1579.4641,1891.380814,2769.980157,2998.386503,5579,178.2997763,11158,-2606080,250368,-2355712,-1
2518,427,27,3,0.144991511,0.855008489,833.8988456,923.2011747,1445.028991,1637.943794,2945,75.82389289,5890,-1289216,218624,-1070592,-1
831,158,21,9,0.159757331,0.840242669,272.7560821,337.0494268,507.7172082,428.1139241,989,26.66486924,1978,-425472,80896,-344576,-1
9438,513,22,8,0.0515526078,0.948447392,2859.035351,3000.100466,5019.725154,4171.559454,9951,1472.04142,19902,-4832256,262656,-4569600,-1
8844,345,20,10,0.0375448906,0.962455109,2645.850904,2820.390096,4592.755993,4652.524638,9189,309.6024259,18378,-4528128,176640,-4351488,-1
9464,501,21,9,0.0502759659,0.949724034,2873.743818,2877.34491,5011.789835,4439.153693,9965,643.7338501,19930,-4845568,256512,-4589056,-1
228,50,26,4,0.179856115,0.820143885,79.74050556,79.8346391,143.6622807,120.52,278,16.86893204,556,-116736,25600,-91136,-1
2561,249,21,9,0.0886120996,0.9113879,800.3375262,904.8754184,1418.250683,1274.35743,2810,170.5097087,5620,-1311232,127488,-1183744,-1
3924,216,21,9,0.052173913,0.947826087,1179.443295,1260.391979,2108.986748,1371.324074,4140,172.7158949,8280,-2009088,110592,-1898496,-1
8839,792,20,10,0.0822344513,0.917765549,2734.137476,3177.999037,4874.638873,4161.569444,9631,230.4066986,19262,-4525568,405504,-4120064,-1
3725,1065,21,9,0.222338205,0.777661795,1409.760049,1271.435525,2350.621477,2552.469484,4790,92.82945736,9580,-1907200,545280,-1361920,-1
7727,541,22,8,0.0654329947,0.934567005,2349.67586,2816.482069,4099.121004,4639.81146,8268,230.0500835,16536,-3956224,276992,-3679232,-1
1178,104,20,10,0.0811232449,0.918876755,362.3366099,348.4251403,665.4083192,370.6923077,1282,94.05722671,2564,-603136,53248,-549888,-1
4398,762,20,10,0.147674419,0.852325581,1459.24725,1568.917909,2496.882674,3063.110236,5160,121.8130312,10320,-2251776,390144,-1861632,-1
7631,393,21,9,0.0489780658,0.951021934,2287.382414,2818.959166,4016.535841,3934.13486,8024,542.5287356,16048,-3907072,201216,-3705856,-1
7790,651,21,9,0.0771235636,0.922876436,2421.616487,2510.518511,4278.451605,3533.522273,8441,407.1876507,16882,-3988480,333312,-3655168,-1
38,22,18,12,0.366666667,0.633333333,18.0095581,15.51811791,32.39473684,27.22727273,60,14.31980907,120,-19456,11264,-8192,-1
4396,404,17,13,0.0841666667,0.915833333,1369.159876,1529.505023,2376.473157,2661.940594,4800,286.7383513,9600,-2250752,206848,-2043904,-1
7202,693,22,8,0.0877770741,0.912222926,2285.133738,2214.311402,3941.898084,4011.414141,7895,182.8392774,15790,-3687424,354816,-3332608,-1
2980,261,21,9,0.0805307004,0.9194693,926.6791405,1004.337461,1640.91745,1393.590038,3241,102.0465995,6482,-1525760,133632,-1392128,-1
2083,284,20,10,0.119983101,0.880016899,660.1926122,832.3773856,1178.765242,1222.394366,2367,118.8253012,4734,-1066496,145408,-921088,-1
2005,245,22,8,0.108888889,0.891111111,650.6493743,527.2152172,1167.391521,782.6734694,2250,83.36420897,4500,-1026560,125440,-901120,-1
4490,429,21,9,0.0872128481,0.912787152,1401.304893,1568.963303,2430.201559,2771.876457,4919,112.5371768,9838,-2298880,219648,-2079232,-1
8739,1144,22,8,0.115754326,0.884245674,2837.124531,2700.542072,4789.45932,6107.256119,9883,470.39505,19766,-4474368,585728,-3888640,-1
1254,235,25,5,0.157824043,0.842175957,437.0370898,386.7638683,737.5661882,784.6680851,1489,64.3474503,2978,-642048,120320,-521728,-1
7930,407,27,3,0.0488185199,0.95118148,2379.054039,2857.64682,4191.519924,3730.22113,8337,219.9736148,16674,-4060160,208384,-3851776,-1
66,10,27,3,0.131578947,0.868421053,22.1558726,19.3238195,39.43939394,32.3,76,13.66906475,152,-33792,5120,-28672,-1
934,124,21,9,0.117202268,0.882797732,294.7020435,366.840757,518.9539615,608.9354839,1058,78.48664688,2116,-478208,63488,-414720,-1
104,17,21,9,0.140495868,0.859504132,33.74615911,33.69576894,64.65384615,38.64705882,121,9.918032787,242,-53248,8704,-44544,-1
9509,457,21,9,0.0458559101,0.95414409,2863.047343,3094.204217,5011.725208,4396.205689,9966,851.0674637,19932,-4868608,233984,-4634624,-1
1302,129,16,14,0.0901467505,0.909853249,408.0638372,353.1803893,743.9715822,433.6821705,1431,130.6849315,2862,-666624,66048,-600576,-1
2251,179,22,8,0.0736625514,0.926337449,691.0473375,821.055647,1213.557086,1239.932961,2430,106.8601583,4860,-1152512,91648,-1060864,-1
2299,385,18,12,0.143442623,0.856557377,719.0932268,840.6959509,1245.643758,1920.87013,2684,222.923588,5368,-1177088,197120,-979968,-1
1127,114,27,3,0.0918614021,0.908138598,352.0245407,395.8621345,632.9299024,503.0614035,1241,124.8490946,2482,-577024,58368,-518656,-1
956,131,20,10,0.120515179,0.879484821,313.1101277,281.4765268,563.209205,403.8167939,1087,53.4677816,2174,-489472,67072,-422400,-1
895,88,20,10,0.0895218718,0.910478128,275.510194,356.6885214,493.5296089,476.4431818,983,64.71362739,1966,-458240,45056,-413184,-1
345,53,19,11,0.133165829,0.866834171,110.6846401,125.9422415,207.9826087,144.2830189,398,37.9047619,796,-176640,27136,-149504,-1
1264,80,21,9,0.0595238095,0.94047619,381.497222,478.3344045,673.914557,650.15,1344,284.1437632,2688,-647168,40960,-606208,-1
2166,156,25,5,0.0671834625,0.932816537,662.303396,772.468653,1163.238689,1137.358974,2322,52.95324971,4644,-1108992,79872,-1029120,-1
9333,599,20,10,0.0603101087,0.939689891,2828.93044,3010.134279,5065.829101,3418.856427,9932,755.8599696,19864,-4778496,306688,-4471808,-1
9201,737,19,11,0.0741597907,0.925840209,2834.44912,3238.433538,5003.31877,4547.29308,9938,706.3255153,19876,-4710912,377344,-4333568,-1
9524,445,22,8,0.044638379,0.955361621,2868.397602,2961.009897,5022.403822,4184.474157,9969,762.1559633,19938,-4876288,227840,-4648448,-1
1784,141,20,10,0.0732467532,0.926753247,545.4663655,666.0422248,969.7040359,878.177305,1925,224.0977881,3850,-913408,72192,-841216,-1
1388,132,19,11,0.0868421053,0.913157895,439.574494,426.4342441,765.8033141,704.7348485,1520,146.7181467,3040,-710656,67584,-643072,-1
2099,213,21,9,0.0921280277,0.907871972,660.5969753,721.740762,1145.147213,1268.375587,2312,54.50259312,4624,-1074688,109056,-965632,-1
9312,630,22,8,0.0633675317,0.936632468,2840.479919,3274.302595,4977.452427,4883.51746,9942,827.8101582,19884,-4767744,322560,-4445184,-1
48,21,20,10,0.304347826,0.695652174,19.98158875,19.11772812,36.83333333,30.80952381,69,11.8556701,138,-24576,10752,-13824,-1
9161,779,20,10,0.0783702213,0.921629779,2868.726613,2872.664375,4984.390569,4807.147625,9940,386.4696734,19880,-4690432,398848,-4291584,-1
1861,124,17,13,0.0624685139,0.937531486,561.0156857,623.8549592,1017.436862,626.25,1985,170.8261618,3970,-952832,63488,-889344,-1
83,28,18,12,0.252252252,0.747747748,32.84285638,22.22941033,61.6746988,39.17857143,111,29.05759162,222,-42496,14336,-28160,-1
9545,429,21,9,0.0430118308,0.956988169,2862.898082,3040.818552,5034.280775,3946.655012,9974,704.8763251,19948,-4887040,219648,-4667392,-1
9443,511,21,9,0.0513361463,0.948663854,2853.266146,3216.018829,4989.567404,4754.500978,9954,799.5180723,19908,-4834816,261632,-4573184,-1
1628,216,22,8,0.117136659,0.882863341,525.8826368,474.8235142,963.7002457,611.9722222,1844,119.7402597,3688,-833536,110592,-722944,-1
9467,494,17,13,0.0495934143,0.950406586,2853.17127,3153.257164,5025.812507,4122.214575,9961,819.8353909,19922,-4847104,252928,-4594176,-1
9246,615,20,10,0.0623668999,0.9376331,2817.655003,2916.242704,5023.57387,3539.230894,9861,388.0755608,19722,-4733952,314880,-4419072,-1
4333,209,19,11,0.0460149714,0.953985029,1299.383297,1395.211991,2301.667667,1646.062201,4542,281.5871048,9084,-2218496,107008,-2111488,-1
7460,385,22,8,0.0490758445,0.950924156,2273.016698,2085.891044,3933.393432,3721.61039,7845,262.2868606,15690,-3819520,197120,-3622400,-1
7584,442,20,10,0.0550710192,0.944928981,2292.706896,2697.706758,4009.710707,4078.5181,8026,458.1050228,16052,-3883008,226304,-3656704,-1
4310,1062,18,12,0.197691735,0.802308265,1427.042031,1615.722886,2435.87471,3703.632768,5372,116.3526099,10744,-2206720,543744,-1662976,-1
8703,832,21,9,0.0872574725,0.912742528,2743.314792,2846.972769,4766.921177,4779.284856,9535,185.037842,19070,-4455936,425984,-4029952,-1
7850,454,20,10,0.054672447,0.945327553,2370.800456,2774.348654,4179.01465,3694.04185,8304,286.246122,16608,-4019200,232448,-3786752,-1
860,108,19,11,0.111570248,0.888429752,277.7258915,290.2412829,488.9895349,448.75,968,55.40927304,1936,-440320,55296,-385024,-1
3143,165,17,13,0.049879081,0.950120919,939.9290261,1205.369331,1653.142539,1680.357576,3308,279.3918919,6616,-1609216,84480,-1524736,-1
427,58,23,7,0.119587629,0.880412371,132.4673957,183.0439705,238.5456674,275.7931034,485,12.60722641,970,-218624,29696,-188928,-1
8678,482,20,10,0.0526200873,0.947379913,2618.583338,2904.125786,4634.332219,3611.29668,9160,386.9877482,18320,-4443136,246784,-4196352,-1
3775,245,20,10,0.0609452736,0.939054726,1141.927504,1415.826101,2009.910199,2019.587755,4020,121.3035607,8040,-1932800,125440,-1807360,-1
1816,333,19,11,0.154955793,0.845044207,629.9732146,561.9472071,1064.977423,1129.657658,2149,100.7973734,4298,-929792,170496,-759296,-1
3169,331,22,8,0.0945714286,0.905428571,999.0736656,1092.942741,1729.771852,1948.951662,3500,114.7164864,7000,-1622528,169472,-1453056,-1
6356,1561,22,8,0.197170645,0.802829355,2194.619882,1979.723798,3580.361076,5500.722614,7917,159.3278326,15834,-3254272,799232,-2455040,-1
2354,142,18,12,0.0568910256,0.943108974,706.1531115,926.9551918,1248.763806,1244.126761,2496,206.1106524,4992,-1205248,72704,-1132544,-1
9508,460,21,9,0.0461476726,0.953852327,2862.000425,3020.805552,5031.637568,4010.186957,9968,400.8041817,19936,-4868096,235520,-4632576,-1
191,42,17,13,0.180257511,0.819742489,65.37611576,60.41840603,125.9267016,76.4047619,233,34.26470588,466,-97792,21504,-76288,-1
3076,368,21,9,0.106852497,0.893147503,975.7517859,1132.3586,1733.759103,1628.388587,3444,84.34974284,6888,-1574912,188416,-1386496,-1
2377,806,16,14,0.253220232,0.746779768,871.8193774,836.7562355,1408.419016,2133.404467,3183,58.55408389,6366,-1217024,412672,-804352,-1
778,73,19,11,0.0857814336,0.914218566,235.9912328,278.5832223,442.1452442,253.9315068,851,158.7686567,1702,-398336,37376,-360960,-1
9591,387,19,11,0.0387853277,0.961214672,2866.029121,3122.582308,5019.960275,4234.604651,9978,1231.851852,19956,-4910592,198144,-4712448,-1
2367,282,21,9,0.106455266,0.893544734,776.4298684,648.0857995,1312.148289,1432.87234,2649,85.64500485,5298,-1211904,144384,-1067520,-1
1665,177,19,11,0.0960912052,0.903908795,521.9841111,557.2599693,948.0306306,671.9322034,1842,71.67315175,3684,-852480,90624,-761856,-1
1997,200,22,8,0.0910332271,0.908966773,630.7995369,652.7841588,1112.265398,966.545,2197,99.59202176,4394,-1022464,102400,-920064,-1
6316,465,20,10,0.0685739566,0.931426043,1924.137574,2363.674253,3386.406111,3453.397849,6781,165.5517578,13562,-3233792,238080,-2995712,-1
791,96,17,13,0.108229989,0.891770011,249.8697258,298.3046146,449.5689001,398.1145833,887,126.7142857,1774,-404992,49152,-355840,-1
2859,442,20,10,0.133898819,0.866101181,953.2617341,934.0497979,1676.472893,1486.233032,3301,67.06623324,6602,-1463808,226304,-1237504,-1
9478,486,17,13,0.0487755921,0.951224408,2835.244464,3556.24541,5005.211015,4539.588477,9964,462.7960985,19928,-4852736,248832,-4603904,-1
668,61,22,8,0.0836762689,0.916323731,205.2642496,244.492764,372.8622754,278.9016393,729,94.67532468,1458,-342016,31232,-310784,-1
674,91,20,10,0.118954248,0.881045752,210.0323226,276.4996532,372.5534125,460.3736264,765,29.69720497,1530,-345088,46592,-298496,-1
58,16,23,7,0.216216216,0.783783784,22.12507012,16.90599006,39.22413793,31.25,74,2.213580616,148,-29696,8192,-21504,-1
69,13,22,8,0.158536585,0.841463415,23.56560065,18.34288795,44.23188406,27,82,13.85135135,164,-35328,6656,-28672,-1
4759,424,17,13,0.0818059039,0.918194096,1490.510491,1536.440038,2569.604959,2843.363208,5183,242.9910924,10366,-2436608,217088,-2219520,-1
7779,457,27,3,0.055488101,0.944511899,2387.059514,2150.224851,4147.397995,3626.601751,8236,734.7011597,16472,-3982848,233984,-3748864,-1
187,20,20,10,0.0966183575,0.903381643,57.00777403,49.71144234,110.5080214,43.15,207,17.19269103,414,-95744,10240,-85504,-1
258,18,20,10,0.0652173913,0.934782609,77.3823735,89.04056504,142.5348837,80.66666667,276,13.8,552,-132096,9216,-122880,-1
5089,619,18,12,0.108444289,0.891555711,1627.178159,1776.901795,2892.904303,2538.765751,5708,113.4114842,11416,-2605568,316928,-2288640,-1
3155,223,19,11,0.0660153937,0.933984606,968.1634434,1025.178697,1710.202536,1396.600897,3378,92.90429043,6756,-1615360,114176,-1501184,-1
9540,434,17,13,0.0435131341,0.956486866,2866.314931,2999.166327,5030.364361,4045.274194,9974,847.4086661,19948,-4884480,222208,-4662272,-1
1048,70,25,5,0.0626118068,0.937388193,322.1770932,322.540592,564.3177481,487.3714286,1118,97.89842382,2236,-536576,35840,-500736,-1
3398,349,22,8,0.0931411796,0.90685882,1065.693025,1218.674717,1860.595939,2004.507163,3747,106.4186311,7494,-1739776,178688,-1561088,-1
702,108,17,13,0.133333333,0.866666667,226.8450643,266.5554912,415.1381766,342.8518519,810,161.0337972,1620,-359424,55296,-304128,-1
9457,508,21,9,0.0509784245,0.949021576,2870.285463,2770.245067,5042.239294,3880.192913,9965,351.1275546,19930,-4841984,260096,-4581888,-1
3001,205,21,9,0.0639426076,0.936057392,903.3726093,1196.420938,1612.1986,1476.160976,3206,391.4529915,6412,-1536512,104960,-1431552,-1
6016,391,20,10,0.0610270017,0.938972998,1842.085431,1948.638248,3190.32879,3414.347826,6407,137.9332616,12814,-3080192,200192,-2880000,-1
56,23,22,8,0.291139241,0.708860759,22.56887842,23.3292372,40.44642857,38.91304348,79,14.99051233,158,-28672,11776,-16896,-1
1835,289,20,10,0.13606403,0.86393597,615.8779632,594.6338806,1067.217439,1032.546713,2124,129.0400972,4248,-939520,147968,-791552,-1
307,33,18,12,0.0970588235,0.902941176,94.28371842,87.30215203,180.1530945,80.6969697,340,51.82926829,680,-157184,16896,-140288,-1
52,35,20,10,0.402298851,0.597701149,24.54506181,25.63645364,41.96153846,47.02857143,87,5.485498108,174,-26624,17920,-8704,-1
4736,518,21,9,0.0985915493,0.901408451,1516.23307,1483.218434,2662.463471,2307.833977,5254,207.9968329,10508,-2424832,265216,-2159616,-1
1604,157,21,9,0.0891538898,0.91084611,497.3341208,592.5696501,894.3890274,744.2101911,1761,72.35004108,3522,-821248,80384,-740864,-1
9551,422,18,12,0.0423142485,0.957685752,2869.95646,2944.909735,5025.358706,4118.838863,9973,435.8828671,19946,-4890112,216064,-4674048,-1
9604,377,20,10,0.0377717664,0.962228234,2880.503821,2858.076987,5010.061016,4505.424403,9981,481.0120482,19962,-4917248,193024,-4724224,-1
4893,293,20,10,0.0564982646,0.943501735,1472.944219,1840.848954,2606.38177,2378.37884,5186,403.5797665,10372,-2505216,150016,-2355200,-1
6868,338,19,11,0.0469053566,0.953094643,2074.412753,2090.59902,3635.534799,2952.568047,7206,497.9958535,14412,-3516416,173056,-3343360,-1
288,38,27,3,0.116564417,0.883435583,91.85014932,108.4794299,165.5381944,148.0526316,326,17.87280702,652,-147456,19456,-128000,-1
8774,951,25,5,0.0977892031,0.902210797,2806.075137,2750.446957,4926.7292,4275.029443,9725,241.3151365,19450,-4492288,486912,-4005376,-1
3920,333,27,3,0.0782976722,0.921702328,1189.218862,1565.032391,2095.008673,2503.594595,4253,107.3176886,8506,-2007040,170496,-1836544,-1
268,53,15,15,0.165109034,0.834890966,89.56094073,100.421823,167.6679104,127.2830189,321,16.95721078,642,-137216,27136,-110080,-1
5604,948,20,10,0.144688645,0.855311355,1827.132081,2022.235283,3128.024982,4154.194093,6552,123.6459709,13104,-2869248,485376,-2383872,-1
400,94,19,11,0.190283401,0.809716599,133.4693935,174.0243826,241.5775,272.7021277,494,49.4,988,-204800,48128,-156672,-1
8999,944,17,13,0.0949411646,0.905058835,2750.65258,3521.191907,4822.27892,6399.266949,9943,782.9133858,19886,-4607488,483328,-4124160,-1
9636,346,27,3,0.0346623923,0.965337608,2875.66624,3028.667971,5001.145185,4722.884393,9982,387.0492439,19964,-4933632,177152,-4756480,-1
1784,259,27,3,0.126774351,0.873225649,582.7372909,607.7940458,996.5650224,1197.196911,2043,123.2207479,4086,-913408,132608,-780800,-1
43,24,19,11,0.358208955,0.641791045,17.75072268,21.79959225,33.06976744,35.66666667,67,16.66666667,134,-22016,12288,-9728,-1
8139,428,22,8,0.0499591456,0.950040854,2471.05836,2444.292484,4313.516403,3722.705607,8567,269.4025157,17134,-4167168,219136,-3948032,-1
3923,232,19,11,0.0558363418,0.944163658,1179.693392,1473.261272,2063.60158,2321.469828,4155,149.2993173,8310,-2008576,118784,-1889792,-1
1919,208,16,14,0.097790315,0.902209685,586.7470445,823.8526299,1062.151641,1081.052885,2127,62.37536657,4254,-982528,106496,-876032,-1
4128,665,18,12,0.138744002,0.861255998,1363.639419,1498.210427,2381.67345,2492.13985,4793,90.50226586,9586,-2113536,340480,-1773056,-1
2996,462,21,9,0.133603239,0.866396761,1004.350073,955.5000659,1738.727637,1669.660173,3458,69.52151186,6916,-1533952,236544,-1297408,-1
3676,440,22,8,0.106899903,0.893100097,1175.522549,1283.850355,2045.305223,2168.736364,4116,123.5294118,8232,-1882112,225280,-1656832,-1
9402,561,21,9,0.0563083409,0.943691659,2855.567526,3025.866831,5042.38779,3969.939394,9963,534.2091153,19926,-4813824,287232,-4526592,-1
7772,617,21,9,0.0735486947,0.926451305,2391.736918,2694.223806,4244.652213,3569.559157,8389,293.3216783,16778,-3979264,315904,-3663360,-1
9350,601,21,9,0.0603959401,0.93960406,2860.600009,3053.247673,4974.711444,4996.046589,9951,709.7717546,19902,-4787200,307712,-4479488,-1
9081,837,20,10,0.0843920145,0.915607985,2826.531878,3167.04783,5016.869177,4337.075269,9918,597.8300181,19836,-4649472,428544,-4220928,-1
9176,736,21,9,0.0742534302,0.92574657,2826.635885,3262.862943,4960.448452,4907.273098,9912,288.558952,19824,-4698112,376832,-4321280,-1
4240,452,27,3,0.0963341858,0.903665814,1325.448142,1497.190891,2288.958255,2886.272124,4692,90.59664028,9384,-2170880,231424,-1939456,-1
246,59,21,9,0.193442623,0.806557377,87.52077645,86.61545972,158.4227642,130.3898305,305,27.08703375,610,-125952,30208,-95744,-1
154,52,16,14,0.252427184,0.747572816,56.49280079,66.67339586,106.5909091,94.34615385,206,8.043732917,412,-78848,26624,-52224,-1
8953,958,20,10,0.0966602765,0.903339724,2765.820132,3592.325812,4901.317212,5467.038622,9911,454.4245759,19822,-4583936,490496,-4093440,-1
9029,871,19,11,0.087979798,0.912020202,2837.644918,3008.394855,4899.042197,5483.924225,9900,627.7742549,19800,-4622848,445952,-4176896,-1
1437,195,20,10,0.119485294,0.880514706,458.140044,556.1077241,821.539318,779.3641026,1632,57.46478873,3264,-735744,99840,-635904,-1
147,43,15,15,0.226315789,0.773684211,51.4429901,63.56385325,99.18367347,82.90697674,190,3.778838504,380,-75264,22016,-53248,-1
9101,816,22,8,0.0822829485,0.917717052,2846.490519,2997.576049,5001.782002,4481.844363,9917,508.5641026,19834,-4659712,417792,-4241920,-1
9613,369,20,10,0.0369665398,0.96303346,2871.702403,3098.514858,5007.451056,4575.95122,9982,1745.104895,19964,-4921856,188928,-4732928,-1
9498,474,22,8,0.0475330927,0.952466907,2864.49373,3062.692226,5022.220573,4270.732068,9972,502.6209677,19944,-4862976,242688,-4620288,-1
2839,228,20,10,0.0743397457,0.925660254,863.4598115,1122.807487,1535.141951,1519.780702,3067,75.43039843,6134,-1453568,116736,-1336832,-1
8067,459,21,9,0.0538353272,0.946164673,2442.063303,2725.841193,4292.809843,3748.374728,8526,179.5703454,17052,-4130304,235008,-3895296,-1
5549,381,21,9,0.0642495784,0.935750422,1679.30424,2129.748433,2962.773112,3005.215223,5930,259.2916484,11860,-2841088,195072,-2646016,-1
727,127,16,14,0.148711944,0.851288056,240.4501374,278.3180266,430.0962861,412.6377953,854,79.96254682,1708,-372224,65024,-307200,-1
1753,188,16,14,0.0968572901,0.90314271,557.6133716,576.3485934,981.179692,876.0797872,1941,132.3108384,3882,-897536,96256,-801280,-1
3487,221,20,10,0.059600863,0.940399137,1060.383769,1210.127856,1862.827359,1723.108597,3708,113.6725935,7416,-1785344,113152,-1672192,-1
9390,563,20,10,0.0565658595,0.94343414,2860.799925,3050.658671,4955.763898,5331.186501,9953,342.616179,19906,-4807680,288256,-4519424,-1
9627,357,22,8,0.0357572115,0.964242788,2867.642165,3141.349016,5022.645892,4179.57423,9984,681.5017065,19968,-4929024,182784,-4746240,-1
7527,704,22,8,0.0855303122,0.914469688,2343.02704,2677.921024,4082.239272,4476.961648,8231,359.9038041,16462,-3853824,360448,-3493376,-1
9454,524,21,9,0.0525155342,0.947484466,2827.235025,3122.528477,5097.690078,3037.53626,9978,828.7375415,19956,-4840448,268288,-4572160,-1
2774,473,20,10,0.145672929,0.854327071,930.5818764,876.4065555,1556.322278,2020.909091,3247,106.1111111,6494,-1420288,242176,-1178112,-1
1863,157,22,8,0.0777227723,0.922277228,578.318467,637.032733,1012.213097,990.1719745,2020,171.1864407,4040,-953856,80384,-873472,-1
3204,347,20,10,0.0977189524,0.902281048,1014.273931,1102.162064,1755.522784,1965.074928,3551,217.8527607,7102,-1640448,177664,-1462784,-1
9159,643,21,9,0.0655988574,0.934401143,2806.807712,2816.472917,4995.127306,3567.856921,9802,282.7228151,19604,-4689408,329216,-4360192,-1
3196,477,22,8,0.129866594,0.870133406,1038.907315,1081.954371,1766.757196,2307.641509,3673,67.54321442,7346,-1636352,244224,-1392128,-1
1835,147,21,9,0.0741675076,0.925832492,558.1577047,704.377608,1004.557493,828.5034014,1982,229.132948,3964,-939520,75264,-864256,-1
9481,489,21,9,0.0490471414,0.950952859,2855.232837,3149.758052,5033.304398,4058.642127,9970,953.1548757,19940,-4854272,250368,-4603904,-1
671,111,21,9,0.141943734,0.858056266,218.2560875,252.0655168,404.7883756,311.1711712,782,19.9846665,1564,-343552,56832,-286720,-1
9212,718,18,12,0.072306143,0.927693857,2830.069116,3208.481727,4907.905124,5704.447075,9930,851.6295026,19860,-4716544,367616,-4348928,-1
6225,330,20,10,0.0503432494,0.949656751,1874.3451,2083.882684,3314.942811,2581.124242,6555,466.8803419,13110,-3187200,168960,-3018240,-1
1925,129,18,12,0.0628042843,0.937195716,585.95339,650.5416606,1042.187532,808.3255814,2054,166.9918699,4108,-985600,66048,-919552,-1
7226,228,21,9,0.030587604,0.969412396,2148.750669,2238.424377,3733.154166,3548.302632,7454,580.529595,14908,-3699712,116736,-3582976,-1
9599,386,22,8,0.038657987,0.961342013,2868.71911,3064.047818,5029.978331,4073.427461,9985,613.7062077,19970,-4914688,197632,-4717056,-1
4643,525,22,8,0.101586687,0.898413313,1458.763223,1695.963293,2634.009261,2146.649524,5168,130.5709955,10336,-2377216,268800,-2108416,-1
8420,433,22,8,0.048909974,0.951090026,2540.30834,2824.698407,4440.434323,4165.759815,8853,361.7899469,17706,-4311040,221696,-4089344,-1
5658,352,17,13,0.0585690516,0.941430948,1716.023832,1985.278017,2984.779604,3338.556818,6010,263.4809294,12020,-2896896,180224,-2716672,-1
9324,616,23,7,0.061971831,0.938028169,2844.197609,3210.750237,4991.427928,4653.727273,9940,749.6229261,19880,-4773888,315392,-4458496,-1
7049,489,19,11,0.0648713187,0.935128681,2139.128442,2606.643406,3802.098596,3299.586912,7538,460.4764814,15076,-3609088,250368,-3358720,-1
1212,85,15,15,0.065535852,0.934464148,369.4634767,398.1268609,661.5305281,470.3294118,1297,89.38662991,2594,-620544,43520,-577024,-1
4881,265,27,3,0.0514963078,0.948503692,1481.149894,1549.856607,2584.54538,2370.056604,5146,135.0656168,10292,-2499072,135680,-2363392,-1
486,104,21,9,0.176271186,0.823728814,161.1209635,188.1619862,278.2942387,375.9038462,590,41.60789845,1180,-248832,53248,-195584,-1
7594,742,19,11,0.0890115163,0.910988484,2400.663358,2457.551255,4185.495654,3994.557951,8336,313.3834586,16672,-3888128,379904,-3508224,-1
1952,356,21,9,0.154246101,0.845753899,645.4919468,652.5037556,1085.849385,1530.921348,2308,86.99585375,4616,-999424,182272,-817152,-1
1467,236,18,12,0.138578978,0.861421022,484.943987,509.7710932,829.7007498,990.6144068,1703,132.9430133,3406,-751104,120832,-630272,-1
8908,999,18,12,0.100837791,0.899162209,2771.363509,3484.636015,4880.145936,5612.550551,9907,275.9610028,19814,-4560896,511488,-4049408,-1
8716,1140,21,9,0.115665584,0.884334416,2801.239119,3102.88246,4854.270652,5496.028947,9856,374.0417457,19712,-4462592,583680,-3878912,-1
2034,245,21,9,0.107503291,0.892496709,659.7979481,641.8346129,1139.818584,1141.506122,2279,61.08281962,4558,-1041408,125440,-915968,-1
94,26,19,11,0.216666667,0.783333333,34.2014063,28.79813953,65.86170213,41.11538462,120,3.263530052,240,-48128,13312,-34816,-1
108,30,17,13,0.217391304,0.782608696,38.21103568,40.3482617,74.50925926,51.46666667,138,18.75,276,-55296,15360,-39936,-1
9615,370,22,8,0.0370555834,0.962944417,2872.041122,3116.404811,5007.556318,4614.732432,9985,1180.260047,19970,-4922880,189440,-4733440,-1
3526,307,21,9,0.0800939212,0.919906079,1093.353785,1188.451057,1948.672717,1553.228013,3833,94.64197531,7666,-1805312,157184,-1648128,-1
68,23,22,8,0.252747253,0.747252747,25.15380027,29.16947416,45.14705882,48.52173913,91,2.614191324,182,-34816,11776,-23040,-1
9287,641,20,10,0.064564867,0.935435133,2869.610051,2749.488808,4924.932271,5537.769111,9928,460.4823748,19856,-4754944,328192,-4426752,-1
2830,329,21,9,0.104146882,0.895853118,896.5798079,992.8995848,1611.979859,1304.914894,3159,88.3142298,6318,-1448960,168448,-1280512,-1
3508,669,21,9,0.160162796,0.839837204,1188.67004,1268.063496,2045.83951,2315.318386,4177,104.1386188,8354,-1796096,342528,-1453568,-1
2786,167,22,8,0.0565526583,0.943447342,843.3622144,925.1709164,1497.835248,1129.413174,2953,206.2150838,5906,-1426432,85504,-1340928,-1
9508,465,22,8,0.0466258899,0.95337411,2850.205115,3136.736581,5051.376525,3670.673118,9973,590.8175355,19946,-4868096,238080,-4630016,-1
271,47,15,15,0.147798742,0.852201258,88.39923855,76.23887907,172.0516605,87.12765957,318,35.81081081,636,-138752,24064,-114688,-1
1336,74,21,9,0.0524822695,0.94751773,401.2753456,499.6714094,705.3368263,708.4459459,1410,46.875,2820,-684032,37888,-646144,-1
9494,470,22,8,0.0471698113,0.952830189,2868.222239,3028.507027,4992.839794,4773.63617,9964,497.4538193,19928,-4860928,240640,-4620288,-1
365,29,20,10,0.0736040609,0.926395939,110.198185,146.3436901,200.4575342,160.2758621,394,53.67847411,788,-186880,14848,-172032,-1
6087,513,21,9,0.0777272727,0.922272727,1885.544212,2108.50854,3322.038278,3044.937622,6600,354.6480387,13200,-3116544,262656,-2853888,-1
9335,613,21,9,0.0616204262,0.938379574,2861.685574,2949.432255,5015.999893,4342.523654,9948,764.6425826,19896,-4779520,313856,-4465664,-1
2984,198,23,7,0.0622250157,0.937774984,902.5661407,1126.117728,1599.290214,1474.09596,3182,115.8354569,6364,-1527808,101376,-1426432,-1
9588,386,18,12,0.0387006216,0.961299378,2860.786165,3199.192163,5020.220693,4174.738342,9974,1025.077081,19948,-4909056,197632,-4711424,-1
6457,361,19,11,0.0529480786,0.947051921,1955.65294,2178.109891,3404.257395,3503.271468,6818,289.8809524,13636,-3305984,184832,-3121152,-1
7576,361,20,10,0.04548318,0.95451682,2270.603921,2488.613023,4016.23878,2977.639889,7937,196.8013885,15874,-3878912,184832,-3694080,-1
4761,673,21,9,0.123849834,0.876150166,1526.574792,1654.088082,2611.135056,3469.956909,5434,115.6170213,10868,-2437632,344576,-2093056,-1
9456,507,20,10,0.0508882867,0.949111713,2857.833471,3151.245351,5010.212986,4455.802761,9963,940.7932011,19926,-4841472,259584,-4581888,-1
8541,499,22,8,0.055199115,0.944800885,2598.876993,2731.023113,4552.101745,3979.597194,9040,474.789916,18080,-4372992,255488,-4117504,-1
1495,330,25,5,0.180821918,0.819178082,527.4363518,524.0788449,913.5317726,910.5909091,1825,93.06476288,3650,-765440,168960,-596480,-1
5951,376,27,3,0.0594278489,0.940572151,1806.883983,2069.581899,3189.834314,2755.117021,6327,121.2765957,12654,-3046912,192512,-2854400,-1
2218,152,27,3,0.0641350211,0.935864979,677.104273,774.2018202,1191.733093,1094.546053,2370,186.3207547,4740,-1135616,77824,-1057792,-1
6644,754,21,9,0.101919438,0.898080562,2130.877605,2077.555574,3769.436183,3083.245358,7398,199.6222342,14796,-3401728,386048,-3015680,-1
9318,629,20,10,0.0632351463,0.936764854,2830.580699,3255.847519,5042.431423,3960.257552,9947,1103.99556,19894,-4770816,322048,-4448768,-1
6056,289,27,3,0.0455476753,0.954452325,1833.13489,1761.230927,3190.34858,2809.460208,6345,337.3205742,12690,-3100672,147968,-2952704,-1
350,49,20,10,0.122807018,0.877192982,110.9768238,91.29542054,214.1971429,98.59183673,399,59.19881306,798,-179200,25088,-154112,-1
2423,206,22,8,0.0783567897,0.92164321,753.9984992,634.6426932,1356.690054,824.6359223,2629,153.7426901,5258,-1240576,105472,-1135104,-1
5209,425,21,9,0.0754348598,0.92456514,1599.351092,1666.205465,2893.487618,1886.16,5634,241.9063976,11268,-2667008,217600,-2449408,-1
1131,167,25,5,0.128659476,0.871340524,371.9250959,386.8233591,639.9504863,714.1736527,1298,25.98078463,2596,-579072,85504,-493568,-1
4195,314,19,11,0.0696385008,0.930361499,1287.223763,1478.000624,2248.442431,2342.60828,4509,100,9018,-2147840,160768,-1987072,-1
2064,292,22,8,0.123938879,0.876061121,663.1163562,779.8744123,1161.862403,1296.10274,2356,179.2998478,4712,-1056768,149504,-907264,-1
5658,522,22,8,0.0844660194,0.915533981,1759.761835,1972.342989,3048.714917,3543.411877,6180,132.6180258,12360,-2896896,267264,-2629632,-1
798,40,21,9,0.0477326969,0.952267303,238.5937637,267.0636581,426.2393484,285.05,838,61.39194139,1676,-408576,20480,-388096,-1
271,58,17,13,0.176291793,0.823708207,90.58915564,99.35620499,175.5498155,115.7068966,329,26.36217949,658,-138752,29696,-109056,-1
9007,478,21,9,0.0503953611,0.949604639,2723.76345,2956.314379,4718.138226,5211.472803,9485,397.6939203,18970,-4611584,244736,-4366848,-1
730,88,17,13,0.107579462,0.892420538,229.868218,254.6330894,423.5178082,293.2159091,818,102.25,1636,-373760,45056,-328704,-1
9150,770,19,11,0.0776209677,0.922379032,2838.025329,3000.180629,5038.696721,4031.279221,9920,674.829932,19840,-4684800,394240,-4290560,-1
1684,251,20,10,0.129715762,0.870284238,543.0248267,593.0248789,929.8307601,1224.083665,1935,87.63586957,3870,-862208,128512,-733696,-1
9649,338,21,9,0.0338439972,0.966156003,2876.072402,3037.490255,5010.297337,4528.754438,9987,485.2769679,19974,-4940288,173056,-4767232,-1
2385,189,21,9,0.0734265734,0.926573427,727.0518409,856.7596648,1313.35304,961.2592593,2574,59.39086294,5148,-1221120,96768,-1124352,-1
61,17,25,5,0.217948718,0.782051282,23.18627466,19.27653431,40.73770492,35.05882353,78,2.394841879,156,-31232,8704,-22528,-1
470,53,22,8,0.101338432,0.898661568,144.1470752,189.3524857,254.5829787,327.7735849,523,56.6017316,1046,-240640,27136,-213504,-1
2451,464,19,11,0.159176672,0.840823328,829.4675931,901.9943959,1453.725418,1480.579741,2915,94.39766839,5830,-1254912,237568,-1017344,-1
9415,546,21,9,0.0548137737,0.945186226,2847.040253,3113.870619,5047.230058,3838.956044,9961,624.122807,19922,-4820480,279552,-4540928,-1
5852,384,21,9,0.0615779346,0.938422065,1784.642062,1872.902927,3166.978469,2379.708333,6236,208.5618729,12472,-2996224,196608,-2799616,-1
9478,490,20,10,0.0491573034,0.950842697,2864.189486,2964.040866,5034.261237,4021.97551,9968,1022.358974,19936,-4852736,250880,-4601856,-1
437,99,19,11,0.184701493,0.815298507,146.872469,163.5830597,286.382151,189.5656566,536,63.80952381,1072,-223744,50688,-173056,-1
931,146,17,13,0.135561746,0.864438254,304.4072247,348.5451932,542.7572503,515.0410959,1077,55.83203733,2154,-476672,74752,-401920,-1
6134,522,20,10,0.0784254808,0.921574519,1900.021248,1927.336188,3249.368764,4258.367816,6656,155.4413825,13312,-3140608,267264,-2873344,-1
2249,187,24,6,0.0767651888,0.923234811,706.5101581,643.6740012,1230.949755,1068.770053,2436,59.51624725,4872,-1151488,95744,-1055744,-1
6991,315,20,10,0.0431152477,0.956884752,2096.758035,2190.761181,3692.849807,2780.184127,7306,306.588334,14612,-3579392,161280,-3418112,-1
6776,626,24,6,0.0845717374,0.915428263,2097.597219,2502.109502,3729.5701,3397.661342,7402,174.32878,14804,-3469312,320512,-3148800,-1
1209,115,24,6,0.086858006,0.913141994,378.0129107,381.9750451,679.1827957,487.1130435,1324,107.0331447,2648,-619008,58880,-560128,-1
8540,441,26,4,0.0491036633,0.950896337,2561.278023,2797.648509,4562.56733,3105.092971,8981,170.094697,17962,-4372480,225792,-4146688,-1
8618,744,19,11,0.0794701987,0.920529801,2626.470046,3209.712092,4573.516709,5932.306452,9362,351.6904583,18724,-4412416,380928,-4031488,-1
8221,357,21,9,0.0416180928,0.958381907,2469.85016,2589.985792,4306.147792,3906.134454,8578,452.1876647,17156,-4209152,182784,-4026368,-1
3280,3270,22,8,0.499236641,0.500763359,1292.975561,1250.465877,1878.56311,4676.708869,6550,362.6799557,13100,-1679360,1674240,-5120,-1
9517,453,20,10,0.0454363089,0.954563691,2857.499579,3037.489538,5043.179468,3773.721854,9970,930.0373134,19940,-4872704,231936,-4640768,-1
1007,114,20,10,0.101694915,0.898305085,318.2939145,365.1657912,565.1370407,524.4561404,1121,143.3503836,2242,-515584,58368,-457216,-1
1933,317,21,9,0.140888889,0.859111111,636.6561311,722.6487354,1129.01552,1104.063091,2250,153.6885246,4500,-989696,162304,-827392,-1
6720,816,21,9,0.108280255,0.891719745,2170.842678,2212.146144,3761.126637,3829.221814,7536,192.0978843,15072,-3440640,417792,-3022848,-1
3625,374,17,13,0.0935233808,0.906476619,1141.32049,1266.0414,2014.270897,1861.679144,3999,98.64331524,7998,-1856000,191488,-1664512,-1
3024,235,22,8,0.0721080086,0.927891991,926.7000598,1100.179832,1638.647156,1518.72766,3259,154.4549763,6518,-1548288,120320,-1427968,-1
4462,351,20,10,0.0729274881,0.927072512,1378.39656,1439.146487,2444.581354,1929.25641,4813,203.0801688,9626,-2284544,179712,-2104832,-1
9444,510,21,9,0.0512356841,0.948764316,2854.673628,3163.226649,5003.527954,4495.523529,9954,1056.687898,19908,-4835328,261120,-4574208,-1
56,11,21,9,0.164179104,0.835820896,18.98183208,13.57196917,36.89285714,19.27272727,67,5.815972222,134,-28672,5632,-23040,-1
1275,94,27,3,0.0686632579,0.931336742,389.7472283,462.5452533,683.8847059,700.1276596,1369,160.3044496,2738,-652800,48128,-604672,-1
9583,391,22,8,0.039201925,0.960798075,2867.862959,3067.092829,5015.390587,4303.930946,9974,515.9855147,19948,-4906496,200192,-4706304,-1
4461,567,21,9,0.112768496,0.887231504,1411.199536,1683.627728,2463.866846,2912.867725,5028,209.0644491,10056,-2284032,290304,-1993728,-1
1004,81,21,9,0.0746543779,0.925345622,305.218303,332.771729,560.1165339,330.8395062,1085,77.44468237,2170,-514048,41472,-472576,-1
4264,551,21,9,0.11443406,0.88556594,1371.263079,1469.425796,2458.513837,2017.090744,4815,102.1642266,9630,-2183168,282112,-1901056,-1
9330,609,21,9,0.06127377,0.93872623,2857.576252,3032.105622,4955.435155,5193.136289,9939,544.3044907,19878,-4776960,311808,-4465152,-1
234,47,20,10,0.167259786,0.832740214,81.16013217,75.06702,146.5299145,113.4680851,281,24.73591549,562,-119808,24064,-95744,-1
83,24,20,10,0.224299065,0.775700935,31.19770585,27.06393536,57.1686747,43.04166667,107,6.114285714,214,-42496,12288,-30208,-1
1855,123,21,9,0.0621840243,0.937815976,561.9282874,688.0727341,983.9078167,1073.837398,1978,61.0870908,3956,-949760,62976,-886784,-1
8622,383,27,3,0.0425319267,0.957468073,2582.228859,2851.709443,4537.833333,3718.840731,9005,316.5202109,18010,-4414464,196096,-4218368,-1
7209,364,21,9,0.0480654958,0.951934504,2172.651734,2280.020343,3829.515883,2944.975275,7573,260.5987612,15146,-3691008,186368,-3504640,-1
4890,231,22,8,0.0451083773,0.954891623,1472.444978,1507.987104,2585.313701,2046.307359,5121,383.3083832,10242,-2503680,118272,-2385408,-1
364,60,22,8,0.141509434,0.858490566,117.5622429,140.7416417,219.6840659,168.9166667,424,34.41558442,848,-186368,30720,-155648,-1
6556,336,19,11,0.0487521764,0.951247824,1971.329384,2248.320591,3474.395973,2902.196429,6892,127.6532691,13784,-3356672,172032,-3184640,-1
9534,432,22,8,0.0433473811,0.956652619,2869.577825,3025.360453,4994.098175,4749.604167,9966,1131.214529,19932,-4881408,221184,-4660224,-1
287,58,16,14,0.168115942,0.831884058,94.68054545,113.1768475,180.8885017,133.9655172,345,28.70216306,690,-146944,29696,-117248,-1
9335,602,25,5,0.0605816645,0.939418336,2842.563905,2990.081197,5047.833315,3746.559801,9937,1015.015322,19874,-4779520,308224,-4471296,-1
6308,461,21,9,0.0681045945,0.931895406,1964.436281,1796.947998,3397.608117,3212.479393,6769,175.4536029,13538,-3229696,236032,-2993664,-1
246,59,19,11,0.193442623,0.806557377,86.97386382,87.2854566,159.5162602,125.8305085,305,22.71034996,610,-125952,30208,-95744,-1
282,39,24,6,0.121495327,0.878504673,90.74216543,104.9961647,162.3687943,151.1025641,321,31.22568093,642,-144384,19968,-124416,-1
9209,725,21,9,0.0729816791,0.927018321,2798.37693,3631.259225,4955.089369,5125.14069,9934,941.6113744,19868,-4715008,371200,-4343808,-1
183,30,18,12,0.14084507,0.85915493,58.28725865,50.28964992,116.1038251,51.46666667,213,20.50048123,426,-93696,15360,-78336,-1
7190,416,20,10,0.0546936629,0.945306337,2168.934757,2561.932043,3774.068985,4312.175481,7606,208.8986542,15212,-3681280,212992,-3468288,-1
4771,224,20,10,0.0448448448,0.955155155,1429.229219,1677.591968,2488.631524,2697.540179,4995,179.8703637,9990,-2442752,114688,-2328064,-1
7696,366,22,8,0.0453981642,0.954601836,2315.508855,2487.044487,4060.216216,3427.674863,8062,588.4671533,16124,-3940352,187392,-3752960,-1
153,33,17,13,0.177419355,0.822580645,51.34040305,48.91517367,101.4117647,56.81818182,186,35.56405354,372,-78336,16896,-61440,-1
2423,390,22,8,0.138642019,0.861357981,803.4899515,858.7561855,1393.806851,1488.966667,2813,87.63239875,5626,-1240576,199680,-1040896,-1
2027,121,17,13,0.0563314711,0.943668529,608.8947062,762.0052413,1085.192403,895.3801653,2148,226.5822785,4296,-1037824,61952,-975872,-1
4448,1614,20,10,0.266248763,0.733751237,1466.378202,1521.196566,2470.139388,4578.545849,6062,112.7184827,12124,-2277376,826368,-1451008,-1
1265,119,22,8,0.085982659,0.914017341,398.3766898,332.1900769,714.3494071,460.2352941,1384,85.96273292,2768,-647680,60928,-586752,-1
9616,366,22,8,0.0366659988,0.963334001,2870.071231,3072.770548,5020.360129,4233.251366,9982,565.2321631,19964,-4923392,187392,-4736000,-1
3073,343,17,13,0.100409836,0.899590164,966.2337631,1142.817486,1721.082981,1595.766764,3416,108.2382763,6832,-1573376,175616,-1397760,-1
2747,186,27,3,0.0634162973,0.936583703,841.973383,826.9696953,1492.419367,1091.586022,2933,131.8794964,5866,-1406464,95232,-1311232,-1
3933,674,21,9,0.14629911,0.85370089,1297.233167,1348.918694,2197.745233,2924.029674,4607,124.6482684,9214,-2013696,345088,-1668608,-1
7131,505,21,9,0.0661341016,0.933865898,2175.616125,2518.142708,3855.574674,3294.976238,7636,184,15272,-3651072,258560,-3392512,-1
5346,406,21,9,0.0705841446,0.929415855,1636.726716,1942.861539,2884.777591,2767.504926,5752,111.3433991,11504,-2737152,207872,-2529280,-1
9481,479,17,13,0.0480923695,0.951907631,2862.703184,3112.275939,4981.383187,4963.018789,9960,1139.588101,19920,-4854272,245248,-4609024,-1
1886,104,25,5,0.0522613065,0.947738693,564.6806924,619.0519067,1016.21315,619.875,1990,184.2592593,3980,-965632,53248,-912384,-1
6822,343,22,8,0.047871598,0.952128402,2036.331701,2477.225344,3625.656992,2734.586006,7165,318.8696039,14330,-3492864,175616,-3317248,-1
422,37,21,9,0.0806100218,0.919389978,128.8200859,164.0538136,233.3791469,191.4594595,459,44.73684211,918,-216064,18944,-197120,-1
2693,872,21,9,0.244600281,0.755399719,1025.877845,760.1061576,1583.6101,2398.776376,3565,86.11111111,7130,-1378816,446464,-932352,-1
74,28,20,10,0.274509804,0.725490196,30.68992406,20.72275073,56.48648649,38.32142857,102,23.1292517,204,-37888,14336,-23552,-1
238,54,19,11,0.184931507,0.815068493,81.42005716,92.37525047,151.802521,123.1296296,292,5.568268497,584,-121856,27648,-94208,-1
9514,456,21,9,0.0457372116,0.954262788,2863.885736,2973.399454,5035.580723,3940.614035,9970,680.0818554,19940,-4871168,233472,-4637696,-1
8262,1557,22,8,0.158570119,0.841429881,2730.968841,3094.508845,4697.158073,6039.415543,9819,359.5386305,19638,-4230144,797184,-3432960,-1
3467,225,24,6,0.0609425785,0.939057421,1061.844911,1065.39126,1869.186905,1496.92,3692,114.3742255,7384,-1775104,115200,-1659904,-1
2570,175,20,10,0.0637522769,0.936247723,795.1362772,712.0548114,1388.78677,1141.16,2745,120.4475647,5490,-1315840,89600,-1226240,-1
1858,292,23,7,0.135813953,0.864186047,624.467826,593.5661094,1067.976857,1123.369863,2150,120.8544126,4300,-951296,149504,-801792,-1
5407,250,24,6,0.0441930352,0.955806965,1628.643316,1707.490636,2840.173479,2587.34,5657,152.7680259,11314,-2768384,128000,-2640384,-1
9586,395,21,9,0.0395751929,0.960424807,2868.292294,3028.136149,5030.202274,4039.625316,9981,476.6475645,19962,-4908032,202240,-4705792,-1
6031,292,18,12,0.0461806105,0.95381939,1818.628598,1952.538913,3168.827889,3020.976027,6323,222.6408451,12646,-3087872,149504,-2938368,-1
3291,274,27,3,0.076858345,0.923141655,1027.177536,1030.557395,1765.993619,1987.262774,3565,130.0620212,7130,-1684992,140288,-1544704,-1
9631,351,15,15,0.0351632939,0.964836706,2873.47388,3047.01341,5010.949849,4457.820513,9982,1003.21608,19964,-4931072,179712,-4751360,-1
3603,198,27,3,0.0520915549,0.947908445,1091.960872,1134.813628,1920.069664,1553.989899,3801,191.4861461,7602,-1844736,101376,-1743360,-1
104,20,22,8,0.161290323,0.838709677,36.14232504,25.92002122,66.35576923,42.45,124,12.4248497,248,-53248,10240,-43008,-1
140,60,21,9,0.3,0.7,58.79400697,54.73271163,97.97857143,106.3833333,200,5.603810591,400,-71680,30720,-40960,-1
4192,263,20,10,0.0590347924,0.940965208,1289.937633,1197.54225,2242.918893,1990.205323,4455,97.37704918,8910,-2146304,134656,-2011648,-1
1857,180,17,13,0.088365243,0.911634757,582.7349963,564.1049157,1047.000539,730.1277778,2037,46.58129431,4074,-950784,92160,-858624,-1
9534,443,21,9,0.0444021249,0.955597875,2856.927856,3248.007048,5024.417558,4226.76298,9977,883.7023915,19954,-4881408,226816,-4654592,-1
783,64,18,12,0.0755608028,0.924439197,237.584013,316.413341,425.7624521,402.4375,847,15.87331334,1694,-400896,32768,-368128,-1
69,28,19,11,0.288659794,0.711340206,29.15550151,19.48688073,54.31884058,35.89285714,97,27.40112994,194,-35328,14336,-20992,-1
996,117,27,3,0.105121294,0.894878706,316.7794779,357.3598518,556.185743,563.9316239,1113,88.75598086,2226,-509952,59904,-450048,-1
7034,1544,20,10,0.179995337,0.820004663,2463.337148,2249.133231,4057.359539,5347.062176,8578,162.0937264,17156,-3601408,790528,-2810880,-1
57,13,20,10,0.185714286,0.814285714,20.10847774,11.66748377,39,20.15384615,70,14.58333333,140,-29184,6656,-22528,-1
1114,157,20,10,0.123524784,0.876475216,361.8720184,325.9578565,666.7746858,417.6369427,1271,24.60793804,2542,-570368,80384,-489984,-1
3696,249,24,6,0.0631178707,0.936882129,1120.17747,1365.95666,1988.472673,1743.333333,3945,311.1198738,7890,-1892352,127488,-1764864,-1
5206,858,20,10,0.141490765,0.858509235,1720.397947,1766.931625,2916.524395,3736.193473,6064,135.8422939,12128,-2665472,439296,-2226176,-1
8963,976,18,12,0.098199014,0.901800986,2852.04396,3008.948644,4941.390941,5232.728484,9939,716.5825523,19878,-4589056,499712,-4089344,-1
3512,329,22,8,0.0856547774,0.914345223,1093.853534,1202.167697,1953.997153,1568.762918,3841,132.0385012,7682,-1798144,168448,-1629696,-1
5232,350,22,8,0.0627015407,0.937298459,1602.213483,1725.934469,2807.134748,2557.782857,5582,186.3150868,11164,-2678784,179200,-2499584,-1
959,124,20,10,0.114496768,0.885503232,302.8617908,378.1524986,546.3253389,508.5483871,1083,42.37089202,2166,-491008,63488,-427520,-1
1532,281,21,9,0.154991726,0.845008274,513.9896189,571.5429731,904.1142298,922.7330961,1813,100.7782101,3626,-784384,143872,-640512,-1
4149,361,23,7,0.0800443459,0.919955654,1285.665729,1475.367661,2259.073753,2214.426593,4510,146.6666667,9020,-2124288,184832,-1939456,-1
3386,463,18,12,0.120290985,0.879709015,1105.476828,1135.4598,1949.543414,1745.509719,3849,76.15749901,7698,-1733632,237056,-1496576,-1
4399,317,17,13,0.0672179813,0.932782019,1353.094915,1427.186884,2383.503296,2011.529968,4716,384.9795918,9432,-2252288,162304,-2089984,-1
7087,487,20,10,0.0642989173,0.935701083,2152.347282,2632.795221,3789.016227,3765.435318,7574,263.2603406,15148,-3628544,249344,-3379200,-1
4061,379,21,9,0.0853603604,0.91463964,1253.361123,1465.606489,2174.548387,2712.873351,4440,138.836773,8880,-2079232,194048,-1885184,-1
9412,546,19,11,0.0548302872,0.945169713,2856.668763,2909.621333,5050.207182,3760.642857,9958,620.8229426,19916,-4818944,279552,-4539392,-1
9629,346,27,3,0.0346867168,0.965313283,2868.296072,3166.819395,4996.69488,4746.026012,9975,460.101476,19950,-4930048,177152,-4752896,-1
9647,341,21,9,0.0341409692,0.965859031,2876.924749,3021.932095,5010.72323,4535.539589,9988,888.6120996,19976,-4939264,174592,-4764672,-1
673,97,16,14,0.125974026,0.874025974,212.4322941,244.938243,404.1292719,256.2474227,770,60.01558846,1540,-344576,49664,-294912,-1
7789,446,20,10,0.0541590771,0.945840923,2375.808297,2347.611294,4146.330338,3623.235426,8235,202.0858896,16470,-3987968,228352,-3759616,-1
4637,368,19,11,0.0735264735,0.926473526,1429.275356,1584.181747,2531.662066,2141.842391,5005,383.8190184,10010,-2374144,188416,-2185728,-1
5455,415,22,8,0.0706984668,0.929301533,1700.006688,1595.685728,2956.309991,2661.961446,5870,432.5718497,11740,-2792960,212480,-2580480,-1
1205,153,19,11,0.112665685,0.887334315,383.5856202,451.1338143,684.4091286,640.8366013,1358,25.49277267,2716,-616960,78336,-538624,-1
323,80,24,6,0.198511166,0.801488834,110.328577,137.8753145,200.9628483,206.1875,403,17.52936059,806,-165376,40960,-124416,-1
5885,611,20,10,0.0940578818,0.905942118,1853.730593,2057.313613,3225.057434,3474.292962,6496,141.4634146,12992,-3013120,312832,-2700288,-1
2964,192,21,9,0.0608365019,0.939163498,897.0389009,983.8182677,1610.104251,1090.609375,3156,64.30317848,6312,-1517568,98304,-1419264,-1
427,97,17,13,0.185114504,0.814885496,141.2454629,171.3604756,278.9297424,190.1752577,524,49.52741021,1048,-218624,49664,-168960,-1
2091,117,20,10,0.0529891304,0.94701087,626.6570896,798.7732187,1110.159732,1003.350427,2208,43.43891403,4416,-1070592,59904,-1010688,-1
3728,444,23,7,0.106423778,0.893576222,1185.428578,1347.318216,2072.748122,2201.966216,4172,255.9509202,8344,-1908736,227328,-1681408,-1
9288,656,18,12,0.0659694288,0.934030571,2844.616188,2855.226616,5073.499677,3542.492378,9944,539.8479913,19888,-4755456,335872,-4419584,-1
9110,808,20,10,0.0814680379,0.918531962,2851.566338,2900.0029,5021.328321,4262.40099,9918,799.1941982,19836,-4664320,413696,-4250624,-1
472,99,21,9,0.173380035,0.826619965,158.7765696,189.974683,289.9279661,267.2727273,571,15.92303402,1142,-241664,50688,-190976,-1
2940,220,21,9,0.0696202532,0.930379747,911.0313119,898.8456879,1563.881633,1802.581818,3160,77.11078575,6320,-1505280,112640,-1392640,-1
3769,210,17,13,0.0527770797,0.94722292,1130.510256,1280.582629,2025.185726,1358.5,3979,244.7109471,7958,-1929728,107520,-1822208,-1
5415,399,19,11,0.068627451,0.931372549,1654.318626,1963.356891,2923.29843,2693.092732,5814,128.6283186,11628,-2772480,204288,-2568192,-1
8538,800,21,9,0.08567145,0.91432855,2685.506949,2779.144049,4701.21539,4331.0175,9338,242.6715177,18676,-4371456,409600,-3961856,-1
2506,147,22,8,0.055408971,0.944591029,758.0564535,871.2496879,1336.884278,1158.496599,2653,199.6237773,5306,-1283072,75264,-1207808,-1
246,47,22,8,0.160409556,0.839590444,81.6658403,97.11436837,149.8211382,132.2340426,293,33.67816092,586,-125952,24064,-101888,-1
2340,252,20,10,0.0972222222,0.902777778,728.4914093,899.8018567,1311.367949,1158.440476,2592,51.5718265,5184,-1198080,129024,-1069056,-1
2474,393,18,12,0.137077084,0.862922916,823.6684591,845.8323219,1449.291835,1337.735369,2867,160.706278,5734,-1266688,201216,-1065472,-1
2130,182,21,9,0.0787197232,0.921280277,648.695336,845.7050016,1145.316901,1287.379121,2312,109.3661306,4624,-1090560,93184,-997376,-1
5528,533,19,11,0.0879392839,0.912060716,1730.795622,1888.101147,3069.776954,2628.825516,6061,188.0546075,12122,-2830336,272896,-2557440,-1
457,65,17,13,0.124521073,0.875478927,143.7299946,175.5344394,272.0612691,187.2461538,522,61.62927981,1044,-233984,33280,-200704,-1
5099,406,21,9,0.0737511353,0.926248865,1586.748815,1592.712189,2730.694646,3033.135468,5505,115.5541562,11010,-2610688,207872,-2402816,-1
2270,181,27,3,0.0738474092,0.926152591,694.7295192,850.2411806,1230.234802,1172.889503,2451,188.2488479,4902,-1162240,92672,-1069568,-1
9609,370,20,10,0.0370778635,0.962922136,2862.908022,3151.624309,5028.121969,3999.962162,9979,1012.068966,19958,-4919808,189440,-4730368,-1
2174,192,21,9,0.0811496196,0.91885038,671.7810201,765.1363347,1203.034499,962.3125,2366,106.6726781,4732,-1113088,98304,-1014784,-1
5228,423,17,13,0.0748540081,0.925145992,1608.121285,1887.333494,2813.151301,2984.801418,5651,150.6531592,11302,-2676736,216576,-2460160,-1
645,83,19,11,0.114010989,0.885989011,202.6643984,209.8004658,383.3348837,218.1325301,728,77.36450584,1456,-330240,42496,-287744,-1
4631,753,20,10,0.139858841,0.860141159,1518.001859,1574.4794,2573.654934,3423.405046,5384,119.5912928,10768,-2371072,385536,-1985536,-1
1432,162,19,11,0.101631117,0.898368883,454.8111408,397.7288852,830.8456704,502.7407407,1594,137.1772806,3188,-733184,82944,-650240,-1
4894,623,20,10,0.11292369,0.88707631,1554.094913,1759.812856,2683.950143,3348.556982,5517,101.1551155,11034,-2505728,318976,-2186752,-1
9384,554,21,9,0.0557456229,0.944254377,2849.793754,3121.654407,4936.453431,5529.263538,9938,641.1612903,19876,-4804608,283648,-4520960,-1
270,56,20,10,0.171779141,0.828220859,91.43705924,99.45736543,170.4444444,130.0178571,326,37.60092272,652,-138240,28672,-109568,-1
2513,160,23,7,0.0598578376,0.940142162,761.0436536,906.8749859,1347.292081,1175.35,2673,170.5807275,5346,-1286656,81920,-1204736,-1
8440,481,20,10,0.0539177222,0.946082278,2542.721287,3025.631063,4496.088033,3845.318087,8921,670.2479339,17842,-4321280,246272,-4075008,-1
4589,248,19,11,0.0512714492,0.948728551,1388.158916,1443.44745,2447.187405,1897.419355,4837,152.972802,9674,-2349568,126976,-2222592,-1
8156,518,22,8,0.0597186996,0.9402813,2485.469081,2579.03871,4401.255272,3333.662162,8674,213.6979552,17348,-4175872,265216,-3910656,-1
3525,514,21,9,0.127259223,0.872740777,1148.142594,1257.206619,2053.819291,1788.068093,4039,151.8421053,8078,-1804800,263168,-1541632,-1
6228,719,17,13,0.103497913,0.896502087,1948.088409,2445.042994,3464.81808,3553.534075,6947,146.3758955,13894,-3188736,368128,-2820608,-1
9551,421,21,9,0.042218211,0.957781789,2862.502357,3213.818032,4997.386452,4739.524941,9972,624.0300375,19944,-4890112,215552,-4674560,-1
139,41,20,10,0.227777778,0.772222222,51.40023001,53.3408333,92.35251799,84.2195122,180,19.39655172,360,-71168,20992,-50176,-1
1029,81,21,9,0.072972973,0.927027027,315.3112919,378.8508801,557.1622935,534.382716,1110,51.2465374,2220,-526848,41472,-485376,-1
2750,342,19,11,0.110608021,0.889391979,892.3815447,879.5692838,1527.602545,1698.453216,3092,187.7352763,6184,-1408000,175104,-1232896,-1
9334,615,21,9,0.0618152578,0.938184742,2867.79919,2622.91896,5059.118384,3698.315447,9949,282.6420455,19898,-4779008,314880,-4464128,-1
9528,442,21,9,0.044332999,0.955667001,2849.279415,3271.571476,5033.86461,3942.925339,9970,1472.67356,19940,-4878336,226304,-4652032,-1
1236,129,17,13,0.0945054945,0.905494505,387.6209283,425.3303099,697.8802589,540.4263566,1365,139.2857143,2730,-632832,66048,-566784,-1
650,90,17,13,0.121621622,0.878378378,208.5505937,223.5006736,384.1938462,271.6,740,84.76517755,1480,-332800,46080,-286720,-1
42,17,22,8,0.288135593,0.711864407,16.69752246,17.78786959,30.38095238,29.05882353,59,11.30268199,118,-21504,8704,-12800,-1
7696,428,22,8,0.0526834072,0.947316593,2326.093511,2404.005904,4124.813669,2942.018692,8124,854.2586751,16248,-3940352,219136,-3721216,-1
110,28,19,11,0.202898551,0.797101449,39.39554134,29.5180678,76.13636364,43.42857143,138,29.17547569,276,-56320,14336,-41984,-1
266,10,27,3,0.0362318841,0.963768116,79.10232626,90.65009653,139.3609023,115.6,276,98.22064057,552,-136192,5120,-131072,-1
6750,472,19,11,0.0653558571,0.934644143,2043.873637,2587.513636,3629.17437,3358.741525,7222,208.6077412,14444,-3456000,241664,-3214336,-1
1017,108,17,13,0.096,0.904,309.6772166,425.6320672,575.120944,448.8611111,1125,106.2322946,2250,-520704,55296,-465408,-1
7597,444,21,9,0.0552170128,0.944782987,2288.959109,2775.023478,4048.451231,3551.29955,8041,209.5647641,16082,-3889664,227328,-3662336,-1
1281,178,21,9,0.122001371,0.877998629,410.1247491,493.45466,730.4676034,726.6348315,1459,64.16007036,2918,-655872,91136,-564736,-1
4129,227,20,10,0.0521120294,0.947887971,1241.854597,1399.495136,2209.363526,1617.110132,4356,281.5772463,8712,-2114048,116224,-1997824,-1
5076,335,21,9,0.0619109222,0.938089078,1535.955957,1905.432135,2717.571513,2530.665672,5411,192.2202487,10822,-2598912,171520,-2427392,-1
9400,549,21,9,0.0551814253,0.944818575,2869.269676,2904.722868,4991.293511,4696.021858,9949,614.894932,19898,-4812800,281088,-4531712,-1
2735,136,23,7,0.0473702543,0.952629746,821.9248172,875.9488932,1454.63181,1061.308824,2871,199.5135511,5742,-1400320,69632,-1330688,-1
9065,895,20,10,0.0898594378,0.910140562,2910.200219,2488.336047,4965.812686,5129.260335,9960,190.5490721,19920,-4641280,458240,-4183040,-1
9475,492,21,9,0.0493628976,0.950637102,2862.633907,2902.830554,5045.276728,3803.924797,9967,514.5585958,19934,-4851200,251904,-4599296,-1
251,15,21,9,0.0563909774,0.943609023,75.13537271,83.02519029,136.7848606,78.53333333,266,77.55102041,532,-128512,7680,-120832,-1
2670,120,22,8,0.0430107527,0.956989247,800.578044,906.1374982,1395.700749,1391.033333,2790,358.1514763,5580,-1367040,61440,-1305600,-1
5861,324,19,11,0.0523848019,0.947615198,1756.520533,2242.63062,3098.994881,2984.555556,6185,387.2886662,12370,-3000832,165888,-2834944,-1
970,75,22,8,0.0717703349,0.928229665,297.0068179,355.0383105,525.3793814,492.2266667,1045,74.11347518,2090,-496640,38400,-458240,-1
2349,251,21,9,0.0965384615,0.903461538,733.047302,848.6327556,1330.326948,1021.36255,2600,60.46511628,5200,-1202688,128512,-1074176,-1
1549,161,22,8,0.0941520468,0.905847953,485.3331028,549.763027,841.6423499,988.826087,1710,89.66963818,3420,-793088,82432,-710656,-1
9260,682,21,9,0.0685978676,0.931402132,2875.1698,2457.677166,5066.707019,3678.806452,9942,789.047619,19884,-4741120,349184,-4391936,-1
9620,363,20,10,0.0363618151,0.963638185,2867.784926,3172.868662,5014.837838,4386.76584,9983,1897.908745,19966,-4925440,185856,-4739584,-1
7221,377,21,9,0.0496183206,0.950381679,2175.657567,2438.997487,3829.306744,3228.586207,7598,291.4461066,15196,-3697152,193024,-3504128,-1
2012,139,19,11,0.0646211065,0.935378894,616.3171928,683.8818713,1077.723161,1051.057554,2151,219.7139939,4302,-1030144,71168,-958976,-1
5631,576,22,8,0.0927984534,0.907201547,1768.43922,1984.614032,3075.564731,3381.984375,6207,156.6633014,12414,-2883072,294912,-2588160,-1
5683,540,19,11,0.0867748674,0.913225133,1790.487276,1666.912727,3186.475981,2328.209259,6223,158.2252733,12446,-2909696,276480,-2633216,-1
3632,140,24,6,0.0371155885,0.962884411,1085.710259,1156.188487,1892.813326,1722.714286,3772,314.3333333,7544,-1859584,71680,-1787904,-1
8547,1298,20,10,0.131843575,0.868156425,2789.111478,3073.575789,4814.176436,5639.575501,9845,316.1528581,19690,-4376064,664576,-3711488,-1
3379,239,27,3,0.0660585959,0.933941404,1031.552333,1170.534323,1830.957384,1506.133891,3618,294.3856794,7236,-1730048,122368,-1607680,-1
5389,448,22,8,0.076751756,0.923248244,1642.051252,2064.158672,2875.454259,3442.8125,5837,143.5563207,11674,-2759168,229376,-2529792,-1
60,15,21,9,0.2,0.8,20.72639219,22.36067977,40.5,28,75,2.242822967,150,-30720,7680,-23040,-1
89,29,16,14,0.245762712,0.754237288,34.07068037,23.93471104,66.34831461,38.48275862,118,11.18483412,236,-45568,14848,-30720,-1
3858,399,19,11,0.0937279774,0.906272023,1201.769446,1337.615151,2070.06169,2698.884712,4257,101.5748031,8514,-1975296,204288,-1771008,-1
1209,149,20,10,0.109720177,0.890279823,375.5339173,489.0830393,694.7320099,555.9060403,1358,24.79006937,2716,-619008,76288,-542720,-1
325,76,27,3,0.189526185,0.810473815,116.5199344,109.7526517,206.1476923,178.9868421,401,36.22402891,802,-166400,38912,-127488,-1
8965,512,21,9,0.0540255355,0.945974464,2719.543398,2920.487127,4778.497156,4047.414063,9477,216.5676417,18954,-4590080,262144,-4327936,-1
2875,489,22,8,0.145362663,0.854637337,953.4519288,1031.914207,1638.608,1940.556237,3364,84.52261307,6728,-1472000,250368,-1221632,-1
6988,717,19,11,0.0930564568,0.906943543,2190.946265,2520.263234,3836.569405,4013.135286,7705,187.2873116,15410,-3577856,367104,-3210752,-1
6314,527,21,9,0.0770355211,0.922964479,1955.890735,2187.946604,3415.564777,3486.119545,6841,247.6828385,13682,-3232768,269824,-2962944,-1
1340,124,19,11,0.0846994536,0.915300546,411.7349044,525.6607587,730.6514925,752.4758065,1464,105.248023,2928,-686080,63488,-622592,-1
5674,849,21,9,0.130154837,0.869845163,1830.626889,1698.930514,3066.627423,4567.705536,6523,152.620496,13046,-2905088,434688,-2470400,-1
1009,65,18,12,0.0605214153,0.939478585,303.9473963,339.2210932,549.8453915,345.8615385,1074,46.67535854,2148,-516608,33280,-483328,-1
2943,522,22,8,0.150649351,0.849350649,945.8774058,1190.823346,1663.812436,2123.074713,3465,64.22613531,6930,-1506816,267264,-1239552,-1
1196,110,22,8,0.0842266462,0.915773354,373.8399298,406.7199479,657.9807692,604.7818182,1306,55.43293718,2612,-612352,56320,-556032,-1
2498,146,22,8,0.0552193646,0.944780635,754.0527824,883.6825288,1333.948759,1126.616438,2644,80.68355203,5288,-1278976,74752,-1204224,-1
8666,584,21,9,0.0631351351,0.936864865,2641.257378,3066.937678,4619.369028,4716.47774,9250,265.0429799,18500,-4436992,299008,-4137984,-1
1544,183,18,12,0.1059641,0.8940359,491.7970409,544.6547562,874.1806995,778.1038251,1727,159.4644506,3454,-790528,93696,-696832,-1
3350,264,24,6,0.0730492529,0.926950747,1024.24785,1181.034433,1774.195224,2230.117424,3614,74.50010307,7228,-1715200,135168,-1580032,-1
39,16,21,9,0.290909091,0.709090909,15.82252823,15.93149397,28.51282051,26.75,55,13.34951456,110,-19968,8192,-11776,-1
437,101,17,13,0.187732342,0.812267658,146.4210846,166.4966863,288.1304348,188.8910891,538,85.80542265,1076,-223744,51712,-172032,-1
585,107,16,14,0.154624277,0.845375723,194.7866271,221.662192,353.025641,310.8224299,692,49.64131994,1384,-299520,54784,-244736,-1
1979,300,25,5,0.131636683,0.868363317,642.6010535,742.0871333,1156.287519,1032.556667,2279,161.9758351,4558,-1013248,153600,-859648,-1
5855,291,24,6,0.0473478685,0.952652131,1765.487227,1888.276166,3095.330658,2634.261168,6146,662.9989213,12292,-2997760,148992,-2848768,-1
8732,491,21,9,0.053236474,0.946763526,2646.466899,2773.318724,4664.090815,3685.610998,9223,594.6486138,18446,-4470784,251392,-4219392,-1
5956,311,20,10,0.0496250199,0.95037498,1792.260384,1909.94669,3179.19728,2268.421222,6267,509.0982941,12534,-3049472,159232,-2890240,-1
65,22,19,11,0.252873563,0.747126437,25.51456714,20.18207412,47.73846154,32.95454545,87,18.04979253,174,-33280,11264,-22016,-1
2442,428,19,11,0.14912892,0.85087108,815.0829236,899.9243966,1443.323915,1390.859813,2870,113.3043822,5740,-1250304,219136,-1031168,-1
2265,245,27,3,0.0976095618,0.902390438,700.2020628,911.9090746,1267.856954,1141.261224,2510,122.7984344,5020,-1159680,125440,-1034240,-1
3985,569,21,9,0.124945103,0.875054897,1283.266578,1497.17345,2245.530238,2501.400703,4554,95.31184596,9108,-2040320,291328,-1748992,-1
439,65,20,10,0.128968254,0.871031746,139.1924523,171.3820052,261.1389522,194.1538462,504,99.21259843,1008,-224768,33280,-191488,-1
9527,450,18,12,0.0451037386,0.954896261,2857.118577,3123.811902,5042.2241,3862.186667,9977,1142.840779,19954,-4877824,230400,-4647424,-1
3634,180,21,9,0.0471945464,0.952805454,1090.180361,1206.599979,1930.951844,1434.033333,3814,517.5033921,7628,-1860608,92160,-1768448,-1
137,38,19,11,0.217142857,0.782857143,49.7982835,47.58311725,93.74452555,67.28947368,175,32.40740741,350,-70144,19456,-50688,-1
1327,132,22,8,0.0904729267,0.909527073,405.5961791,553.377332,727.5553881,754.5757576,1459,79.33659598,2918,-679424,67584,-611840,-1
5742,514,21,9,0.0821611253,0.917838875,1754.702413,2220.544349,3076.39272,3710.601167,6256,117.7046096,12512,-2939904,263168,-2676736,-1
5842,2301,22,8,0.28257399,0.71742601,2289.868637,1912.06115,3535.492126,5434.137766,8143,152.7767355,16286,-2991104,1178112,-1812992,-1
4694,351,22,8,0.0695738355,0.930426165,1434.365363,1578.969122,2572.886877,1855.851852,5045,135.947184,10090,-2403328,179712,-2223616,-1
532,53,24,6,0.0905982906,0.909401709,163.9621932,206.4862162,297.5507519,247.3207547,585,75.19280206,1170,-272384,27136,-245248,-1
9399,568,18,12,0.0569880606,0.943011939,2851.427949,3093.670081,5047.016278,3941.235915,9967,1060.319149,19934,-4812288,290816,-4521472,-1
9355,585,19,11,0.0588531187,0.941146881,2840.835082,3098.253266,5038.208979,3887.735043,9940,604.9908704,19880,-4789760,299520,-4490240,-1
3779,498,19,11,0.116436755,0.883563245,1218.146104,1334.932007,2166.639058,1929.26506,4277,80.27402402,8554,-1934848,254976,-1679872,-1
884,129,22,8,0.127344521,0.872655479,285.4237494,322.4066681,520.14819,416.8992248,1013,74.98149519,2026,-452608,66048,-386560,-1
2640,406,20,10,0.13328956,0.86671044,869.3495766,927.0613177,1500.006818,1676.263547,3046,170.3579418,6092,-1351680,207872,-1143808,-1
2799,287,17,13,0.0930006481,0.906999352,881.0865477,972.8082951,1555.854948,1423.006969,3086,56.92676628,6172,-1433088,146944,-1286144,-1
2246,191,21,9,0.0783750513,0.921624949,696.4702251,781.2297224,1217.48976,1236.759162,2437,137.373168,4874,-1149952,97792,-1052160,-1
9508,461,22,8,0.0462433544,0.953756646,2854.886282,3169.927068,5030.976967,4036.737527,9969,941.3597734,19938,-4868096,236032,-4632064,-1
1023,168,17,13,0.141057935,0.858942065,320.9252954,406.5851983,628.4780059,398.2321429,1191,56.87679083,2382,-523776,86016,-437760,-1
4521,494,20,10,0.0985044865,0.901495513,1456.338692,1365.241155,2502.782791,2555.746964,5015,171.0436562,10030,-2314752,252928,-2061824,-1
9372,576,20,10,0.0579010856,0.942098914,2838.943358,3045.406566,5059.27977,3595.0625,9948,874.1652021,19896,-4798464,294912,-4503552,-1
4943,1123,22,8,0.185130234,0.814869766,1660.01609,1698.900529,2778.359498,4156.527159,6066,480.6656101,12132,-2530816,574976,-1955840,-1
1019,54,25,5,0.0503261883,0.949673812,306.596331,330.6074059,544.8832188,388.2407407,1073,50.78088027,2146,-521728,27648,-494080,-1
8456,1483,21,9,0.149210182,0.850789818,2601.839488,2889.937583,4506.241249,7614.33176,9939,550.9423503,19878,-4329472,759296,-3570176,-1
6661,392,21,9,0.0555791862,0.944420814,2027.060805,2153.666406,3547.306561,3181.943878,7053,535.9422492,14106,-3410432,200704,-3209728,-1
206,30,27,3,0.127118644,0.872881356,67.88671789,65.89675426,121.6116505,97.13333333,236,44.36090226,472,-105472,15360,-90112,-1
9492,472,27,3,0.0473705339,0.952629466,2858.352423,3081.331701,5027.389802,4079.758475,9964,1295.708713,19928,-4859904,241664,-4618240,-1
73,20,19,11,0.215053763,0.784946237,24.57313562,32.25565842,49.50684932,37.85,93,7.506053269,186,-37376,10240,-27136,-1
1312,122,24,6,0.0850767085,0.914923291,409.8434679,438.5536896,728.5746951,598.4016393,1434,107.3353293,2868,-671744,62464,-609280,-1
1173,169,22,8,0.125931446,0.874068554,386.4743653,372.9348659,688.5285592,553.3076923,1342,112.1136174,2684,-600576,86528,-514048,-1
9089,818,21,9,0.0825678813,0.917432119,2835.201734,3038.096809,4892.305314,5639.50489,9907,649.2136304,19814,-4653568,418816,-4234752,-1
9504,472,21,9,0.0473135525,0.952686447,2852.357024,3107.574607,5053.652673,3676.612288,9976,355.3972212,19952,-4866048,241664,-4624384,-1
9484,488,21,9,0.0489370237,0.951062976,2873.177753,2923.971137,5016.224905,4408.813525,9972,187.3379673,19944,-4855808,249856,-4605952,-1
199,46,20,10,0.187755102,0.812244898,67.4753193,82.89911479,121.2261307,130.673913,245,9.394171779,490,-101888,23552,-78336,-1
2416,179,20,10,0.0689788054,0.931021195,745.2050988,767.1657413,1314.211093,1079.195531,2595,76.82060391,5190,-1236992,91648,-1145344,-1
9445,522,20,10,0.0523728303,0.94762717,2856.118931,3225.560613,4997.578401,4738.314176,9967,377.5378788,19934,-4835840,267264,-4568576,-1
773,86,15,15,0.100116414,0.899883586,240.113103,232.9994815,451.545925,236.3372093,859,63.06901615,1718,-395776,44032,-351744,-1
671,89,20,10,0.117105263,0.882894737,209.1494097,270.5229838,391.6795827,296.2134831,760,69.27985415,1520,-343552,45568,-297984,-1
7068,649,20,10,0.0841000389,0.915899961,2200.743234,2487.545522,3883.092247,3596.620955,7717,253.2655071,15434,-3618816,332288,-3286528,-1
50,25,18,12,0.333333333,0.666666667,22.97641399,16.78160898,41.38,31.24,75,15.59251559,150,-25600,12800,-12800,-1
3503,367,22,8,0.0948320413,0.905167959,1086.350748,1360.08715,1914.005424,2140.66485,3870,232.0143885,7740,-1793536,187904,-1605632,-1
9593,388,17,13,0.0388738603,0.96112614,2860.178787,3161.171464,5036.247889,3872.280928,9981,1181.183432,19962,-4911616,198656,-4712960,-1
9297,649,20,10,0.0652523628,0.934747637,2841.200112,2824.956825,5084.708616,3380.423729,9946,732.9403095,19892,-4760064,332288,-4427776,-1
9289,668,20,10,0.0670884805,0.93291152,2841.149759,3295.115039,4993.19916,4781.550898,9957,417.3093043,19914,-4755968,342016,-4413952,-1
1001,257,20,10,0.204292528,0.795707472,377.4756962,300.5622387,632.9460539,616.077821,1258,36.00457928,2516,-512512,131584,-380928,-1
44,24,19,11,0.352941176,0.647058824,20.69470128,17.1868813,35.95454545,31.83333333,68,24.90842491,136,-22528,12288,-10240,-1
4923,495,17,13,0.0913621262,0.908637874,1534.516919,1830.403931,2702.260207,2781.50303,5418,180.7204803,10836,-2520576,253440,-2267136,-1
369,22,21,9,0.0562659847,0.943734015,110.1172871,148.2496011,197.8888889,164.3181818,391,71.09090909,782,-188928,11264,-177664,-1
5573,809,20,10,0.12676277,0.87323723,1864.241923,1605.412209,3122.706262,3665.402967,6382,133.0692244,12764,-2853376,414208,-2439168,-1
633,74,20,10,0.10466761,0.89533239,199.8727907,227.5349422,361.3917852,290.7702703,707,29.55685619,1414,-324096,37888,-286208,-1
9305,641,20,10,0.0644480193,0.935551981,2830.194981,3383.374841,4944.688017,5391.74571,9946,1271.867008,19892,-4764160,328192,-4435968,-1
1910,155,20,10,0.0750605327,0.924939467,589.0355985,585.5193085,1059.569634,705.5935484,2065,73.93483709,4130,-977920,79360,-898560,-1
2579,113,17,13,0.0419762259,0.958023774,770.3283699,863.1961375,1359.954634,1039.424779,2692,280.7090719,5384,-1320448,57856,-1262592,-1
9203,752,21,9,0.0755399297,0.92446007,2846.276377,2990.863023,5065.388678,3908.534574,9955,408.8295688,19910,-4711936,385024,-4326912,-1
5663,450,22,8,0.0736136103,0.92638639,1747.963935,1902.87125,3093.813173,2593.726667,6113,174.010817,12226,-2899456,230400,-2669056,-1
9670,317,25,5,0.0317412636,0.968258736,2877.293134,3029.232853,5005.981489,4628.507886,9987,336.4892183,19974,-4951040,162304,-4788736,-1
5094,487,21,9,0.0872603476,0.912739652,1612.010937,1533.097315,2748.708873,3233.36345,5581,205.7132326,11162,-2608128,249344,-2358784,-1
1380,101,20,10,0.0681971641,0.931802836,418.4182044,502.629587,754.2992754,559.2871287,1481,46.47003452,2962,-706560,51712,-654848,-1
9408,541,20,10,0.0543773244,0.945622676,2843.541993,3267.107379,5010.629783,4355.397412,9949,770.0464396,19898,-4816896,276992,-4539904,-1
5454,307,18,12,0.0532893595,0.946710641,1657.997205,1653.709376,2912.441144,2322.433225,5761,225.8330067,11522,-2792448,157184,-2635264,-1
4977,520,21,9,0.0945970529,0.905402947,1569.227537,1711.842972,2714.572835,3078.507692,5497,241.7326297,10994,-2548224,266240,-2281984,-1
6413,918,21,9,0.125221661,0.874778339,2018.993991,2324.880382,3482.235615,4949.748366,7331,221.8825666,14662,-3283456,470016,-2813440,-1
5829,349,18,12,0.0564907737,0.943509226,1764.071333,1948.951059,3131.820552,2382.661891,6178,186.590154,12356,-2984448,178688,-2805760,-1
3554,302,16,14,0.0783195021,0.921680498,1102.636739,1181.18126,1900.533202,2257.619205,3856,132.7823691,7712,-1819648,154624,-1665024,-1
2598,142,20,10,0.0518248175,0.948175182,779.8320373,971.4859632,1368.157429,1413.359155,2740,263.2084534,5480,-1330176,72704,-1257472,-1
5541,450,20,10,0.075112669,0.924887331,1693.503136,1992.139398,2938.734344,3701.131111,5991,177.8272484,11982,-2836992,230400,-2606592,-1
4737,224,21,9,0.0451521871,0.954847813,1422.872118,1594.185698,2493.024066,2226.723214,4961,149.6079614,9922,-2425344,114688,-2310656,-1
9489,484,19,11,0.0485310338,0.951468966,2875.117532,2951.927367,4982.64443,5072.392562,9973,438.9524648,19946,-4858368,247808,-4610560,-1
1040,91,19,11,0.0804597701,0.91954023,321.4066651,374.7576087,571.175,506.8571429,1131,53.88280133,2262,-532480,46592,-485888,-1
4035,360,20,10,0.0819112628,0.918088737,1270.676399,1194.725289,2228.443618,1856.777778,4395,86.22719247,8790,-2065920,184320,-1881600,-1
440,99,19,11,0.183673469,0.816326531,147.5152983,170.5209541,285.7704545,199.9090909,539,83.05084746,1078,-225280,50688,-174592,-1
8454,1477,23,7,0.148726211,0.851273789,2570.303081,3086.506894,4512.342205,7562.630332,9931,556.0470325,19862,-4328448,756224,-3572224,-1
139,23,27,3,0.141975309,0.858024691,47.17472399,42.70109768,79.74820144,92.08695652,162,5.680224404,324,-71168,11776,-59392,-1
9526,438,27,3,0.0439582497,0.95604175,2866.902917,3069.450197,4990.676045,4804.680365,9964,1040.083507,19928,-4877312,224256,-4653056,-1
658,91,18,12,0.121495327,0.878504673,204.7879925,269.6619928,362.8221884,463.0549451,749,32.27057303,1498,-336896,46592,-290304,-1
4160,309,21,9,0.069142985,0.930857015,1269.93151,1310.790215,2292.371875,1462.614887,4469,168.3239171,8938,-2129920,158208,-1971712,-1
6135,280,21,9,0.0436477007,0.956352299,1849.643291,1874.015422,3221.862429,2904.264286,6415,381.164587,12830,-3141120,143360,-2997760,-1
1539,163,21,9,0.0957696827,0.904230317,483.2741676,479.862626,880.899935,573.9141104,1702,36.64944014,3404,-787968,83456,-704512,-1
6793,363,22,8,0.0507266629,0.949273337,2053.786726,2273.770638,3585.918593,3439.672176,7156,191.9527897,14312,-3478016,185856,-3292160,-1
4021,234,20,10,0.0549941246,0.945005875,1208.249645,1370.237572,2166.834121,1460.683761,4255,357.2628044,8510,-2058752,119808,-1938944,-1
336,66,16,14,0.164179104,0.835820896,112.07359,131.8434946,206.2470238,177.3333333,402,33.16831683,804,-172032,33792,-138240,-1
629,49,17,13,0.0722713864,0.927728614,190.6113298,196.3539949,351.3863275,186.9183673,678,127.2045028,1356,-322048,25088,-296960,-1
6382,575,21,9,0.0826505678,0.917349432,1975.166355,2218.607601,3544.527107,2751.706087,6957,244.7923997,13914,-3267584,294400,-2973184,-1
61,27,19,11,0.306818182,0.693181818,26.22769461,23.11805451,45.90163934,41.33333333,88,20.6088993,176,-31232,13824,-17408,-1
4444,427,21,9,0.0876616711,0.912338329,1382.98912,1551.532445,2390.862511,2905.76815,4871,119.7688714,9742,-2275328,218624,-2056704,-1
2090,220,20,10,0.0952380952,0.904761905,652.1827019,783.3719647,1167.624402,1040.318182,2310,57.83675513,4620,-1070080,112640,-957440,-1
1148,70,20,10,0.0574712644,0.942528736,346.4086058,414.6699521,615.7578397,506.8714286,1218,36.74208145,2436,-587776,35840,-551936,-1
5255,582,16,14,0.0997087545,0.900291246,1673.817759,1745.234712,2957.237108,2573.749141,5837,333.5428571,11674,-2690560,297984,-2392576,-1
1824,124,21,9,0.0636550308,0.936344969,554.9177351,589.0543284,994.3667763,682.266129,1948,128.5808581,3896,-933888,63488,-870400,-1
371,61,15,15,0.141203704,0.858796296,120.4406507,123.5726331,228.9191375,140.9672131,432,89.07216495,864,-189952,31232,-158720,-1
1793,153,27,3,0.078622816,0.921377184,566.1583774,506.3232619,970.7858338,1005.30719,1946,113.3372161,3892,-918016,78336,-839680,-1
3503,292,18,12,0.0769433465,0.923056653,1082.386163,1074.579328,1947.927491,1299.041096,3795,72.4513173,7590,-1793536,149504,-1644032,-1
7999,632,20,10,0.0732244236,0.926775576,2406.287659,3162.374404,4223.061383,5492.291139,8631,395.0114416,17262,-4095488,323584,-3771904,-1
3266,426,18,12,0.115384615,0.884615385,1056.84482,1085.012432,1806.899265,2150.105634,3692,125.9208731,7384,-1672192,218112,-1454080,-1
3992,610,16,14,0.132551065,0.867448935,1292.273468,1505.363843,2252.246242,2623.829508,4602,95.31897266,9204,-2043904,312320,-1731584,-1
2310,187,21,9,0.0748898678,0.925110132,709.1542886,851.03061,1251.944156,1212.631016,2497,68.8447753,4994,-1182720,95744,-1086976,-1
7725,413,20,10,0.0507495699,0.94925043,2325.804176,2517.993628,4127.217605,2989.915254,8138,150.4251386,16276,-3955200,211456,-3743744,-1
4550,291,20,10,0.0601115472,0.939888453,1379.204513,1602.986772,2447.06022,2013.52921,4841,277.8989667,9682,-2329600,148992,-2180608,-1
5008,305,20,10,0.0574063618,0.942593638,1507.676034,1905.743551,2648.304513,2799.777049,5313,110.4803493,10626,-2564096,156160,-2407936,-1
8427,1091,20,10,0.114624921,0.885375079,2738.022269,2818.450308,4746.187611,4862.326306,9518,176.9802901,19036,-4314624,558592,-3756032,-1
1276,181,20,10,0.124227865,0.875772135,415.5720343,453.0621652,724.2601881,762.4143646,1457,84.95626822,2914,-653312,92672,-560640,-1
6658,385,21,9,0.0546642056,0.945335794,2007.436261,2434.335091,3518.598378,3580.825974,7043,130.0406204,14086,-3408896,197120,-3211776,-1
1417,143,18,12,0.0916666667,0.908333333,434.337734,475.0894454,813.4424841,454.0699301,1560,280.0718133,3120,-725504,73216,-652288,-1
300,56,17,13,0.157303371,0.842696629,98.81158698,108.7894413,187.8833333,128.2321429,356,44.05940594,712,-153600,28672,-124928,-1
1413,129,21,9,0.0836575875,0.916342412,441.4153591,482.8288268,768.5194621,804.1472868,1542,146.8571429,3084,-723456,66048,-657408,-1
1716,109,19,11,0.0597260274,0.940273973,515.5396167,552.2994074,937.469697,527.7706422,1825,64.1025641,3650,-878592,55808,-822784,-1
8651,585,27,3,0.0633391078,0.936660892,2649.426055,2894.438768,4603.909259,4834.268376,9236,202.7216857,18472,-4429312,299520,-4129792,-1
9444,528,19,11,0.0529482551,0.947051745,2866.07695,2964.336155,5034.958492,4119.753788,9972,314.0787402,19944,-4835328,270336,-4564992,-1
3543,259,22,8,0.068122041,0.931877959,1103.751433,907.3163586,1932.61558,1475.853282,3802,246.8831169,7604,-1814016,132608,-1681408,-1
9454,509,27,3,0.0510890294,0.948910971,2848.99273,3007.34132,5058.128305,3568.017682,9963,1045.435467,19926,-4840448,260608,-4579840,-1
1177,63,20,10,0.0508064516,0.949193548,355.6798611,373.0719796,627.7468139,485.1111111,1240,63.98348813,2480,-602624,32256,-570368,-1
3235,343,22,8,0.095863611,0.904136389,1018.575678,1139.9579,1768.330139,1989.163265,3578,104.77306,7156,-1656320,175616,-1480704,-1
9584,397,27,3,0.0397755736,0.960224426,2878.281601,2903.480742,5012.727462,4466.476071,9981,958.7896254,19962,-4907008,203264,-4703744,-1
5850,270,20,10,0.0441176471,0.955882353,1750.889872,2078.422941,3063.903932,2986.748148,6120,434.6590909,12240,-2995200,138240,-2856960,-1
9472,492,20,10,0.0493777599,0.95062224,2866.558234,3000.377937,5012.665118,4401.760163,9964,871.7410324,19928,-4849664,251904,-4597760,-1
172,23,23,7,0.117948718,0.882051282,53.67653802,72.74771903,97.35465116,102.826087,195,5.595408895,390,-88064,11776,-76288,-1
9572,412,20,10,0.0412660256,0.958733974,2879.293703,2848.941673,5024.324488,4253.121359,9984,531.0638298,19968,-4900864,210944,-4689920,-1
9055,860,20,10,0.0867372668,0.913262733,2875.969243,2673.779037,4999.801215,4517.872093,9915,647.1932115,19830,-4636160,440320,-4195840,-1
38,15,18,12,0.283018868,0.716981132,14.77551317,15.42494372,29,21.93333333,53,12.3255814,106,-19456,7680,-11776,-1
3570,306,22,8,0.0789473684,0.921052632,1096.426248,1351.911943,1932.538655,2008.04902,3876,138.2310984,7752,-1827840,156672,-1671168,-1
8907,919,22,8,0.0935273763,0.906472624,2843.852746,2760.280448,4928.433367,4768.764962,9826,185.9224219,19652,-4560384,470528,-4089856,-1
176,84,23,7,0.323076923,0.676923077,78.0160571,68.07138693,133.2727273,124.6904762,260,33.41902314,520,-90112,43008,-47104,-1
9475,487,22,8,0.0488857659,0.951114234,2861.869617,2953.901501,5034.01562,3959.76386,9962,515.098242,19924,-4851200,249344,-4601856,-1
131,21,18,12,0.138157895,0.861842105,42.17916948,45.1951676,80.69465649,50.33333333,152,14.16589003,304,-67072,10752,-56320,-1
9346,613,20,10,0.0615523647,0.938447635,2863.953775,2709.273861,5067.215172,3650.288744,9959,1110.25641,19918,-4785152,313856,-4471296,-1
9602,384,20,10,0.0384538354,0.961546165,2868.80081,3129.785989,5021.637471,4289.916667,9986,677.0169492,19972,-4916224,196608,-4719616,-1
2238,114,17,13,0.0484693878,0.951530612,670.5416405,760.5544794,1192.652815,859.3947368,2352,201.888412,4704,-1145856,58368,-1087488,-1
8611,975,20,10,0.101710828,0.898289172,2742.889154,2914.504172,4730.166996,5352.844103,9586,199.2931393,19172,-4408832,499200,-3909632,-1
1137,46,24,6,0.0388841927,0.961115807,338.5723726,384.8468848,597.2875989,461.3043478,1183,121.3333333,2366,-582144,23552,-558592,-1
9387,551,21,9,0.0554437513,0.944556249,2850.226003,2937.751,5037.356877,3813.470054,9938,575.1157407,19876,-4806144,282112,-4524032,-1
9433,521,20,10,0.0523407675,0.947659232,2865.66123,2962.206455,5006.644546,4449.821497,9954,1212.423873,19908,-4829696,266752,-4562944,-1
7651,1610,19,11,0.173847317,0.826152683,2722.423125,2379.19153,4539.252647,5066.999379,9261,179.8951049,18522,-3917312,824320,-3092992,-1
3711,374,21,9,0.0915544676,0.908445532,1157.721213,1374.604257,2043.137968,2041.631016,4085,144.1425547,8170,-1900032,191488,-1708544,-1
9297,645,21,9,0.0648762824,0.935123718,2861.420981,2889.886712,5023.246101,4225.634109,9942,514.8627654,19884,-4760064,330240,-4429824,-1
2589,270,22,8,0.0944386149,0.905561385,825.0691917,814.9997861,1444.359212,1292.311111,2859,79.10902048,5718,-1325568,138240,-1187328,-1
4148,229,21,9,0.0523189399,0.94768106,1252.819935,1441.333603,2193.585583,2105.938865,4377,87.82102729,8754,-2123776,117248,-2006528,-1
9414,540,22,8,0.0542495479,0.945750452,2882.08244,2698.569423,4996.054706,4654.02963,9954,805.9919028,19908,-4819968,276480,-4543488,-1
6813,442,21,9,0.060923501,0.939076499,2061.728145,2517.779743,3604.807867,3985.484163,7255,256.1793785,14510,-3488256,226304,-3261952,-1
1675,186,17,13,0.0999462654,0.900053735,527.6623644,562.9232503,957.5313433,692.0752688,1861,96.52489627,3722,-857600,95232,-762368,-1
8630,1248,22,8,0.126341365,0.873658635,2867.020607,2513.783932,4791.450058,5963.27484,9878,232.4782302,19756,-4418560,638976,-3779584,-1
6764,550,21,9,0.0751982499,0.92480175,2100.46712,2187.149878,3619.271881,4127.636364,7314,222.1075008,14628,-3463168,281600,-3181568,-1
9614,368,22,8,0.0368663594,0.963133641,2872.947848,3066.032966,5008.164656,4556.13587,9982,522.0711297,19964,-4922368,188416,-4733952,-1
3006,367,20,10,0.108805218,0.891194782,961.4490486,1059.629463,1703.086161,1555.242507,3373,65.21655066,6746,-1539072,187904,-1351168,-1
4606,263,23,7,0.0540151982,0.945984802,1384.879236,1703.997317,2419.037343,2714.558935,4869,388.277512,9738,-2358272,134656,-2223616,-1
160,33,19,11,0.170984456,0.829015544,54.45844137,51.6622321,103.24375,66.72727273,193,28.76304024,386,-81920,16896,-65024,-1
59,38,18,12,0.391752577,0.608247423,27.73914067,28.396883,49.22033898,48.65789474,97,8.449477352,194,-30208,19456,-10752,-1
4598,467,20,10,0.092201382,0.907798618,1452.675063,1550.201336,2525.290996,2608.901499,5065,100.2374827,10130,-2354176,239104,-2115072,-1
5892,816,16,14,0.121645796,0.878354204,1913.245963,2094.703161,3364.975221,3278.862745,6708,128.3336522,13416,-3016704,417792,-2598912,-1
4458,644,20,10,0.12622501,0.87377499,1366.434464,1623.537448,2379.402198,3742.822981,5102,94.93859323,10204,-2282496,329728,-1952768,-1
4732,740,16,14,0.135233918,0.864766082,1531.908817,1802.108587,2671.928994,3149.405405,5472,115.2242577,10944,-2422784,378880,-2043904,-1
9527,462,21,9,0.046250876,0.953749124,2882.091793,2794.189219,5034.167104,4187.32684,9989,412.257532,19978,-4877824,236544,-4641280,-1
4120,273,20,10,0.0621443205,0.937855679,1256.8673,1245.381566,2241.789078,1521.062271,4393,83.24805761,8786,-2109440,139776,-1969664,-1
7561,337,21,9,0.0426690301,0.95733097,2261.289478,2649.713632,3961.76802,3674.252226,7898,747.9166667,15796,-3871232,172544,-3698688,-1
9127,633,21,9,0.0648565574,0.935143443,2800.999938,3043.322234,4873.621891,4979.672986,9760,192.353173,19520,-4673024,324096,-4348928,-1
1817,132,20,10,0.0677270395,0.93227296,558.503863,568.8212335,991.6929004,745.219697,1949,153.9494471,3898,-930304,67584,-862720,-1
1032,111,17,13,0.0971128609,0.902887139,320.0775919,404.1324642,579.4021318,503.1801802,1143,104.0983607,2286,-528384,56832,-471552,-1
3164,340,21,9,0.0970319635,0.902968037,991.9201027,1176.101039,1759.95196,1683.152941,3504,122.6890756,7008,-1619968,174080,-1445888,-1
6212,511,25,5,0.0760077346,0.923992265,1911.39429,2176.650247,3412.262556,2750.980431,6723,456.7255435,13446,-3180544,261632,-2918912,-1
1570,158,20,10,0.0914351852,0.908564815,490.1099895,574.6127802,858.1751592,927.3481013,1728,75.06516073,3456,-803840,80896,-722944,-1
9563,415,27,3,0.0415915013,0.958408499,2863.34123,3043.702834,5037.761581,3877.390361,9978,837.7833753,19956,-4896256,212480,-4683776,-1
2258,127,17,13,0.0532494759,0.946750524,674.3696735,847.2025013,1210.168733,887.7480315,2385,432.8493648,4770,-1156096,65024,-1091072,-1
2789,439,20,10,0.135997522,0.864002478,923.7832308,975.9866653,1599.294012,1711.104784,3228,192.0285544,6456,-1427968,224768,-1203200,-1
9255,662,19,11,0.0667540587,0.933245941,2808.80395,3511.604428,4932.694976,5326.753776,9917,1083.825137,19834,-4738560,338944,-4399616,-1
91,34,20,10,0.272,0.728,35.06268818,38.654053,63.47252747,61.73529412,125,28.40909091,250,-46592,17408,-29184,-1
3615,290,20,10,0.0742637644,0.925736236,1115.888399,1259.348332,1948.615768,2007.651724,3905,276.5580737,7810,-1850880,148480,-1702400,-1
960,124,23,7,0.114391144,0.885608856,302.6112768,381.3923701,537.63125,580.1935484,1084,20.63189951,2168,-491520,63488,-428032,-1
9610,376,17,13,0.0376527138,0.962347286,2866.068799,3147.343107,5028.872633,4089.428191,9986,1047.848898,19972,-4920320,192512,-4727808,-1
5793,419,21,9,0.0674500966,0.932549903,1765.817899,2123.990089,3122.769204,2881.565632,6212,223.4532374,12424,-2966016,214528,-2751488,-1
9205,745,22,8,0.0748743719,0.925125628,2834.061736,3206.024647,5039.16654,4188.855034,9950,1093.406593,19900,-4712960,381440,-4331520,-1
2203,177,22,8,0.0743697479,0.925630252,671.8979507,843.1914655,1180.336813,1316.99435,2380,129.1372762,4760,-1127936,90624,-1037312,-1
8099,568,20,10,0.0655359409,0.934464059,2488.737181,2679.260839,4343.907149,4192.735915,8667,258.2538737,17334,-4146688,290816,-3855872,-1
44,14,20,10,0.24137931,0.75862069,16.33659382,16.50803762,31.45454545,23.35714286,58,11.0056926,116,-22528,7168,-15360,-1
292,43,21,9,0.128358209,0.871641791,93.17281944,97.7917457,177.0616438,106.4651163,335,39.64497041,670,-149504,22016,-127488,-1
1249,111,22,8,0.0816176471,0.918382353,389.1785443,429.0279778,679.4603683,692.1981982,1360,103.1866464,2720,-639488,56832,-582656,-1
8166,1350,21,9,0.14186633,0.85813367,2814.504098,2292.127415,4735.517022,4897.521481,9516,178.4696174,19032,-4180992,691200,-3489792,-1
9558,418,20,10,0.0419005613,0.958099439,2865.451663,3137.020689,5013.478343,4417.344498,9976,1275.703325,19952,-4893696,214016,-4679680,-1
425,103,18,12,0.195075758,0.804924242,146.9116779,173.3073595,264.4352941,264.7669903,528,25.69343066,1056,-217600,52736,-164864,-1
4708,717,22,8,0.132165899,0.867834101,1533.398559,1635.555622,2618.648046,3332.538354,5425,122.8765572,10850,-2410496,367104,-2043392,-1
9366,585,16,14,0.0587880615,0.941211938,2852.14055,3063.009036,5028.324365,4138.273504,9951,822.3966942,19902,-4795392,299520,-4495872,-1
3471,166,22,8,0.0456420126,0.954357987,1037.617394,1162.21543,1844.081533,1294.554217,3637,545.2773613,7274,-1777152,84992,-1692160,-1
1768,239,19,11,0.119083209,0.880916791,572.1938082,627.8289712,997.479638,1052.23431,2007,157.7830189,4014,-905216,122368,-782848,-1
1656,90,27,3,0.0515463918,0.948453608,499.1507986,555.5780139,883.455314,690.3222222,1746,120.5801105,3492,-847872,46080,-801792,-1
4410,490,21,9,0.1,0.9,1404.116728,1502.87184,2458.537868,2378.159184,4900,96.49468295,9800,-2257920,250880,-2007040,-1
903,99,20,10,0.0988023952,0.901197605,287.5892782,295.7274402,508.8316722,434.6262626,1002,19.57413557,2004,-462336,50688,-411648,-1
264,55,16,14,0.172413793,0.827586207,88.14287375,96.50330187,169.625,113.8,319,29.81308411,638,-135168,28160,-107008,-1
5430,692,20,10,0.113034956,0.886965044,1763.694919,1682.724092,3136.521731,2472.817919,6122,292.0801527,12244,-2780160,354304,-2425856,-1
7179,459,22,8,0.0600942655,0.939905734,2216.582343,1982.820255,3841.165901,3480.633987,7638,145.5688965,15276,-3675648,235008,-3440640,-1
9477,489,21,9,0.0490668272,0.950933173,2856.42701,2988.570637,5047.623826,3740.756646,9966,991.641791,19932,-4852224,250368,-4601856,-1
5730,508,20,10,0.0814363578,0.918563642,1801.5603,1785.152523,3106.544328,3265.633858,6238,123.4758511,12476,-2933760,260096,-2673664,-1
2378,177,22,8,0.0692759295,0.93072407,721.9198141,850.4977003,1303.633305,933.6158192,2555,397.3561431,5110,-1217536,90624,-1126912,-1
2097,306,20,10,0.127340824,0.872659176,674.2114024,759.8593821,1161.93753,1476.545752,2403,58.26867119,4806,-1073664,156672,-916992,-1
6866,425,20,10,0.0582910438,0.941708956,2077.810367,2443.722071,3677.620157,3135.167059,7291,196.7350243,14582,-3515392,217600,-3297792,-1
9434,540,22,8,0.054140766,0.945859234,2858.529759,3044.266461,5045.861777,3967.898148,9974,391.2907022,19948,-4830208,276480,-4553728,-1
1054,129,22,8,0.109044801,0.890955199,336.1374505,381.5390079,588.8216319,617.9689922,1183,30.55268595,2366,-539648,66048,-473600,-1
9523,463,21,9,0.0463649109,0.953635089,2843.635032,3256.208516,5065.651055,3509.4946,9986,772.9102167,19972,-4875776,237056,-4638720,-1
471,75,25,5,0.137362637,0.862637363,152.9545092,182.4214286,277.2929936,249.68,546,9.989023052,1092,-241152,38400,-202752,-1
1005,226,22,8,0.183590577,0.816409423,350.6620971,375.4324266,614.2189055,623.920354,1231,35.39390454,2462,-514560,115712,-398848,-1
7749,416,21,9,0.0509491733,0.949050827,2333.510578,2605.389053,4130.437089,3199.370192,8165,352.0914187,16330,-3967488,212992,-3754496,-1
9071,391,22,8,0.0413231875,0.958676813,2716.29852,2915.80312,4770.934627,3816.636829,9462,1152.496955,18924,-4644352,200192,-4444160,-1
9250,671,19,11,0.0676343111,0.932365689,2839.077527,3179.8692,4946.019892,5167.506706,9921,1030.218069,19842,-4736000,343552,-4392448,-1
9622,368,21,9,0.0368368368,0.963163163,2864.667008,3204.594142,5031.750572,4047.665761,9990,842.3271501,19980,-4926464,188416,-4738048,-1
8225,679,22,8,0.0762578616,0.923742138,2538.518144,2928.606902,4454.746869,4425.282769,8904,399.8203862,17808,-4211200,347648,-3863552,-1
734,114,27,3,0.134433962,0.865566038,242.7745789,219.787145,443.8678474,299.7982456,848,150.0884956,1696,-375808,58368,-317440,-1
9481,487,21,9,0.0488563403,0.95114366,2855.154968,3249.231572,5007.885455,4529.227926,9968,977.254902,19936,-4854272,249344,-4604928,-1
6384,431,22,8,0.0632428467,0.936757153,1958.04307,2038.297437,3441.005639,2919.118329,6815,209.4989241,13630,-3268608,220672,-3047936,-1
9606,374,19,11,0.0374749499,0.96252505,2872.543727,3057.365529,5007.535811,4552.94385,9980,661.3651425,19960,-4918272,191488,-4726784,-1
417,87,19,11,0.172619048,0.827380952,137.9824471,161.4982885,266.3021583,186.3448276,504,63.95939086,1008,-213504,44544,-168960,-1
1466,187,20,10,0.113127647,0.886872353,464.3373977,567.6121683,824.8888131,843.5508021,1653,97.0640047,3306,-750592,95744,-654848,-1
2788,140,22,8,0.0478142077,0.952185792,838.19086,918.8166883,1480.49462,1145.978571,2928,386.7899604,5856,-1427456,71680,-1355776,-1
284,44,26,4,0.134146341,0.865853659,92.82844213,98.75749788,170.0070423,128.9545455,328,26.19808307,656,-145408,22528,-122880,-1
278,19,17,13,0.063973064,0.936026936,83.13659726,84.24430244,154.4028777,69.94736842,297,17.12802768,594,-142336,9728,-132608,-1
639,61,21,9,0.0871428571,0.912857143,197.1477915,241.0379308,345.2378717,405.6229508,700,58.92255892,1400,-327168,31232,-295936,-1
3488,505,25,5,0.126471325,0.873528675,1170.279255,1022.848689,1998.180333,1988.847525,3993,75.12699906,7986,-1785856,258560,-1527296,-1
1151,73,20,10,0.0596405229,0.940359477,348.4590008,421.2157061,610.1859253,648.9863014,1224,106.25,2448,-589312,37376,-551936,-1
5094,187,20,10,0.0354099602,0.96459004,1517.78812,1658.885222,2653.892422,2289.802139,5281,1037.524558,10562,-2608128,95744,-2512384,-1
927,149,22,8,0.138475836,0.861524164,303.5832064,346.9726598,546.6148867,488.0134228,1076,126.5882353,2152,-474624,76288,-398336,-1
2469,142,23,7,0.054385293,0.945614707,745.6186453,786.5679435,1328.433779,915.9366197,2611,179.2038435,5222,-1264128,72704,-1191424,-1
2539,231,26,4,0.0833935018,0.916606498,789.1156642,776.2154434,1426.402521,935.9264069,2770,174.5431632,5540,-1299968,118272,-1181696,-1
259,67,17,13,0.205521472,0.794478528,92.86611745,94.6415945,170.007722,138.3432836,326,26.98675497,652,-132608,34304,-98304,-1
6981,523,21,9,0.069696162,0.930303838,2138.034575,2255.192204,3832.504512,2684.600382,7504,235.678392,15008,-3574272,267776,-3306496,-1
3506,417,21,9,0.106296202,0.893703798,1120.31258,1213.934151,1939.745009,2149.11271,3923,77.99204771,7846,-1795072,213504,-1581568,-1
9198,731,22,8,0.0736227213,0.926377279,2847.664224,3074.65115,4940.982387,5267.207934,9929,838.597973,19858,-4709376,374272,-4335104,-1
1459,140,20,10,0.0875547217,0.912445278,454.5969406,515.5950189,810.8498972,686.9285714,1599,36.97964847,3198,-747008,71680,-675328,-1
4997,369,21,9,0.0687663064,0.931233694,1522.688704,1786.845786,2722.688813,2152.804878,5366,370.8362129,10732,-2558464,188928,-2369536,-1
1844,179,17,13,0.0884824518,0.911517548,579.0457797,604.6176398,1029.267896,834.1117318,2023,56.38238573,4046,-944128,91648,-852480,-1
5386,439,22,8,0.0753648069,0.924635193,1650.604738,1987.401785,2883.449127,3275.553531,5825,212.8242601,11650,-2757632,224768,-2532864,-1
9400,535,27,3,0.0538500252,0.946149975,2843.075377,3169.698699,5013.589468,4166.988785,9935,1082.244009,19870,-4812800,273920,-4538880,-1
123,17,22,8,0.121428571,0.878571429,37.87051388,55.2426544,71.10569106,66.11764706,140,12.93900185,280,-62976,8704,-54272,-1
829,79,27,3,0.0870044053,0.912995595,255.7390415,321.2586323,453.3606755,466.4556962,908,39.98238661,1816,-424448,40448,-384000,-1
306,40,23,7,0.115606936,0.884393064,96.18280245,104.6922842,181.8039216,109.975,346,12.84812477,692,-156672,20480,-136192,-1
1864,188,21,9,0.0916179337,0.908382066,573.620922,750.9170787,1032.319742,968.7978723,2052,57.786539,4104,-954368,96256,-858112,-1
9577,399,20,10,0.0399959904,0.96000401,2863.216836,3059.374678,5033.638509,3905.062657,9976,937.593985,19952,-4903424,204288,-4699136,-1
2467,414,21,9,0.143700104,0.856299896,819.2629317,900.6008399,1432.951358,1488.961353,2881,141.4334806,5762,-1263104,211968,-1051136,-1
3068,731,19,11,0.192419058,0.807580942,1068.394579,1193.947835,1860.412321,2066.149111,3799,81.12321162,7598,-1570816,374272,-1196544,-1
9573,408,20,10,0.0408776676,0.959122332,2856.209123,3186.269716,5042.504126,3782.546569,9981,807.5242718,19962,-4901376,208896,-4692480,-1
78,28,18,12,0.264150943,0.735849057,31.00372186,27.15645806,57,43.75,106,26.83544304,212,-39936,14336,-25600,-1
7424,809,22,8,0.0982630876,0.901736912,2373.651664,2347.256194,4170.784617,3623.431397,8233,257.4421513,16466,-3801088,414208,-3386880,-1
3220,204,21,9,0.0595794393,0.940420561,972.5564294,1204.637686,1704.498447,1838.79902,3424,78.83951186,6848,-1648640,104448,-1544192,-1
9071,840,21,9,0.0847543134,0.915245687,2838.636297,2913.989977,5047.830449,3964.340476,9911,491.1298315,19822,-4644352,430080,-4214272,-1
2461,283,19,11,0.103134111,0.896865889,783.7251312,853.0411767,1385.786672,1256.957597,2744,51.51116951,5488,-1260032,144896,-1115136,-1
6967,784,22,8,0.101148239,0.898851761,2208.372188,2461.069934,3842.051529,4177.682398,7751,153.7896825,15502,-3567104,401408,-3165696,-1
4733,520,20,10,0.0989910527,0.901008947,1518.623973,1492.908695,2616.794422,2719.890385,5253,118.0980216,10506,-2423296,266240,-2157056,-1
9549,427,20,10,0.0428027265,0.957197273,2867.808639,2978.930821,5031.446225,4028.093677,9976,272.7919059,19952,-4889088,218624,-4670464,-1
4610,433,21,9,0.0858615903,0.91413841,1438.769089,1603.975723,2498.057484,2776.907621,5043,150.8074163,10086,-2360320,221696,-2138624,-1
1801,141,20,10,0.0726055613,0.927394439,554.6028956,572.1307339,991.7967796,712.248227,1942,53.95943318,3884,-922112,72192,-849920,-1
8542,667,20,10,0.0724291454,0.927570855,2668.014166,2472.738862,4646.02037,4079.668666,9209,317.3328739,18418,-4373504,341504,-4032000,-1
5366,1229,22,8,0.186353298,0.813646702,1649.010754,1763.19605,2861.299292,5204.701383,6595,146.1657801,13190,-2747392,629248,-2118144,-1
2915,253,21,9,0.0798611111,0.920138889,909.4879942,970.5480155,1583.327273,1598.011858,3168,245.3911696,6336,-1492480,129536,-1362944,-1
1356,108,20,10,0.0737704918,0.926229508,414.2775204,510.7141786,738.1548673,661.5,1464,109.2537313,2928,-694272,55296,-638976,-1
1975,250,17,13,0.112359551,0.887640449,629.3022267,734.6643576,1119.967089,1057.96,2225,133.2335329,4450,-1011200,128000,-883200,-1
72,19,21,9,0.208791209,0.791208791,24.06914791,32.02016332,48.15277778,37.84210526,91,7.640638119,182,-36864,9728,-27136,-1
6537,283,20,10,0.0414956012,0.958504399,1959.553574,2148.862816,3423.509408,3109.996466,6820,130.6263168,13640,-3346944,144896,-3202048,-1
288,49,18,12,0.145400593,0.854599407,92.17989369,82.83842153,183.3159722,84.85714286,337,60.17857143,674,-147456,25088,-122368,-1
6117,318,21,9,0.0494172494,0.950582751,1848.043959,2012.902265,3232.505967,2938.965409,6435,165.466701,12870,-3131904,162816,-2969088,-1
1183,114,20,10,0.0878951426,0.912104857,360.8043114,485.4237763,657.4167371,561.6578947,1297,23.72850348,2594,-605696,58368,-547328,-1
9467,497,22,8,0.0498795664,0.950120434,2869.629213,2762.981247,5042.525615,3839.114688,9964,420.599409,19928,-4847104,254464,-4592640,-1
4931,1007,21,9,0.169585719,0.830414281,1620.471051,1872.027889,2786.826202,3864.002979,5938,114.8771523,11876,-2524672,515584,-2009088,-1
2785,541,22,8,0.162657847,0.837342153,900.9096717,1169.880059,1601.763375,1981.312384,3326,197.8584176,6652,-1425920,276992,-1148928,-1
1705,115,27,3,0.0631868132,0.936813187,515.4942856,654.6358655,911.3695015,897.6086957,1820,85.36585366,3640,-872960,58880,-814080,-1
2506,252,21,9,0.0913705584,0.908629442,789.3327722,829.6984978,1401.612929,1159.599206,2758,51.9984917,5516,-1283072,129024,-1154048,-1
642,95,18,12,0.12890095,0.87109905,200.7072028,263.0450356,355.376947,461.0631579,737,29.75373436,1474,-328704,48640,-280064,-1
5423,316,22,8,0.0550618575,0.944938143,1649.965701,1751.681505,2883.736862,2634.256329,5739,122.2364217,11478,-2776576,161792,-2614784,-1
3817,278,27,3,0.0678876679,0.932112332,1166.726362,1372.606762,2040.979827,2144.388489,4095,245.0628366,8190,-1954304,142336,-1811968,-1
2207,114,27,3,0.04911676,0.95088324,663.458499,786.2297445,1160.770729,1165.438596,2321,177.0404272,4642,-1129984,58368,-1071616,-1
4003,702,21,9,0.149202976,0.850797024,1303.279223,1318.157863,2196.089183,3247.749288,4705,217.9249653,9410,-2049536,359424,-1690112,-1
9579,404,21,9,0.040468797,0.959531203,2870.238517,2997.418049,5031.264955,4061.012376,9983,753.4339623,19966,-4904448,206848,-4697600,-1
9468,488,22,8,0.0490156689,0.950984331,2838.733784,3131.037656,5055.896493,3476.881148,9956,661.9680851,19912,-4847616,249856,-4597760,-1
3319,234,19,11,0.0658598368,0.934140163,1024.047333,1047.708414,1779.413378,1742.769231,3553,454.9295775,7106,-1699328,119808,-1579520,-1
1977,437,23,7,0.181027341,0.818972659,679.663998,755.0075589,1177.376328,1343.78032,2414,55.2908841,4828,-1012224,223744,-788480,-1
331,39,18,12,0.105405405,0.894594595,101.7298388,111.9934369,195.3776435,101.6666667,370,43.73522459,740,-169472,19968,-149504,-1
2343,334,19,11,0.12476653,0.87523347,756.7476039,868.8621921,1323.035851,1450.988024,2677,49.94402985,5354,-1199616,171008,-1028608,-1
5484,283,19,11,0.049072308,0.950927692,1638.416723,1987.613665,2919.903355,2188.261484,5767,492.0648464,11534,-2807808,144896,-2662912,-1
1893,241,18,12,0.112933458,0.887066542,599.9866507,680.8625221,1099.03962,819.7634855,2134,100.8030231,4268,-969216,123392,-845824,-1
98,18,22,8,0.155172414,0.844827586,31.24845019,43.57142568,59.06122449,55.44444444,116,3.085927108,232,-50176,9216,-40960,-1
3484,407,26,4,0.10460036,0.89539964,1115.928171,1166.196882,1968.571757,1752.781327,3891,105.7911909,7782,-1783808,208384,-1575424,-1
3100,271,20,10,0.0803915752,0.919608425,953.9358915,1158.959807,1699.713226,1529.132841,3371,279.0562914,6742,-1587200,138752,-1448448,-1
4751,340,21,9,0.0667845217,0.933215478,1453.775673,1671.455774,2537.713955,2661.785294,5091,449.7349823,10182,-2432512,174080,-2258432,-1
1979,142,17,13,0.0669495521,0.933050448,607.4419167,674.6297141,1064.100556,1017.788732,2121,121.8265365,4242,-1013248,72704,-940544,-1
5595,939,20,10,0.143709826,0.856290174,1926.327169,1616.267545,3238.882752,3438.014909,6534,191.1644236,13068,-2864640,480768,-2383872,-1
1934,108,21,9,0.0528893242,0.947110676,580.2645411,680.3733333,1036.628749,750.5833333,2042,46.89940285,4084,-990208,55296,-934912,-1
2654,173,22,8,0.0611956137,0.938804386,807.8386084,870.7553992,1435.250565,1087.99422,2827,254.2266187,5654,-1358848,88576,-1270272,-1
9452,497,27,3,0.0499547693,0.950045231,2860.231845,3087.320391,4972.155946,5029.088531,9949,631.6825397,19898,-4839424,254464,-4584960,-1
2937,188,19,11,0.06016,0.93984,898.5993241,860.3150173,1588.767109,1160.457447,3125,165.6067833,6250,-1503744,96256,-1407488,-1
5188,399,21,9,0.0714157866,0.928584213,1589.299092,1869.23044,2772.161527,3077.954887,5587,177.4777637,11174,-2656256,204288,-2451968,-1
3309,289,20,10,0.0803224013,0.919677599,1038.970573,1008.735226,1818.909338,1577.266436,3598,121.3081591,7196,-1694208,147968,-1546240,-1
6362,396,27,3,0.0585972181,0.941402782,1944.798466,1918.418077,3336.568375,4069.224747,6758,183.8911565,13516,-3257344,202752,-3054592,-1
43,16,23,7,0.271186441,0.728813559,16.74173109,17.73579978,29.60465116,31.0625,59,6.455142232,118,-22016,8192,-13824,-1
2223,267,21,9,0.107228916,0.892771084,692.5360376,887.9909328,1267.263158,1064.303371,2490,251.0080645,4980,-1138176,136704,-1001472,-1
6301,704,22,8,0.100499643,0.899500357,2031.32413,1916.209722,3533.92525,3226.210227,7005,149.455942,14010,-3226112,360448,-2865664,-1
1695,100,19,11,0.0557103064,0.944289694,512.215272,606.8265795,894.2430678,961.68,1795,286.2838915,3590,-867840,51200,-816640,-1
2543,303,22,8,0.106465214,0.893534786,811.6785879,886.9735134,1440.887141,1277.574257,2846,170.6235012,5692,-1302016,155136,-1146880,-1
8507,658,21,9,0.0717948718,0.928205128,2612.046959,3046.652052,4577.339368,4656.183891,9165,298.8262145,18330,-4355584,336896,-4018688,-1
9523,451,20,10,0.0452175657,0.954782434,2849.90303,3197.93309,5046.271343,3746.525499,9974,293.4392468,19948,-4875776,230912,-4644864,-1
7487,380,27,3,0.048303038,0.951696962,2261.157235,2324.952804,3973.351142,3158.678947,7867,190.4381506,15734,-3833344,194560,-3638784,-1
5269,320,17,13,0.057255323,0.942744677,1587.384332,1969.054458,2813.392484,2492.15625,5589,274.9139203,11178,-2697728,163840,-2533888,-1
9481,486,21,9,0.048760911,0.951239089,2863.44672,3112.474261,5002.299019,4627.018519,9967,616.769802,19934,-4854272,248832,-4605440,-1
5104,284,21,9,0.0527097253,0.947290275,1539.765725,1812.19296,2697.842281,2634.433099,5388,251.1888112,10776,-2613248,145408,-2467840,-1
6362,622,17,13,0.0890607102,0.91093929,2000.201854,2153.367663,3465.928953,3764.276527,6984,261.475103,13968,-3257344,318464,-2938880,-1
3414,274,21,9,0.0742950108,0.925704989,1050.281196,1229.486144,1844.124194,1849.182482,3688,74.29492345,7376,-1747968,140288,-1607680,-1
1587,157,25,5,0.0900229358,0.909977064,499.6452405,513.9356098,888.2640202,713.1528662,1744,163.9097744,3488,-812544,80384,-732160,-1
241,50,17,13,0.171821306,0.828178694,81.69708205,91.97583161,149.9585062,126.92,291,21.19446468,582,-123392,25600,-97792,-1
9205,724,21,9,0.0729177158,0.927082284,2822.279843,3229.234256,5039.508637,4017.690608,9929,867.1615721,19858,-4712960,370688,-4342272,-1
9406,419,27,3,0.0426463104,0.95735369,2822.646327,2981.007668,4953.975548,3993.152745,9825,1475.225225,19650,-4815872,214528,-4601344,-1
5003,459,20,10,0.084035152,0.915964848,1556.573709,1781.211519,2735.670598,2686.041394,5462,171.923198,10924,-2561536,235008,-2326528,-1
977,213,21,9,0.178991597,0.821008403,334.7501167,381.089207,593.8024565,603.286385,1190,56.93779904,2380,-500224,109056,-391168,-1
84,29,18,12,0.256637168,0.743362832,31.73538016,31.39139593,61.64285714,43.55172414,113,2.895208814,226,-43008,14848,-28160,-1
9431,525,20,10,0.0527320209,0.947267979,2852.995391,2932.054617,5051.778496,3662.139048,9956,561.2175874,19912,-4828672,268800,-4559872,-1
9566,408,21,9,0.0409063565,0.959093643,2872.587897,2909.430376,5023.019862,4154.698529,9974,698.4593838,19948,-4897792,208896,-4688896,-1
856,82,20,10,0.0874200426,0.912579957,260.890454,346.8429219,477.6296729,384.6341463,938,18.3203125,1876,-438272,41984,-396288,-1
8140,1667,20,10,0.169980626,0.830019374,2810.259384,2795.36842,4739.957617,5705.022795,9807,211.4489004,19614,-4167680,853504,-3314176,-1
3184,177,19,11,0.0526628979,0.947337102,964.8392765,1043.809567,1691.782977,1487.028249,3361,111.4759536,6722,-1630208,90624,-1539584,-1
1364,153,27,3,0.100856955,0.899143045,433.4424827,474.3039912,763.244868,721.1568627,1517,125.0618302,3034,-698368,78336,-620032,-1
9445,519,17,13,0.0520875151,0.947912485,2830.657264,3327.125027,5057.21207,3622.855491,9964,1084.22198,19928,-4835840,265728,-4570112,-1
2569,171,24,6,0.0624087591,0.937591241,778.9353803,948.5264183,1376.869599,1274.807018,2740,187.0307167,5480,-1315328,87552,-1227776,-1
4478,230,22,8,0.0488530161,0.951146984,1356.34126,1396.790433,2364.643591,2157.008696,4708,197.5660932,9416,-2292736,117760,-2174976,-1
2837,309,21,9,0.0982199619,0.901780038,894.8768806,1001.825305,1552.502996,1766.278317,3146,65.81589958,6292,-1452544,158208,-1294336,-1
426,108,24,6,0.202247191,0.797752809,148.558369,174.4765914,267.4389671,267.7407407,534,25.05865791,1068,-218112,55296,-162816,-1
107,28,20,10,0.207407407,0.792592593,38.27315617,41.09905903,69.38317757,62.71428571,135,6.317267197,270,-54784,14336,-40448,-1
81,25,27,3,0.235849057,0.764150943,29.82634289,26.71329257,48.28395062,70.4,106,8.610885459,212,-41472,12800,-28672,-1
5028,1112,20,10,0.181107492,0.818892508,1751.220416,1727.839789,2929.736675,3706.973022,6140,142.2283994,12280,-2574336,569344,-2004992,-1
9578,398,21,9,0.0398957498,0.96010425,2857.74034,3298.169394,5016.251932,4320.640704,9976,894.7085202,19952,-4903936,203776,-4700160,-1
54,15,20,10,0.217391304,0.782608696,19.76193185,18.00666543,37.38888889,26.4,69,12.29946524,138,-27648,7680,-19968,-1
9493,478,17,13,0.0479390232,0.952060977,2860.345339,3090.618863,5029.628042,4119.554393,9971,445.5317248,19942,-4860416,244736,-4615680,-1
3497,395,16,14,0.101490236,0.898509764,1098.948043,1320.230364,1952.209036,1895.956962,3892,204.3044619,7784,-1790464,202240,-1588224,-1
9280,657,20,10,0.0661165342,0.933883466,2853.294323,3020.272566,5008.939332,4404.864536,9937,192.5029059,19874,-4751360,336384,-4414976,-1
3695,544,21,9,0.128332154,0.871667846,1175.301254,1492.255261,2086.572395,2347.049632,4239,114.9403471,8478,-1891840,278528,-1613312,-1
2108,218,20,10,0.0937231298,0.90627687,664.0346748,644.748362,1199.136148,818.9082569,2326,157.4813812,4652,-1079296,111616,-967680,-1
4516,383,17,13,0.0781792202,0.92182078,1396.610858,1588.973216,2430.258415,2682.775457,4899,128.4478238,9798,-2312192,196096,-2116096,-1
5340,348,20,10,0.0611814346,0.938818565,1624.047262,1894.998422,2848.508427,2782.991379,5688,198.3955354,11376,-2734080,178176,-2555904,-1
1143,136,16,14,0.106333073,0.893666927,358.8672236,446.2306153,642.5643045,618.4485294,1279,97.63358779,2558,-585216,69632,-515584,-1
9373,572,17,13,0.0575163399,0.94248366,2866.189989,2927.125595,4993.022405,4644.905594,9945,1029.503106,19890,-4798976,292864,-4506112,-1
9306,493,21,9,0.0503112563,0.949688744,2821.68554,2775.011037,4952.954868,3900.409736,9799,184.2263583,19598,-4764672,252416,-4512256,-1
5132,366,20,10,0.0665696617,0.933430338,1582.670154,1648.457727,2748.911925,2757.745902,5498,127.7416357,10996,-2627584,187392,-2440192,-1
3674,440,20,10,0.106951872,0.893048128,1155.28927,1403.303578,2026.829341,2313.6,4114,113.5209713,8228,-1881088,225280,-1655808,-1
3239,218,20,10,0.063060457,0.936939543,992.5007303,1072.56689,1723.684779,1807.972477,3457,66.41690682,6914,-1658368,111616,-1546752,-1
2844,258,21,9,0.083172147,0.916827853,880.5314928,1045.717004,1553.961674,1524.364341,3102,69.07147629,6204,-1456128,132096,-1324032,-1
9517,467,21,9,0.0467748397,0.95322516,2851.359627,3110.340107,5064.011979,3535.156317,9984,1027.160494,19968,-4872704,239104,-4633600,-1
3148,252,22,8,0.0741176471,0.925882353,972.261817,1041.023528,1725.45521,1388.757937,3400,107.6289965,6800,-1611776,129024,-1482752,-1
3840,328,21,9,0.0786948177,0.921305182,1185.697912,1327.035488,2050.095313,2487.286585,4168,79.63316775,8336,-1966080,167936,-1798144,-1
5664,516,21,9,0.0834951456,0.916504854,1764.839845,1980.549201,3083.210805,3170.511628,6180,275.4010695,12360,-2899968,264192,-2635776,-1
9453,508,21,9,0.0509988957,0.949001104,2864.455295,3062.938608,4994.429916,4731.09252,9961,1213.276492,19922,-4839936,260096,-4579840,-1
1094,119,21,9,0.0981038747,0.901896125,336.047433,452.1778604,615.7632541,526.4369748,1213,72.54784689,2426,-560128,60928,-499200,-1
6396,408,22,8,0.0599647266,0.940035273,1946.915634,2181.149884,3426.994371,3018.514706,6804,337.1655104,13608,-3274752,208896,-3065856,-1
3461,646,20,10,0.157292428,0.842707572,1148.766467,1181.994316,1936.653857,2682.69195,4107,111.2103981,8214,-1772032,330752,-1441280,-1
9153,546,22,8,0.0562944633,0.943705537,2790.116338,2805.045839,4904.484978,3936.628205,9699,432.6048171,19398,-4686336,279552,-4406784,-1
2793,146,24,6,0.0496767608,0.950323239,839.527504,936.5918942,1488.346939,1119.020548,2939,175.2534287,5878,-1430016,74752,-1355264,-1
9409,522,25,5,0.0525626825,0.947437317,2841.875907,3074.101925,5028.432777,3840.655172,9931,681.138546,19862,-4817408,267264,-4550144,-1
1966,238,17,13,0.107985481,0.892014519,625.5035517,716.6400979,1096.103764,1155.336134,2204,42.68009295,4408,-1006592,121856,-884736,-1
230,53,23,7,0.187279152,0.812720848,80.62402603,81.1430269,148.0347826,115.8113208,283,16.34893125,566,-117760,27136,-90624,-1
42,22,21,9,0.34375,0.65625,17.35889011,20.26090157,31.38095238,34.63636364,64,1.237193118,128,-21504,11264,-10240,-1
2175,132,17,13,0.0572171651,0.942782835,657.8159455,782.620482,1159.578391,1062.083333,2307,348.489426,4614,-1113600,67584,-1046016,-1
1418,173,20,10,0.108736644,0.891263356,451.210911,484.3130257,818.0394922,615.3526012,1591,30.33943555,3182,-726016,88576,-637440,-1
9459,498,27,3,0.0500150648,0.949984935,2859.892045,3050.165657,5016.41886,4268.267068,9957,1122.547914,19914,-4843008,254976,-4588032,-1
4919,473,20,10,0.0877225519,0.912277448,1531.908009,1608.20861,2623.746696,3453.103594,5392,167.5574891,10784,-2518528,242176,-2276352,-1
2899,333,22,8,0.103032178,0.896967822,909.5555825,1105.11932,1599.220076,1766.933934,3232,277.186964,6464,-1484288,170496,-1313792,-1
7913,552,21,9,0.0652096869,0.934790313,2435.431461,2454.827867,4281.586503,3536.505435,8465,631.7164179,16930,-4051456,282624,-3768832,-1
9596,363,22,8,0.0364494427,0.963550557,2853.305202,3277.157043,5013.166319,4103.239669,9959,997.8957916,19918,-4913152,185856,-4727296,-1
2902,192,24,6,0.0620555915,0.937944409,876.6744552,986.6348716,1580.50379,1048.661458,3094,343.0155211,6188,-1485824,98304,-1387520,-1
2299,329,21,9,0.125190259,0.874809741,733.9156439,909.2399294,1303.573293,1390.854103,2628,72.47655819,5256,-1177088,168448,-1008640,-1
156,30,20,10,0.161290323,0.838709677,52.25337921,38.13426572,101.8012821,50.33333333,186,42.17687075,372,-79872,15360,-64512,-1
1868,239,17,13,0.113431419,0.886568581,585.7682393,755.0104677,1042.190043,1146.305439,2107,135.8478401,4214,-956416,122368,-834048,-1
2743,199,21,9,0.0676410605,0.932358939,830.2859169,847.7721484,1518.090777,829.2964824,2942,269.9082569,5884,-1404416,101888,-1302528,-1
4819,302,21,9,0.0589728569,0.941027143,1465.339503,1665.855058,2569.454244,2426.096026,5121,180.190007,10242,-2467328,154624,-2312704,-1
9466,497,19,11,0.0498845729,0.950115427,2864.681417,3075.47457,4994.378407,4746.237425,9963,535.0698174,19926,-4846592,254464,-4592128,-1
8908,993,19,11,0.1002929,0.8997071,2830.315843,3096.794254,4948.525707,4973.196375,9901,493.8154613,19802,-4560896,508416,-4052480,-1
9147,415,16,14,0.0434009621,0.956599038,2740.765093,3041.033518,4819.709413,3939.327711,9562,346.7005076,19124,-4683264,212480,-4470784,-1
9476,486,19,11,0.0487853845,0.951214616,2858.012479,2913.570636,5048.006437,3684.761317,9962,489.0525282,19924,-4851712,248832,-4602880,-1
5678,489,20,10,0.0792930112,0.920706989,1761.730596,1857.98162,3141.209581,2419.713701,6167,121.4215397,12334,-2907136,250368,-2656768,-1
1492,141,20,10,0.0863441519,0.913655848,468.6306784,498.0241462,820.8391421,776.3758865,1633,79.73632813,3266,-763904,72192,-691712,-1
8570,472,21,9,0.0522008405,0.947799159,2582.645593,2663.511192,4603.115286,3039.629237,9042,426.7107126,18084,-4387840,241664,-4146176,-1
6600,287,20,10,0.0416727167,0.958327283,1973.135539,2157.236033,3478.651212,2647.142857,6887,546.5873016,13774,-3379200,146944,-3232256,-1
8309,723,20,10,0.0800487157,0.919951284,2594.161652,2689.230855,4566.038512,3947.183956,9032,232.6635755,18064,-4254208,370176,-3884032,-1
6595,418,21,9,0.0596035933,0.940396407,1992.260808,2147.634477,3582.975436,2308.296651,7013,328.1703322,14026,-3376640,214016,-3162624,-1
9355,581,22,8,0.0584742351,0.941525765,2848.995719,3103.020497,5005.312881,4375.755594,9936,830.075188,19872,-4789760,297472,-4492288,-1
9172,416,20,10,0.0433875678,0.956612432,2749.270203,3109.733102,4816.522133,4308.954327,9588,184.0307102,19176,-4696064,212992,-4483072,-1
9363,585,20,10,0.0588057901,0.94119421,2834.471581,3153.714146,5053.640927,3707.839316,9948,1433.429395,19896,-4793856,299520,-4494336,-1
1882,136,18,12,0.0673934589,0.932606541,574.3836264,643.6057135,1025.987248,781.3455882,2018,43.11044649,4036,-963584,69632,-893952,-1
9442,517,16,14,0.0519128427,0.948087157,2854.886771,3148.713016,5015.631222,4329.26499,9959,1322.576361,19918,-4834304,264704,-4569600,-1
1333,194,27,3,0.127046496,0.872953504,434.0175154,437.3384428,792.4763691,568.3350515,1527,92.26586103,3054,-682496,99328,-583168,-1
4205,279,22,8,0.062221231,0.937778769,1285.464374,1317.8013,2276.928419,1723.605735,4484,120.1178677,8968,-2152960,142848,-2010112,-1
5432,232,17,13,0.040960452,0.959039548,1620.221627,1867.684343,2856.004971,2282.159483,5664,245.5136541,11328,-2781184,118784,-2662400,-1
9608,376,27,3,0.0376602564,0.962339744,2872.36809,3018.54776,5022.992402,4213.321809,9984,337.183384,19968,-4919296,192512,-4726784,-1
5837,426,18,12,0.0680185215,0.931981479,1807.103209,1710.924407,3175.691965,2533.338028,6263,140.3630659,12526,-2988544,218112,-2770432,-1
6708,432,21,9,0.0605042017,0.939495798,2050.700105,2215.256918,3565.083781,3654.601852,7140,323.8095238,14280,-3434496,221184,-3213312,-1
261,62,18,12,0.191950464,0.808049536,90.03315401,102.3273819,167.6436782,138.2419355,323,27.0519263,646,-133632,31744,-101888,-1
1344,133,22,8,0.0900473934,0.909952607,423.6817276,438.1797934,749.7261905,630.6090226,1477,43.09892034,2954,-688128,68096,-620032,-1
8358,482,22,8,0.0545248869,0.945475113,2543.198844,2697.581438,4417.485164,4472.778008,8840,547.3684211,17680,-4279296,246784,-4032512,-1
601,80,21,9,0.117474302,0.882525698,191.6471188,229.3652314,343.6455907,321.125,681,27.01309004,1362,-307712,40960,-266752,-1
3604,230,23,7,0.059989567,0.940010433,1099.602475,992.1889925,1960.753885,1239.730435,3834,673.8137083,7668,-1845248,117760,-1727488,-1
814,120,16,14,0.128479657,0.871520343,268.6720349,260.2646056,480.1351351,381.7916667,934,70.54380665,1868,-416768,61440,-355328,-1
443,84,21,9,0.159392789,0.840607211,142.5540719,182.8317257,252.2076749,326.1904762,527,46.76131322,1054,-226816,43008,-183808,-1
8994,428,20,10,0.0454255997,0.9545744,2695.134418,3177.34464,4727.613075,4372.899533,9422,297.5994946,18844,-4604928,219136,-4385792,-1
1994,152,21,9,0.0708294501,0.92917055,608.9355078,711.7204371,1057.497994,1283.421053,2146,164.9500384,4292,-1020928,77824,-943104,-1
60,20,23,7,0.25,0.75,21.74600857,26.41968963,39.33333333,44,80,2.252252252,160,-30720,10240,-20480,-1
6048,874,18,12,0.126264086,0.873735914,1987.946898,2054.146313,3429.4208,3683.485126,6922,129.8686679,13844,-3096576,447488,-2649088,-1
945,138,19,11,0.127423823,0.872576177,300.4794961,382.0818513,549.2042328,492.6666667,1083,43.14741036,2166,-483840,70656,-413184,-1
98,31,19,11,0.240310078,0.759689922,35.45163038,38.15871341,70.09183673,48.90322581,129,29.58715596,258,-50176,15872,-34304,-1
9568,408,23,7,0.0408981556,0.959101844,2873.400731,2961.469612,5014.56574,4377.232843,9976,913.5531136,19952,-4898816,208896,-4689920,-1
4307,204,25,5,0.0452227887,0.954777211,1289.121131,1461.884717,2280.267472,1743.647059,4511,648.1321839,9022,-2205184,104448,-2100736,-1
9396,560,21,9,0.056247489,0.943752511,2852.037441,3088.520529,5031.440294,4090.2375,9956,596.882494,19912,-4810752,286720,-4524032,-1
9302,645,16,14,0.0648436715,0.935156329,2873.371991,2723.052946,5028.93152,4181.793798,9947,247.8694244,19894,-4762624,330240,-4432384,-1
4520,394,20,10,0.0801790802,0.91982092,1396.970495,1637.780471,2471.22677,2300.025381,4914,128.4705882,9828,-2314240,201728,-2112512,-1
2937,110,25,5,0.036101083,0.963898917,876.7073505,940.711759,1529.70446,1371.690909,3047,157.7938892,6094,-1503744,56320,-1447424,-1
218,56,22,8,0.204379562,0.795620438,70.28267037,92.18802188,125.1972477,185.3928571,274,28.66108787,548,-111616,28672,-82944,-1
3509,320,18,12,0.0835727344,0.916427266,1089.61274,1261.251096,1906.498148,2008.228125,3829,221.3294798,7658,-1796608,163840,-1632768,-1
297,31,20,10,0.0945121951,0.905487805,91.74796622,88.27046696,172.4579125,88.25806452,328,50.07633588,656,-152064,15872,-136192,-1
2360,188,27,3,0.0737833595,0.926216641,727.6781369,823.3727409,1281.169068,1190.781915,2548,202.5437202,5096,-1208320,96256,-1112064,-1
3726,239,19,11,0.0602774275,0.939722573,1138.0031,1209.939466,2000.674181,1707.460251,3965,204.3814433,7930,-1907712,122368,-1785344,-1
3690,335,25,5,0.0832298137,0.916770186,1159.125926,1183.953559,2000.807859,2147.295522,4025,90.49010791,8050,-1889280,171520,-1717760,-1
5660,458,20,10,0.0748610657,0.925138934,1753.985656,1884.494986,3035.45265,3356.679039,6118,142.4115456,12236,-2897920,234496,-2663424,-1
6923,288,21,9,0.0399389821,0.960061018,2076.903519,2169.720632,3618.801676,3298.270833,7211,420.2214452,14422,-3544576,147456,-3397120,-1
1402,143,23,7,0.0925566343,0.907443366,443.2143715,376.6640809,800.7132668,501.2937063,1545,39.39316675,3090,-717824,73216,-644608,-1
9536,437,27,3,0.0438183094,0.956181691,2859.523733,3073.769854,5037.575503,3883.366133,9973,637.2523962,19946,-4882432,223744,-4658688,-1
3717,324,17,13,0.0801781737,0.919821826,1145.714652,1312.10979,1984.416196,2440.697531,4041,197.5073314,8082,-1903104,165888,-1737216,-1
1232,144,18,12,0.104651163,0.895348837,392.0808687,407.1990107,706.5560065,534.0208333,1376,124.1877256,2752,-630784,73728,-557056,-1
9465,489,22,8,0.0491259795,0.95087402,2861.386942,3080.411018,4994.164606,4654.94274,9954,920.8140611,19908,-4846080,250368,-4595712,-1
1655,232,17,13,0.122946476,0.877053524,537.581431,592.5224628,947.8042296,916.862069,1887,34.63020738,3774,-847360,118784,-728576,-1
9499,468,20,10,0.0469549513,0.953045049,2863.973451,3062.950637,5015.939046,4335.732906,9967,1247.434293,19934,-4863488,239616,-4623872,-1
9474,494,21,9,0.0495585875,0.950441413,2852.738083,3260.114879,5015.607452,4387.917004,9968,886.8327402,19936,-4850688,252928,-4597760,-1
2329,181,20,10,0.0721115538,0.927888446,712.0449203,859.3650929,1245.423787,1385.154696,2510,157.8616352,5020,-1192448,92672,-1099776,-1
2709,223,20,10,0.0760572988,0.923942701,828.8539375,1031.362252,1474.277962,1372.013453,2932,68.23365138,5864,-1387008,114176,-1272832,-1
46,12,22,8,0.206896552,0.793103448,16.83321947,14.32048843,31.34782609,22.41666667,58,13.33333333,116,-23552,6144,-17408,-1
5325,618,27,3,0.103987885,0.896012115,1715.672899,1620.780464,2910.433615,3502.487055,5943,176.875,11886,-2726400,316416,-2409984,-1
3808,269,22,8,0.0659798872,0.934020113,1155.740013,1439.606505,2031.406775,2146.490706,4077,142.1052632,8154,-1949696,137728,-1811968,-1
3069,163,24,6,0.0504331683,0.949566832,922.3649744,1055.098937,1635.066797,1266.920245,3232,221.5215901,6464,-1571328,83456,-1487872,-1
31,21,17,13,0.403846154,0.596153846,14.64679542,15.45294958,27.29032258,25.33333333,52,13.82978723,104,-15872,10752,-5120,-1
126,21,20,10,0.142857143,0.857142857,39.41969218,57.12999855,74.64285714,70.14285714,147,13.68715084,294,-64512,10752,-53760,-1
7939,546,22,8,0.0643488509,0.935651149,2449.270014,2450.468328,4247.546668,4176.89011,8485,401.1820331,16970,-4064768,279552,-3785216,-1
9581,398,20,10,0.0398837559,0.960116244,2875.701931,2918.518086,5017.955954,4317.020101,9979,380.4422417,19958,-4905472,203776,-4701696,-1
70,9,22,8,0.113924051,0.886075949,21.7158881,20.73644135,42.61428571,19.66666667,79,3.882063882,158,-35840,4608,-31232,-1
141,21,25,5,0.12962963,0.87037037,45.76768128,49.86134971,83.9858156,64.80952381,162,15.47277937,324,-72192,10752,-61440,-1
3004,190,19,11,0.0594865373,0.940513463,909.376265,906.9357443,1635.999667,988.8,3194,141.0777385,6388,-1538048,97280,-1440768,-1
51,19,24,6,0.271428571,0.728571429,19.61699786,21.6937894,35.2745098,36.10526316,70,9.162303665,140,-26112,9728,-16384,-1
9445,504,20,10,0.0506583576,0.949341642,2866.338895,2843.068681,5020.841821,4115.920635,9949,848.890785,19898,-4835840,258048,-4577792,-1
1409,250,17,13,0.150693189,0.849306811,466.3474967,543.8499784,826.2682754,851.032,1659,68.78109453,3318,-721408,128000,-593408,-1
5653,358,21,9,0.059557478,0.940442522,1735.432805,1644.177872,3039.433752,2478.064246,6011,251.9279128,12022,-2894336,183296,-2711040,-1
3336,464,17,13,0.122105263,0.877894737,1062.676242,1246.549317,1844.92476,2300.06681,3800,94.76309227,7600,-1708032,237568,-1470464,-1
3850,986,17,13,0.20388751,0.79611249,1416.648294,1236.408181,2317.905974,2811.286004,4836,185.2163922,9672,-1971200,504832,-1466368,-1
5766,543,24,6,0.0860675226,0.913932477,1800.273066,2021.231061,3137.374436,3342.162063,6309,159.0771558,12618,-2952192,278016,-2674176,-1
2870,275,22,8,0.0874403816,0.912559618,893.5989561,1036.052516,1585.750871,1439.927273,3145,102.7106466,6290,-1469440,140800,-1328640,-1
41,17,22,8,0.293103448,0.706896552,16.47203027,17.34945129,29.80487805,28.76470588,58,9.324758842,116,-20992,8704,-12288,-1
8148,517,19,11,0.0596653203,0.94033468,2503.379004,2328.042096,4383.686426,3534.174081,8665,233.8100378,17330,-4171776,264704,-3907072,-1
1375,143,23,7,0.0942028986,0.905797101,435.6448253,364.0539515,787.6763636,488.5734266,1518,35.73446328,3036,-704000,73216,-630784,-1
9557,428,22,8,0.0428642964,0.957135704,2848.316263,3229.448995,5058.621325,3527.712617,9985,819.7865353,19970,-4893184,219136,-4674048,-1
426,88,19,11,0.171206226,0.828793774,140.4851673,166.4231451,271.2652582,190.8636364,514,54.62274176,1028,-218112,45056,-173056,-1
4274,818,23,7,0.160644148,0.839355852,1489.972443,1289.399936,2470.422321,2944.001222,5092,121.065145,10184,-2188288,418816,-1769472,-1
6393,1097,17,13,0.146461949,0.853538051,2168.269772,2047.168748,3654.384014,4276.497721,7490,147.8775913,14980,-3273216,561664,-2711552,-1
745,87,22,8,0.104567308,0.895432692,235.2397873,278.8386069,415.833557,422.2068966,832,37.99086758,1664,-381440,44544,-336896,-1
9135,767,19,11,0.0774590992,0.922540901,2885.150066,2473.429808,4913.055939,5409.370274,9902,328.206828,19804,-4677120,392704,-4284416,-1
583,35,27,3,0.0566343042,0.943365696,179.1163164,165.1375333,310.5042882,292.7714286,618,66.52314316,1236,-298496,17920,-280576,-1
9166,788,20,10,0.0791641551,0.920835845,2844.816943,3162.798353,5010.453306,4594.187817,9954,729.7653959,19908,-4692992,403456,-4289536,-1
3302,159,26,4,0.0459404796,0.95405952,993.2147328,1024.370158,1751.639612,1302.371069,3461,64.69158879,6922,-1690624,81408,-1609216,-1
3980,234,27,3,0.0555291884,0.944470812,1214.962598,1241.508811,2109.394975,2075.269231,4214,260.9287926,8428,-2037760,119808,-1917952,-1
6319,774,24,6,0.109121669,0.890878331,2021.990879,2207.557826,3499.447223,3935.224806,7093,155.1739226,14186,-3235328,396288,-2839040,-1
6210,545,21,9,0.0806809771,0.919319023,1909.286026,2364.931219,3378.214815,3375.552294,6755,206.7013464,13510,-3179520,279040,-2900480,-1
359,27,20,10,0.0699481865,0.930051813,107.7290111,135.443852,198.551532,126.3333333,386,12.07381921,772,-183808,13824,-169984,-1
1954,144,21,9,0.0686367969,0.931363203,603.5028895,627.8698657,1055.720573,965.0902778,2098,45.08918977,4196,-1000448,73728,-926720,-1
9233,638,27,3,0.0646337757,0.935366224,2813.272864,3327.860343,4944.158887,4817.926332,9871,536.4673913,19742,-4727296,326656,-4400640,-1
750,90,19,11,0.107142857,0.892857143,238.7125242,260.2537321,429.4306667,346.0777778,840,83.91608392,1680,-384000,46080,-337920,-1
1105,193,22,8,0.148690293,0.851309707,367.3325801,414.23099,647.7809955,659.3419689,1298,72.3522854,2596,-565760,98816,-466944,-1
9601,381,22,8,0.0381687037,0.961831296,2876.176446,2985.726231,5007.509218,4588.076115,9982,652.4183007,19964,-4915712,195072,-4720640,-1
2490,289,25,5,0.103994243,0.896005757,799.955064,820.9864924,1386.650602,1418.858131,2779,79.35465448,5558,-1274880,147968,-1126912,-1
1482,217,21,9,0.12772219,0.87227781,482.1112227,518.239363,872.6470985,695.3317972,1699,106.9899244,3398,-758784,111104,-647680,-1
9516,447,20,10,0.0448660042,0.955133996,2866.427317,3069.154606,4990.07356,4810.12528,9963,862.5974026,19926,-4872192,228864,-4643328,-1
6196,522,19,11,0.0777016969,0.922298303,1916.456377,1972.071438,3437.031956,2439.216475,6718,192.4928367,13436,-3172352,267264,-2905088,-1
2778,502,21,9,0.15304878,0.84695122,944.3145563,954.2195324,1621.848092,1743.717131,3280,80.47105005,6560,-1422336,257024,-1165312,-1
1183,153,17,13,0.114520958,0.885479042,383.5630503,368.2739471,687.9898563,517.8039216,1336,174.1851369,2672,-605696,78336,-527360,-1
9434,535,20,10,0.0536663657,0.946333634,2843.882624,3064.502123,5068.898982,3505.55514,9969,745.6245325,19938,-4830208,273920,-4556288,-1
2539,215,19,11,0.0780682643,0.921931736,775.3315549,995.7500265,1383.51792,1306.432558,2754,273.4856008,5508,-1299968,110080,-1189888,-1
1913,177,21,9,0.0846889952,0.915311005,586.4309124,758.792604,1038.901202,1116.819209,2090,158.5735964,4180,-979456,90624,-888832,-1
9458,511,22,8,0.0512589026,0.948741097,2850.995192,3114.208716,5047.840664,3821.894325,9969,1174.204947,19938,-4842496,261632,-4580864,-1
5002,708,17,13,0.123992995,0.876007005,1601.628432,1923.182281,2815.579768,3137.535311,5710,108.2054197,11420,-2561024,362496,-2198528,-1
9606,373,19,11,0.0373784948,0.962621505,2873.259071,2992.48863,5015.396835,4335.946381,9979,864.7313692,19958,-4918272,190976,-4727296,-1
9588,394,21,9,0.0394710479,0.960528952,2864.039433,3103.660263,5034.115978,3954.439086,9982,660.1851852,19964,-4909056,201728,-4707328,-1
65,12,22,8,0.155844156,0.844155844,21.17441797,23.36961465,41.36923077,26.16666667,77,12.10691824,154,-33280,6144,-27136,-1
9075,825,22,8,0.0833333333,0.916666667,2820.754017,3231.588497,4968.684518,4750.470303,9900,529.6950241,19800,-4646400,422400,-4224000,-1
1291,125,18,12,0.0882768362,0.911723164,401.8195628,461.3935819,718.7699458,602.432,1416,73.21613237,2832,-660992,64000,-596992,-1
8518,541,20,10,0.0597196159,0.940280384,2592.707448,2667.783623,4606.884832,3319.454713,9059,167.5110947,18118,-4361216,276992,-4084224,-1
4290,434,20,10,0.0918712955,0.908128704,1354.868912,1379.456142,2320.023077,2782.375576,4724,107.8046554,9448,-2196480,222208,-1974272,-1
3055,251,23,7,0.075922565,0.924077435,935.8538015,1011.329693,1609.25892,2191.972112,3306,66.13322665,6612,-1564160,128512,-1435648,-1
817,171,27,3,0.173076923,0.826923077,290.335753,228.0593521,471.002448,606.7660819,988,21.35292846,1976,-418304,87552,-330752,-1
5611,358,20,10,0.0599765455,0.940023455,1699.491613,1955.533657,3024.681875,2363.058659,5969,180.8787879,11938,-2872832,183296,-2689536,-1
9347,604,21,9,0.0606974173,0.939302583,2847.946862,2985.529871,5053.250562,3780.534768,9951,711.2937813,19902,-4785664,309248,-4476416,-1
633,47,19,11,0.0691176471,0.930882353,189.9311406,247.7994761,347.7535545,242.8085106,680,12.77955272,1360,-324096,24064,-300032,-1
166,29,21,9,0.148717949,0.851282051,55.24096287,45.44092348,104.7891566,59.13793103,195,5.525644659,390,-84992,14848,-70144,-1
3799,385,21,9,0.0920172084,0.907982792,1198.827763,1291.258337,2085.712819,2159.472727,4184,114.8188804,8368,-1945088,197120,-1747968,-1
119,48,19,11,0.28742515,0.71257485,46.7971295,51.53881611,84.05882353,83.85416667,167,27.42200328,334,-60928,24576,-36352,-1
3789,545,21,9,0.125749885,0.874250115,1215.793862,1464.950666,2188.785695,2019.515596,4334,86.71468587,8668,-1939968,279040,-1660928,-1
1353,159,22,8,0.10515873,0.89484127,430.5979664,461.6397924,772.5232816,620.1509434,1512,111.5044248,3024,-692736,81408,-611328,-1
9092,783,25,5,0.0792911392,0.920708861,2766.325467,3664.237423,4900.981852,5367.845466,9875,209.1717856,19750,-4655104,400896,-4254208,-1
2501,209,19,11,0.0771217712,0.922878229,757.3324212,1034.701626,1358.694122,1317.277512,2710,172.1728081,5420,-1280512,107008,-1173504,-1
7519,1430,18,12,0.15979439,0.84020561,2551.462683,2633.056849,4339.767921,5186.055944,8949,168.8490566,17898,-3849728,732160,-3117568,-1
3863,654,20,10,0.144786363,0.855213637,1305.485668,1270.179282,2298.353352,2026.550459,4517,270.9658068,9034,-1977856,334848,-1643008,-1
6104,697,22,8,0.102484929,0.897515071,1961.788228,1976.227025,3402.732962,3385.823529,6801,232.9907503,13602,-3125248,356864,-2768384,-1
2079,145,24,6,0.0651978417,0.934802158,632.0072749,724.2430848,1130.396344,855.9034483,2224,148.9618218,4448,-1064448,74240,-990208,-1
2470,263,21,9,0.0962312477,0.903768752,782.3191621,836.5747881,1352.535223,1502.847909,2733,52.37638942,5466,-1264640,134656,-1129984,-1
601,23,23,7,0.0368589744,0.963141026,178.7268142,196.8197145,315.6189684,231,624,178.7965616,1248,-307712,11776,-295936,-1
156,38,19,11,0.195876289,0.804123711,54.09773759,59.16868697,102.3653846,77.52631579,194,34.27561837,388,-79872,19456,-60416,-1
3591,583,22,8,0.139674173,0.860325827,1181.428112,1332.377909,2109.873573,1949.689537,4174,131.8799368,8348,-1838592,298496,-1540096,-1
488,64,14,16,0.115942029,0.884057971,150.8001111,146.9842205,295.6045082,130.828125,552,131.4285714,1104,-249856,32768,-217088,-1
212,67,22,8,0.240143369,0.759856631,75.70441773,90.52365419,132.8018868,162.7761194,279,7.386814932,558,-108544,34304,-74240,-1
9194,721,18,12,0.0727181039,0.927281896,2802.357524,3511.190781,4990.692517,4541.113731,9915,1061.563169,19830,-4707328,369152,-4338176,-1
3376,251,18,12,0.0692031982,0.930796802,1027.784932,1274.876429,1807.638033,1899.569721,3627,85.54245283,7254,-1728512,128512,-1600000,-1
6882,461,20,10,0.0627808797,0.93721912,2080.861897,2632.748633,3672.244987,3668.342733,7343,242.1035279,14686,-3523584,236032,-3287552,-1
4490,266,22,8,0.0559293524,0.944070648,1354.835517,1591.570259,2403.286414,1960.112782,4756,229.4259527,9512,-2298880,136192,-2162688,-1
3668,573,21,9,0.135109644,0.864890356,1142.568819,1512.565876,2023.666303,2744.071553,4241,159.7363465,8482,-1878016,293376,-1584640,-1
2818,268,17,13,0.0868438108,0.913156189,863.5602984,1095.370688,1515.161817,1841.473881,3086,68.07853519,6172,-1442816,137216,-1305600,-1
327,85,25,5,0.20631068,0.79368932,112.9482556,139.5820633,206.2079511,207.6235294,412,18.74431301,824,-167424,43520,-123904,-1
2503,315,21,9,0.111781405,0.888218595,805.7580343,845.8168252,1434.880943,1207.822222,2818,235.4218881,5636,-1281536,161280,-1120256,-1
58,16,23,7,0.216216216,0.783783784,22.12202673,17.00723651,39.17241379,31.4375,74,2.205663189,148,-29696,8192,-21504,-1
6278,541,20,10,0.0793371462,0.920662854,1962.733532,1989.310173,3445.03122,3003.48244,6819,287.357775,13638,-3214336,276992,-2937344,-1
9619,367,21,9,0.036751452,0.963248548,2872.347834,3059.955006,5020.233704,4292.814714,9986,880.5996473,19972,-4924928,187904,-4737024,-1
2457,221,20,10,0.0825242718,0.917475728,744.5004976,1038.391844,1336.235653,1375.791855,2678,81.37344272,5356,-1257984,113152,-1144832,-1
9338,445,20,10,0.0454870694,0.954512931,2792.814323,3139.743402,4954.571857,3578.975281,9783,1178.674699,19566,-4781056,227840,-4553216,-1
5018,232,27,3,0.0441904762,0.955809524,1507.536831,1621.132341,2645.326425,2196.668103,5250,461.7414248,10500,-2569216,118784,-2450432,-1
5992,596,27,3,0.0904675167,0.909532483,1910.994912,1804.876564,3286.88034,3371.105705,6588,293.5828877,13176,-3067904,305152,-2762752,-1
928,64,21,9,0.064516129,0.935483871,284.371374,279.5474016,506.018319,358.484375,992,106.5520945,1984,-475136,32768,-442368,-1
2376,198,20,10,0.0769230769,0.923076923,729.9133181,849.8110634,1267.542088,1526.994949,2574,144.2016807,5148,-1216512,101376,-1115136,-1
1702,173,20,10,0.0922666667,0.907733333,544.4018251,509.3488462,937.413631,943.7687861,1875,133.7375178,3750,-871424,88576,-782848,-1
2935,155,22,8,0.0501618123,0.949838188,885.9017953,931.5174043,1564.302555,1189.464516,3090,258.1453634,6180,-1502720,79360,-1423360,-1
4087,297,25,5,0.0677463504,0.93225365,1246.871489,1494.61781,2200.675801,2079.993266,4384,225.6304683,8768,-2092544,152064,-1940480,-1
9308,629,21,9,0.0632987823,0.936701218,2831.488187,3152.780223,5046.827675,3817.298887,9937,389.0759593,19874,-4765696,322048,-4443648,-1
9446,507,21,9,0.0509394153,0.949060585,2844.890875,3167.907941,5035.077811,3894.942801,9953,610.6134969,19906,-4836352,259584,-4576768,-1
9353,590,21,9,0.0593382279,0.940661772,2856.89629,2871.654376,5039.267294,3905.642373,9943,1211.084044,19886,-4788736,302080,-4486656,-1
212,67,19,11,0.240143369,0.759856631,80.14996665,77.19781882,147.4198113,116.5223881,279,20.78986587,558,-108544,34304,-74240,-1
622,40,21,9,0.0604229607,0.939577039,188.042342,203.70864,338.6254019,220.7,662,116.7548501,1324,-318464,20480,-297984,-1
4365,462,17,13,0.0957116221,0.904288378,1356.80559,1700.046835,2408.225888,2468.554113,4827,459.7142857,9654,-2234880,236544,-1998336,-1
1152,142,18,12,0.109737249,0.890262751,371.6196348,383.9712784,654.6171875,589.7605634,1294,59.54901058,2588,-589824,72704,-517120,-1
1802,227,19,11,0.111877772,0.888122228,572.8086902,674.0107221,1004.692564,1096.823789,2029,37.29093917,4058,-922624,116224,-806400,-1
3184,163,17,13,0.0487003287,0.951299671,953.384501,1155.164084,1688.078832,1398.98773,3347,265.2139461,6694,-1630208,83456,-1546752,-1
6387,329,20,10,0.0489874926,0.951012507,1929.742773,2064.847493,3379.271646,2955.25228,6716,240.0285919,13432,-3270144,168448,-3101696,-1
304,39,20,10,0.113702624,0.886297376,95.73930488,88.44174435,182.0723684,93.48717949,343,10.68203052,686,-155648,19968,-135680,-1
9638,347,20,10,0.0347521282,0.965247872,2868.289552,3208.519418,5011.412741,4481.582133,9985,713.7240886,19970,-4934656,177664,-4756992,-1
8496,1411,21,9,0.142424548,0.857575452,2927.844374,2390.811419,5001.503766,4667.967399,9907,502.893401,19814,-4349952,722432,-3627520,-1
4966,430,21,9,0.0796886583,0.920311342,1547.862801,1659.120179,2711.949456,2543.174419,5396,278.7190083,10792,-2542592,220160,-2322432,-1
9542,425,19,11,0.0426407144,0.957359286,2859.659688,3074.022164,5029.525676,3961.868235,9967,813.6326531,19934,-4885504,217600,-4667904,-1
9559,419,22,8,0.0419923832,0.958007617,2872.565085,2988.796804,5016.367402,4376.551313,9978,857.2164948,19956,-4894208,214528,-4679680,-1
2494,415,22,8,0.142660708,0.857339292,837.9352656,833.1688056,1428.592622,1613.698795,2909,73.18238994,5818,-1276928,212480,-1064448,-1
9628,354,21,9,0.0354638349,0.964536165,2873.659769,3042.671063,5010.654342,4470.545198,9982,466.6666667,19964,-4929536,181248,-4748288,-1
7737,612,21,9,0.0733021919,0.926697808,2375.773092,2807.207754,4168.073284,4262.568627,8349,179.7416577,16698,-3961344,313344,-3648000,-1
9342,639,21,9,0.0640216411,0.935978359,2842.94688,3158.306839,4909.049133,6189.098592,9981,522.0188285,19962,-4783104,327168,-4455936,-1
9113,811,22,8,0.0817210802,0.91827892,2847.843415,2685.363186,5085.646549,3578.733662,9924,464.1721235,19848,-4665856,415232,-4250624,-1
4028,229,21,9,0.0537937515,0.946206249,1214.122048,1463.688953,2126.298908,2176.510917,4257,115.2721365,8514,-2062336,117248,-1945088,-1
9546,426,21,9,0.0427196149,0.957280385,2861.995195,3198.390517,5006.117222,4546.908451,9972,1053.009504,19944,-4887552,218112,-4669440,-1
41,22,19,11,0.349206349,0.650793651,18.56365161,17.29400603,33.02439024,30.09090909,63,12.90983607,126,-20992,11264,-9728,-1
58,16,23,7,0.216216216,0.783783784,22.12202673,17.00723651,39.17241379,31.4375,74,2.116704805,148,-29696,8192,-21504,-1
6500,425,25,5,0.0613718412,0.938628159,1985.56341,2157.413582,3437.244923,3856.901176,6925,182.0452156,13850,-3328000,217600,-3110400,-1
4142,186,27,3,0.0429759704,0.95702403,1244.602947,1302.498734,2180.345485,1811.639785,4328,410.626186,8656,-2120704,95232,-2025472,-1
2420,1117,22,8,0.315804354,0.684195646,823.8504829,854.8387885,1368.578926,2636.519248,3537,73.81051753,7074,-1239040,571904,-667136,-1
2220,162,17,13,0.0680100756,0.931989924,670.234506,891.8735658,1193.692793,1161.450617,2382,116.138469,4764,-1136640,82944,-1053696,-1
509,63,20,10,0.11013986,0.88986014,162.2384188,172.6765611,294.8172888,219.3015873,572,42.27642276,1144,-260608,32256,-228352,-1
47,16,20,10,0.253968254,0.746031746,18.13539941,17.211801,33.85106383,26.5625,63,10.84337349,126,-24064,8192,-15872,-1
4311,242,20,10,0.0531517681,0.946848232,1311.649295,1318.847239,2295.43447,1948.607438,4553,209.7190235,9106,-2207232,123904,-2083328,-1
6370,681,21,9,0.0965820451,0.903417955,2023.059605,2094.296841,3477.556515,3979.135095,7051,247.6642079,14102,-3261440,348672,-2912768,-1
9366,581,18,12,0.0584095707,0.941590429,2851.638299,3173.622441,4971.825859,5009.048193,9947,723.4181818,19894,-4795392,297472,-4497920,-1
947,151,21,9,0.137522769,0.862477231,311.2874154,320.8982398,570.3695882,418.615894,1098,96.40035119,2196,-484864,77312,-407552,-1
3745,322,22,8,0.0791738382,0.920826162,1156.86565,1349.352182,2046.582644,1887.658385,4067,95.98772717,8134,-1917440,164864,-1752576,-1
669,113,16,14,0.144501279,0.855498721,221.7890288,247.8507672,391.9566517,388.7964602,782,71.74311927,1564,-342528,57856,-284672,-1
2431,276,20,10,0.101957887,0.898042113,761.985374,876.7662547,1389.104484,1044.800725,2707,82.65648855,5414,-1244672,141312,-1103360,-1
8397,540,21,9,0.0604229607,0.939577039,2547.295956,3036.457652,4457.442182,4648.724074,8937,605.8983051,17874,-4299264,276480,-4022784,-1
9616,366,20,10,0.0366659988,0.963334001,2871.924175,3037.32632,5018.795237,4274.36612,9982,1022.745902,19964,-4923392,187392,-4736000,-1
2112,233,20,10,0.0993603412,0.900639659,659.9364393,814.6821204,1175.631629,1149.145923,2345,88.12476513,4690,-1081344,119296,-962048,-1
7522,741,20,10,0.0896768728,0.910323127,2385.314635,2350.177722,4093.611539,4521.68691,8263,335.4851807,16526,-3851264,379392,-3471872,-1
4577,186,21,9,0.0390510183,0.960948982,1363.676924,1526.810718,2404.525016,1827.715054,4763,372.6917058,9526,-2343424,95232,-2248192,-1
9508,457,21,9,0.0458605118,0.954139488,2863.726003,3001.770901,5025.194994,4105.122538,9965,562.676454,19930,-4868096,233984,-4634112,-1
1074,142,19,11,0.116776316,0.883223684,351.8598805,336.1839902,617.9497207,537.028169,1216,46.93168661,2432,-549888,72704,-477184,-1
9505,472,18,12,0.0473088103,0.95269119,2845.965897,3186.853332,5058.842399,3582.533898,9977,188.672466,19954,-4866560,241664,-4624896,-1
6441,318,27,3,0.0470483799,0.95295162,1935.486001,2023.0568,3426.920354,2429.641509,6759,132.7115649,13518,-3297792,162816,-3134976,-1
3893,334,20,10,0.0790158505,0.92098415,1198.260531,1447.330484,2123.562805,2002.538922,4227,145.5578512,8454,-1993216,171008,-1822208,-1
8455,1028,21,9,0.108404513,0.891595487,2581.332454,3358.837716,4541.694027,6389.458171,9483,177.2854739,18966,-4328960,526336,-3802624,-1
1421,48,21,9,0.0326752893,0.967324711,418.7831977,458.4328031,745.5805771,421.7708333,1469,78.38847385,2938,-727552,24576,-702976,-1
5921,271,21,9,0.0437661499,0.95623385,1793.664335,1623.148877,3108.862523,2826.394834,6192,460.0297177,12384,-3031552,138752,-2892800,-1
2800,233,19,11,0.0768216288,0.923178371,861.0154189,970.5624893,1545.599643,1173.313305,3033,205.3486798,6066,-1433600,119296,-1314304,-1
3729,190,20,10,0.0484817555,0.951518244,1130.06663,1108.130261,1976.292572,1640.236842,3919,232.4436536,7838,-1909248,97280,-1811968,-1
9546,429,21,9,0.0430075188,0.956992481,2862.19561,3093.773213,5030.523151,4041.785548,9975,608.2317073,19950,-4887552,219648,-4667904,-1
5873,338,21,9,0.0544195782,0.945580422,1780.121535,1948.446037,3131.97463,2654.671598,6211,300.1933301,12422,-3006976,173056,-2833920,-1
1571,266,25,5,0.144801306,0.855198694,527.6447192,528.0998462,940.521324,791.8947368,1837,113.4651019,3674,-804352,136192,-668160,-1
4945,286,19,11,0.0546740585,0.945325942,1486.143317,1875.968692,2616.113043,2614.045455,5231,103.913389,10462,-2531840,146432,-2385408,-1
8097,583,20,10,0.0671658986,0.932834101,2460.974137,3059.046638,4345.865876,4265.975986,8680,290.3981265,17360,-4145664,298496,-3847168,-1
7437,774,20,10,0.0942637925,0.905736208,2387.623918,2195.163604,4097.049213,4192.003876,8211,181.659292,16422,-3807744,396288,-3411456,-1
3416,133,25,5,0.0374753452,0.962524655,1019.694788,1103.1546,1786.1613,1488.330827,3549,222.9271357,7098,-1748992,68096,-1680896,-1
5782,783,19,11,0.11926885,0.88073115,1869.917939,1948.725173,3193.526116,3943.712644,6565,121.3269266,13130,-2960384,400896,-2559488,-1
8599,481,25,5,0.0529735683,0.947026432,2590.926536,2955.92809,4593.586812,3591.449064,9080,383.4459459,18160,-4402688,246272,-4156416,-1
2713,388,22,8,0.125120929,0.874879071,880.6261562,955.7536373,1515.959086,1796.015464,3101,59.63461538,6202,-1389056,198656,-1190400,-1
2237,216,22,8,0.0880554423,0.911944558,698.2750535,782.6863857,1243.554314,1055.555556,2453,83.3503228,4906,-1145344,110592,-1034752,-1
3518,269,21,9,0.0710324795,0.92896752,1075.613596,1301.099136,1896.793633,1857.464684,3787,277.0299927,7574,-1801216,137728,-1663488,-1
578,32,21,9,0.0524590164,0.947540984,172.355713,215.0977884,310.3961938,217.0625,610,59.45419103,1220,-295936,16384,-279552,-1
9465,506,21,9,0.0507471668,0.949252833,2839.76174,3436.339974,5026.588801,4226.764822,9971,826.097763,19942,-4846080,259072,-4587008,-1
1448,130,22,8,0.082382763,0.917617237,450.3030073,508.3410282,785.823895,830.4461538,1578,77.73399015,3156,-741376,66560,-674816,-1
7157,497,22,8,0.0649333682,0.935066632,2192.596482,2425.967744,3845.195333,3572.68008,7654,351.908046,15308,-3664384,254464,-3409920,-1
9541,436,21,9,0.0437005112,0.956299489,2865.13451,3059.95881,5029.335395,4106.33945,9977,1056.885593,19954,-4884992,223232,-4661760,-1
335,84,19,11,0.200477327,0.799522673,114.9710458,142.3272967,210.3731343,208.5119048,419,42.71151886,838,-171520,43008,-128512,-1
2788,170,21,9,0.0574712644,0.942528736,850.9348253,865.5328642,1494.35043,1235.952941,2958,255.4404145,5916,-1427456,87040,-1340416,-1
2641,186,20,10,0.0657941281,0.934205872,804.9083941,954.3532974,1421.591821,1306.204301,2827,146.9334719,5654,-1352192,95232,-1256960,-1
6258,597,21,9,0.0870897155,0.912910284,1942.551351,2325.671517,3428.112816,3426.81742,6855,164.8629149,13710,-3204096,305664,-2898432,-1
2109,307,17,13,0.127069536,0.872930464,684.2356519,782.001308,1206.491702,1222.296417,2416,85.19040903,4832,-1079808,157184,-922624,-1
3393,498,19,11,0.127987664,0.872012336,1077.273972,1328.166711,1886.777778,2349.495984,3891,161.6535106,7782,-1737216,254976,-1482240,-1
4370,452,19,11,0.0937370386,0.906262961,1383.745643,1458.693614,2394.124256,2579.49115,4822,107.0128717,9644,-2237440,231424,-2006016,-1
149,48,21,9,0.243654822,0.756345178,56.85879423,55.21714945,102.8456376,87.0625,197,26.30173565,394,-76288,24576,-51712,-1
3614,243,25,5,0.0630023334,0.936997667,1099.01109,1290.669685,1943.257886,1716.950617,3857,299.2242048,7714,-1850368,124416,-1725952,-1
8711,732,21,9,0.077517738,0.922482262,2691.172158,3018.291173,4661.423258,5442.879781,9443,250.6769312,18886,-4460032,374784,-4085248,-1
216,32,27,3,0.129032258,0.870967742,70.12416099,80.73756072,124.0694444,127.40625,248,48.72298625,496,-110592,16384,-94208,-1
9609,373,22,8,0.0373672611,0.962632739,2880.160164,2888.295422,5007.118431,4589.147453,9982,561.1017426,19964,-4919808,190976,-4728832,-1
6568,342,21,9,0.0494934877,0.950506512,1978.689162,2174.505534,3490.515225,2783.04386,6910,427.3345702,13820,-3362816,175104,-3187712,-1
1041,170,22,8,0.140379851,0.859620149,345.4901847,365.5192744,617.7636888,533.9647059,1211,31.66841004,2422,-532992,87040,-445952,-1
5743,290,23,7,0.0480689541,0.951931046,1737.849948,1813.74573,3017.751524,3002.117241,6033,446.2278107,12066,-2940416,148480,-2791936,-1
556,94,27,3,0.144615385,0.855384615,187.0594595,148.666027,344.2571942,214.5531915,650,17.42627346,1300,-284672,48128,-236544,-1
1200,182,24,6,0.131693198,0.868306802,383.9269769,486.5185442,691.3933333,692.2032967,1382,39.03954802,2764,-614400,93184,-521216,-1
9035,899,20,10,0.0904972821,0.909502718,2823.623828,3136.154125,4877.015938,5876.869855,9934,581.6159251,19868,-4625920,460288,-4165632,-1
4642,359,21,9,0.0717856429,0.928214357,1426.775361,1641.363744,2491.302456,2626.392758,5001,125.7164404,10002,-2376704,183808,-2192896,-1
8554,1016,22,8,0.106165099,0.893834901,2759.996712,2744.341381,4732.509235,5231.644685,9570,273.7414188,19140,-4379648,520192,-3859456,-1
2495,252,22,8,0.0917364398,0.90826356,796.5124287,740.71758,1358.857715,1523.920635,2747,222.6094003,5494,-1277440,129024,-1148416,-1
9483,487,21,9,0.0488465396,0.95115346,2875.464031,2867.878608,5015.257513,4406.053388,9970,1356.462585,19940,-4855296,249344,-4605952,-1
5171,310,21,9,0.0565590221,0.943440978,1558.2212,1936.314112,2747.310385,2635.73871,5481,445.247766,10962,-2647552,158720,-2488832,-1
1910,134,22,8,0.0655577299,0.93444227,580.6705389,703.9080137,1029.013089,929.6641791,2044,164.4408689,4088,-977920,68608,-909312,-1
4623,389,22,8,0.0776137271,0.922386273,1433.499563,1596.089808,2510.531473,2458.588689,5012,420.1173512,10024,-2366976,199168,-2167808,-1
2641,219,21,9,0.0765734266,0.923426573,807.2297755,1021.434471,1429.248769,1445.589041,2860,170.3394878,5720,-1352192,112128,-1240064,-1
1235,203,22,8,0.141168289,0.858831711,411.1795202,438.2774242,718.902834,723.1330049,1438,78.23721436,2876,-632320,103936,-528384,-1
455,66,23,7,0.126679463,0.873320537,141.3224819,192.4237724,252.5912088,318.969697,521,14.59383754,1042,-232960,33792,-199168,-1
2200,181,18,12,0.0760184796,0.92398152,677.3867328,707.2514247,1220.298636,834.8839779,2381,295.7763975,4762,-1126400,92672,-1033728,-1
4073,361,21,9,0.0814163284,0.918583672,1255.928217,1524.379854,2212.889271,2269.520776,4434,119.450431,8868,-2085376,184832,-1900544,-1
7609,406,20,10,0.0506550218,0.949344978,2299.615813,2504.710454,4036.484952,3474.152709,8015,466.2594532,16030,-3895808,207872,-3687936,-1
9611,372,22,8,0.0372633477,0.962736652,2869.229492,3116.59201,5017.930184,4322.067204,9983,791.6732752,19966,-4920832,190464,-4730368,-1
2632,238,20,10,0.0829268293,0.917073171,802.4611318,964.9492545,1394.43465,1889.634454,2870,84.56098998,5740,-1347584,121856,-1225728,-1
4914,510,21,9,0.0940265487,0.905973451,1560.944183,1586.06628,2740.709402,2440.694118,5424,199.2652461,10848,-2515968,261120,-2254848,-1
2666,247,17,13,0.0847923103,0.91520769,821.0488957,1031.108302,1455.644786,1471.62753,2913,236.4448052,5826,-1364992,126464,-1238528,-1
5822,347,20,10,0.0562489869,0.943751013,1763.328021,2042.303703,3096.799382,2887.028818,6169,473.0828221,12338,-2980864,177664,-2803200,-1
2680,154,21,9,0.0543401553,0.945659845,814.4462367,856.7335388,1428.572015,1224.818182,2834,186.939314,5668,-1372160,78848,-1293312,-1
9242,701,21,9,0.0705018606,0.929498139,2840.252584,3239.596969,4977.466674,4899.927247,9943,813.0008177,19886,-4731904,358912,-4372992,-1
3002,245,22,8,0.0754542655,0.924545735,908.3437829,1061.068226,1674.136909,1009.669388,3247,231.2678063,6494,-1537024,125440,-1411584,-1
120,55,21,9,0.314285714,0.685714286,44.6883273,60.08326454,83.30833333,98.23636364,175,17.00680272,350,-61440,28160,-33280,-1
71,27,18,12,0.275510204,0.724489796,28.04811379,24.31435643,54.56338028,36.18518519,98,21.21212121,196,-36352,13824,-22528,-1
568,52,20,10,0.0838709677,0.916129032,175.8109273,188.8539821,318.6461268,221.5192308,620,95.09202454,1240,-290816,26624,-264192,-1
5476,417,21,9,0.0707619209,0.929238079,1692.733537,1799.39186,2960.092221,2775.074341,5893,361.5337423,11786,-2803712,213504,-2590208,-1
448,106,20,10,0.19133574,0.80866426,156.4472388,171.6673539,283.3571429,252.745283,554,50.13574661,1108,-229376,54272,-175104,-1
9160,494,20,10,0.0511704993,0.948829501,2773.127366,2957.011503,4862.326638,4181.726721,9654,317.357002,19308,-4689920,252928,-4436992,-1
3696,251,22,8,0.063592602,0.936407398,1127.88978,1292.371512,1981.292749,1866.613546,3947,91.00760895,7894,-1892352,128512,-1763840,-1
9267,665,24,6,0.066955296,0.933044704,2866.559323,2871.137333,4976.750297,4823.658647,9932,521.0912907,19864,-4744704,340480,-4404224,-1
1620,167,19,11,0.093452714,0.906547286,492.770897,665.9205383,915.6376543,684.1017964,1787,68.81016558,3574,-829440,85504,-743936,-1
8944,396,25,5,0.0423982869,0.957601713,2691.748835,2789.398814,4678.452706,4490.881313,9340,174.1562558,18680,-4579328,202752,-4376576,-1
5132,393,17,13,0.0711312217,0.928868778,1584.828464,1692.902846,2786.025526,2462.320611,5525,201.9371345,11050,-2627584,201216,-2426368,-1
4927,315,19,11,0.0600915681,0.939908432,1493.089746,1794.933276,2613.812868,2741.736508,5242,161.1931119,10484,-2522624,161280,-2361344,-1
1272,61,27,3,0.0457614404,0.95423856,382.2916731,410.5445339,673.577044,529.852459,1333,251.0357815,2666,-651264,31232,-620032,-1
4982,281,24,6,0.0533916017,0.946608398,1508.141991,1556.678594,2670.168808,1955.284698,5263,296.5070423,10526,-2550784,143872,-2406912,-1
7305,406,20,10,0.0526520555,0.947347944,2215.918118,2398.195912,3860.618891,3772.894089,7711,268.4888579,15422,-3740160,207872,-3532288,-1
6129,330,20,10,0.0510915002,0.9489085,1850.139411,2040.486816,3259.078153,2689.939394,6459,238.780037,12918,-3138048,168960,-2969088,-1
395,56,20,10,0.124168514,0.875831486,129.7316115,128.7287418,230.6405063,193.2678571,451,73.81342062,902,-202240,28672,-173568,-1
4719,632,19,11,0.118108765,0.881891235,1534.000045,1621.532094,2682.556898,2627.041139,5351,107.4282273,10702,-2416128,323584,-2092544,-1
7188,393,20,10,0.0518401266,0.948159873,2190.408341,2099.53137,3816.203534,3330.025445,7581,472.3364486,15162,-3680256,201216,-3479040,-1
6623,1342,20,10,0.168487131,0.831512869,2243.689809,2350.379905,3797.378982,4899.071535,7965,147.4726902,15930,-3390976,687104,-2703872,-1
1418,149,21,9,0.0950861519,0.904913848,450.3813855,451.7888544,797.2066291,658.3154362,1567,48.03801349,3134,-726016,76288,-649728,-1
1666,141,21,9,0.0780298838,0.921970116,505.1038457,678.268857,913.1272509,796.1560284,1807,47.40293809,3614,-852992,72192,-780800,-1
199,43,26,4,0.17768595,0.82231405,69.70561604,67.09095559,125.7839196,101.6744186,242,24.94845361,484,-101888,22016,-79872,-1
639,152,21,9,0.19216182,0.80783818,230.0934613,197.7204981,417.0250391,307.6118421,791,26.84085511,1582,-327168,77824,-249344,-1
8735,371,21,9,0.0407423677,0.959257632,2622.550755,2694.068314,4580.110475,3926.97035,9106,728.48,18212,-4472320,189952,-4282368,-1
6791,427,21,9,0.0591576614,0.940842339,2066.085041,2208.377395,3657.693271,2843.035129,7218,333.8575393,14436,-3476992,218624,-3258368,-1
36,20,20,10,0.357142857,0.642857143,16.5447392,15.44020725,28.77777778,28,56,15.30054645,112,-18432,10240,-8192,-1
4877,351,25,5,0.0671384851,0.932861515,1496.170714,1675.555679,2606.277835,2728.74359,5228,425.0406504,10456,-2497024,179712,-2317312,-1
8140,450,21,9,0.0523864959,0.947613504,2464.574308,2699.914605,4320.394717,3845.182222,8590,347.3513951,17180,-4167680,230400,-3937280,-1
1409,101,20,10,0.0668874172,0.933112583,433.1829662,406.1668848,772.171753,522.9207921,1510,252.0868114,3020,-721408,51712,-669696,-1
325,84,18,12,0.205378973,0.794621027,116.306537,101.4872141,221.6738462,140.4880952,409,10.90085288,818,-166400,43008,-123392,-1
5693,468,21,9,0.0759616945,0.924038305,1758.338373,1985.931449,3104.422976,2796.070513,6161,140.5337591,12322,-2914816,239616,-2675200,-1
9602,384,20,10,0.0384538354,0.961546165,2865.882563,3132.225945,5031.073318,4053.971354,9986,996.6067864,19972,-4916224,196608,-4719616,-1
1688,189,17,13,0.100692595,0.899307405,531.656655,588.2902348,961.5675355,737.4444444,1877,206.7180617,3754,-864256,96768,-767488,-1
92,24,23,7,0.206896552,0.793103448,33.67017269,31.53690519,60.56521739,50.58333333,116,2.345329559,232,-47104,12288,-34816,-1
2371,160,20,10,0.0632161201,0.93678388,718.9018235,789.1739985,1292.3779,875.1125,2531,229.2572464,5062,-1213952,81920,-1132032,-1
9452,514,20,10,0.0515753562,0.948424644,2862.681919,3126.541417,4987.605269,4908.007782,9966,243.1324713,19932,-4839424,263168,-4576256,-1
9601,384,25,5,0.0384576865,0.961542313,2877.294924,2956.080622,5014.771586,4448.653646,9985,374.5311328,19970,-4915712,196608,-4719104,-1
3902,275,21,9,0.0658367249,0.934163275,1203.168476,1222.539134,2104.101999,1874.716364,4177,315.9606657,8354,-1997824,140800,-1857024,-1
759,149,22,8,0.164096916,0.835903084,254.824237,296.4854593,454.9064559,452.4295302,908,88.15533981,1816,-388608,76288,-312320,-1
585,62,18,12,0.0958268934,0.904173107,180.0228789,165.419185,341.7094017,156.9032258,647,19.21021378,1294,-299520,31744,-267776,-1
6439,413,21,9,0.0602743724,0.939725628,1961.052576,1994.613319,3487.892841,2469.336562,6852,160.3182031,13704,-3296768,211456,-3085312,-1
8929,460,21,9,0.048993503,0.951006497,2697.796368,2926.801141,4710.885318,4386.652174,9389,346.5854559,18778,-4571648,235520,-4336128,-1
9071,857,20,10,0.0863215149,0.913678485,2829.230628,3224.625402,4948.843126,5130.221704,9928,579.9065421,19856,-4644352,438784,-4205568,-1
259,41,20,10,0.136666667,0.863333333,84.01554249,62.99041975,162.1930502,76.63414634,300,47.02194357,600,-132608,20992,-111616,-1
6180,384,19,11,0.0585009141,0.941499086,1871.339887,2218.78286,3264.080583,3578.9375,6564,173.1926121,13128,-3164160,196608,-2967552,-1
2165,239,23,7,0.0994176373,0.900582363,688.7025058,697.1540595,1228.504388,966.9372385,2404,101.6920474,4808,-1108480,122368,-986112,-1
6207,767,22,8,0.109979925,0.890020075,1994.991905,1973.941304,3588.316256,2671.637549,6974,229.785832,13948,-3177984,392704,-2785280,-1
4274,419,21,9,0.0892819092,0.910718091,1336.543113,1522.181625,2334.376228,2475.768496,4693,240.6666667,9386,-2188288,214528,-1973760,-1
6566,622,22,8,0.0865331107,0.913466889,1993.959196,2609.006215,3504.89339,4540.411576,7188,284.447962,14376,-3361792,318464,-3043328,-1
2704,395,21,9,0.127460471,0.872539529,880.9336195,958.5258881,1520.196746,1754.020253,3099,128.6425903,6198,-1384448,202240,-1182208,-1
3759,434,21,9,0.103505843,0.896494157,1206.17399,1246.507579,2098.016228,2088.198157,4193,104.1221753,8386,-1924608,222208,-1702400,-1
745,129,20,10,0.147597254,0.852402746,247.7565862,271.7609827,446.1516779,387.5348837,874,23.51991389,1748,-381440,66048,-315392,-1
3220,307,22,8,0.0870428126,0.912957187,1006.835076,1129.863997,1761.913043,1785.889251,3527,73.37216559,7054,-1648640,157184,-1491456,-1
2118,196,21,9,0.084701815,0.915298185,640.8603581,814.0381225,1193.71577,766.1479592,2314,164.3465909,4628,-1084416,100352,-984064,-1
3355,256,17,13,0.0708944891,0.929105511,1016.264234,1334.163501,1814.028316,1700.785156,3611,335.5947955,7222,-1717760,131072,-1586688,-1
6362,295,19,11,0.0443142557,0.955685744,1902.354097,2119.910136,3369.424238,2457.20678,6657,273.3880903,13314,-3257344,151040,-3106304,-1
9606,377,20,10,0.0377641991,0.962235801,2870.026058,3067.794712,5022.451385,4216.095491,9983,948.0531814,19966,-4918272,193024,-4725248,-1
1088,65,21,9,0.0563746748,0.943625325,328.7565347,388.7774332,581.0551471,509.1230769,1153,128.1111111,2306,-557056,33280,-523776,-1
7236,336,20,10,0.0443740095,0.95562599,2169.904667,2446.865225,3810.790077,3263.395833,7572,564.2324888,15144,-3704832,172032,-3532800,-1
9467,497,20,10,0.0498795664,0.950120434,2860.932337,3085.16947,5016.485581,4335.132797,9964,898.4670875,19928,-4847104,254464,-4592640,-1
1972,202,22,8,0.0929162833,0.907083717,620.5546844,689.5029088,1093.700811,1026.965347,2174,125.7374205,4348,-1009664,103424,-906240,-1
2450,241,22,8,0.0895577852,0.910442215,755.7832428,959.0513788,1335.92898,1448.381743,2691,99.26226485,5382,-1254400,123392,-1131008,-1
2261,319,21,9,0.123643411,0.876356589,741.5591346,766.735236,1286.841663,1316.429467,2580,54.25867508,5160,-1157632,163328,-994304,-1
5568,715,16,14,0.113799141,0.886200859,1770.577083,2114.781659,3160.062141,3001.342657,6283,247.4596298,12566,-2850816,366080,-2484736,-1
7455,779,20,10,0.0946077241,0.905392276,2373.465346,2398.868541,4140.560027,3896.816431,8234,535.022742,16468,-3816960,398848,-3418112,-1
7703,1013,20,10,0.116223038,0.883776962,2458.583516,2655.038371,4209.274439,5493.232971,8716,160.4270201,17432,-3943936,518656,-3425280,-1
4972,374,20,10,0.0699588477,0.930041152,1512.708983,1818.149489,2632.654063,3216.510695,5346,109.1243111,10692,-2545664,191488,-2354176,-1
123,33,19,11,0.211538462,0.788461538,43.97365498,43.02174477,83.97560976,58.09090909,156,47.70642202,312,-62976,16896,-46080,-1
203,28,20,10,0.121212121,0.878787879,64.06422066,49.43275168,124.6600985,53.21428571,231,46.95121951,462,-103936,14336,-89600,-1
151,73,19,11,0.325892857,0.674107143,62.02339298,68.06131815,106.3443709,125.2328767,224,36.48208469,448,-77312,37376,-39936,-1
2161,152,17,13,0.065715521,0.934284479,660.2301809,758.1653058,1164.492827,1050.473684,2313,179.4414275,4626,-1106432,77824,-1028608,-1
7618,359,20,10,0.0450043876,0.954995612,2283.30559,2676.571607,3997.245996,3814.019499,7977,396.471173,15954,-3900416,183808,-3716608,-1
38,17,21,9,0.309090909,0.690909091,15.73534582,16.09186431,28.63157895,26.58823529,55,7.124352332,110,-19456,8704,-10752,-1
1123,60,20,10,0.0507185123,0.949281488,336.4920539,418.5553126,595.6874443,522.9833333,1183,122.4637681,2366,-574976,30720,-544256,-1
9381,565,17,13,0.0568067565,0.943193244,2858.455411,2708.070588,5058.642469,3559.833628,9946,494.8258706,19892,-4803072,289280,-4513792,-1
614,57,17,13,0.084947839,0.915052161,189.8136725,191.755829,347.5130293,211.9824561,671,82.12974296,1342,-314368,29184,-285184,-1
5422,381,20,10,0.0656556953,0.934344305,1645.226174,2051.780192,2894.586315,3007.503937,5803,341.9563936,11606,-2776064,195072,-2580992,-1
9291,649,19,11,0.0652917505,0.934708249,2848.008434,3155.021187,4982.749435,4795.138675,9940,583.6758661,19880,-4756992,332288,-4424704,-1
9421,537,21,9,0.0539264913,0.946073509,2849.442363,3247.970386,5006.844284,4499.778399,9958,548.952591,19916,-4823552,274944,-4548608,-1
117,34,21,9,0.225165563,0.774834437,43.71471444,39.87202712,80.22222222,61.47058824,151,3.621103118,302,-59904,17408,-42496,-1
1239,149,20,10,0.107348703,0.892651297,395.135307,440.399579,701.0193705,640.2885906,1388,95.06849315,2776,-634368,76288,-558080,-1
5102,391,27,3,0.0711815037,0.928818496,1549.13907,1982.903351,2767.592905,2478.29156,5493,109.8160736,10986,-2612224,200192,-2412032,-1
5284,229,24,6,0.0415381825,0.958461818,1577.899991,1874.037693,2752.192657,2867.925764,5513,155.6904829,11026,-2705408,117248,-2588160,-1
2608,341,19,11,0.115632418,0.884367582,845.1579071,875.3181882,1450.947469,1658.956012,2949,169.9711816,5898,-1335296,174592,-1160704,-1
205,41,16,14,0.166666667,0.833333333,68.31813533,80.73108098,127.1658537,105.1707317,246,39.10969793,492,-104960,20992,-83968,-1
4148,400,22,8,0.0879507476,0.912049252,1293.221345,1459.752514,2242.006509,2611.4575,4548,207.1038251,9096,-2123776,204800,-1918976,-1
9317,631,17,13,0.0634298351,0.936570165,2821.820448,3351.813721,5046.563808,3910.445325,9948,1038.413361,19896,-4770304,323072,-4447232,-1
4578,669,20,10,0.127501429,0.872498571,1473.54678,1553.650651,2508.055046,3417.41704,5247,113.5960165,10494,-2343936,342528,-2001408,-1
2300,195,16,14,0.0781563126,0.921843687,700.6507724,913.7005299,1238.98,1354.389744,2495,128.5419887,4990,-1177600,99840,-1077760,-1
7038,1015,27,3,0.126039985,0.873960015,2328.610106,2294.724527,4012.025007,4130.836453,8053,178.7172659,16106,-3603456,519680,-3083776,-1
8510,1041,20,10,0.108993823,0.891006177,2743.184677,2803.184126,4705.642421,5351.161383,9551,184.5247295,19102,-4357120,532992,-3824128,-1
9484,482,21,9,0.0483644391,0.951635561,2867.260391,3053.889374,4993.917229,4778.526971,9966,1072.766416,19932,-4855808,246784,-4609024,-1
3651,235,24,6,0.0604734946,0.939526505,1108.508155,1243.240215,1969.453027,1540.289362,3886,83.40845675,7772,-1869312,120320,-1748992,-1
8399,613,21,9,0.0680204172,0.931979583,2581.400443,2406.821656,4615.77795,3009.231648,9012,187.1262458,18024,-4300288,313856,-3986432,-1
7640,496,20,10,0.0609636185,0.939036382,2323.969656,2665.350753,4095.866754,3646.96371,8136,317.3166927,16272,-3911680,253952,-3657728,-1
673,115,22,8,0.145939086,0.854060914,225.2875589,239.5140755,396.5973254,382.226087,788,60.84942085,1576,-344576,58880,-285696,-1
3746,199,21,9,0.0504435995,0.949556401,1127.248565,1185.87269,2005.0937,1368.864322,3945,77.27717924,7890,-1917952,101888,-1816064,-1
1823,89,21,9,0.0465481172,0.953451883,545.9088617,659.7886328,959.9051015,886.752809,1912,82.13058419,3824,-933376,45568,-887808,-1
3495,275,21,9,0.0729442971,0.927055703,1071.798853,1167.127296,1925.255508,1380.243636,3770,197.7964323,7540,-1789440,140800,-1648640,-1
236,16,21,9,0.0634920635,0.936507937,71.02503835,60.97229776,131.2415254,56.5625,252,29.82248521,504,-120832,8192,-112640,-1
3160,197,20,10,0.0586833482,0.941316652,959.7188273,1095.532629,1668.765823,1843.162437,3357,66.47524752,6714,-1617920,100864,-1517056,-1
1381,137,21,9,0.0902503294,0.909749671,431.124977,499.6961591,765.7813179,696.1824818,1518,93.35793358,3036,-707072,70144,-636928,-1
6581,263,17,13,0.03842782,0.96157218,1964.682244,2168.53785,3443.472725,2897.703422,6844,592.0415225,13688,-3369472,134656,-3234816,-1
699,122,18,12,0.148599269,0.851400731,234.6438509,250.0332594,411.8226037,406.2868852,821,123.8310709,1642,-357888,62464,-295424,-1
1260,119,20,10,0.0862944162,0.913705584,393.7301436,440.8203063,687.7150794,714.1932773,1379,54.12087912,2758,-645120,60928,-584192,-1
1790,99,19,11,0.0524086818,0.947591318,534.7832786,628.144656,962.7189944,624.6262626,1889,118.284283,3778,-916480,50688,-865792,-1
9178,743,22,8,0.074891644,0.925108356,2856.460183,2954.185516,4956.114186,5021.352624,9921,784.2687747,19842,-4699136,380416,-4318720,-1
712,82,27,3,0.103274559,0.896725441,227.5693738,241.326872,400.5772472,370.7804878,794,110.5849582,1588,-364544,41984,-322560,-1
4587,558,18,12,0.10845481,0.89154519,1480.893423,1487.563564,2536.878134,2869.937276,5145,97.66514806,10290,-2348544,285696,-2062848,-1
4987,446,21,9,0.0820909258,0.917909074,1532.757303,1917.663057,2728.276519,2590.910314,5433,175.1450677,10866,-2553344,228352,-2324992,-1
4863,237,22,8,0.0464705882,0.953529412,1470.828576,1488.828642,2559.568785,2364.417722,5100,377.2189349,10200,-2489856,121344,-2368512,-1
189,31,23,7,0.140909091,0.859090909,62.36238443,68.61626241,112.6719577,97.25806452,220,49.77375566,440,-96768,15872,-80896,-1
92,30,19,11,0.245901639,0.754098361,36.08150005,25.75862315,67.07608696,44.4,122,25,244,-47104,15360,-31744,-1
9563,413,27,3,0.0413993585,0.958600642,2876.597076,2892.572254,5013.743386,4403.990315,9976,736.7799114,19952,-4896256,211456,-4684800,-1
6088,352,18,12,0.0546583851,0.945341615,1837.152389,2009.403152,3271.388633,2340.357955,6440,118.5348794,12880,-3117056,180224,-2936832,-1
3781,308,21,9,0.0753240401,0.92467596,1147.823525,1499.516009,2023.456757,2309.464286,4089,193.6079545,8178,-1935872,157696,-1778176,-1
8429,1492,20,10,0.150388066,0.849611934,2756.949902,2722.009411,4627.007356,6847.879357,9921,498.5427136,19842,-4315648,763904,-3551744,-1
112,34,19,11,0.232876712,0.767123288,41.21400621,40.17250863,78.9375,55.58823529,146,29.91803279,292,-57344,17408,-39936,-1
70,27,20,10,0.278350515,0.721649485,29.44701572,20.40219736,53.04285714,38.51851852,97,20.995671,194,-35840,13824,-22016,-1
4828,610,25,5,0.112173593,0.887826407,1539.718421,1740.312466,2669.5058,3115.191803,5438,178.5292186,10876,-2471936,312320,-2159616,-1
2238,280,19,11,0.111199365,0.888800635,709.2995814,847.3326741,1246.449508,1363.810714,2518,131.4882507,5036,-1145856,143360,-1002496,-1
7031,320,20,10,0.0435314923,0.956468508,2111.803065,2321.942346,3687.347746,3426.66875,7351,388.5306554,14702,-3599872,163840,-3436032,-1
9564,413,25,5,0.041395209,0.958604791,2861.155394,3096.948583,5035.78074,3905.680387,9977,663.8057219,19954,-4896768,211456,-4685312,-1
9513,455,21,9,0.0456460674,0.954353933,2871.408549,2890.683761,5022.397771,4192.145055,9968,996.8,19936,-4870656,232960,-4637696,-1
1568,136,22,8,0.0798122066,0.920187793,487.4298473,538.2550937,848.1377551,902.7941176,1704,84.02366864,3408,-802816,69632,-733184,-1
9552,424,21,9,0.0425020048,0.957497995,2867.827148,3030.816132,5023.809045,4193.04717,9976,999.5991984,19952,-4890624,217088,-4673536,-1
466,18,27,3,0.0371900826,0.962809917,139.076709,155.4119575,242.5236052,241.8888889,484,61.26582278,968,-238592,9216,-229376,-1
4131,252,27,3,0.0574948665,0.942505133,1257.743949,1356.640858,2207.824982,1932.583333,4383,101.434853,8766,-2115072,129024,-1986048,-1
9255,674,17,13,0.0678819619,0.932118038,2841.367803,3182.78322,4951.687304,5147.802671,9929,193.0209953,19858,-4738560,345088,-4393472,-1
3540,250,19,11,0.0659630607,0.934036939,1067.428011,1320.475611,1860.097458,2396.8,3790,120.7390889,7580,-1812480,128000,-1684480,-1
2778,231,25,5,0.0767696909,0.923230309,864.392228,916.8705727,1508.607271,1461.619048,3009,95.37242472,6018,-1422336,118272,-1304064,-1
1861,187,17,13,0.0913085938,0.908691406,573.7262511,728.2044875,1038.674369,883.4385027,2048,162.5396825,4096,-952832,95744,-857088,-1
6747,305,18,12,0.0432501418,0.956749858,2029.606096,2139.961964,3541.56929,3193.147541,7052,402.9714286,14104,-3454464,156160,-3298304,-1
5246,505,22,8,0.0878108155,0.912189184,1631.500823,1674.16036,2787.159931,3798.881188,5751,138.6117137,11502,-2685952,258560,-2427392,-1
9518,451,27,3,0.0452402448,0.954759755,2855.391704,3064.35025,5043.621244,3747.844789,9969,1287.984496,19938,-4873216,230912,-4642304,-1
130,27,20,10,0.171974522,0.828025478,43.47734838,51.68733159,81.46923077,67.11111111,157,18.10841984,314,-66560,13824,-52736,-1
1679,276,19,11,0.141176471,0.858823529,519.0295172,699.4097969,923.4800476,1309.663043,1955,39.35977451,3910,-859648,141312,-718336,-1
7534,1297,21,9,0.146868984,0.853131016,2443.314905,2513.163174,4129.065437,6082.742483,8831,158.9738974,17662,-3857408,664064,-3193344,-1
676,115,17,13,0.145385588,0.854614412,218.5420589,231.4955372,420.5118343,251.9130435,791,61.17556071,1582,-346112,58880,-287232,-1
75,24,18,12,0.242424242,0.757575758,28.50465849,17.6799773,56.33333333,30.20833333,99,15.76433121,198,-38400,12288,-26112,-1
7087,365,22,8,0.0489801396,0.95101986,2130.129627,2487.340473,3704.437138,4154.882192,7452,554.0520446,14904,-3628544,186880,-3441664,-1
93,31,21,9,0.25,0.75,36.05630481,30.89312246,67.24731183,48.25806452,124,25.77962578,248,-47616,15872,-31744,-1
9413,548,21,9,0.0550145568,0.944985443,2845.669088,3156.915692,5043.846914,3901.478102,9961,295.4033215,19922,-4819456,280576,-4538880,-1
2614,285,21,9,0.098309762,0.901690238,822.5574828,926.7947301,1424.804132,1681.094737,2899,82.33456404,5798,-1338368,145920,-1192448,-1
548,109,17,13,0.165905632,0.834094368,184.2520734,213.2102335,333.7262774,305.2385321,657,113.4715026,1314,-280576,55808,-224768,-1
1500,180,27,3,0.107142857,0.892857143,480.5738137,507.4663741,853.47,732.4166667,1680,77.92207792,3360,-768000,92160,-675840,-1
562,63,16,14,0.1008,0.8992,174.2879263,187.7575027,326.7402135,190.4285714,625,70.54176072,1250,-287744,32256,-255488,-1
213,88,17,13,0.292358804,0.707641196,85.47946232,90.01028121,153.1126761,145.8863636,301,5.745371254,602,-109056,45056,-64000,-1
114,31,20,10,0.213793103,0.786206897,41.429051,28.89044216,80.80701754,44.29032258,145,26.85185185,290,-58368,15872,-42496,-1
856,120,20,10,0.12295082,0.87704918,280.2931058,274.4280161,501.5619159,395.325,976,75.54179567,1952,-438272,61440,-376832,-1
1971,148,20,10,0.0698442662,0.930155734,601.6366556,731.8916921,1062.473364,1027.060811,2119,293.4903047,4238,-1009152,75776,-933376,-1
9617,369,17,13,0.0369517324,0.963048268,2868.321848,3134.775655,5023.617344,4208.571816,9986,500.8024072,19972,-4923904,188928,-4734976,-1
1514,165,20,10,0.0982727814,0.901727219,477.2831114,517.6638956,858.5944518,669.3818182,1679,31.64938737,3358,-775168,84480,-690688,-1
92,24,23,7,0.206896552,0.793103448,33.70411359,31.46291357,60.51086957,50.79166667,116,2.318608835,232,-47104,12288,-34816,-1
8992,920,22,8,0.0928167877,0.907183212,2849.783029,2878.398378,4884.381673,5661.378261,9912,781.0874704,19824,-4603904,471040,-4132864,-1
1308,43,27,3,0.0318282754,0.968171725,389.3729317,408.4192615,676.4090214,663.5581395,1351,112.5833333,2702,-669696,22016,-647680,-1
1487,83,21,9,0.052866242,0.947133758,448.9230309,500.5257413,793.9731002,633.6987952,1570,120.5837174,3140,-761344,42496,-718848,-1
343,29,21,9,0.0779569892,0.922043011,103.9504168,108.5592382,193.9125364,98.82758621,372,79.82832618,744,-175616,14848,-160768,-1
9524,451,20,10,0.0452130326,0.954786967,2872.434888,2937.149023,5021.598068,4278.492239,9975,955.4597701,19950,-4876288,230912,-4645376,-1
1808,90,19,11,0.0474183351,0.952581665,539.2207258,621.4258782,965.1449115,635.2111111,1898,309.6247961,3796,-925696,46080,-879616,-1
4689,361,21,9,0.0714851485,0.928514851,1424.979502,1736.352224,2482.269141,3087.022161,5050,259.1072345,10100,-2400768,184832,-2215936,-1
2768,160,21,9,0.0546448087,0.945355191,835.9725839,890.8006222,1489.028179,1040.1625,2928,231.6455696,5856,-1417216,81920,-1335296,-1
1460,197,21,9,0.118889559,0.881110441,467.9874169,537.2760591,843.2773973,723.1878173,1657,31.09984985,3314,-747520,100864,-646656,-1
448,58,23,7,0.114624506,0.885375494,138.549529,188.8087098,247.7611607,297.8275862,506,12.93456033,1012,-229376,29696,-199680,-1
8292,907,21,9,0.0985976737,0.901402326,2546.54238,3495.315369,4586.26218,4725.594267,9199,172.4273664,18398,-4245504,464384,-3781120,-1
8561,1032,20,10,0.107578443,0.892421557,2737.37738,2805.849145,4669.555426,5854.221899,9593,177.156048,19186,-4383232,528384,-3854848,-1
149,29,21,9,0.162921348,0.837078652,48.70006119,63.21582231,88.63087248,93.96551724,178,8.721215091,356,-76288,14848,-61440,-1
3234,553,19,11,0.146025878,0.853974122,1039.129125,1221.075829,1796.781076,2462.546112,3787,274.2215786,7574,-1655808,283136,-1372672,-1
2186,240,21,9,0.098928277,0.901071723,691.2788495,775.7473531,1219.52699,1158.604167,2426,85.72438163,4852,-1119232,122880,-996352,-1
4960,365,21,9,0.0685446009,0.931455399,1521.978923,1676.648649,2632.504234,3077.408219,5325,112.9374337,10650,-2539520,186880,-2352640,-1
9170,751,20,10,0.0756980143,0.924301986,2829.085974,3229.529935,4926.178517,5386.183755,9921,1024.896694,19842,-4695040,384512,-4310528,-1
7026,571,20,10,0.0751612479,0.924838752,2143.234067,2562.981282,3724.876032,4711.075306,7597,170.6807459,15194,-3597312,292352,-3304960,-1
9477,491,18,12,0.0492576244,0.950742376,2856.685269,3208.685871,5011.689353,4459.706721,9968,1005.852674,19936,-4852224,251392,-4600832,-1
235,56,20,10,0.192439863,0.807560137,82.85182812,84.79325848,151.5574468,122.6785714,291,21.19446468,582,-120320,28672,-91648,-1
9536,444,22,8,0.044488978,0.955511022,2861.554337,3125.698501,5034.288066,4050.042793,9980,931.8394024,19960,-4882432,227328,-4655104,-1
4635,344,21,9,0.0690901788,0.930909821,1402.300234,1808.938161,2516.13808,2137.819767,4979,337.559322,9958,-2373120,176128,-2196992,-1
6061,846,20,10,0.122484436,0.877515564,1909.645814,2269.49495,3311.928065,4471.846336,6907,133.7529047,13814,-3103232,433152,-2670080,-1
6327,522,21,9,0.0762155059,0.923784494,1965.678047,2105.808924,3436.816501,3281.775862,6849,140.4634947,13698,-3239424,267264,-2972160,-1
130,20,20,10,0.133333333,0.866666667,41.70965364,31.31788626,81.53076923,36.3,150,5.630630631,300,-66560,10240,-56320,-1
9253,694,20,10,0.0697697798,0.93023022,2831.334118,3200.23379,5048.267913,3983.79683,9947,341.2349914,19894,-4737536,355328,-4382208,-1
7568,842,25,5,0.100118906,0.899881094,2393.964118,2640.822054,4140.044794,4793.819477,8410,220.3301022,16820,-3874816,431104,-3443712,-1
9532,441,21,9,0.0442193924,0.955780608,2866.919594,3025.411796,5022.908414,4210.857143,9973,717.9985601,19946,-4880384,225792,-4654592,-1
6310,2101,23,7,0.249791939,0.750208061,2115.770207,2223.540518,3547.550555,6183.542123,8411,274.0632128,16822,-3230720,1075712,-2155008,-1
466,104,17,13,0.18245614,0.81754386,156.3381101,176.1341986,303.3798283,205.3846154,570,79.16666667,1140,-238592,53248,-185344,-1
5824,365,22,8,0.0589756019,0.941024398,1767.833075,2028.391124,3117.955185,2728.723288,6189,417.329737,12378,-2981888,186880,-2795008,-1
6444,282,20,10,0.041926851,0.958073149,1920.566776,2168.493453,3404.728119,2421.393617,6726,337.9899497,13452,-3299328,144384,-3154944,-1
6979,675,16,14,0.0881891821,0.911810818,2141.480947,2421.849326,3960.614128,2451.198519,7654,506.8874172,15308,-3573248,345600,-3227648,-1
5312,652,21,9,0.109322602,0.890677398,1677.272523,2040.46186,3002.481551,2819.705521,5964,117.4709474,11928,-2719744,333824,-2385920,-1
9610,377,22,8,0.0377490738,0.962250926,2876.06109,3030.769558,5008.631113,4621.04244,9987,686.3917526,19974,-4920320,193024,-4727296,-1
2272,177,22,8,0.0722743977,0.927725602,699.1963291,799.6418465,1223.159771,1248.621469,2449,61.34769539,4898,-1163264,90624,-1072640,-1
1008,59,18,12,0.0552952202,0.94470478,302.834788,348.5836718,543.4236111,373,1067,46.07081174,2134,-516096,30208,-485888,-1
1505,226,25,5,0.13056037,0.86943963,488.6007555,565.09321,857.8451827,920.3053097,1731,38.01054018,3462,-770560,115712,-654848,-1
7517,1131,18,12,0.130781684,0.869218316,2472.27535,2454.015402,4183.602235,5260.953139,8648,167.9223301,17296,-3848704,579072,-3269632,-1
8508,1344,21,9,0.136419001,0.863580999,2851.273933,2796.008319,4912.140339,5017.401786,9852,208.7288136,19704,-4356096,688128,-3667968,-1
3154,263,21,9,0.0769681007,0.923031899,976.8739697,1059.070865,1731.043754,1444.642586,3417,96.44369179,6834,-1614848,134656,-1480192,-1
4785,416,20,10,0.0799846183,0.920015382,1482.043247,1562.535304,2658.588088,1938.598558,5201,223.0274443,10402,-2449920,212992,-2236928,-1
4387,512,21,9,0.104511125,0.895488875,1415.938951,1398.883686,2445.803738,2485.955078,4899,131.5874295,9798,-2246144,262144,-1984000,-1
8831,1051,22,8,0.106354989,0.893645011,2854.155532,2777.275067,4874.543993,5504.096099,9882,436.4840989,19764,-4521472,538112,-3983360,-1
9094,811,23,7,0.0818778395,0.918122161,2842.201992,2925.000684,5025.254673,4142.78545,9905,1003.546099,19810,-4656128,415232,-4240896,-1
5683,537,22,8,0.0863344051,0.913665595,1810.344583,1606.303599,3135.983459,2840.811918,6220,155.6556557,12440,-2909696,274944,-2634752,-1
7158,1096,21,9,0.132784105,0.867215895,2357.545733,2334.517126,3984.420229,5061.957117,8254,163.9976157,16508,-3664896,561152,-3103744,-1
4470,245,19,11,0.051961824,0.948038176,1336.829853,1728.887375,2370.893512,2122.759184,4715,330.877193,9430,-2288640,125440,-2163200,-1
9565,414,20,10,0.041487123,0.958512877,2860.216934,3107.047527,5039.417878,3848.256039,9979,748.612153,19958,-4897280,211968,-4685312,-1
210,19,25,5,0.0829694323,0.917030568,65.17691761,75.61559,114.947619,115.5789474,229,45.256917,458,-107520,9728,-97792,-1
9564,418,21,9,0.0418753757,0.958124624,2864.661616,3091.211739,5033.609368,4028.021531,9982,546.3601533,19964,-4896768,214016,-4682752,-1
1902,312,20,10,0.140921409,0.859078591,624.9896762,718.1458014,1113.755521,1069.365385,2214,51.13163972,4428,-973824,159744,-814080,-1
9621,364,19,11,0.036454682,0.963545318,2882.241767,2885.797501,4996.293629,4905.945055,9985,1286.726804,19970,-4925952,186368,-4739584,-1
7553,471,21,9,0.0586989033,0.941301097,2301.781137,2518.522391,4031.613928,3705.987261,8024,192.791927,16048,-3867136,241152,-3625984,-1
184,30,18,12,0.140186916,0.859813084,58.78291596,49.37808781,116.5597826,51.93333333,214,22.01646091,428,-94208,15360,-78848,-1
2527,155,20,10,0.057792692,0.942207308,758.0038788,970.9671467,1356.313019,1100,2682,215.4216867,5364,-1293824,79360,-1214464,-1
9126,805,22,8,0.0810593092,0.918940691,2877.133347,2729.759632,4939.746548,5263.626087,9931,204.1735197,19862,-4672512,412160,-4260352,-1
1129,158,17,13,0.122766123,0.877233877,353.3622547,481.4670596,646.2595217,627.8544304,1287,85.06278916,2574,-578048,80896,-497152,-1
819,107,17,13,0.115550756,0.884449244,262.180941,295.3766748,472.1953602,396.9439252,926,95.66115702,1852,-419328,54784,-364544,-1
4539,373,20,10,0.0759364821,0.924063518,1398.988349,1570.792788,2491.294558,2033.088472,4912,124.4489486,9824,-2323968,190976,-2132992,-1
9211,532,22,8,0.0546033049,0.945396695,2801.837956,2893.694702,4914.749213,4131.843985,9743,565.1392111,19486,-4716032,272384,-4443648,-1
2483,279,21,9,0.101013758,0.898986242,794.0901202,782.5881612,1409.491341,1132.387097,2762,75.6919704,5524,-1271296,142848,-1128448,-1
8018,671,20,10,0.0772240764,0.922775924,2482.405413,2781.262796,4319.544026,4649.181818,8689,197.6569609,17378,-4105216,343552,-3761664,-1
9554,424,27,3,0.0424934857,0.957506514,2868.014438,3129.435335,5003.751099,4668.379717,9978,785.0511408,19956,-4891648,217088,-4674560,-1
58,16,23,7,0.216216216,0.783783784,22.12202673,17.00723651,39.17241379,31.4375,74,2.105263158,148,-29696,8192,-21504,-1
9476,487,20,10,0.0488808592,0.951119141,2870.015131,2891.76678,5020.383812,4235.131417,9963,652.4557957,19926,-4851712,249344,-4602368,-1
5343,679,21,9,0.112753238,0.887246762,1710.24446,1945.769074,3010.14505,3022.162003,6022,200.2660459,12044,-2735616,347648,-2387968,-1
2390,280,22,8,0.104868914,0.895131086,763.4007565,828.6537316,1328.656485,1393.914286,2670,83.02238806,5340,-1223680,143360,-1080320,-1
9050,823,22,8,0.0833586549,0.916641345,2893.305876,2230.421985,4993.347735,4317.380316,9873,349.115983,19746,-4633600,421376,-4212224,-1
9339,609,20,10,0.0612183353,0.938781665,2844.039609,3185.845323,5020.29243,4272.27422,9948,988.8667992,19896,-4781568,311808,-4469760,-1
51,26,19,11,0.337662338,0.662337662,23.97254293,17.71574535,40.94117647,35.19230769,77,18.33333333,154,-26112,13312,-12800,-1
3847,251,21,9,0.0612493899,0.93875061,1179.32057,1225.443398,2060.564856,1879.912351,4098,336.453202,8196,-1969664,128512,-1841152,-1
1016,62,19,11,0.0575139147,0.942486085,304.1924187,377.902481,548.7942913,387.1935484,1078,78.34302326,2156,-520192,31744,-488448,-1
9210,718,19,11,0.0723207091,0.927679291,2866.394559,2838.3522,4937.840174,5306.473538,9928,578.2178218,19856,-4715520,367616,-4347904,-1
2118,122,21,9,0.0544642857,0.945535714,636.0453631,775.4735192,1133.336638,897.647541,2240,224.2242242,4480,-1084416,62464,-1021952,-1
1031,87,19,11,0.0778175313,0.922182469,316.3677296,385.3923207,564.5509214,499.6436782,1118,53.62110312,2236,-527872,44544,-483328,-1
4129,242,21,9,0.0553649051,0.944635095,1254.545594,1367.392869,2196.471058,2007.342975,4371,142.192583,8742,-2114048,123904,-1990144,-1
1242,112,25,5,0.082717873,0.917282127,385.12142,447.6311446,681.2004831,636.4642857,1354,103.2012195,2708,-635904,57344,-578560,-1
1919,155,22,8,0.074734812,0.925265188,580.9188462,749.0839071,1018.919229,1267.541935,2074,84.58401305,4148,-982528,79360,-903168,-1
9289,652,21,9,0.0655869631,0.934413037,2874.34465,2700.933862,5021.85316,4246.498466,9941,1199.155609,19882,-4755968,333824,-4422144,-1
440,98,17,13,0.182156134,0.817843866,146.464037,175.9996557,283.9204545,204.755102,538,78.19767442,1076,-225280,50176,-175104,-1
2087,226,21,9,0.0977086035,0.902291396,643.7999376,779.4414603,1120.223766,1496.610619,2313,140.9506399,4626,-1068544,115712,-952832,-1
9543,423,22,8,0.0424443107,0.957555689,2860.256974,3051.332221,5029.505816,3945.595745,9966,958.2692308,19932,-4886016,216576,-4669440,-1
9553,421,20,10,0.0422097453,0.957790255,2858.370399,3066.411518,5042.140793,3747.634204,9974,1497.597598,19948,-4891136,215552,-4675584,-1
4440,478,20,10,0.0971939813,0.902806019,1402.03644,1573.029442,2452.856306,2521.211297,4918,108.4693427,9836,-2273280,244736,-2028544,-1
321,71,19,11,0.181122449,0.818877551,108.7987906,123.0552652,205.5389408,155.6338028,392,82.35294118,784,-164352,36352,-128000,-1
410,33,18,12,0.0744920993,0.925507901,123.4282857,159.9293634,227.3,156.1515152,443,17.39301139,886,-209920,16896,-193024,-1
2985,408,19,11,0.120247569,0.879752431,972.1248426,1022.55747,1679.473367,1825.227941,3393,83.32514735,6786,-1528320,208896,-1319424,-1
69,24,19,11,0.258064516,0.741935484,26.32859106,27.76360402,48.60869565,42.375,93,15.70945946,186,-35328,12288,-23040,-1
3182,344,23,7,0.0975609756,0.902439024,1004.414125,1119.708085,1744.56631,1938.636628,3526,85.27206771,7052,-1629184,176128,-1453056,-1
9530,440,21,9,0.0441323972,0.955867603,2856.893075,3269.544964,5006.986884,4520.113636,9970,1637.110016,19940,-4879360,225280,-4654080,-1
2048,244,17,13,0.106457243,0.893542757,651.0004141,744.6492153,1143.909668,1168.241803,2292,163.8313081,4584,-1048576,124928,-923648,-1
78,40,25,5,0.338983051,0.661016949,36.03227423,29.71824986,58.33333333,61.775,118,8.470926059,236,-39936,20480,-19456,-1
119,30,16,14,0.201342282,0.798657718,41.08532186,38.16340597,82.25210084,46.23333333,149,13.68227732,298,-60928,15360,-45568,-1
1912,286,21,9,0.130118289,0.869881711,629.5297987,623.9205223,1132.334205,879.993007,2198,44.30558355,4396,-978944,146432,-832512,-1
77,15,20,10,0.163043478,0.836956522,25.62935601,11.6428328,51.5974026,20.33333333,92,12.83124128,184,-39424,7680,-31744,-1
3987,397,21,9,0.0905565693,0.909443431,1240.624631,1458.195725,2162.071984,2498.083123,4384,219.8595787,8768,-2041344,203264,-1838080,-1
2850,367,20,10,0.114081442,0.885918558,904.831925,1093.036249,1598.801404,1688.19891,3217,60.33383346,6434,-1459200,187904,-1271296,-1
54,22,19,11,0.289473684,0.710526316,21.90546624,21.90970388,39.24074074,36.68181818,76,20.43010753,152,-27648,11264,-16384,-1
2692,122,22,8,0.0433546553,0.956645345,803.4228411,933.1505321,1421.981798,1087.95082,2814,364.0362225,5628,-1378304,62464,-1315840,-1
3182,199,21,9,0.0588583259,0.941141674,956.9406249,1178.832417,1714.681961,1312.326633,3381,78.66449511,6762,-1629184,101888,-1527296,-1
2918,424,22,8,0.126870138,0.873129862,950.9776735,1047.34605,1654.639822,1787.533019,3342,75.03367759,6684,-1494016,217088,-1276928,-1
6069,367,21,9,0.0570229956,0.942977004,1830.698117,2222.097161,3193.99242,3623.776567,6436,361.3700168,12872,-3107328,187904,-2919424,-1
252,49,21,9,0.162790698,0.837209302,84.39325785,85.22184588,159.8730159,105.3673469,301,19.58360442,602,-129024,25088,-103936,-1
88,29,20,10,0.247863248,0.752136752,33.75591278,31.35997889,62.625,48,117,11.01694915,234,-45056,14848,-30208,-1
4512,175,22,8,0.037337316,0.962662684,1346.20589,1472.760829,2358.027704,1982.325714,4687,116.187407,9374,-2310144,89600,-2220544,-1
9525,446,19,11,0.0447297162,0.955270284,2858.078259,3104.236759,5034.776378,3944.307175,9971,1079.112554,19942,-4876800,228352,-4648448,-1
974,77,20,10,0.0732635585,0.926736441,293.9246538,398.0937988,531.4589322,456.9480519,1051,61.24708625,2102,-498688,39424,-459264,-1
1157,97,21,9,0.0773524721,0.922647528,355.6636716,427.2519728,631.704408,577.3505155,1254,60.14388489,2508,-592384,49664,-542720,-1
4589,735,18,12,0.138054095,0.861945905,1490.647207,1714.093178,2581.273262,3169.642177,5324,132.01091,10648,-2349568,376320,-1973248,-1
8145,517,21,9,0.0596859848,0.940314015,2491.397059,2577.170415,4366.693063,3777.056093,8662,171.1857708,17324,-4170240,264704,-3905536,-1
9560,413,20,10,0.0414118119,0.958588188,2867.452279,2983.939953,5027.455439,4050.549637,9973,1137.172178,19946,-4894720,211456,-4683264,-1
7082,973,21,9,0.120794538,0.879205462,2277.238693,2305.36116,3859.956509,5251.107914,8055,151.296018,16110,-3625984,498176,-3127808,-1
3253,392,16,14,0.107544582,0.892455418,1041.834484,1129.433475,1835.489702,1719.354592,3645,87.05517077,7290,-1665536,200704,-1464832,-1
8363,809,19,11,0.0882032272,0.911796773,2577.289501,2831.246919,4431.957432,6184.076638,9172,184.3247588,18344,-4281856,414208,-3867648,-1
1623,485,20,10,0.230075901,0.769924099,555.0417746,650.1837109,950.9938386,1400.872165,2108,43.75259444,4216,-830976,248320,-582656,-1
9372,574,21,9,0.0577116429,0.942288357,2852.266297,2969.759455,5038.354673,3914.583624,9946,564.1520136,19892,-4798464,293888,-4504576,-1
9390,566,18,12,0.0568501406,0.943149859,2853.2488,3196.430976,4970.344089,5113.80742,9956,668.1879195,19912,-4807680,289792,-4517888,-1
685,97,24,6,0.124040921,0.875959079,222.527325,246.4677582,394.1372263,372.8762887,782,20.40177407,1564,-350720,49664,-301056,-1
8449,669,21,9,0.0733713534,0.926628647,2583.302938,3161.625897,4588.92579,4187.872945,9118,514.5598194,18236,-4325888,342528,-3983360,-1
50,10,20,10,0.166666667,0.833333333,16.9966585,8.611620057,33.56,15.2,60,7.894736842,120,-25600,5120,-20480,-1
7060,877,22,8,0.110495149,0.889504851,2264.053206,2468.054578,3922.965297,4339.587229,7937,175.6750775,15874,-3614720,449024,-3165696,-1
496,81,19,11,0.140381282,0.859618718,162.2001022,184.7381229,296.4233871,243.5432099,577,46.3081862,1154,-253952,41472,-212480,-1
5272,290,18,12,0.0521395182,0.947860482,1594.073348,1626.994882,2823.052162,2026.110345,5562,320.2072539,11124,-2699264,148480,-2550784,-1
49,34,17,13,0.409638554,0.590361446,23.96340748,23.91342878,42.71428571,40.97058824,83,4.862331576,166,-25088,17408,-7680,-1
6866,648,21,9,0.0862390205,0.91376098,2180.553351,1933.785099,3817.197495,3124.964506,7514,135.5583619,15028,-3515392,331776,-3183616,-1
9136,792,21,9,0.0797743755,0.920225624,2861.710215,2881.497775,5000.935858,4544.199495,9928,981.027668,19856,-4677632,405504,-4272128,-1
8956,707,17,13,0.0731656835,0.926834316,2798.58779,2614.220264,4873.723537,4303.462518,9663,250.2719503,19326,-4585472,361984,-4223488,-1
3679,203,16,14,0.0522926327,0.947707367,1111.676395,1246.577811,1955.129383,1694.492611,3882,152.2352941,7764,-1883648,103936,-1779712,-1
9521,448,18,12,0.0449393119,0.955060688,2853.34767,3290.356942,5015.289675,4341.276786,9969,749.5488722,19938,-4874752,229376,-4645376,-1
1750,89,16,14,0.0483958673,0.951604133,521.421694,598.3469722,937.1411429,582.9550562,1839,320.3832753,3678,-896000,45568,-850432,-1
6608,1406,18,12,0.175442975,0.824557025,2328.870087,1969.391936,3801.489861,4975.71835,8014,158.6930693,16028,-3383296,719872,-2663424,-1
1469,189,17,13,0.113992762,0.886007238,469.6995817,478.8229985,860.5139551,588.4444444,1658,40.92816588,3316,-752128,96768,-655360,-1
9493,471,23,7,0.0472701726,0.952729827,2856.6419,3184.269879,5013.590751,4355.866242,9964,789.540412,19928,-4860416,241152,-4619264,-1
5001,335,19,11,0.0627811094,0.937218891,1514.86943,1796.358385,2632.455309,3206.58806,5336,266.6666667,10672,-2560512,171520,-2388992,-1
4513,338,21,9,0.0696763554,0.930323645,1365.68513,1752.781729,2455.742078,2028.881657,4851,118.2882224,9702,-2310656,173056,-2137600,-1
1891,63,23,7,0.0322415558,0.967758444,562.4432227,598.9641285,981.4415653,859.1904762,1954,90.71494893,3908,-968192,32256,-935936,-1
3963,280,27,3,0.0659910441,0.934008956,1229.257378,1119.568961,2142.899571,1826.196429,4243,246.3995354,8486,-2029056,143360,-1885696,-1
9149,771,22,8,0.0777217742,0.922278226,2831.473428,3193.948862,4926.718439,5361.365759,9920,482.9600779,19840,-4684288,394752,-4289536,-1
2285,146,22,8,0.0600575895,0.939942411,693.6460858,774.8915619,1232.322101,960.5479452,2431,128.4883721,4862,-1169920,74752,-1095168,-1
2562,315,19,11,0.109489051,0.890510949,816.8767901,931.8603325,1446.498829,1378.009524,2877,219.9541284,5754,-1311744,161280,-1150464,-1
764,76,20,10,0.0904761905,0.90952381,233.3893147,300.87934,430.802356,316.9342105,840,45.01607717,1680,-391168,38912,-352256,-1
101,26,21,9,0.204724409,0.795275591,35.49266186,39.03124223,66.79207921,53.15384615,127,2.628311258,254,-51712,13312,-38400,-1
9649,337,19,11,0.0337472461,0.966252754,2871.684549,3127.553604,5013.664007,4416.163205,9986,473.0459498,19972,-4940288,172544,-4767744,-1
202,23,19,11,0.102222222,0.897777778,61.50675949,79.47257615,117.4851485,73.60869565,225,20.69917203,450,-103424,11776,-91648,-1
9380,564,21,9,0.0567176187,0.943282381,2845.235079,3256.359461,4959.944776,5181.308511,9944,366.2615101,19888,-4802560,288768,-4513792,-1
64,12,21,9,0.157894737,0.842105263,21.21311136,18.88047198,41.4375,22.83333333,76,15.57377049,152,-32768,6144,-26624,-1
2038,241,27,3,0.105748135,0.894251865,656.2892828,665.6674247,1130.314033,1221.908714,2279,133.1191589,4558,-1043456,123392,-920064,-1
3894,172,21,9,0.0423020167,0.957697983,1170.714941,1213.657477,2044.604006,1782.110465,4066,542.1333333,8132,-1993728,88064,-1905664,-1
1344,291,21,9,0.177981651,0.822018349,469.0928627,481.4179731,829.7299107,763.8247423,1635,59.45454545,3270,-688128,148992,-539136,-1
9543,430,20,10,0.0431164143,0.956883586,2862.697484,3091.176526,5026.544273,4109.393023,9973,640.5266538,19946,-4886016,220160,-4665856,-1
1202,125,17,13,0.0941974378,0.905802562,378.7788885,383.0471874,681.5574043,495.168,1327,109.7601323,2654,-615424,64000,-551424,-1
1956,152,21,9,0.0721062619,0.927893738,598.0416277,729.6003305,1056.607873,1027.375,2108,75.85462397,4216,-1001472,77824,-923648,-1
9602,378,20,10,0.0378757515,0.962124248,2868.697307,3096.16019,5018.006769,4291.769841,9980,572.5760184,19960,-4916224,193536,-4722688,-1
8656,805,21,9,0.0850861431,0.914913857,2695.579007,3079.214246,4710.400647,4952.500621,9461,195.8799172,18922,-4431872,412160,-4019712,-1
9418,549,20,10,0.0550817698,0.94491823,2850.991887,3034.741467,5056.712041,3736.637523,9967,702.8913963,19934,-4822016,281088,-4540928,-1
6220,587,20,10,0.0862347583,0.913765242,1983.709501,1514.764551,3483.898071,2557.379898,6807,136.8516285,13614,-3184640,300544,-2884096,-1
5470,406,16,14,0.0690946222,0.930905378,1669.725269,1868.819807,2993.409324,2198.711823,5876,109.2802678,11752,-2800640,207872,-2592768,-1
9056,891,21,9,0.0895747462,0.910425254,2798.38793,3342.159565,4867.554108,6055.901235,9947,340.1846785,19894,-4636672,456192,-4180480,-1
148,28,19,11,0.159090909,0.840909091,48.82442905,28.33266306,97.71621622,39.78571429,176,35.2,352,-75776,14336,-61440,-1
885,151,25,5,0.145752896,0.854247104,299.5590907,295.9430786,520.3220339,507.8211921,1036,65.03452605,2072,-453120,77312,-375808,-1
6089,567,21,9,0.0851862981,0.914813702,1928.921301,1759.271383,3376.191,2816.347443,6656,245.7902511,13312,-3117568,290304,-2827264,-1
3237,455,22,8,0.123239437,0.876760563,1051.003168,1160.666982,1832.436515,1946.551648,3692,86.12083042,7384,-1657344,232960,-1424384,-1
3146,227,22,8,0.0672991402,0.93270086,951.7465947,1188.10049,1711.376351,1349.167401,3373,216.2179487,6746,-1610752,116224,-1494528,-1
5269,828,21,9,0.135804494,0.864195506,1743.352569,1819.005177,2990.327387,3422.364734,6097,191.0087719,12194,-2697728,423936,-2273792,-1
103,42,21,9,0.289655172,0.710344828,40.69254608,44.33046894,71.36893204,77,145,19.28191489,290,-52736,21504,-31232,-1
4898,240,23,7,0.0467107824,0.953289218,1466.387203,1599.956766,2608.157003,1780.575,5138,449.1258741,10276,-2507776,122880,-2384896,-1
8674,316,20,10,0.0351501669,0.964849833,2583.899395,2839.990025,4514.248213,3980.873418,8990,666.4195701,17980,-4441088,161792,-4279296,-1
8753,567,17,13,0.0608369099,0.93916309,2665.273288,3047.668601,4671.730721,4487.126984,9320,280.3007519,18640,-4481536,290304,-4191232,-1
5907,430,21,9,0.0678554521,0.932144548,1821.122368,1887.260442,3137.843914,3596.997674,6337,141.9578853,12674,-3024384,220160,-2804224,-1
6888,700,21,9,0.0922509225,0.907749077,2188.598337,2208.101929,3799.756823,3742.772857,7588,362.0229008,15176,-3526656,358400,-3168256,-1
813,98,20,10,0.107574094,0.892425906,257.4302835,263.6661345,473.498155,310.8367347,911,51.09366237,1822,-416256,50176,-366080,-1
6795,3089,22,8,0.312525293,0.687474707,2438.787704,2202.986666,3868.890066,7304.163807,9884,689.2608089,19768,-3479040,1581568,-1897472,-1
8642,885,24,6,0.0928938806,0.907106119,2696.12927,3186.466455,4711.824809,5273.489266,9527,293.4996919,19054,-4424704,453120,-3971584,-1
871,107,19,11,0.109406953,0.890593047,279.9364466,286.2141789,500.3237658,401.3925234,978,67.0781893,1956,-445952,54784,-391168,-1
810,82,19,11,0.0919282511,0.908071749,247.8579454,335.8615133,450.3888889,408.0853659,892,64.35786436,1784,-414720,41984,-372736,-1
6110,720,20,10,0.105417277,0.894582723,1900.217363,2394.601569,3336.65761,4084.565278,6830,182.6691629,13660,-3128320,368640,-2759680,-1
8830,1136,24,6,0.113987558,0.886012442,2702.298428,3324.628958,4718.267724,7045.120599,9966,592.508918,19932,-4520960,581632,-3939328,-1
9518,455,20,10,0.0456231826,0.954376817,2865.48899,2939.574018,5039.540345,3887.925275,9973,431.3581315,19946,-4873216,232960,-4640256,-1
245,32,21,9,0.115523466,0.884476534,77.69618165,60.60836595,148.0734694,69.53125,277,26.10744581,554,-125440,16384,-109056,-1
525,98,18,12,0.157303371,0.842696629,166.4455255,237.1990678,306.7542857,340.1020408,623,72.2737819,1246,-268800,50176,-218624,-1
5519,264,22,8,0.0456510462,0.954348954,1653.186674,1881.06713,2920.6262,2293.560606,5783,631.3318777,11566,-2825728,135168,-2690560,-1
3830,252,22,8,0.0617344439,0.938265556,1155.070282,1203.531323,2097.296606,1193.480159,4082,92.16527433,8164,-1960960,129024,-1831936,-1
457,74,21,9,0.139359699,0.860640301,145.3629459,188.4154278,258.3260394,313.3918919,531,42.34449761,1062,-233984,37888,-196096,-1
3843,343,21,9,0.0819397993,0.918060201,1191.280725,1307.849101,2054.323705,2532.434402,4186,85.65582157,8372,-1967616,175616,-1792000,-1
1169,99,21,9,0.0780757098,0.92192429,355.8435007,449.1300089,645.7621899,501.5151515,1268,91.2886969,2536,-598528,50688,-547840,-1
9543,432,21,9,0.0433082707,0.956691729,2868.769102,3007.765765,5022.640469,4222.782407,9975,932.2429907,19950,-4886016,221184,-4664832,-1
8726,1140,23,7,0.115548348,0.884451652,2844.7862,2752.926581,4832.486592,5706.695614,9866,236.5380005,19732,-4467712,583680,-3884032,-1
3730,305,20,10,0.0755885998,0.9244114,1160.800471,1192.675711,2035.253351,1807,4035,200.4470939,8070,-1909760,156160,-1753600,-1
9335,609,18,12,0.0612429606,0.938757039,2840.737007,2898.027536,5071.534762,3454.454844,9944,1100,19888,-4779520,311808,-4467712,-1
9564,409,21,9,0.041010729,0.958989271,2876.502193,2935.102748,4984.364806,5048.621027,9973,897.659766,19946,-4896768,209408,-4687360,-1
1139,145,19,11,0.112928349,0.887071651,363.610655,385.9151469,662.9569798,481.8068966,1284,119.5530726,2568,-583168,74240,-508928,-1
9484,473,25,5,0.0475042684,0.952495732,2852.394548,3114.103253,5029.674715,3962.934461,9957,1304.980341,19914,-4855808,242176,-4613632,-1
6683,351,21,9,0.0499004834,0.950099517,1996.628796,2586.42329,3508.090528,3696.655271,7034,129.2539508,14068,-3421696,179712,-3241984,-1
5825,1336,18,12,0.186566122,0.813433878,2090.499857,1856.582749,3449.502661,4154.332335,7161,139.9179367,14322,-2982400,684032,-2298368,-1
4673,517,22,8,0.0996146435,0.900385356,1475.278695,1674.157959,2620.90413,2365.880077,5190,117.5537939,10380,-2392576,264704,-2127872,-1
55,11,21,9,0.166666667,0.833333333,18.60285235,13.61209962,36.45454545,18.72727273,66,6.748466258,132,-28160,5632,-22528,-1
238,55,21,9,0.187713311,0.812286689,83.82237831,83.71135768,152.5084034,123.1636364,293,24.05582923,586,-121856,28160,-93696,-1
2194,288,19,11,0.116035455,0.883964545,693.4512383,871.9974551,1244.141294,1221.378472,2482,46.15956853,4964,-1123328,147456,-975872,-1
6635,451,19,11,0.0636466272,0.936353373,1999.689845,2485.164214,3599.989902,2712.43459,7086,133.6981132,14172,-3397120,230912,-3166208,-1
4602,442,20,10,0.087628866,0.912371134,1449.985086,1506.283737,2505.189048,2702.737557,5044,207.4013158,10088,-2356224,226304,-2129920,-1
624,54,25,5,0.0796460177,0.920353982,195.4198381,171.4995951,347.9086538,242.3333333,678,55.21172638,1356,-319488,27648,-291840,-1
3172,196,20,10,0.0581947743,0.941805226,959.6044437,1141.274722,1672.752207,1874.622449,3368,117.6799441,6736,-1624064,100352,-1523712,-1
1683,106,16,14,0.0592509782,0.940749022,507.6507782,571.2675962,912.6280452,615.1132075,1789,34.04376784,3578,-861696,54272,-807424,-1
4490,296,19,11,0.0618470539,0.938152946,1375.892743,1415.777418,2417.653007,2027.125,4786,90.62677523,9572,-2298880,151552,-2147328,-1
9541,428,18,12,0.0429330926,0.957066907,2853.228672,3152.745177,5038.414212,3794.287383,9969,1481.27786,19938,-4884992,219136,-4665856,-1
4539,440,21,9,0.0883711589,0.911628841,1416.424448,1635.518874,2482.892047,2563.325,4979,392.6656151,9958,-2323968,225280,-2098688,-1
6310,1064,20,10,0.144290751,0.855709249,2104.684834,2220.006102,3616.776862,4106.920113,7374,150.581989,14748,-3230720,544768,-2685952,-1
1846,196,21,9,0.0959843291,0.904015671,591.745315,556.2824773,1032.906826,914.0663265,2042,120.4009434,4084,-945152,100352,-844800,-1
5782,292,20,10,0.048073757,0.951926243,1730.658273,2101.760989,3060.969215,2572.777397,6074,278.4961027,12148,-2960384,149504,-2810880,-1
2616,120,18,12,0.0438596491,0.956140351,780.4501118,886.139733,1386.393731,978.4166667,2736,261.8181818,5472,-1339392,61440,-1277952,-1
9598,379,27,3,0.037987371,0.962012629,2873.43934,2978.017334,5013.45447,4369.701847,9977,1513.960546,19954,-4914176,194048,-4720128,-1
2089,131,21,9,0.059009009,0.940990991,635.4850983,647.7964061,1129.777884,803.0839695,2220,163.7168142,4440,-1069568,67072,-1002496,-1
9543,433,20,10,0.04340417,0.95659583,2872.643085,2924.21197,5024.351567,4198.357968,9976,473.0203888,19952,-4886016,221696,-4664320,-1
6159,808,22,8,0.115975312,0.884024688,1954.311933,2321.879567,3408.630622,4058.50495,6967,245.9230498,13934,-3153408,413696,-2739712,-1
2847,372,19,11,0.11556384,0.88443616,906.7076097,1063.513509,1582.768177,1818.41129,3219,218.0894309,6438,-1457664,190464,-1267200,-1
3389,200,27,3,0.0557258289,0.944274171,1030.091922,1129.866459,1799.28563,1722.38,3589,231.5483871,7178,-1735168,102400,-1632768,-1
3509,301,19,11,0.0790026247,0.920997375,1079.856817,1200.325215,1948.825591,1400.418605,3810,305.2884615,7620,-1796608,154112,-1642496,-1
3891,479,17,13,0.109610984,0.890389016,1244.562993,1324.698172,2234.999743,1783.40501,4370,150.7936508,8740,-1992192,245248,-1746944,-1
9144,766,22,8,0.0772956609,0.922704339,2840.607963,3090.591034,4950.097441,5019.992167,9910,648.1360366,19820,-4681728,392192,-4289536,-1
8224,509,21,9,0.0582846674,0.941715333,2490.369612,2965.885007,4378.874878,4175.13556,8733,220.6417383,17466,-4210688,260608,-3950080,-1
2821,221,22,8,0.0726495726,0.927350427,858.9025263,1052.159718,1498.757887,1811.79638,3042,143.490566,6084,-1444352,113152,-1331200,-1
250,59,19,11,0.190938511,0.809061489,85.43537965,87.9296257,166.648,105.6440678,309,18.92222903,618,-128000,30208,-97792,-1
3016,242,21,9,0.0742786986,0.925721301,939.7103441,948.630511,1625.109748,1684.214876,3258,153.6067893,6516,-1544192,123904,-1420288,-1
1401,101,18,12,0.0672436751,0.932756325,423.4745454,530.5968985,762.882227,593.6138614,1502,98.55643045,3004,-717312,51712,-665600,-1
2678,265,21,9,0.0900441726,0.909955827,837.4341332,961.0518762,1478.715086,1404.139623,2943,98.1981982,5886,-1371136,135680,-1235456,-1
147,34,19,11,0.187845304,0.812154696,50.33620963,51.37521416,97.3877551,63.38235294,181,21.29411765,362,-75264,17408,-57856,-1
4359,277,22,8,0.0597497843,0.940250216,1330.307233,1401.198577,2343.396421,1926.718412,4636,101.9797624,9272,-2231808,141824,-2089984,-1
5866,359,27,3,0.0576706827,0.942329317,1789.507751,1833.42017,3145.918002,2575.125348,6225,190.3669725,12450,-3003392,183808,-2819584,-1
9116,807,20,10,0.0813262118,0.918673788,2885.973165,2522.888638,5018.740127,4321.054523,9923,654.5514512,19846,-4667392,413184,-4254208,-1
1422,149,12,18,0.0948440484,0.905155952,441.9628569,470.078941,814.7834037,511.3020134,1571,118.2091798,3142,-728064,76288,-651776,-1
9419,543,22,8,0.0545071271,0.945492873,2855.425896,3050.023523,5037.307464,4013.451197,9962,377.3484848,19924,-4822528,278016,-4544512,-1
3465,296,27,3,0.0787024727,0.921297527,1073.679558,1217.523954,1879.303319,1900.861486,3761,220.5865103,7522,-1774080,151552,-1622528,-1
3330,232,17,13,0.0651319483,0.934868052,1025.252625,1061.970989,1790.588589,1651.047414,3562,272.7411945,7124,-1704960,118784,-1586176,-1
4796,704,22,8,0.128,0.872,1591.529599,1546.249638,2720.692452,2953.56392,5500,121.8971631,11000,-2455552,360448,-2095104,-1
3313,452,16,14,0.120053121,0.879946879,1071.072919,1128.615069,1933.747057,1511.042035,3765,206.5277016,7530,-1696256,231424,-1464832,-1
41,12,21,9,0.226415094,0.773584906,15.45637294,13.21063334,28.68292683,21.25,53,13.65979381,106,-20992,6144,-14848,-1
1635,205,16,14,0.111413043,0.888586957,514.7960538,638.9640863,932.5455657,824.4292683,1840,52.15419501,3680,-837120,104960,-732160,-1
5464,305,22,8,0.0528687814,0.947131219,1661.292418,1683.215134,2908.242496,2468.616393,5769,479.1528239,11538,-2797568,156160,-2641408,-1
4860,270,20,10,0.0526315789,0.947368421,1474.516785,1470.764508,2598.377572,1973.703704,5130,282.0230896,10260,-2488320,138240,-2350080,-1
9645,341,21,9,0.0341478069,0.965852193,2879.777713,2962.645899,4997.086781,4892.049853,9986,1178.984652,19972,-4938240,174592,-4763648,-1
891,52,21,9,0.0551431601,0.94485684,269.0938988,303.467778,477.952862,370,943,148.503937,1886,-456192,26624,-429568,-1
8908,981,21,9,0.0992011326,0.900798867,2836.911492,3006.844364,4962.503031,4786.063201,9889,653.1704095,19778,-4560896,502272,-4058624,-1
8576,515,22,8,0.0566494335,0.943350566,2595.602839,3054.381169,4532.147505,4776.67767,9091,271.6163729,18182,-4390912,263680,-4127232,-1
8339,582,20,10,0.0652393229,0.934760677,2513.833609,2987.887902,4560.729944,3032.051546,8921,333.4953271,17842,-4269568,297984,-3971584,-1
7420,383,16,14,0.0490836858,0.950916314,2232.36716,2321.233186,3962.356469,2732.691906,7803,400.770416,15606,-3799040,196096,-3602944,-1
9593,385,21,9,0.0385848868,0.961415113,2872.896577,3015.049403,5010.393412,4468.901299,9978,1328.628495,19956,-4911616,197120,-4714496,-1
5195,874,20,10,0.144010545,0.855989455,1708.552022,1784.518033,2897.711068,3851.036613,6069,135.7718121,12138,-2659840,447488,-2212352,-1
32,19,19,11,0.37254902,0.62745098,14.87706787,14.36948136,26.71875,24.78947368,51,13.38582677,102,-16384,9728,-6656,-1
9463,495,19,11,0.0497087769,0.950291223,2850.296787,3195.628242,5022.595054,4155.644444,9958,600.2411091,19916,-4845056,253440,-4591616,-1
8316,524,21,9,0.0592760181,0.940723982,2530.608921,2849.818562,4400.503127,4737.854962,8840,175.7105943,17680,-4257792,268288,-3989504,-1
2663,447,22,8,0.143729904,0.856270096,902.0294977,871.5815442,1551.147578,1581.42953,3110,56.9284276,6220,-1363456,228864,-1134592,-1
475,40,17,13,0.0776699029,0.922330097,144.9814954,138.9132621,268.12,137.825,515,93.80692168,1030,-243200,20480,-222720,-1
147,33,24,6,0.183333333,0.816666667,53.37238262,38.06535871,95.42176871,68.57575758,180,16.91729323,360,-75264,16896,-58368,-1
5649,234,21,9,0.0397756247,0.960224375,1691.59056,1829.409046,2953.798548,2657.17094,5883,298.6294416,11766,-2892288,119808,-2772480,-1
5568,980,21,9,0.14966402,0.85033598,1877.674949,1709.421106,3118.826149,4158.981633,6548,135.3172143,13096,-2850816,501760,-2349056,-1
639,56,21,9,0.0805755396,0.91942446,196.2239271,215.6586605,357.8325509,235.8035714,695,115.0662252,1390,-327168,28672,-298496,-1
1199,124,21,9,0.0937263794,0.906273621,372.1835818,465.4018004,660.4895746,676.6048387,1323,102.0046261,2646,-613888,63488,-550400,-1
3339,258,20,10,0.0717264387,0.928273561,1017.510148,1277.010967,1795.421983,1845.306202,3597,88.94658754,7194,-1709568,132096,-1577472,-1
455,41,17,13,0.0826612903,0.91733871,139.0345196,130.0459398,259.6131868,125.1707317,496,67.66712142,992,-232960,20992,-211968,-1
880,90,14,16,0.0927835052,0.907216495,274.1984587,318.3407438,494.5261364,397.2444444,970,81.64983165,1940,-450560,46080,-404480,-1
1512,158,20,10,0.0946107784,0.905389222,467.3679667,598.2419158,844.5337302,749.0506329,1670,134.3523733,3340,-774144,80896,-693248,-1
4717,397,22,8,0.0776300352,0.922369965,1474.879191,1491.332698,2552.003816,2622.803526,5114,103.4385113,10228,-2415104,203264,-2211840,-1
8471,322,20,10,0.0366200387,0.963379961,2526.333055,2781.882648,4417.482115,3858.167702,8793,868.0157947,17586,-4337152,164864,-4172288,-1
52,8,25,5,0.133333333,0.866666667,16.63246985,17.46961648,32.23076923,19.25,60,5.110732538,120,-26624,4096,-22528,-1
2045,151,20,10,0.0687613843,0.931238616,628.4856095,619.6787118,1122.235208,777.0529801,2196,122.4762967,4392,-1047040,77312,-969728,-1
9242,667,16,14,0.0673125442,0.932687456,2829.066455,3188.30063,5003.974573,4276.404798,9909,1411.538462,19818,-4731904,341504,-4390400,-1
2462,108,22,8,0.0420233463,0.957976654,737.6708234,792.5044743,1296.431357,1036.305556,2570,228.6476868,5140,-1260544,55296,-1205248,-1
4785,326,20,10,0.0637839953,0.936216005,1456.208899,1660.864637,2588.628213,2077.08589,5111,166.8625531,10222,-2449920,166912,-2283008,-1
449,84,21,9,0.157598499,0.842401501,144.4039688,184.2676702,255.1024499,330.5952381,533,50.52132701,1066,-229888,43008,-186880,-1
577,114,19,11,0.164978292,0.835021708,192.774369,221.0895242,357.7157712,286.7017544,691,48.35549335,1382,-295424,58368,-237056,-1
9425,475,25,5,0.047979798,0.952020202,2835.970901,2962.689873,5017.666101,3617.783158,9900,226.8041237,19800,-4825600,243200,-4582400,-1
3545,167,17,13,0.0449892241,0.955010776,1064.5884,1162.874726,1871.919887,1529.173653,3712,371.2,7424,-1815040,85504,-1729536,-1
62,19,20,10,0.234567901,0.765432099,22.61078634,25.15811495,42.4516129,36.26315789,81,15.02782931,162,-31744,9728,-22016,-1
6770,331,20,10,0.0466131531,0.953386847,2031.523067,2306.607693,3581.722157,2922.634441,7101,160.2572783,14202,-3466240,169472,-3296768,-1
6902,646,20,10,0.0855855856,0.914414414,2121.47115,2709.339746,3755.153144,3981.205882,7548,351.396648,15096,-3533824,330752,-3203072,-1
420,118,27,3,0.219330855,0.780669145,148.8996623,169.2130087,257.2761905,313.0084746,538,39.97028232,1076,-215040,60416,-154624,-1
2194,253,19,11,0.103391908,0.896608092,703.3583773,711.0313817,1243.055606,1058.750988,2447,45.14760148,4894,-1123328,129536,-993792,-1
9412,550,22,8,0.0552097972,0.944790203,2846.027506,2943.812799,5071.622291,3439.261818,9962,579.1860465,19924,-4818944,281600,-4537344,-1
3325,253,20,10,0.0707098938,0.929290106,1007.968942,1308.843412,1778.643008,1932.185771,3578,273.3384263,7156,-1702400,129536,-1572864,-1
6318,327,19,11,0.0492099323,0.950790068,1919.202521,1837.304147,3347.364831,2852.244648,6645,549.1735537,13290,-3234816,167424,-3067392,-1
4217,431,19,11,0.0927280551,0.907271945,1319.591016,1521.815479,2300.314679,2561.134571,4648,121.1363044,9296,-2159104,220672,-1938432,-1
9384,569,19,11,0.0571686929,0.942831307,2860.188075,2901.898207,5037.701726,3975.901582,9953,649.2498369,19906,-4804608,291328,-4513280,-1
9644,342,27,3,0.0342479471,0.965752053,2874.651079,3065.620621,5009.858669,4532.204678,9986,765.210728,19972,-4937728,175104,-4762624,-1
9533,435,21,9,0.0436396469,0.956360353,2855.295234,3309.244112,4999.983426,4645.181609,9968,609.6636086,19936,-4880896,222720,-4658176,-1
1513,120,17,13,0.0734843846,0.926515615,462.3126714,524.5319339,834.7647059,593.0166667,1633,112.7762431,3266,-774656,61440,-713216,-1
2408,188,21,9,0.0724191063,0.927580894,750.7592335,719.0472648,1308.718023,1167.62234,2596,185.1640514,5192,-1232896,96256,-1136640,-1
1344,150,21,9,0.100401606,0.899598394,430.5888051,428.2992217,738.0885417,831.8266667,1494,28.39224629,2988,-688128,76800,-611328,-1
3884,248,20,10,0.0600193611,0.939980639,1182.566167,1324.723177,2052.822348,2280.709677,4132,326.8987342,8264,-1988608,126976,-1861632,-1
1868,234,21,9,0.11132255,0.88867745,600.9552928,484.2206792,1102.978587,640.5512821,2102,86.85950413,4204,-956416,119808,-836608,-1
8974,944,21,9,0.0951804799,0.90481952,2871.565276,2778.838441,4970.777468,4852.292373,9918,1001.818182,19836,-4594688,483328,-4111360,-1
226,48,25,5,0.175182482,0.824817518,78.01236471,81.34876209,141.5486726,118.4375,274,23.95104895,548,-115712,24576,-91136,-1
2654,343,20,10,0.114447781,0.885552219,845.8472596,1002.079277,1499.425396,1495.708455,2997,60.79107505,5994,-1358848,175616,-1183232,-1
1771,138,21,9,0.0722891566,0.927710843,536.7386561,654.4530805,975.6363636,690.1666667,1909,55.44583212,3818,-906752,70656,-836096,-1
8318,580,20,10,0.0651831872,0.934816813,2538.284007,2772.693231,4377.749219,5478.505172,8898,196.4672113,17796,-4258816,296960,-3961856,-1
3472,258,19,11,0.0691689008,0.930831099,1076.192801,1061.348546,1881.423099,1651.217054,3730,238.4910486,7460,-1777664,132096,-1645568,-1
439,57,15,15,0.114919355,0.885080645,137.4651497,141.2642952,262.3758542,141.6315789,496,71.16212339,992,-224768,29184,-195584,-1
433,101,19,11,0.189138577,0.810861423,149.2601226,173.4482224,268.8637413,261.6534653,534,9.870609982,1068,-221696,51712,-169984,-1
9597,377,21,9,0.0377982755,0.962201724,2872.092052,3055.555131,4986.283005,5018.480106,9974,1762.190813,19948,-4913664,193024,-4720640,-1
5390,509,17,13,0.0862858112,0.913714189,1676.740506,1926.127013,2982.028571,2610.836935,5899,145.9065051,11798,-2759680,260608,-2499072,-1
9332,380,20,10,0.0391268534,0.960873147,2787.00791,3013.215839,4897.605979,3847.023684,9712,448.1772035,19424,-4777984,194560,-4583424,-1
5987,446,21,9,0.0693300171,0.930669983,1812.021999,2312.842911,3257.462001,2673.847534,6433,337.5131165,12866,-3065344,228352,-2836992,-1
4903,323,22,8,0.0618063529,0.938193647,1497.301473,1655.842957,2627.822762,2396.086687,5226,180.4558011,10452,-2510336,165376,-2344960,-1
4010,336,23,7,0.0773124712,0.922687529,1235.569324,1405.852828,2141.045885,2560.824405,4346,117.4594595,8692,-2053120,172032,-1881088,-1
9458,505,22,8,0.0506875439,0.949312456,2867.354742,2977.961771,5012.38063,4413.009901,9963,735.2767528,19926,-4842496,258560,-4583936,-1
5482,496,22,8,0.0829708933,0.917029107,1703.762732,1804.810433,2925.115104,3701.108871,5978,129.3939394,11956,-2806784,253952,-2552832,-1
366,47,18,12,0.113801453,0.886198547,114.3710937,99.59178791,220.8469945,99.17021277,413,20.34482759,826,-187392,24064,-163328,-1
7218,742,21,9,0.0932160804,0.90678392,2288.512092,2359.269099,4015.899834,3636.138814,7960,217.9627601,15920,-3695616,379904,-3315712,-1
9370,579,20,10,0.0581968037,0.941803196,2832.008776,3090.462746,5067.743116,3474.131261,9949,897.1145176,19898,-4797440,296448,-4500992,-1
117,31,20,10,0.209459459,0.790540541,42.26964533,41.56731687,78.17094017,60.64516129,148,8.958837772,296,-59904,15872,-44032,-1
3271,224,20,10,0.0640915594,0.935908441,1013.393404,935.7277949,1741.304494,1845.772321,3495,108.946384,6990,-1674752,114688,-1560064,-1
2515,215,19,11,0.0787545788,0.921245421,774.1992204,928.1316109,1356.010736,1476.502326,2730,54.99597099,5460,-1287680,110080,-1177600,-1
9263,664,20,10,0.0668882845,0.933111716,2859.674034,2941.660894,4950.451366,5153.00753,9927,286.0806916,19854,-4742656,339968,-4402688,-1
4863,244,22,8,0.0477775602,0.95222244,1465.704805,1632.981525,2549.52848,2643.118852,5107,359.901339,10214,-2489856,124928,-2364928,-1
7277,413,21,9,0.0537061118,0.946293888,2190.219879,2688.7567,3841.284595,3919.774818,7690,266.7360388,15380,-3725824,211456,-3514368,-1
2595,459,21,9,0.150294695,0.849705305,862.214415,969.3075442,1499.76185,1684.320261,3054,98.70717518,6108,-1328640,235008,-1093632,-1
354,70,18,12,0.16509434,0.83490566,118.2573551,130.8541765,222.2259887,163.3142857,424,41.85587364,848,-181248,35840,-145408,-1
3142,432,20,10,0.120872971,0.879127029,1034.953895,1007.847273,1785.848504,1799.511574,3574,95.56149733,7148,-1608704,221184,-1387520,-1
9493,476,21,9,0.0477480189,0.952251981,2857.197854,3043.170273,5042.42821,3839.693277,9969,805.2504039,19938,-4860416,243712,-4616704,-1
3204,135,21,9,0.0404312668,0.959568733,954.3094466,1103.149166,1685.885144,1292.992593,3339,249.1791045,6678,-1640448,69120,-1571328,-1
972,72,20,10,0.0689655172,0.931034483,293.4479207,383.3613936,528.7026749,438.7638889,1044,59.69125214,2088,-497664,36864,-460800,-1
1838,334,23,7,0.153775322,0.846224678,574.588022,799.2911679,1033.414581,1378.628743,2172,51.2505899,4344,-941056,171008,-770048,-1
6443,636,20,10,0.0898431982,0.910156802,2003.813453,2392.727314,3566.531274,3271.224843,7079,166.0957297,14158,-3298816,325632,-2973184,-1
2995,242,20,10,0.0747605808,0.925239419,918.0557798,1078.572621,1641.729883,1337.694215,3237,93.04397815,6474,-1533440,123904,-1409536,-1
5827,1114,20,10,0.160495606,0.839504394,1805.288269,1879.735208,3102.135576,5400.41921,6941,152.1481806,13882,-2983424,570368,-2413056,-1
1813,121,17,13,0.0625646329,0.937435367,551.1395239,618.3826915,981.6999448,754.7355372,1934,266.3911846,3868,-928256,61952,-866304,-1
2612,162,16,14,0.0583994232,0.941600577,788.8982199,900.1314012,1409.668836,1030.061728,2774,104.2073629,5548,-1337344,82944,-1254400,-1
61,21,17,13,0.256097561,0.743902439,23.65330072,20.79682515,44.8852459,31.66666667,82,11.23287671,164,-31232,10752,-20480,-1
2525,352,19,11,0.12234967,0.87765033,821.1781178,893.9339419,1443.720396,1405.139205,2877,58.08600848,5754,-1292800,180224,-1112576,-1
58,16,23,7,0.216216216,0.783783784,22.12893925,16.76678264,39.29310345,31,74,2.199762188,148,-29696,8192,-21504,-1
554,83,17,13,0.130298273,0.869701727,178.2897006,206.7154559,328.4873646,255.6746988,637,42.55177021,1274,-283648,42496,-241152,-1
323,32,19,11,0.0901408451,0.909859155,98.81001095,120.4749674,183.5448916,122.03125,355,25.65028902,710,-165376,16384,-148992,-1
32,19,18,12,0.37254902,0.62745098,14.45250843,14.92399952,27.25,23.89473684,51,9.392265193,102,-16384,9728,-6656,-1
7619,356,22,8,0.0446394984,0.955360502,2300.796427,2210.948559,4021.822943,3264.132022,7975,245.1583154,15950,-3900928,182272,-3718656,-1
9555,428,18,12,0.0428728839,0.957127116,2856.9951,3203.299696,5040.551648,3908.095794,9983,825.0413223,19966,-4892160,219136,-4673024,-1
8883,470,18,12,0.0502512563,0.949748744,2674.209101,3133.773034,4661.807948,4964.129787,9353,234.0590591,18706,-4548096,240640,-4307456,-1
2431,299,21,9,0.10952381,0.89047619,783.0888428,824.7234003,1357.539696,1430.220736,2730,88.63636364,5460,-1244672,153088,-1091584,-1
7168,665,21,9,0.0848972297,0.91510277,2231.140033,2549.216196,3893.570313,4169.547368,7833,145.2707715,15666,-3670016,340480,-3329536,-1
987,136,19,11,0.121104185,0.878895815,320.6861472,347.4899253,565.4316109,537.0955882,1123,60.40882195,2246,-505344,69632,-435712,-1
5016,358,20,10,0.066617045,0.933382955,1539.380034,1674.047568,2711.599083,2349.843575,5374,101.8188708,10748,-2568192,183296,-2384896,-1
1466,156,17,13,0.0961775586,0.903822441,462.6601891,505.3697374,822.8444748,704.8910256,1622,119.8817443,3244,-750592,79872,-670720,-1
3476,257,19,11,0.0688454326,0.931154567,1063.498397,1248.912818,1859.666571,1966.18677,3733,121.437866,7466,-1779712,131584,-1648128,-1
92,29,23,7,0.239669421,0.760330579,35.1777286,34.03180998,61.69565217,58.79310345,121,2.444938371,242,-47104,14848,-32256,-1
6064,419,17,13,0.0646305723,0.935369428,1843.2963,2236.253133,3250.682388,3116.343675,6483,288.1333333,12966,-3104768,214528,-2890240,-1
893,116,19,11,0.114965312,0.885034688,285.3990874,312.3363813,519.1265398,396.25,1009,100.1986097,2018,-457216,59392,-397824,-1
5150,308,21,9,0.0564309271,0.943569073,1554.588516,1891.615386,2726.10835,2786.211039,5458,449.218107,10916,-2636800,157696,-2479104,-1
4843,483,22,8,0.0906871949,0.909312805,1538.68819,1481.741456,2697.940533,2318.167702,5326,193.1809938,10652,-2479616,247296,-2232320,-1
6519,304,16,14,0.044555181,0.955444819,1950.250046,2203.995846,3448.775732,2623.378289,6823,175.9865876,13646,-3337728,155648,-3182080,-1
3530,393,19,11,0.100178435,0.899821565,1126.813464,1178.924267,1971.129178,1880,3923,106.9228673,7846,-1807360,201216,-1606144,-1
435,98,17,13,0.183864916,0.816135084,145.8348481,168.1574214,282.8666667,196.5714286,533,61.12385321,1066,-222720,50176,-172544,-1
2979,199,23,7,0.0626179987,0.937382001,895.7257774,1022.629091,1629.599866,989.2110553,3178,119.3390913,6356,-1525248,101888,-1423360,-1
4096,423,21,9,0.0936047798,0.90639522,1278.852684,1520.670332,2242.552246,2428.950355,4519,81.74746744,9038,-2097152,216576,-1880576,-1
3996,2983,20,10,0.427425133,0.572574867,1643.701875,1514.426135,2420.725475,4922.390546,6979,136.1224888,13958,-2045952,1527296,-518656,-1
3730,262,20,10,0.0656312625,0.934368737,1134.338975,1208.793662,2042.274799,1344.820611,3992,73.69392653,7984,-1909760,134144,-1775616,-1
1449,77,20,10,0.0504587156,0.949541284,432.2097077,488.6027007,779.1870255,468.2987013,1526,28.28544949,3052,-741888,39424,-702464,-1
7383,424,23,7,0.0543102344,0.945689766,2233.04773,2580.169366,3914.340377,3723.945755,7807,202.9373538,15614,-3780096,217088,-3563008,-1
2981,363,20,10,0.108552632,0.891447368,958.1899407,1002.1355,1695.599128,1482.807163,3344,72.93347874,6688,-1526272,185856,-1340416,-1
1125,86,18,12,0.0710156895,0.92898431,341.7890906,438.3633705,607.7422222,583.2093023,1211,92.86809816,2422,-576000,44032,-531968,-1
676,96,20,10,0.124352332,0.875647668,210.1953733,292.5192878,379.5843195,435.1979167,772,19.00073837,1544,-346112,49152,-296960,-1
9598,382,17,13,0.0382765531,0.961723447,2875.912289,2969.839523,5008.504793,4538.117801,9980,1199.519231,19960,-4914176,195584,-4718592,-1
3138,294,20,10,0.0856643357,0.914335664,981.9075727,1045.782843,1740.822498,1456.894558,3432,187.4385582,6864,-1606656,150528,-1456128,-1
9375,576,18,12,0.0578836298,0.94211637,2852.131098,3081.16304,5024.671147,4183.826389,9951,481.6553727,19902,-4800000,294912,-4505088,-1
9476,491,21,9,0.0492625665,0.950737434,2867.483297,3038.298722,5002.020895,4636.207739,9967,733.4069169,19934,-4851712,251392,-4600320,-1
9632,353,20,10,0.0353530295,0.96464697,2868.577046,3142.306992,5021.037272,4227.971671,9985,419.8906644,19970,-4931584,180736,-4750848,-1
442,100,19,11,0.184501845,0.815498155,149.4347494,166.2584133,287.7669683,199.6,542,78.43704776,1084,-226304,51200,-175104,-1
7427,420,22,8,0.0535236396,0.94647636,2262.086606,2292.997092,3943.482564,3579.483333,7847,215.4585393,15694,-3802624,215040,-3587584,-1
949,121,21,9,0.113084112,0.886915888,300.0701708,335.8438022,554.3730242,387.4793388,1070,185.4419411,2140,-485888,61952,-423936,-1
825,75,17,13,0.0833333333,0.916666667,255.4466573,256.5178394,464.6460606,294.8933333,900,18.06866091,1800,-422400,38400,-384000,-1
6674,604,20,10,0.0829898324,0.917010168,2085.824417,2257.954247,3628.274348,3763.539735,7278,157.6689775,14556,-3417088,309248,-3107840,-1
2631,229,25,5,0.0800699301,0.91993007,816.4089748,924.6722479,1431.710756,1416.58952,2860,238.93066,5720,-1347072,117248,-1229824,-1
2819,193,22,8,0.0640770252,0.935922975,856.1637662,1023.749169,1492.633913,1709.031088,3012,117.335411,6024,-1443328,98816,-1344512,-1
43,13,22,8,0.232142857,0.767857143,16.43302615,14.07419057,30.04651163,23.38461538,56,11.57024793,112,-22016,6656,-15360,-1
5797,570,21,9,0.0895241087,0.910475891,1830.418934,1842.707557,3135.675867,3675.464912,6367,142.311131,12734,-2968064,291840,-2676224,-1
831,125,18,12,0.130753138,0.869246862,271.4876954,302.6639077,474.3369434,506.176,956,20.86425142,1912,-425472,64000,-361472,-1
9604,371,22,8,0.0371929825,0.962807018,2868.500235,3100.220285,5009.516451,4431.008086,9975,371.9239374,19950,-4917248,189952,-4727296,-1
2029,369,22,8,0.153878232,0.846121768,683.028872,738.7968668,1190.25037,1250.360434,2398,63.5400106,4796,-1038848,188928,-849920,-1
523,84,18,12,0.138385502,0.861614498,168.572627,209.4785676,308.8623327,273.7261905,607,46.65641814,1214,-267776,43008,-224768,-1
1222,176,12,18,0.125894134,0.874105866,390.941382,428.075031,729.3895254,491.9715909,1398,136.7906067,2796,-625664,90112,-535552,-1
9421,528,18,12,0.0530706604,0.94692934,2852.33591,3144.5201,5008.26165,4381.518939,9949,893.8903863,19898,-4823552,270336,-4553216,-1
1978,151,22,8,0.0709253171,0.929074683,607.7738681,689.7924581,1057.26997,1166.258278,2129,242.4829157,4258,-1012736,77312,-935424,-1
4809,632,21,9,0.116155119,0.883844881,1517.37344,1872.088715,2663.720524,3156.849684,5441,113.4487073,10882,-2462208,323584,-2138624,-1
753,128,21,9,0.145289444,0.854710556,248.7732743,278.9578541,431.9907039,494,881,73.05140962,1762,-385536,65536,-320000,-1
9454,516,20,10,0.0517552658,0.948244734,2848.962022,3066.446818,5059.466892,3630.300388,9970,1090.809628,19940,-4840448,264192,-4576256,-1
4249,603,22,8,0.124278648,0.875721352,1329.796308,1613.703048,2313.730054,3221.126036,4852,385.3852264,9704,-2175488,308736,-1866752,-1
1339,130,20,10,0.0884955752,0.911504425,415.8242341,495.788839,741.7490665,665.4846154,1469,143.4570313,2938,-685568,66560,-619008,-1
3196,231,21,9,0.0674058944,0.932594106,977.8049885,1121.189749,1726.906446,1535.4329,3427,191.881299,6854,-1636352,118272,-1518080,-1
9091,825,21,9,0.0831988705,0.916801129,2879.914484,2661.804626,4965.733583,4878.790303,9916,446.0638776,19832,-4654592,422400,-4232192,-1
3626,258,19,11,0.0664263646,0.933573635,1106.284412,1172.632471,1983.140099,1371.333333,3884,326.9360269,7768,-1856512,132096,-1724416,-1
4451,174,26,4,0.0376216216,0.962378378,1332.667425,1368.475257,2323.667041,2040.132184,4625,277.4445111,9250,-2278912,89088,-2189824,-1
9257,655,22,8,0.0660815174,0.933918483,2845.792924,3060.139413,4975.535271,4687.477863,9912,1508.675799,19824,-4739584,335360,-4404224,-1
183,60,20,10,0.24691358,0.75308642,71.82599303,61.38058642,127.8743169,104.0833333,243,37.1559633,486,-93696,30720,-62976,-1
6061,1125,21,9,0.156554411,0.843445589,2076.689113,1972.99947,3491.258868,4144.329778,7186,148.4404049,14372,-3103232,576000,-2527232,-1
9225,528,21,9,0.0541371886,0.945862811,2789.809034,3217.446204,4893.299621,4592.219697,9753,403.1831335,19506,-4723200,270336,-4452864,-1
5726,411,20,10,0.0669708327,0.933029167,1747.803482,2069.193817,3079.685644,2920.128954,6137,192.1415153,12274,-2931712,210432,-2721280,-1
8700,1013,20,10,0.104293215,0.895706785,2762.737474,3060.731327,4782.116437,5500.126357,9713,214.9845064,19426,-4454400,518656,-3935744,-1
9400,557,22,8,0.0559405443,0.944059456,2859.90823,3107.557685,4976.9,5014.439856,9957,368.3684795,19914,-4812800,285184,-4527616,-1
9500,473,21,9,0.0474280558,0.952571944,2864.46637,3028.587407,5030.126526,4120.82241,9973,952.5310411,19946,-4864000,242176,-4621824,-1
9367,589,22,8,0.0591603053,0.940839695,2833.571071,3051.368997,5077.290595,3407.410866,9956,1140.435281,19912,-4795904,301568,-4494336,-1
5496,677,20,10,0.109671149,0.890328851,1754.864252,1957.258381,3046.148108,3418.642541,6173,168.7072971,12346,-2813952,346624,-2467328,-1
705,99,21,9,0.123134328,0.876865672,225.0096828,277.054724,400.7801418,414.7474747,804,59.55555556,1608,-360960,50688,-310272,-1
3014,187,19,11,0.058419244,0.941580756,926.7414945,866.0833317,1610.21931,1452.406417,3201,100.3133814,6402,-1543168,95744,-1447424,-1
9404,555,21,9,0.0557284868,0.944271513,2852.802748,2847.258336,5067.056784,3504.897297,9959,595.6339713,19918,-4814848,284160,-4530688,-1
9394,567,21,9,0.0569219958,0.943078004,2852.067725,3065.399297,5042.32723,3964.936508,9961,921.4616096,19922,-4809728,290304,-4519424,-1
876,78,19,11,0.0817610063,0.918238994,267.8987495,344.523639,482.0878995,425.974359,954,83.53765324,1908,-448512,39936,-408576,-1
5360,274,25,5,0.0486332978,0.951366702,1616.180091,1759.971095,2839.554851,2386.062044,5634,373.8553417,11268,-2744320,140288,-2604032,-1
4356,1032,20,10,0.191536748,0.808463252,1464.57607,1561.321487,2467.157025,3654.098837,5388,111.0012361,10776,-2230272,528384,-1701888,-1
4790,1058,21,9,0.180916553,0.819083447,1720.53287,1441.789696,2820.291023,3396.296786,5848,110.7995453,11696,-2452480,541696,-1910784,-1
1160,105,25,5,0.0830039526,0.916996047,362.3855434,385.2663518,640.4232759,550.9904762,1265,142.7765237,2530,-593920,53760,-540160,-1
9504,462,21,9,0.0463576159,0.953642384,2869.045943,3032.729365,4978.302189,5090.426407,9966,1126.101695,19932,-4866048,236544,-4629504,-1
8878,440,27,3,0.0472204336,0.952779566,2697.079228,2505.132788,4679.833521,4249.225,9318,647.0833333,18636,-4545536,225280,-4320256,-1
5796,242,21,9,0.0400794965,0.959920503,1729.440547,2001.296752,3035.981712,2624.756198,6038,318.9646064,12076,-2967552,123904,-2843648,-1
2747,222,16,14,0.0747726507,0.925227349,835.6446909,1045.768816,1461.699308,1773.31982,2969,245.5748553,5938,-1406464,113664,-1292800,-1
7179,473,16,14,0.0618139049,0.938186095,2174.737953,2672.694704,3819.550773,3931.972516,7652,239.9498275,15304,-3675648,242176,-3433472,-1
8406,871,21,9,0.0938881104,0.90611189,2663.548441,2808.193286,4621.091839,4811.831228,9277,252.4353741,18554,-4303872,445952,-3857920,-1
9370,455,27,3,0.0463104326,0.953689567,2836.136082,2821.653444,4927.526254,4613.854945,9825,184.3685494,19650,-4797440,232960,-4564480,-1
9647,340,20,10,0.0340442575,0.965955742,2877.344532,3004.081417,5009.921737,4542.244118,9987,828.1094527,19974,-4939264,174080,-4765184,-1
1785,135,18,12,0.0703125,0.9296875,544.1814413,615.0450268,980.5030812,696.0148148,1920,146.5648855,3840,-913920,69120,-844800,-1
4884,455,21,9,0.0852219517,0.914778048,1505.318985,1853.91753,2699.948812,2348.527473,5339,98.16142673,10678,-2500608,232960,-2267648,-1
8066,527,20,10,0.0613289887,0.938671011,2461.283736,2744.076656,4315.267915,4017.40038,8593,237.7697842,17186,-4129792,269824,-3859968,-1
1895,255,25,5,0.118604651,0.881395349,617.9255555,629.4152109,1090.519789,963.8823529,2150,65.46894032,4300,-970240,130560,-839680,-1
587,75,17,13,0.113293051,0.886706949,186.1187326,202.4799956,343.6729131,236.2266667,662,18.20682068,1324,-300544,38400,-262144,-1
6595,700,22,8,0.0959561343,0.904043866,2109.075621,2072.969033,3637.486732,3747.05,7295,131.3467771,14590,-3376640,358400,-3018240,-1
74,13,21,9,0.149425287,0.850574713,24.30450018,25.0029584,46.47297297,29.92307692,87,3.8174638,174,-37888,6656,-31232,-1
4133,313,19,11,0.0704003599,0.92959964,1253.560276,1562.781935,2256.660295,1785.635783,4446,90.9016561,8892,-2116096,160256,-1955840,-1
6320,535,17,13,0.0780452225,0.921954778,1968.55282,2064.934472,3398.360127,3778.138318,6855,135.877106,13710,-3235840,273920,-2961920,-1
986,126,18,12,0.113309353,0.886690647,318.4342421,319.0300193,570.8073022,444.5396825,1112,21.01284958,2224,-504832,64512,-440320,-1
246,21,22,8,0.0786516854,0.921348315,75.83877415,86.49055891,136.1300813,109.047619,267,21.14014252,534,-125952,10752,-115200,-1
2265,111,17,13,0.0467171717,0.953282828,678.1399367,788.809913,1200.604415,941.5045045,2376,49.90548204,4752,-1159680,56832,-1102848,-1
1812,92,21,9,0.0483193277,0.951680672,541.494692,680.4880907,958.3664459,836.9565217,1904,67.39823009,3808,-927744,47104,-880640,-1
2191,188,20,10,0.0790248003,0.9209752,678.7084963,628.0989523,1227.303971,755.25,2379,425.5813953,4758,-1121792,96256,-1025536,-1
6437,456,20,10,0.0661540693,0.933845931,1973.988118,2159.031498,3476.435607,3031.480263,6893,182.8867073,13786,-3295744,233472,-3062272,-1
7092,378,27,3,0.0506024096,0.94939759,2132.912327,2310.311319,3792.460942,2666.804233,7470,508.8555858,14940,-3631104,193536,-3437568,-1
1972,257,18,12,0.11529834,0.88470166,615.3576699,784.113421,1082.425963,1364.945525,2229,264.4128114,4458,-1009664,131584,-878080,-1
637,92,16,14,0.126200274,0.873799726,202.9095925,252.9270601,370.8508634,324.4891304,729,70.16361886,1458,-326144,47104,-279040,-1
5815,269,20,10,0.0442143327,0.955785667,1734.739227,1960.026491,3084.682373,2130.639405,6084,553.5941765,12168,-2977280,137728,-2839552,-1
775,63,19,11,0.0751789976,0.924821002,241.5504445,243.980193,422.1277419,387.1746032,838,190.8883827,1676,-396800,32256,-364544,-1
3129,478,19,11,0.1325201,0.8674799,1013.606362,1146.680804,1750.538511,2153.960251,3607,73.11980539,7214,-1602048,244736,-1357312,-1
237,86,27,3,0.26625387,0.73374613,88.04766868,104.0479027,155.3122363,180.4302326,323,5.967116202,646,-121344,44032,-77312,-1
5921,340,21,9,0.0543044242,0.945695576,1784.283808,2105.305018,3160.54484,2616.485294,6261,135.0517688,12522,-3031552,174080,-2857472,-1
3060,495,18,12,0.139240506,0.860759494,992.824284,1199.258636,1751.14183,1944.032323,3555,66.42376682,7110,-1566720,253440,-1313280,-1
2925,181,20,10,0.0582743078,0.941725692,876.6981517,1155.845599,1541.640342,1745.154696,3106,59.66192854,6212,-1497600,92672,-1404928,-1
3146,428,20,10,0.119753777,0.880246223,1017.812304,1128.659223,1785.79466,1800.035047,3574,93.09716072,7148,-1610752,219136,-1391616,-1
2178,166,27,3,0.0708191126,0.929180887,669.4417396,702.3936121,1194.770891,880.2951807,2344,140.2752843,4688,-1115136,84992,-1030144,-1
9170,746,20,10,0.0752319484,0.924768052,2866.825518,2803.983227,4945.608506,5116.965147,9916,780.1730921,19832,-4695040,381952,-4313088,-1
2049,308,20,10,0.130674586,0.869325414,673.8002894,720.4536683,1187.199122,1124.454545,2357,73.42679128,4714,-1049088,157696,-891392,-1
255,21,20,10,0.0760869565,0.923913043,77.79809968,80.05746236,143.2,81.42857143,276,17.68097373,552,-130560,10752,-119808,-1
1350,220,17,13,0.140127389,0.859872611,450.1540104,460.9305111,770.4288889,877.9818182,1570,68.92010536,3140,-691200,112640,-578560,-1
2262,292,22,8,0.114330462,0.885669538,725.0100293,825.23581,1282.221043,1240.928082,2554,87.82668501,5108,-1158144,149504,-1008640,-1
4876,1109,18,12,0.185296575,0.814703425,1725.004258,1541.807952,2827.606645,3720.193868,5985,111.2867237,11970,-2496512,567808,-1928704,-1
2514,199,27,3,0.0733505345,0.926649466,779.2032936,827.1182426,1363.661893,1272.839196,2713,254.2642924,5426,-1287168,101888,-1185280,-1
9619,366,20,10,0.0366549825,0.963345018,2869.541673,3201.378562,4989.983782,5072.270492,9985,1228.167282,19970,-4924928,187392,-4737536,-1
1041,93,20,10,0.082010582,0.917989418,321.6629983,382.4046009,571.6042267,521.5591398,1134,32.08828523,2268,-532992,47616,-485376,-1
1170,184,22,8,0.135893648,0.864106352,376.7743647,470.6681594,676.6752137,682.7445652,1354,111.1658456,2708,-599040,94208,-504832,-1
115,34,16,14,0.228187919,0.771812081,41.16368176,45.41455531,79.6,59.44117647,149,2.868142445,298,-58880,17408,-41472,-1
636,32,21,9,0.0479041916,0.952095808,189.6192515,225.6539087,339.5801887,233.53125,668,39.08718549,1336,-325632,16384,-309248,-1
104,34,17,13,0.246376812,0.753623188,38.676915,37.68013253,75.49038462,51.17647059,138,17.78350515,276,-53248,17408,-35840,-1
82,19,19,11,0.188118812,0.811881188,29.27321351,21.84648022,54.86585366,34.31578947,101,26.03092784,202,-41984,9728,-32256,-1
3648,635,20,10,0.148260565,0.851739435,1152.552779,1401.546626,2006.158991,2922.390551,4283,85.90052146,8566,-1867776,325120,-1542656,-1
4116,223,25,5,0.0513943305,0.94860567,1241.303465,1340.108582,2198.476433,1644.399103,4339,677.96875,8678,-2107392,114176,-1993216,-1
2798,389,20,10,0.122058362,0.877941638,897.3279849,1052.234106,1569.393853,1770.987147,3187,172.3634397,6374,-1432576,199168,-1233408,-1
9640,346,22,8,0.0346485079,0.965351492,2872.113155,3150.389997,5003.726971,4708.563584,9986,935.8950328,19972,-4935680,177152,-4758528,-1
85,21,19,11,0.198113208,0.801886792,30.25150401,15.41975056,59.69411765,28.42857143,106,31.08504399,212,-43520,10752,-32768,-1
933,56,21,9,0.0566228514,0.943377149,281.1351999,293.7677822,506.1243301,309.6607143,989,109.5238095,1978,-477696,28672,-449024,-1
9639,344,27,3,0.0344585796,0.96554142,2871.139454,3102.968771,5014.238925,4368.857558,9983,1727.16263,19966,-4935168,176128,-4759040,-1
86,25,19,11,0.225225225,0.774774775,30.28182256,36.51410686,58.15116279,48.6,111,8.937198068,222,-44032,12800,-31232,-1
638,136,20,10,0.175710594,0.824289406,221.0593958,234.2486894,387.1786834,389.0073529,774,48.19427148,1548,-326656,69632,-257024,-1
6732,456,24,6,0.0634390651,0.936560935,2037.585359,2524.982443,3565.074124,4028.91886,7188,203.453156,14376,-3446784,233472,-3213312,-1
9544,438,18,12,0.0438789822,0.956121018,2851.977925,3176.660251,5053.475272,3641.061644,9982,709.4527363,19964,-4886528,224256,-4662272,-1
66,17,23,7,0.204819277,0.795180723,24.0556441,22.67294166,43.48484848,36.23529412,83,8.627858628,166,-33792,8704,-25088,-1
2561,274,21,9,0.09664903,0.90335097,796.6792374,968.708921,1393.26474,1649.193431,2835,94.43704197,5670,-1311232,140288,-1170944,-1
2633,256,27,3,0.0886119765,0.911388024,835.2570135,817.7790135,1451.484998,1378.300781,2889,129.8426966,5778,-1348096,131072,-1217024,-1
2278,235,22,8,0.0935137286,0.906486271,718.322579,782.8916732,1245.817384,1365.4,2513,51.34859011,5026,-1166336,120320,-1046016,-1
3383,152,25,5,0.0429985856,0.957001414,1011.625187,1125.778138,1786.326633,1360.111842,3535,430.0486618,7070,-1732096,77824,-1654272,-1
3246,302,16,14,0.0851183766,0.914881623,989.354783,1321.942544,1795.5687,1548.046358,3548,128.9712832,7096,-1661952,154624,-1507328,-1
3134,432,20,10,0.121144139,0.878855861,1016.039824,1113.868102,1766.417039,1907.430556,3566,79.31494662,7132,-1604608,221184,-1383424,-1
629,92,19,11,0.127600555,0.872399445,203.1977685,214.9185376,375.3370429,262.9782609,721,52.89801908,1442,-322048,47104,-274944,-1
8309,554,21,9,0.0625070518,0.937492948,2518.121598,3088.381041,4413.23276,4713.474729,8863,274.8217054,17726,-4254208,283648,-3970560,-1
9675,314,21,9,0.031434578,0.968565422,2879.472828,2994.309465,5003.903979,4720.649682,9989,706.4356436,19978,-4953600,160768,-4792832,-1
4287,294,19,11,0.064178127,0.935821873,1312.529887,1146.340808,2350.881969,1417.823129,4581,288.4760705,9162,-2194944,150528,-2044416,-1
1434,124,22,8,0.0795892169,0.920410783,442.4041658,475.6468329,798.3974895,560.9596774,1558,78.44914401,3116,-734208,63488,-670720,-1
46,18,22,8,0.28125,0.71875,17.40092125,20.95998539,32.34782609,32.88888889,64,6.645898235,128,-23552,9216,-14336,-1
2298,164,20,10,0.0666125102,0.93338749,690.7880741,946.8247143,1231.103568,1237.054878,2462,174.48618,4924,-1176576,83968,-1092608,-1
9561,415,22,8,0.0415998396,0.95840016,2864.795233,3039.248163,5031.944044,3987.612048,9976,672.2371968,19952,-4895232,212480,-4682752,-1
237,49,21,9,0.171328671,0.828671329,79.20453568,82.72976537,153.092827,97.10204082,286,39.77746871,572,-121344,25088,-96256,-1
3079,393,20,10,0.113191244,0.886808756,979.1936089,1166.273982,1730.179279,1786.020356,3472,83.90526825,6944,-1576448,201216,-1375232,-1
4490,384,20,10,0.0787853919,0.921214608,1390.894702,1538.33357,2468.230512,2078.177083,4874,136.0312587,9748,-2298880,196608,-2102272,-1
9389,536,19,11,0.0540050378,0.945994962,2861.019939,2717.914809,5024.606774,3883.847015,9925,490.8506429,19850,-4807168,274432,-4532736,-1
9502,462,19,11,0.0463669209,0.953633079,2876.690687,2854.675998,4996.34477,4697.753247,9964,1374.344828,19928,-4865024,236544,-4628480,-1
4227,401,22,8,0.0866464996,0.9133535,1316.635024,1508.864283,2294.359357,2526.805486,4628,96.4970809,9256,-2164224,205312,-1958912,-1
8667,1191,20,10,0.120815581,0.879184419,2838.672801,2756.671062,4814.812392,5764.09068,9858,778.0584057,19716,-4437504,609792,-3827712,-1
1487,289,19,11,0.162725225,0.837274775,494.694893,594.5732557,879.4512441,935.0588235,1776,35.49160671,3552,-761344,147968,-613376,-1
4919,299,21,9,0.0573016481,0.942698352,1483.065006,1845.330464,2614.345395,2529.785953,5218,272.0542231,10436,-2518528,153088,-2365440,-1
1588,107,22,8,0.0631268437,0.936873156,487.8220582,490.4535084,857.3079345,709.8598131,1695,51.28593041,3390,-813056,54784,-758272,-1
5694,355,27,3,0.0586873863,0.941312614,1735.905507,1819.39023,3058.881805,2481.55493,6049,425.6861365,12098,-2915328,181760,-2733568,-1
9424,532,21,9,0.0534351145,0.946564885,2860.679829,2828.800796,5048.32396,3741.618421,9956,628.9324068,19912,-4825088,272384,-4552704,-1
43,12,23,7,0.218181818,0.781818182,16.09130922,14.51699196,29,24.41666667,55,2.363558229,110,-22016,6144,-15872,-1
9532,438,22,8,0.0439317954,0.956068205,2857.432557,3060.366327,5040.456987,3789.495434,9970,787.5197472,19940,-4880384,224256,-4656128,-1
9584,386,27,3,0.0387161484,0.961283852,2868.277906,2981.938222,5020.632513,4113.194301,9970,876.8689534,19940,-4907008,197632,-4709376,-1
4477,352,21,9,0.0728929385,0.927107062,1406.537904,1212.950071,2402.825329,2569.846591,4829,133.4346505,9658,-2292224,180224,-2112000,-1
808,90,16,14,0.100222717,0.899777283,249.2669861,290.2618018,467.3155941,289.5555556,898,87.86692759,1796,-413696,46080,-367616,-1
6578,635,20,10,0.0880354915,0.911964509,2044.499225,2198.210353,3704.375494,2598.28189,7213,242.8619529,14426,-3367936,325120,-3042816,-1
2041,232,20,10,0.102067752,0.897932248,652.1215681,671.6801617,1154.318961,984.637931,2273,87.5577812,4546,-1044992,118784,-926208,-1
9552,425,18,12,0.0425979753,0.957402025,2854.30884,3346.777625,5017.203413,4355.12,9977,676.4067797,19954,-4890624,217600,-4673024,-1
9454,500,21,9,0.0502310629,0.949768937,2836.743139,3242.89579,5044.822721,3704.562,9954,883.2298137,19908,-4840448,256000,-4584448,-1
7052,281,20,10,0.0383199236,0.961680076,2114.074289,2154.177451,3681.401021,3305.590747,7333,668.4594348,14666,-3610624,143872,-3466752,-1
9481,489,16,14,0.0490471414,0.950952859,2852.601901,3319.595673,5001.06666,4683.685072,9970,911.3345521,19940,-4854272,250368,-4603904,-1
597,60,20,10,0.0913242009,0.908675799,182.1237441,252.5228351,329.8509213,320.5333333,657,24.57912458,1314,-305664,30720,-274944,-1
9559,416,19,11,0.0417042607,0.958295739,2860.353222,3238.413375,5012.630924,4422.021635,9975,698.5294118,19950,-4894208,212992,-4681216,-1
9648,339,22,8,0.0339441274,0.966055873,2877.608345,3016.103257,5004.839656,4685.501475,9987,396.4668519,19974,-4939776,173568,-4766208,-1
407,57,21,9,0.122844828,0.877155172,126.8630866,147.9274381,245.1130221,142.4385965,464,52.96803653,928,-208384,29184,-179200,-1
4049,579,20,10,0.125108038,0.874891962,1263.925521,1616.857106,2221.750556,2963.105354,4628,97.86424191,9256,-2073088,296448,-1776640,-1
3827,519,27,3,0.119420156,0.880579844,1236.885693,1370.459489,2155.089888,2309.252408,4346,124.5986239,8692,-1959424,265728,-1693696,-1
2635,111,24,6,0.0404224326,0.959577567,790.0966379,822.3554154,1382.726755,1154.468468,2746,172.9219144,5492,-1349120,56832,-1292288,-1
1058,155,19,11,0.127782358,0.872217642,341.4063798,401.4125224,614.2618147,557.4322581,1213,34.25585993,2426,-541696,79360,-462336,-1
756,88,16,14,0.104265403,0.895734597,236.354488,284.20391,432.739418,334.5340909,844,168.8,1688,-387072,45056,-342016,-1
4271,293,20,10,0.0641980719,0.935801928,1297.602077,1573.481947,2273.349801,2415.880546,4564,84.02061856,9128,-2186752,150016,-2036736,-1
7549,363,22,8,0.0458796764,0.954120324,2270.714755,2437.563226,3990.794145,3243.31405,7912,613.8091544,15824,-3865088,185856,-3679232,-1
80,20,22,8,0.2,0.8,29.13793704,21.85314623,54.325,35.2,100,13.71742112,200,-40960,10240,-30720,-1
9176,740,22,8,0.0746268657,0.925373134,2825.233546,3201.472883,4899.776046,5686.677027,9916,666.8459987,19832,-4698112,378880,-4319232,-1
3323,257,21,9,0.0717877095,0.928212291,1024.734056,1115.393647,1808.143244,1562.373541,3580,434.9939247,7160,-1701376,131584,-1569792,-1
3719,650,20,10,0.148775463,0.851224537,1234.618822,1283.113427,2093.186072,2710.316923,4369,107.7966938,8738,-1904128,332800,-1571328,-1
1844,185,19,11,0.0911779202,0.90882208,564.9252537,762.5097154,1016.237527,1002.664865,2029,105.3478712,4058,-944128,94720,-849408,-1
9518,451,21,9,0.0452402448,0.954759755,2865.693726,2946.902299,5032.785879,3976.51663,9969,750.1128668,19938,-4873216,230912,-4642304,-1
3794,326,20,10,0.0791262136,0.920873786,1168.408668,1369.955819,2088.112546,1739.144172,4120,241.5005862,8240,-1942528,166912,-1775616,-1
5657,365,27,3,0.0606110927,0.939388907,1731.190079,1708.001112,3055.389606,2331.271233,6022,252.8127624,12044,-2896384,186880,-2709504,-1
58,16,23,7,0.216216216,0.783783784,22.12917433,16.85681891,39.24137931,31.1875,74,2.231604343,148,-29696,8192,-21504,-1
806,58,25,5,0.0671296296,0.93287037,245.2448799,300.9697545,433.6873449,416,864,132.1100917,1728,-412672,29696,-382976,-1
2832,204,19,11,0.0671936759,0.932806324,862.2405643,1053.61113,1517.517655,1532.137255,3036,191.7877448,6072,-1449984,104448,-1345536,-1
7081,531,22,8,0.0697582764,0.930241724,2163.254543,2599.847901,3789.597091,4031.903955,7612,246.6623461,15224,-3625472,271872,-3353600,-1
158,29,22,8,0.155080214,0.844919786,52.54502346,53.85398853,98.91139241,67.24137931,187,5.238095238,374,-80896,14848,-66048,-1
6628,476,21,9,0.0670045045,0.932995495,2043.502198,2036.325443,3504.840223,4216.132353,7104,329.4990724,14208,-3393536,243712,-3149824,-1
9611,372,21,9,0.0372633477,0.962736652,2868.005602,3102.024776,5024.629487,4148.983871,9983,995.3140578,19966,-4920832,190464,-4730368,-1
7546,1026,23,7,0.119692021,0.880307979,2463.465025,2422.620024,4183.193082,5046.29922,8572,175.9080648,17144,-3863552,525312,-3338240,-1
8126,869,20,10,0.0966092273,0.903390773,2579.402608,2652.902443,4423.40635,5195.52359,8995,229.0552585,17990,-4160512,444928,-3715584,-1
6773,720,22,8,0.0960896837,0.903910316,2148.211822,2263.278832,3706.851321,4124.676389,7493,188.6455186,14986,-3467776,368640,-3099136,-1
905,141,19,11,0.134799235,0.865200765,296.1003118,320.6206008,538.5944751,426.6170213,1046,84.08360129,2092,-463360,72192,-391168,-1
1108,155,18,12,0.122723674,0.877276326,355.4146348,419.8962814,623.8420578,690.316129,1263,33.15830927,2526,-567296,79360,-487936,-1
3706,218,25,5,0.0555555556,0.944444444,1123.081861,1286.129287,1963.33864,1948.243119,3924,180.0826067,7848,-1897472,111616,-1785856,-1
58,17,23,7,0.226666667,0.773333333,22.46532538,17.76723784,39.4137931,33.17647059,75,2.190420561,150,-29696,8704,-20992,-1
3507,332,21,9,0.0864808544,0.913519146,1090.381015,1270.268169,1904.600228,2082.671687,3839,131.2478632,7678,-1795584,169984,-1625600,-1
3687,385,21,9,0.0945481336,0.905451866,1155.591376,1345.875468,2024.539734,2151.038961,4072,76.02688574,8144,-1887744,197120,-1690624,-1
464,89,17,13,0.160940325,0.839059675,153.6794971,179.5028603,286.6142241,226.8764045,553,72.09908735,1106,-237568,45568,-192000,-1
9305,629,20,10,0.0633178981,0.936682102,2837.300597,2902.755674,5068.072542,3479.697933,9934,712.1146953,19868,-4764160,322048,-4442112,-1
652,90,16,14,0.121293801,0.878706199,202.6223344,267.7113196,359.1150307,461.2222222,742,30.81395349,1484,-333824,46080,-287744,-1
1362,139,27,3,0.09260493,0.90739507,428.5615505,474.8777676,755.6299559,705.6330935,1501,129.8442907,3002,-697344,71168,-626176,-1
7231,781,22,8,0.0974787818,0.902521218,2304.810433,2287.894723,3936.964597,4650.303457,8012,166.7429761,16024,-3702272,399872,-3302400,-1
5253,300,20,10,0.0540248514,0.945975149,1596.49001,1692.579743,2791.723777,2519.186667,5553,330.1426873,11106,-2689536,153600,-2535936,-1
446,98,18,12,0.180147059,0.819852941,149.0569371,169.8375627,289.0695067,197.0918367,544,71.11111111,1088,-228352,50176,-178176,-1
9566,407,20,10,0.0408101875,0.959189812,2857.495729,3151.904321,5033.540769,3893.120393,9973,1208.848485,19946,-4897792,208384,-4689408,-1
1575,130,19,11,0.0762463343,0.923753666,486.9790546,529.6736857,865.168254,705.5769231,1705,151.4209591,3410,-806400,66560,-739840,-1
195,30,19,11,0.133333333,0.866666667,63.01338889,43.37952666,122,54.5,225,29.45026178,450,-99840,15360,-84480,-1
4660,281,22,8,0.0568710787,0.943128921,1406.281443,1721.530172,2477.734335,2359.320285,4941,97.35960591,9882,-2385920,143872,-2242048,-1
380,56,17,13,0.128440367,0.871559633,120.9349323,153.9006262,221.2763158,199.6607143,436,37.88010426,872,-194560,28672,-165888,-1
736,140,21,9,0.159817352,0.840182648,252.1761227,226.8930482,459.375,328.7571429,876,23.36,1752,-376832,71680,-305152,-1
5032,345,19,11,0.0641621722,0.935837828,1545.103501,1639.042777,2702.873211,2486.652174,5377,98.53399304,10754,-2576384,176640,-2399744,-1
81,29,20,10,0.263636364,0.736363636,30.84704709,33.0715723,58.12345679,48.17241379,110,15.42776999,220,-41472,14848,-26624,-1
5397,474,27,3,0.0807358201,0.91926418,1680.108198,1853.941899,2937.455068,2919.432489,5871,253.1694696,11742,-2763264,242688,-2520576,-1
4929,587,18,12,0.106417694,0.893582306,1575.143111,1723.098601,2741.19578,2903.802385,5516,172.3211496,11032,-2523648,300544,-2223104,-1
3424,198,21,9,0.0546659304,0.94533407,1034.592601,1206.081759,1801.148657,1990.505051,3622,114.4753477,7244,-1753088,101376,-1651712,-1
2858,202,21,9,0.0660130719,0.933986928,880.3939215,908.7568034,1541.955213,1368.425743,3060,302.6706231,6120,-1463296,103424,-1359872,-1
2543,250,23,7,0.089509488,0.910490512,793.3899118,923.8558667,1404.348014,1322.256,2793,151.6286645,5586,-1302016,128000,-1174016,-1
3544,546,21,9,0.133496333,0.866503667,1178.716006,1129.664252,1990.335214,2403.565934,4090,143.5087719,8180,-1814528,279552,-1534976,-1
5664,740,20,10,0.11555278,0.88444722,1820.930157,1991.868192,3143.65625,3652.893243,6404,146.6117216,12808,-2899968,378880,-2521088,-1
689,145,25,5,0.173860911,0.826139089,233.3195913,266.1571799,405.5965167,474.062069,834,46.61822247,1668,-352768,74240,-278528,-1
5861,913,20,10,0.134780041,0.865219959,1896.495973,1967.168558,3215.269579,4493.13253,6774,137.5152253,13548,-3000832,467456,-2533376,-1
4255,507,21,9,0.106467871,0.893532129,1369.831231,1411.138296,2370.302468,2475.475345,4762,145.7606367,9524,-2178560,259584,-1918976,-1
1617,118,16,14,0.0680115274,0.931988473,487.6785606,566.0295603,891.2486085,549.4152542,1735,192.3503326,3470,-827904,60416,-767488,-1
3115,299,21,9,0.0875805507,0.912419449,978.4463522,1054.660259,1701.662921,1768.311037,3414,107.8672986,6828,-1594880,153088,-1441792,-1
9663,323,21,9,0.0323452834,0.967654717,2873.810323,3100.519067,5009.249819,4522.321981,9986,690.5947441,19972,-4947456,165376,-4782080,-1
8622,505,20,10,0.0553303386,0.944669661,2631.640976,2554.408386,4611.469033,3753.548515,9127,170.3434117,18254,-4414464,258560,-4155904,-1
620,82,19,11,0.116809117,0.883190883,195.9202745,204.0500953,368.95,219.5609756,702,59.74468085,1404,-317440,41984,-275456,-1
2753,182,27,3,0.0620102215,0.937989779,851.3124572,731.6645532,1485.931711,1196.758242,2935,85.04781223,5870,-1409536,93184,-1316352,-1
9314,623,18,12,0.0626949784,0.937305022,2837.302159,3227.728783,4924.262615,5637.834671,9937,502.6302479,19874,-4768768,318976,-4449792,-1
1379,105,26,4,0.070754717,0.929245283,424.055349,467.6608551,750.9920232,630.9714286,1484,40.18413214,2968,-706048,53760,-652288,-1
1248,122,18,12,0.0890510949,0.910948905,385.0573674,484.1340472,692.2804487,616.1393443,1370,72.79489904,2740,-638976,62464,-576512,-1
9583,391,27,3,0.039201925,0.960798075,2858.545608,3160.558196,5031.528227,3908.414322,9974,1307.208388,19948,-4906496,200192,-4706304,-1
4674,389,21,9,0.0768319178,0.923168082,1442.739667,1669.442755,2525.824989,2606.195373,5063,380.1051051,10126,-2393088,199168,-2193920,-1
6737,543,21,9,0.0745879121,0.925412088,2081.083973,2339.911521,3645.19623,3582.233886,7280,183.4677419,14560,-3449344,278016,-3171328,-1
634,88,18,12,0.121883657,0.878116343,197.6536064,259.7295637,350.2444795,442.5909091,722,28.91469764,1444,-324608,45056,-279552,-1
2378,159,21,9,0.0626724478,0.937327552,718.6226541,912.9884933,1266.833474,1301.402516,2537,113.6648746,5074,-1217536,81408,-1136128,-1
5461,352,19,11,0.0605539308,0.939446069,1651.425705,2040.033789,2896.107673,3075.985795,5813,175.6724086,11626,-2796032,180224,-2615808,-1
1081,59,17,13,0.051754386,0.948245614,323.4771899,378.3065906,580.0499537,395.5254237,1140,136.0381862,2280,-553472,30208,-523264,-1
6183,1126,18,12,0.154056642,0.845943358,1905.230655,2743.234257,3454.035096,4758.522202,7309,183.3667837,14618,-3165696,576512,-2589184,-1
748,81,21,9,0.097708082,0.902291918,235.2803288,255.2088637,425.1858289,320.9382716,829,30.72646405,1658,-382976,41472,-341504,-1
987,386,27,3,0.281136198,0.718863802,394.0687275,401.9995262,690.3617021,678.4041451,1373,61.43176734,2746,-505344,197632,-307712,-1
9602,378,22,8,0.0378757515,0.962124248,2867.908311,3055.451343,5026.575609,4074.103175,9980,558.7905935,19960,-4916224,193536,-4722688,-1
6318,1600,21,9,0.20207123,0.79792877,2389.458082,1740.613504,3839.823678,4432.071875,7918,177.374552,15836,-3234816,819200,-2415616,-1
60,10,23,7,0.142857143,0.857142857,19.39816715,20.07112354,37.66666667,22.5,70,11.3452188,140,-30720,5120,-25600,-1
1229,92,20,10,0.0696442089,0.930355791,373.1006312,414.2357157,678.2180635,430.9891304,1321,36.27127952,2642,-629248,47104,-582144,-1
9530,449,20,10,0.0449944884,0.955005512,2846.302723,3410.006118,5032.450682,4088.986637,9979,593.2818074,19958,-4879360,229888,-4649472,-1
3816,787,20,10,0.170975451,0.829024549,1223.287672,1276.681463,2076.583857,3394.996188,4603,85.06745518,9206,-1953792,402944,-1550848,-1
9461,498,21,9,0.0500050206,0.949994979,2853.378122,3253.817094,4987.55047,4836.556225,9959,485.5680156,19918,-4844032,254976,-4589056,-1
9306,625,21,9,0.0629342463,0.937065754,2865.396235,2848.514401,4996.995917,4504.4832,9931,657.6821192,19862,-4764672,320000,-4444672,-1
4336,358,20,10,0.0762675756,0.923732424,1343.399327,1409.788025,2385.483625,1887.452514,4694,150.5935194,9388,-2220032,183296,-2036736,-1
5107,224,20,10,0.042018383,0.957981617,1523.627841,1852.582664,2663.125514,2731.535714,5331,313.7728075,10662,-2614784,114688,-2500096,-1
58,16,23,7,0.216216216,0.783783784,22.12917433,16.85681891,39.24137931,31.1875,74,2.145549435,148,-29696,8192,-21504,-1
4138,405,21,9,0.08914814,0.91085186,1305.063196,1333.208843,2240.568149,2593.148148,4543,247.0364328,9086,-2118656,207360,-1911296,-1
863,85,21,9,0.0896624473,0.910337553,266.9932816,333.8883078,474.9895713,469.5294118,948,150.7154213,1896,-441856,43520,-398336,-1
1152,147,19,11,0.113163972,0.886836028,362.7567461,457.973248,654.8029514,612.3605442,1299,107.9800499,2598,-589824,75264,-514560,-1
5460,422,21,9,0.0717443047,0.928255695,1701.035501,1654.010637,2950.103114,2830.189573,5882,210.0714286,11764,-2795520,216064,-2579456,-1
6039,318,21,9,0.050023596,0.949976404,1829.0837,1910.346052,3198.023514,2817.732704,6357,189.9880454,12714,-3091968,162816,-2929152,-1
2286,239,20,10,0.0946534653,0.905346535,720.7363213,792.2512679,1275.931759,1139.309623,2525,66.46485917,5050,-1170432,122368,-1048064,-1
458,82,21,9,0.151851852,0.848148148,147.1158122,186.2399086,259.4956332,331.9634146,540,51.57593123,1080,-234496,41984,-192512,-1
6274,278,18,12,0.0424297924,0.957570208,1887.132133,1954.835119,3291.514504,2937.647482,6552,342.3197492,13104,-3212288,142336,-3069952,-1
7879,1119,20,10,0.124360969,0.875639031,2551.050608,2550.367764,4315.041122,5798.294906,8998,169.8376746,17996,-4034048,572928,-3461120,-1
136,32,16,14,0.19047619,0.80952381,45.90402957,45.24171195,92.26470588,51.5,168,22.85714286,336,-69632,16384,-53248,-1
591,112,21,9,0.159317212,0.840682788,187.2693409,263.4412788,340.9475465,410.3214286,703,56.42054575,1406,-302592,57344,-245248,-1
9273,671,19,11,0.0674778761,0.932522124,2837.988151,2711.749417,5102.446134,3176.687034,9944,986.5079365,19888,-4747776,343552,-4404224,-1
2567,289,17,13,0.101190476,0.898809524,807.2825319,941.9543021,1450.206467,1235.695502,2856,73.874806,5712,-1314304,147968,-1166336,-1
286,32,19,11,0.100628931,0.899371069,88.06378286,86.92840085,168.2972028,80.875,318,55.4973822,636,-146432,16384,-130048,-1
9457,512,27,3,0.0513592136,0.948640786,2861.792749,3098.907229,5017.324416,4387.945313,9969,915.4269972,19938,-4841984,262144,-4579840,-1
446,92,19,11,0.171003717,0.828996283,153.3308754,163.3354849,273.2488789,251.326087,538,56.04166667,1076,-228352,47104,-181248,-1
9503,468,22,8,0.0469361147,0.953063885,2849.595088,3077.741286,5056.668315,3551.040598,9971,678.2993197,19942,-4865536,239616,-4625920,-1
1935,156,21,9,0.0746054519,0.925394548,603.5953412,556.6237663,1064.170026,820.6217949,2091,94.18918919,4182,-990720,79872,-910848,-1
776,112,20,10,0.126126126,0.873873874,249.0361273,301.0219614,440.9703608,468.9553571,888,21.75404214,1776,-397312,57344,-339968,-1
3110,329,20,10,0.0956673452,0.904332655,987.1988934,993.7360532,1752.131511,1416.264438,3439,174.8347738,6878,-1592320,168448,-1423872,-1
9477,483,24,6,0.0484939759,0.951506024,2832.67943,3608.804052,4976.677641,5055.498965,9960,320.0514139,19920,-4852224,247296,-4604928,-1
6542,811,21,9,0.110295118,0.889704882,2018.800645,2507.897728,3525.232039,4901.249075,7353,272.2325065,14706,-3349504,415232,-2934272,-1
1205,109,20,10,0.0829528158,0.917047184,376.603834,392.1221712,667.3053942,549.1009174,1314,194.6666667,2628,-616960,55808,-561152,-1
291,87,19,11,0.23015873,0.76984127,101.5872956,130.0932296,185.0274914,204.4597701,378,20.6557377,756,-148992,44544,-104448,-1
3727,817,23,7,0.179797535,0.820202465,1297.905642,1217.525569,2146.471961,2847.416157,4544,101.6782278,9088,-1908224,418304,-1489920,-1
169,38,20,10,0.183574879,0.816425121,60.11845094,50.60260825,109.8047337,78.18421053,207,11.31147541,414,-86528,19456,-67072,-1
1278,125,25,5,0.0890947969,0.910905203,401.0342589,442.6844775,704.7018779,674.376,1403,53.67253252,2806,-654336,64000,-590336,-1
3605,417,21,9,0.103679761,0.896320239,1121.617113,1263.377612,1931.765881,2700.808153,4022,93.05876909,8044,-1845760,213504,-1632256,-1
6498,313,21,9,0.0459550727,0.954044927,1945.655991,2164.174069,3449.32133,2506.632588,6811,199.6189918,13622,-3326976,160256,-3166720,-1
780,99,22,8,0.112627986,0.887372014,245.2797632,312.0404763,437.924359,456.3535354,879,61.38268156,1758,-399360,50688,-348672,-1
9349,601,19,11,0.0604020101,0.93959799,2822.903361,3227.290934,5068.189218,3533.650582,9950,1017.382413,19900,-4786688,307712,-4478976,-1
2528,270,20,10,0.0964974982,0.903502502,798.5345909,872.4816639,1416.851266,1237.040741,2798,64.67868701,5596,-1294336,138240,-1156096,-1
8659,1197,22,8,0.121448864,0.878551136,2853.892676,2781.328086,4926.820303,4940.650794,9856,321.3563743,19712,-4433408,612864,-3820544,-1
444,112,17,13,0.201438849,0.798561151,149.7254126,190.9425414,289.8986486,233.3125,556,10.63707672,1112,-227328,57344,-169984,-1
5088,368,22,8,0.0674486804,0.93255132,1552.198809,1705.261039,2780.725432,2006.42663,5456,421.6383308,10912,-2605056,188416,-2416640,-1
9365,569,22,8,0.057278035,0.942721965,2844.284285,3170.119229,5003.638761,4372.702988,9934,357.8530259,19868,-4794880,291328,-4503552,-1
652,97,20,10,0.129506008,0.870493992,203.4458047,269.7762325,361.1211656,468.2886598,749,28.80769231,1498,-333824,49664,-284160,-1
5368,345,20,10,0.0603885874,0.939611413,1651.008234,1564.465824,2883.395306,2446.304348,5713,300.052521,11426,-2748416,176640,-2571776,-1
441,95,18,12,0.177238806,0.822761194,146.2170925,169.6210912,284.9206349,192.2736842,536,59.2920354,1072,-225792,48640,-177152,-1
9518,447,18,12,0.0448569995,0.955143001,2876.667342,2858.453852,4997.654234,4670.966443,9965,991.5422886,19930,-4873216,228864,-4644352,-1
7038,494,21,9,0.0655868295,0.93441317,2146.525538,2537.144851,3767.6894,3749.554656,7532,204.8409029,15064,-3603456,252928,-3350528,-1
6133,833,18,12,0.119580821,0.880419179,2014.681789,1977.566567,3464.930214,3620.220888,6966,138.6820625,13932,-3140096,426496,-2713600,-1
8124,398,21,9,0.046702652,0.953297348,2448.12448,2687.188969,4253.244092,4430.020101,8522,267.6507538,17044,-4159488,203776,-3955712,-1
204,47,19,11,0.187250996,0.812749004,67.29996418,91.20061808,124.3823529,133.0212766,251,8.102001291,502,-104448,24064,-80384,-1
7603,801,21,9,0.0953117563,0.904688244,2393.233976,2597.318092,4122.361831,4963.162297,8404,159.1968176,16808,-3892736,410112,-3482624,-1
9495,469,17,13,0.04706945,0.95293055,2868.235157,2948.826179,5017.359768,4276.75693,9964,917.4953959,19928,-4861440,240128,-4621312,-1
3808,181,20,10,0.0453747806,0.954625219,1142.968942,1290.207528,2007.667805,1728.486188,3989,745.6074766,7978,-1949696,92672,-1857024,-1
7820,651,20,10,0.0768504309,0.923149569,2420.933726,2674.25565,4276.50422,3749.451613,8471,158.4252852,16942,-4003840,333312,-3670528,-1
2469,200,21,9,0.0749344324,0.925065568,759.9469989,822.1164331,1361.608343,1006.52,2669,109.9258649,5338,-1264128,102400,-1161728,-1
6744,423,20,10,0.0590205107,0.940979489,2055.293372,2270.523687,3593.060943,3439.539007,7167,607.3728814,14334,-3452928,216576,-3236352,-1
2793,337,20,10,0.107667732,0.892332268,889.0093565,1014.791726,1559.605084,1614.356083,3130,82.15223097,6260,-1430016,172544,-1257472,-1
9184,758,21,9,0.0762422048,0.923757795,2837.021733,3235.949678,4954.396559,5178.726913,9942,620.5992509,19884,-4702208,388096,-4314112,-1
8090,503,20,10,0.0585360177,0.941463982,2446.702849,2946.291757,4273.035476,4682.4334,8593,503.9882698,17186,-4142080,257536,-3884544,-1
9501,461,27,3,0.0462758482,0.953724152,2856.700777,2995.711659,5040.496474,3765.609544,9962,452.2015433,19924,-4864512,236032,-4628480,-1
98,34,17,13,0.257575758,0.742424242,36.15122225,40.99561121,70.6122449,54.64705882,132,25.19083969,264,-50176,17408,-32768,-1
9138,781,25,5,0.078737776,0.921262224,2823.505427,3285.876615,4979.122456,4736.259923,9919,233.5530963,19838,-4678656,399872,-4278784,-1
9443,524,22,8,0.0525734925,0.947426507,2860.060567,2883.068147,5055.267923,3699.681298,9967,542.5694066,19934,-4834816,268288,-4566528,-1
404,42,17,13,0.0941704036,0.905829596,124.1715466,122.4955851,234.6534653,116.2142857,446,51.62037037,892,-206848,21504,-185344,-1
7053,406,22,8,0.0544308889,0.945569111,2123.419956,2613.98013,3737.516234,3599.428571,7459,167.2796591,14918,-3611136,207872,-3403264,-1
9519,450,21,9,0.0451399338,0.954860066,2864.908129,3082.328542,5012.225864,4409.082222,9969,1148.502304,19938,-4873728,230400,-4643328,-1
4030,696,22,8,0.147270419,0.852729581,1222.274672,1374.648371,2132.480149,3701.158046,4726,101.9193444,9452,-2063360,356352,-1707008,-1
4304,287,27,3,0.0625136136,0.937486386,1317.464935,1434.750765,2289.960502,2386.571429,4591,418.1238616,9182,-2203648,146944,-2056704,-1
4255,240,21,9,0.0533926585,0.946607341,1291.868395,1370.533006,2262.339835,1993.766667,4495,136.2121212,8990,-2178560,122880,-2055680,-1
2801,365,21,9,0.115287429,0.884712571,900.2443746,1010.859094,1575.550161,1644.506849,3166,59.47773812,6332,-1434112,186880,-1247232,-1
365,97,20,10,0.20995671,0.79004329,125.827591,158.5427923,230.969863,233.4948454,462,20.28985507,924,-186880,49664,-137216,-1
8766,410,21,9,0.0446817786,0.955318221,2633.809602,2763.255589,4636.084873,3571.112195,9176,602.0997375,18352,-4488192,209920,-4278272,-1
884,115,18,12,0.115115115,0.884884885,286.041123,291.3670466,511.3665158,412.626087,999,69.86013986,1998,-452608,58880,-393728,-1
146,11,24,6,0.0700636943,0.929936306,43.76570838,60.14830157,80.20547945,63,157,6.220285261,314,-74752,5632,-69120,-1
988,171,19,11,0.147540984,0.852459016,329.4202473,362.7817416,581.6194332,570.6432749,1159,51.37411348,2318,-505856,87552,-418304,-1
3317,288,21,9,0.079889043,0.920110957,1024.998571,1177.948477,1824.777208,1552.184028,3605,214.0736342,7210,-1698304,147456,-1550848,-1
343,55,20,10,0.138190955,0.861809045,112.2833381,129.7695656,200.6180758,192.5272727,398,15.78738596,796,-175616,28160,-147456,-1
9524,445,21,9,0.044638379,0.955361621,2868.867435,3019.750904,5008.366338,4484.907865,9969,1030.920372,19938,-4876288,227840,-4648448,-1
7170,414,20,10,0.0545886076,0.945411392,2165.871618,2522.500325,3817.489819,3359.705314,7584,272.218234,15168,-3671040,211968,-3459072,-1
1074,126,21,9,0.105,0.895,334.8225101,429.9373503,595.018622,647.2222222,1200,77.31958763,2400,-549888,64512,-485376,-1
538,34,27,3,0.0594405594,0.940559441,161.7118202,206.9717502,283.7156134,330.5588235,572,39.80514962,1144,-275456,17408,-258048,-1
9506,462,17,13,0.0463483146,0.953651685,2859.072139,3082.284249,5030.913949,4029.497835,9968,1002.816901,19936,-4867072,236544,-4630528,-1
6893,582,21,9,0.0778595318,0.922140468,2121.894577,2539.973918,3724.637458,3896.261168,7475,300.9259259,14950,-3529216,297984,-3231232,-1
4966,357,21,9,0.0670674432,0.932932557,1528.340069,1647.40711,2662.874346,2649.837535,5323,230.4329004,10646,-2542592,182784,-2359808,-1
2594,365,19,11,0.123352484,0.876647516,860.9383448,763.8170422,1513.319584,1243.20274,2959,59.98378269,5918,-1328128,186880,-1141248,-1
703,47,24,6,0.0626666667,0.937333333,214.1654199,219.1904939,383.1337127,261.3191489,750,97.65625,1500,-359936,24064,-335872,-1
9421,529,21,9,0.0531658291,0.946834171,2847.970992,2887.174115,5060.051375,3469.718336,9950,509.9948744,19900,-4823552,270848,-4552704,-1
308,89,18,12,0.22418136,0.77581864,108.9689062,132.183036,200.1753247,194.9325843,397,32.17179903,794,-157696,45568,-112128,-1
44,12,22,8,0.214285714,0.785714286,15.93497894,15.0249792,30.40909091,21.5,56,11.91489362,112,-22528,6144,-16384,-1
3031,247,22,8,0.0753508237,0.924649176,927.9485899,1104.088415,1614.973276,1940.473684,3278,230.5203938,6556,-1551872,126464,-1425408,-1
2019,154,20,10,0.0708697653,0.929130235,609.282897,724.6054495,1116.444775,700.9675325,2173,41.17089807,4346,-1033728,78848,-954880,-1
9296,638,21,9,0.0642238776,0.935776122,2866.783154,2752.345041,5024.02216,4143.942006,9934,710.0786276,19868,-4759552,326656,-4432896,-1
9637,350,27,3,0.0350455592,0.964954441,2876.771587,2987.463648,5015.826294,4393.028571,9987,471.0849057,19974,-4934144,179200,-4754944,-1
3369,252,27,3,0.0695940348,0.930405965,1034.916822,1055.886583,1848.232116,1313.242063,3621,197.5450082,7242,-1724928,129024,-1595904,-1
9029,875,20,10,0.0883481422,0.911651858,2856.741532,2744.867874,5033.972644,4111.795429,9904,1142.329873,19808,-4622848,448000,-4174848,-1
7243,2677,22,8,0.269858871,0.730141129,2710.125863,2792.514261,4439.859174,6369.166978,9920,365.2430044,19840,-3708416,1370624,-2337792,-1
9124,797,20,10,0.0803346437,0.919665356,2828.531008,3231.338362,4939.070473,5212.047679,9921,383.4943951,19842,-4671488,408064,-4263424,-1
9387,569,19,11,0.0571514665,0.942848534,2836.651143,3388.397261,5010.860871,4444.630931,9956,715.744069,19912,-4806144,291328,-4514816,-1
2936,421,21,9,0.125409592,0.874590408,945.2251035,1086.784916,1641.905654,1937.691211,3357,114.1060503,6714,-1503232,215552,-1287680,-1
9436,527,20,10,0.0528957141,0.947104286,2846.876853,3156.047018,5044.033807,3871.27704,9963,1321.352785,19926,-4831232,269824,-4561408,-1
2395,265,17,13,0.0996240602,0.90037594,744.0170586,951.7333786,1320.082672,1424.649057,2660,60.50955414,5320,-1226240,135680,-1090560,-1
636,88,21,9,0.121546961,0.878453039,198.733576,256.4794508,350.7893082,447.1363636,724,23.24983943,1448,-325632,45056,-280576,-1
80,29,18,12,0.266055046,0.733944954,31.04577014,28.88494541,59.6875,42.06896552,109,2.991218441,218,-40960,14848,-26112,-1
2811,304,21,9,0.0975922953,0.902407705,874.5399074,1044.81468,1522.1455,1889.536184,3115,158.3629893,6230,-1439232,155648,-1283584,-1
9518,451,17,13,0.0452402448,0.954759755,2870.42957,3022.199906,4994.541185,4783.640798,9969,1380.747922,19938,-4873216,230912,-4642304,-1
8528,1304,23,7,0.132628153,0.867371847,2874.643754,2587.650505,4914.668269,4928.479294,9832,231.5591145,19664,-4366336,667648,-3698688,-1
9624,365,19,11,0.0365401942,0.963459806,2864.997957,3202.96593,5029.76143,4078.441096,9989,370.6493506,19978,-4927488,186880,-4740608,-1
9207,700,21,9,0.0706571111,0.929342889,2852.875994,2834.142171,5014.208754,4162.082857,9907,299.6672716,19814,-4713984,358400,-4355584,-1
6914,369,18,12,0.0506659344,0.949334066,2084.751587,2405.533116,3634.674139,3779.265583,7283,181.984008,14566,-3539968,188928,-3351040,-1
9102,819,21,9,0.0825521621,0.917447838,2875.445722,2713.35383,4989.111404,4648.582418,9921,631.5085933,19842,-4660224,419328,-4240896,-1
33,20,16,14,0.377358491,0.622641509,15.52142392,14.60616308,28.45454545,24.6,53,12.67942584,106,-16896,10240,-6656,-1
706,83,21,9,0.105196451,0.894803549,227.1921099,229.0762474,399.470255,356.9759036,789,53.67346939,1578,-361472,42496,-318976,-1
2286,125,22,8,0.0518457072,0.948154293,691.5577472,723.4039374,1220.455818,941.632,2411,167.0824671,4822,-1170432,64000,-1106432,-1
9102,828,21,9,0.0833836858,0.916616314,2906.267461,2381.727179,4978.891013,4818.295894,9930,456.3419118,19860,-4660224,423936,-4236288,-1
7726,508,19,11,0.0616954093,0.938304591,2318.028003,3008.527142,4060.318664,4987.151575,8234,494.8317308,16468,-3955712,260096,-3695616,-1
7595,2324,20,10,0.234297812,0.765702188,2458.966628,2913.182151,4264.540224,7232.812823,9919,189.9100134,19838,-3888640,1189888,-2698752,-1
229,28,20,10,0.108949416,0.891050584,70.51446337,88.2489738,134.2445415,86.10714286,257,5.01953125,514,-117248,14336,-102912,-1
50,20,20,10,0.285714286,0.714285714,20.25265415,19.36749855,37.3,31,70,11.82432432,140,-25600,10240,-15360,-1
4436,259,21,9,0.0551650692,0.944834931,1344.96086,1469.006532,2370.593553,1961.030888,4695,276.6647024,9390,-2271232,132608,-2138624,-1
4792,625,21,9,0.115377515,0.884622485,1548.054216,1658.256476,2676.528381,2957.9664,5417,174.4605475,10834,-2453504,320000,-2133504,-1
5778,360,27,3,0.0586510264,0.941348974,1760.040282,1856.084414,3106.07892,2482.408333,6138,175.2712736,12276,-2958336,184320,-2774016,-1
608,100,19,11,0.141242938,0.858757062,197.0315559,229.6954122,367.2072368,277.24,708,13.3383572,1416,-311296,51200,-260096,-1
87,26,20,10,0.230088496,0.769911504,33.00764794,23.99210916,62.26436782,39.38461538,113,21.64750958,226,-44544,13312,-31232,-1
3862,255,22,8,0.0619383046,0.938061695,1182.047826,1263.901245,2072.684878,1851.741176,4117,163.9585822,8234,-1977344,130560,-1846784,-1
9201,581,22,8,0.0593948068,0.940605193,2761.105285,3345.563821,4798.058907,6371.27883,9782,754.2020046,19564,-4710912,297472,-4413440,-1
116,13,24,6,0.100775194,0.899224806,36.8626012,36.2819335,66.89655172,48.07692308,129,6.462925852,258,-59392,6656,-52736,-1
9327,608,22,8,0.0611977856,0.938802214,2857.830997,2950.491249,5008.544334,4346.03125,9935,695.7282913,19870,-4775424,311296,-4464128,-1
4228,437,20,10,0.093676313,0.906323687,1328.128873,1485.790996,2304.18543,2611.782609,4665,231.0549777,9330,-2164736,223744,-1940992,-1
5519,297,20,10,0.0510660248,0.948933975,1669.886136,1815.595014,2923.829679,2623.636364,5816,304.3432758,11632,-2825728,152064,-2673664,-1
7706,342,20,10,0.0424950298,0.95750497,2304.227471,2655.335007,4049.482351,3461.593567,8048,576.9175627,16096,-3945472,175104,-3770368,-1
3695,501,24,6,0.119399428,0.880600572,1207.966153,1224.125061,2077.261976,2255.135729,4196,142.8182437,8392,-1891840,256512,-1635328,-1
9170,746,22,8,0.0752319484,0.924768052,2856.987513,2883.947959,4998.735005,4463.922252,9916,439.9290151,19832,-4695040,381952,-4313088,-1
9465,496,21,9,0.0497941974,0.950205803,2844.752423,3344.621272,5014.789012,4336.215726,9961,621.0099751,19922,-4846080,253952,-4592128,-1
5113,239,20,10,0.0446562033,0.955343797,1535.556063,1726.91891,2683.926462,2517.623431,5352,132.4424647,10704,-2617856,122368,-2495488,-1
532,119,21,9,0.182795699,0.817204301,184.7578282,201.3191266,324.3327068,333.4537815,651,72.49443207,1302,-272384,60928,-211456,-1
8976,930,20,10,0.0938824955,0.906117505,2826.912646,3132.711736,4992.753899,4574.636559,9906,793.75,19812,-4595712,476160,-4119552,-1
9489,471,20,10,0.0472891566,0.952710843,2855.623026,3196.272549,5007.536832,4435.802548,9960,691.6666667,19920,-4858368,241152,-4617216,-1
9435,519,18,12,0.0521398433,0.947860157,2837.784326,3397.575009,4942.847801,5607.44894,9954,611.0497238,19908,-4830720,265728,-4564992,-1
824,49,27,3,0.0561282932,0.943871707,247.0895453,306.8101269,442.9769417,336.4897959,873,70.80291971,1746,-421888,25088,-396800,-1
416,80,18,12,0.161290323,0.838709677,139.1090841,156.6319088,256.2716346,208.0875,496,37.1814093,992,-212992,40960,-172032,-1
874,53,20,10,0.0571736785,0.942826321,262.5039611,318.4717546,471.1510297,346.0754717,927,93.25955734,1854,-447488,27136,-420352,-1
3739,268,18,12,0.0668829548,0.933117045,1144.532186,1295.111296,2019.793528,1783.656716,4007,568.3687943,8014,-1914368,137216,-1777152,-1
82,31,21,9,0.274336283,0.725663717,33.26427806,29.40697249,60,49.06451613,113,15.33242877,226,-41984,15872,-26112,-1
1837,235,18,12,0.113416988,0.886583012,573.6990767,751.1416855,1052.383778,912.3361702,2072,145.7102672,4144,-940544,120320,-820224,-1
656,96,18,12,0.127659574,0.872340426,214.5715516,233.2757881,377.9786585,366.3958333,752,47.20652856,1504,-335872,49152,-286720,-1
388,70,18,12,0.152838428,0.847161572,127.7720945,153.8285164,231.943299,215.9571429,458,20.00873744,916,-198656,35840,-162816,-1
6335,285,22,8,0.0430513595,0.95694864,1890.510589,2232.761575,3338.356906,2691.294737,6620,323.0844314,13240,-3243520,145920,-3097600,-1
433,112,17,13,0.205504587,0.794495413,155.7248132,162.6637391,276.5150115,259.4107143,545,26.58536585,1090,-221696,57344,-164352,-1
150,44,21,9,0.226804124,0.773195876,55.08932585,55.80489181,102.4466667,80.63636364,194,14.31734317,388,-76800,22528,-54272,-1
2893,777,19,11,0.211716621,0.788283379,916.6251178,1120.279064,1607.011753,2686.229086,3670,78.06849606,7340,-1481216,397824,-1083392,-1
9474,488,21,9,0.0489861474,0.951013853,2864.340867,3075.831398,4996.086869,4698.311475,9962,1021.74359,19924,-4850688,249856,-4600832,-1
430,96,20,10,0.182509506,0.817490494,142.5355035,175.662669,276.9976744,203.0416667,526,74.29378531,1052,-220160,49152,-171008,-1
7171,409,20,10,0.0539577836,0.946042216,2147.102557,2798.754512,3775.246967,4057.93154,7580,208.9881445,15160,-3671552,209408,-3462144,-1
8984,927,20,10,0.0935324387,0.906467561,2836.116255,3091.397695,4948.312333,5030.504854,9911,273.3314948,19822,-4599808,474624,-4125184,-1
4866,384,17,13,0.0731428571,0.926857143,1499.32991,1476.191448,2690.731402,1798.895833,5250,171.5125776,10500,-2491392,196608,-2294784,-1
238,68,22,8,0.222222222,0.777777778,87.64303601,86.45945306,160.4159664,129.2941176,306,39.43298969,612,-121856,34816,-87040,-1
1565,89,18,12,0.053808948,0.946191052,468.6846278,595.9307721,835.1220447,693.4719101,1654,225.9562842,3308,-801280,45568,-755712,-1
8059,874,21,9,0.0978394716,0.902160528,2523.684522,3035.526813,4450.553419,4618.65103,8933,433.0101794,17866,-4126208,447488,-3678720,-1
271,51,19,11,0.158385093,0.841614907,88.84761961,108.2252269,166.6605166,134.0784314,322,31.41463415,644,-138752,26112,-112640,-1
8787,388,12,18,0.0422888283,0.957711172,2634.783586,2938.408913,4580.115398,4766.561856,9175,590.7920155,18350,-4498944,198656,-4300288,-1
3675,496,16,14,0.118916327,0.881083673,1180.641932,1267.117314,2021.647619,2562.804435,4171,88.74468085,8342,-1881600,253952,-1627648,-1
7973,428,19,11,0.0509463159,0.949053684,2397.594097,2657.364671,4260.54233,3091.815421,8401,430.1587302,16802,-4082176,219136,-3863040,-1
1223,123,20,10,0.0913818722,0.908618128,383.0334861,418.378837,686.4717907,544.5203252,1346,40.11922504,2692,-626176,62976,-563200,-1
9326,606,20,10,0.0610149013,0.938985099,2846.703031,3146.276078,4944.983165,5297.632013,9932,1047.679325,19864,-4774912,310272,-4464640,-1
5299,268,21,9,0.0481408299,0.95185917,1604.375489,1642.265842,2795.644839,2553.753731,5567,239.1323024,11134,-2713088,137216,-2575872,-1
153,43,19,11,0.219387755,0.780612245,53.96651563,63.31726666,102.1830065,85.39534884,196,30.76923077,392,-78336,22016,-56320,-1
3065,162,17,13,0.0502014255,0.949798575,917.8351717,1012.927895,1643.221533,1061.135802,3227,143.4222222,6454,-1569280,82944,-1486336,-1
4414,308,22,8,0.0652265989,0.934773401,1348.313669,1493.504052,2391.900091,1925.831169,4722,124.9206349,9444,-2259968,157696,-2102272,-1
5330,266,17,13,0.0475339528,0.952466047,1598.430117,1726.549532,2839.917824,1968.586466,5596,106.8550697,11192,-2728960,136192,-2592768,-1
9543,437,21,9,0.0437875752,0.956212425,2855.896645,3248.872998,5032.673268,4069.540046,9980,1050.526316,19960,-4886016,223744,-4662272,-1
6712,564,20,10,0.0775151182,0.922484882,2053.513949,2533.394531,3593.463647,4174.464539,7276,285.8939096,14552,-3436544,288768,-3147776,-1
1233,206,18,12,0.143154969,0.856845031,415.1908668,407.0022823,706.1970803,802.6165049,1439,90.90334807,2878,-631296,105472,-525824,-1
8313,774,22,8,0.0851766259,0.914823374,2604.296076,2817.872196,4540.465295,4581.963824,9087,263.5440835,18174,-4256256,396288,-3859968,-1
7262,390,20,10,0.0509670674,0.949032933,2193.539088,2399.885361,3858.863536,3223.874359,7652,149.7455969,15304,-3718144,199680,-3518464,-1
452,66,17,13,0.127413127,0.872586873,146.7502754,161.7017002,265.3827434,219.2121212,518,80.18575851,1036,-231424,33792,-197632,-1
9549,424,21,9,0.0425147899,0.95748521,2858.107881,3103.28099,5037.517646,3849.28066,9973,1032.401656,19946,-4889088,217088,-4672000,-1
1414,196,27,3,0.12173913,0.87826087,461.3768985,485.1204396,798.0190948,859.4693878,1610,85.41114058,3220,-723968,100352,-623616,-1
3543,241,17,13,0.0636892178,0.936310782,1078.024755,1090.79136,1937.158905,1235.958506,3784,412.6499455,7568,-1814016,123392,-1690624,-1
2967,285,21,9,0.0876383764,0.912361624,933.0541752,979.4462231,1643.265251,1451.964912,3252,195.1980792,6504,-1519104,145920,-1373184,-1
271,65,21,9,0.193452381,0.806547619,94.24455437,98.20023018,178.0295203,128.7692308,336,26.37362637,672,-138752,33280,-105472,-1
3134,594,21,9,0.159334764,0.840665236,1019.054621,1141.036279,1743.138481,2504.814815,3728,84.92027335,7456,-1604608,304128,-1300480,-1
1353,71,18,12,0.0498595506,0.950140449,404.125716,455.7695102,725.9541759,456.1126761,1424,189.3617021,2848,-692736,36352,-656384,-1
8843,1072,20,10,0.108119012,0.891880988,2812.958184,2867.716109,4785.344792,6382.244403,9915,312.2834646,19830,-4527616,548864,-3978752,-1
6581,499,21,9,0.070480226,0.929519774,2033.046601,2061.646954,3592.504483,2854.645291,7080,320.2170963,14160,-3369472,255488,-3113984,-1
290,29,27,3,0.0909090909,0.909090909,88.83172913,103.9629725,154.3103448,216.8965517,319,31.67825223,638,-148480,14848,-133632,-1
3270,324,22,8,0.0901502504,0.90984975,1022.94707,999.0364631,1855.831498,1208.783951,3594,298.2572614,7188,-1674240,165888,-1508352,-1
1113,124,21,9,0.100242522,0.899757478,350.8639304,355.6454597,640.2938005,427.8709677,1237,22.95842613,2474,-569856,63488,-506368,-1
5554,302,26,4,0.0515710383,0.948428962,1677.879607,1906.385843,2925.121894,2990.625828,5856,190.4390244,11712,-2843648,154624,-2689024,-1
9624,357,20,10,0.0357679591,0.964232041,2870.966303,3055.352648,5018.349439,4253.714286,9981,453.4756929,19962,-4927488,182784,-4744704,-1
1533,172,16,14,0.100879765,0.899120235,470.7528668,636.8550083,868.2922374,716.7034884,1705,140.3292181,3410,-784896,88064,-696832,-1
9392,578,21,9,0.0579739218,0.942026078,2838.776479,3083.916099,5078.515226,3474.083045,9970,813.877551,19940,-4808704,295936,-4512768,-1
4430,249,21,9,0.0532164993,0.946783501,1330.493823,1419.682964,2388.094808,1484.337349,4679,317.220339,9358,-2268160,127488,-2140672,-1
605,79,18,12,0.115497076,0.884502924,188.7744321,247.9326377,349.4347107,289.3924051,684,108.056872,1368,-309760,40448,-269312,-1
119,11,22,8,0.0846153846,0.915384615,35.673325,44.0099538,68.21008403,36.18181818,130,6.622516556,260,-60928,5632,-55296,-1
2318,145,22,8,0.0588712952,0.941128705,711.3903254,703.2192666,1234.905522,1185.551724,2463,79.14524422,4926,-1186816,74240,-1112576,-1
3594,591,20,10,0.141218638,0.858781362,1180.284341,1355.150855,2067.88286,2245.742809,4185,80.90083124,8370,-1840128,302592,-1537536,-1
4065,484,22,8,0.10639701,0.89360299,1312.46241,1318.890276,2278.324477,2247.078512,4549,86.25331816,9098,-2081280,247808,-1833472,-1
4827,398,20,10,0.0761722488,0.923827751,1485.162375,1581.128997,2550.794489,3367.437186,5225,188.0849532,10450,-2471424,203776,-2267648,-1
548,52,18,12,0.0866666667,0.913333333,168.1879377,187.6564594,310.7737226,192.2307692,600,52.67778753,1200,-280576,26624,-253952,-1
1833,320,21,9,0.148629819,0.851370181,618.2782526,639.232987,1072.832515,1100.871875,2153,49.66551326,4306,-938496,163840,-774656,-1
2019,205,17,13,0.092176259,0.907823741,623.9833655,793.2477408,1121.015354,1028.634146,2224,119.4414608,4448,-1033728,104960,-928768,-1
325,43,27,3,0.116847826,0.883152174,106.4175676,97.5247469,189.2769231,148.3953488,368,37.24696356,736,-166400,22016,-144384,-1
6903,415,25,5,0.0567094835,0.943290517,2104.005499,2117.223575,3703.876865,2921.346988,7318,232.9089752,14636,-3534336,212480,-3321856,-1
9436,522,25,5,0.0524201647,0.947579835,2845.050369,3338.520693,5002.076092,4571.400383,9958,1069.602578,19916,-4831232,267264,-4563968,-1
5304,350,25,5,0.0619030775,0.938096923,1624.859993,1735.774647,2834.451357,2722.157143,5654,106.218298,11308,-2715648,179200,-2536448,-1
9437,522,20,10,0.0524149011,0.947585099,2851.433879,2960.399554,5054.844654,3626.917625,9959,889.1964286,19918,-4831744,267264,-4564480,-1
41,12,20,10,0.226415094,0.773584906,15.66920843,10.73804245,29.29268293,19.16666667,53,7.391910739,106,-20992,6144,-14848,-1
3274,276,22,8,0.0777464789,0.922253521,1010.79887,1178.155409,1776.529627,1763.286232,3550,90.56122449,7100,-1676288,141312,-1534976,-1
9531,454,24,6,0.0454682023,0.954531798,2843.599303,3196.052006,5070.320218,3369.786344,9985,929.7020484,19970,-4879872,232448,-4647424,-1
478,72,19,11,0.130909091,0.869090909,152.7548257,184.5208463,283.9288703,219.5416667,550,48.0349345,1100,-244736,36864,-207872,-1
9029,900,21,9,0.0906435693,0.909356431,2887.705752,2512.732628,5042.419205,4188.313333,9929,339.9178364,19858,-4622848,460800,-4162048,-1
2639,162,22,8,0.057836487,0.942163513,803.6578031,879.2470834,1395.04964,1497.932099,2801,200.6446991,5602,-1351168,82944,-1268224,-1
2746,227,21,9,0.0763538513,0.923646149,836.3346398,1083.400494,1478.420976,1590.779736,2973,116.8172888,5946,-1405952,116224,-1289728,-1
5460,4464,20,10,0.449818622,0.550181378,1964.377367,1934.860314,3065.798168,7282.390681,9924,312.7639458,19848,-2795520,2285568,-509952,-1
5440,344,18,12,0.0594744122,0.940525588,1667.806895,1634.476747,2921.010294,2441.639535,5784,523.438914,11568,-2785280,176128,-2609152,-1
3308,184,21,9,0.0526918671,0.947308133,995.9895454,1183.708905,1758.564389,1529.603261,3492,185.3503185,6984,-1693696,94208,-1599488,-1
7623,976,21,9,0.11350157,0.88649843,2428.693053,2764.591188,4208.524334,5014.466189,8599,187.9152098,17198,-3902976,499712,-3403264,-1
417,92,21,9,0.180746562,0.819253438,138.0321734,181.7603028,253.5467626,261.5869565,509,11.94835681,1018,-213504,47104,-166400,-1
9430,545,18,12,0.0546365915,0.945363409,2829.071105,3308.532534,5073.77211,3503.906422,9975,979.8624754,19950,-4828160,279040,-4549120,-1
9098,582,21,9,0.0601239669,0.939876033,2738.435582,3458.720643,4789.207518,5642.319588,9680,226.8041237,19360,-4658176,297984,-4360192,-1
9441,519,23,7,0.0521084337,0.947891566,2864.179115,2983.05186,5019.068001,4278.919075,9960,770.3016241,19920,-4833792,265728,-4568064,-1
2281,242,27,3,0.0959175585,0.904082442,696.7736562,973.3216931,1253.590969,1341.260331,2523,186.612426,5046,-1167872,123904,-1043968,-1
2203,195,22,8,0.0813177648,0.918682235,675.0719283,658.6385816,1246.785747,665.2923077,2398,126.4767932,4796,-1127936,99840,-1028096,-1
415,112,19,11,0.212523719,0.787476281,143.3441701,179.8657698,259.1325301,282.0357143,527,9.808300763,1054,-212480,57344,-155136,-1
787,66,21,9,0.0773739742,0.922626026,240.4799033,219.0893164,444.2884371,220.8484848,853,15.92606423,1706,-402944,33792,-369152,-1
6081,320,20,10,0.0499921887,0.950007811,1835.843922,1927.776785,3238.539714,2487.628125,6401,122.6480169,12802,-3113472,163840,-2949632,-1
7035,642,20,10,0.0836264166,0.916373583,2207.691137,2262.950746,3799.843639,4268.073209,7677,181.7901965,15354,-3601920,328704,-3273216,-1
6891,435,21,9,0.0593775594,0.940622441,2089.302933,2378.22377,3707.517922,2966.195402,7326,210.2755454,14652,-3528192,222720,-3305472,-1
174,50,16,14,0.223214286,0.776785714,62.40104466,65.80008815,119.8908046,86.78,224,29.01554404,448,-89088,25600,-63488,-1
3415,471,17,13,0.121204323,0.878795677,1114.996569,1168.61496,1936.471157,1994.462845,3886,157.4554295,7772,-1748480,241152,-1507328,-1
9428,525,21,9,0.0527479152,0.947252085,2865.465136,2691.760027,5049.814171,3669.39619,9953,828.7260616,19906,-4827136,268800,-4558336,-1
1840,261,20,10,0.124226559,0.875773441,589.0716449,669.6933533,1016.816848,1291.984674,2101,46.56471631,4202,-942080,133632,-808448,-1
459,82,21,9,0.151571165,0.848428835,147.8345929,186.0541158,260.6405229,328.9878049,541,47.96099291,1082,-235008,41984,-193024,-1
9645,345,23,7,0.0345345345,0.965465465,2874.666632,3069.99153,5016.953655,4395.730435,9990,1118.701008,19980,-4938240,176640,-4761600,-1
2294,263,21,9,0.102854908,0.897145092,722.2967629,840.0173401,1301.007847,1087.038023,2557,185.1556843,5114,-1174528,134656,-1039872,-1
6405,343,18,12,0.0508298755,0.949170124,1926.26335,2275.263459,3397.175176,2951.075802,6748,838.2608696,13496,-3279360,175616,-3103744,-1
225,45,21,9,0.166666667,0.833333333,77.47705037,80.04998438,134.5333333,140.3333333,270,34.88372093,540,-115200,23040,-92160,-1
46,17,21,9,0.26984127,0.73015873,17.76720126,19.01683829,32.97826087,29.35294118,63,10.53511706,126,-23552,8704,-14848,-1
3836,193,21,9,0.0479027054,0.952097295,1157.115271,1265.308016,2022.981491,1856.362694,4029,113.3971292,8058,-1964032,98816,-1865216,-1
2713,189,25,5,0.0651274983,0.934872502,829.0292328,932.7183341,1464.993734,1257.804233,2902,170.7058824,5804,-1389056,96768,-1292288,-1
2416,293,21,9,0.108157992,0.891842008,764.4624988,830.4972752,1311.27856,1715.515358,2709,51.29710282,5418,-1236992,150016,-1086976,-1
3019,211,21,9,0.0653250774,0.934674923,921.592405,1073.280549,1620.142763,1549.07109,3230,98.44559585,6460,-1545728,108032,-1437696,-1
1957,260,18,12,0.117275598,0.882724402,637.3298443,657.2440651,1116.085846,1055.665385,2217,207.5842697,4434,-1001984,133120,-868864,-1
1551,134,23,7,0.0795252226,0.920474777,476.5143367,517.7580941,866.2836879,573.5,1685,140.8862876,3370,-794112,68608,-725504,-1
4526,251,27,3,0.0525434373,0.947456563,1366.089943,1415.908227,2428.518118,1676.414343,4777,88.92405063,9554,-2317312,128512,-2188800,-1
2233,183,21,9,0.0757450331,0.924254967,688.8897397,794.3721866,1208.820421,1204.590164,2416,105.8720421,4832,-1143296,93696,-1049600,-1
8989,950,22,8,0.0955830566,0.904416943,2743.917993,3314.180564,4771.53966,6847.852632,9939,762.1932515,19878,-4602368,486400,-4115968,-1
1371,144,27,3,0.095049505,0.904950495,433.043634,472.1069498,764.3267688,697.7638889,1515,154.4342508,3030,-701952,73728,-628224,-1
5686,615,18,12,0.097603555,0.902396445,1811.368033,1798.97941,3092.296166,3693.747967,6301,166.8697034,12602,-2911232,314880,-2596352,-1
7651,379,17,13,0.0471980075,0.952801993,2306.110966,2390.425685,4058.062475,3156.277045,8030,660.9053498,16060,-3917312,194048,-3723264,-1
4912,234,22,8,0.0454722114,0.954527789,1471.072863,1604.064475,2607.400448,1861.880342,5146,223.6418948,10292,-2514944,119808,-2395136,-1
5416,293,19,11,0.0513224733,0.948677527,1632.582265,1904.652823,2863.514956,2697.604096,5709,112.0290424,11418,-2772992,150016,-2622976,-1
1162,252,20,10,0.178217822,0.821782178,406.4629949,394.3707888,681.4466437,827.6349206,1414,86.85503686,2828,-594944,129024,-465920,-1
9598,384,27,3,0.0384692446,0.961530755,2868.6349,3090.28162,5022.15274,4225.341146,9982,1407.898449,19964,-4914176,196608,-4717568,-1
8597,1341,22,8,0.134936607,0.865063393,2666.918251,3404.92742,4686.564965,6783.364653,9938,534.013971,19876,-4401664,686592,-3715072,-1
762,71,21,9,0.0852340936,0.914765906,235.4701038,244.9146623,430.6207349,270.8169014,833,71.99654278,1666,-390144,36352,-353792,-1
9481,481,20,10,0.0482834772,0.951716523,2850.852773,3301.121208,5002.881869,4560.04158,9962,891.0554562,19924,-4854272,246272,-4608000,-1
5685,545,19,11,0.0874799358,0.912520064,1779.129969,1982.793916,3101.377485,3262.814679,6230,153.5617451,12460,-2910720,279040,-2631680,-1
643,54,27,3,0.0774748924,0.922525108,202.2414844,186.6218862,346.8911353,374.1111111,697,42.78698588,1394,-329216,27648,-301568,-1
2101,289,20,10,0.120920502,0.879079498,678.4106627,768.5247842,1195.242742,1197.370242,2390,81.29251701,4780,-1075712,147968,-927744,-1
986,59,24,6,0.0564593301,0.94354067,299.1490156,338.5192497,525.3772819,483.2711864,1045,67.20257235,2090,-504832,30208,-474624,-1
1239,103,24,6,0.0767511177,0.923248882,374.6751826,495.7543542,683.0686037,532.3398058,1342,107.1884984,2684,-634368,52736,-581632,-1
2162,168,21,9,0.0721030043,0.927896996,659.5335605,818.866981,1159.657724,1240.684524,2330,81.24128312,4660,-1106944,86016,-1020928,-1
897,84,20,10,0.0856269113,0.914373089,273.8106185,368.6677753,491.7491639,483,981,18.40870707,1962,-459264,43008,-416256,-1
9449,517,21,9,0.0518763797,0.94812362,2853.338477,2934.590639,5061.370515,3560.29207,9966,964.7628267,19932,-4837888,264704,-4573184,-1
545,47,18,12,0.0793918919,0.920608108,165.437282,218.5547947,300.8201835,246.4042553,592,24.12387938,1184,-279040,24064,-254976,-1
1698,68,27,3,0.0385050963,0.961494904,506.9895852,557.7356516,889.0795053,744.1764706,1766,58.71010638,3532,-869376,34816,-834560,-1
642,46,23,7,0.0668604651,0.933139535,194.380744,245.2727591,347.9423676,296.4565217,688,72.57383966,1376,-328704,23552,-305152,-1
4706,636,20,10,0.119056533,0.880943467,1516.71379,1705.350267,2644.743944,2869.477987,5342,104.8273155,10684,-2409472,325632,-2083840,-1
9463,503,21,9,0.0504716035,0.949528397,2869.765815,2929.743996,5018.956251,4316.457256,9966,587.9646018,19932,-4845056,257536,-4587520,-1
8989,366,20,10,0.0391234634,0.960876537,2692.824905,2847.600603,4696.212816,4230.691257,9355,296.5134707,18710,-4602368,187392,-4414976,-1
9588,388,18,12,0.038893344,0.961106656,2878.098697,2885.236308,5006.859199,4534.819588,9976,673.1443995,19952,-4909056,198656,-4710400,-1
4093,178,21,9,0.0416764224,0.958323578,1226.171694,1344.594328,2149.081847,1835.191011,4271,249.4742991,8542,-2095616,91136,-2004480,-1
9070,815,21,9,0.0824481538,0.917551846,2858.537438,2785.118505,4920.378721,5194.748466,9885,592.2708209,19770,-4643840,417280,-4226560,-1
1261,123,27,3,0.0888728324,0.911127168,390.4801012,462.3579244,679.628073,824.4634146,1384,36.48826786,2768,-645632,62976,-582656,-1
5907,416,18,12,0.0657915546,0.934208445,1797.601218,2102.066482,3122.452006,3723.5625,6323,326.4326278,12646,-3024384,212992,-2811392,-1
7056,434,20,10,0.0579439252,0.942056075,2145.729714,2168.127042,3808.853175,2715.5,7490,406.6232356,14980,-3612672,222208,-3390464,-1
2248,264,18,12,0.105095541,0.894904459,725.0759207,724.8917818,1252.471085,1290.806818,2512,171.3506139,5024,-1150976,135168,-1015808,-1
67,26,20,10,0.279569892,0.720430108,27.8609586,21.21714306,50.71641791,37.42307692,93,14.97584541,186,-34304,13312,-20992,-1
2403,246,19,11,0.0928652322,0.907134768,757.4238906,641.9686259,1376.670412,820.2682927,2649,293.3554817,5298,-1230336,125952,-1104384,-1
7197,511,20,10,0.0662947587,0.933705241,2198.836228,2531.989682,3825.631096,4261.093933,7708,467.7184466,15416,-3684864,261632,-3423232,-1
3101,1561,19,11,0.334834835,0.665165165,1051.215388,1018.036569,1725.670429,3535.008969,4662,90.54185279,9324,-1587712,799232,-788480,-1
5830,404,17,13,0.0648059031,0.935194097,1772.268092,2151.217507,3108.099828,3253.15099,6234,753.808948,12468,-2984960,206848,-2778112,-1
5492,518,25,5,0.0861896839,0.913810316,1715.916652,1923.268417,3013.024581,2925.722008,6010,116.6310887,12020,-2811904,265216,-2546688,-1
1527,208,17,13,0.119884726,0.880115274,494.2544724,532.5092192,852.1015062,984.7163462,1735,115.7438292,3470,-781824,106496,-675328,-1
3130,254,18,12,0.0750591017,0.924940898,962.6530076,1137.635996,1692.121086,1697.169291,3384,97.2972973,6768,-1602560,130048,-1472512,-1
7164,321,21,9,0.0428857715,0.957114228,2148.583543,2364.00933,3764.862228,3255.084112,7485,305.3855569,14970,-3667968,164352,-3503616,-1
3927,305,22,8,0.0720699433,0.927930057,1190.564762,1426.169643,2067.742552,2744.272131,4232,121.260745,8464,-2010624,156160,-1854464,-1
2088,184,19,11,0.0809859155,0.919014085,646.8030924,690.1009706,1161.554119,852.1902174,2272,148.7884741,4544,-1069056,94208,-974848,-1
9100,822,27,3,0.0828462004,0.9171538,2808.498265,3228.905727,4863.694505,6044.261557,9922,591.2991657,19844,-4659200,420864,-4238336,-1
4552,312,21,9,0.0641447368,0.935855263,1400.419701,1456.302138,2429.563489,2475.342949,4864,274.028169,9728,-2330624,159744,-2170880,-1
6058,522,17,13,0.079331307,0.920668693,1868.817348,2080.208012,3225.30307,4047.1341,6580,230.0699301,13160,-3101696,267264,-2834432,-1
118,38,18,12,0.243589744,0.756410256,43.84981616,45.88897236,82.91525424,64.78947368,156,17.68707483,312,-60416,19456,-40960,-1
82,25,20,10,0.23364486,0.76635514,30.83356378,22.65744911,59.67073171,35.4,107,13.93229167,214,-41984,12800,-29184,-1
2355,188,22,8,0.073928431,0.926071569,730.9254287,733.8065426,1290.613588,1038.835106,2543,88.14558059,5086,-1205760,96256,-1109504,-1
4444,335,21,9,0.0700983469,0.929901653,1359.960786,1488.848606,2435.946445,1780.489552,4779,355.3159851,9558,-2275328,171520,-2103808,-1
1050,143,18,12,0.119865884,0.880134116,340.7714961,352.8563251,611.1685714,492.965035,1193,27.29352551,2386,-537600,73216,-464384,-1
9563,411,19,11,0.0412071386,0.958792861,2864.505764,3010.314153,5033.561016,3915.768856,9974,413.0020704,19948,-4896256,210432,-4685824,-1
9559,418,20,10,0.0418963616,0.958103638,2871.739861,3014.075579,5012.89298,4442.605263,9977,1054.651163,19954,-4894208,214016,-4680192,-1
9538,432,20,10,0.04332999,0.95667001,2861.687043,3109.863578,5022.325016,4172.451389,9970,977.4509804,19940,-4883456,221184,-4662272,-1
1060,117,19,11,0.0994052676,0.900594732,330.0191202,417.7066397,587.7679245,600.1623932,1177,23.16017316,2354,-542720,59904,-482816,-1
312,29,18,12,0.0850439883,0.914956012,94.92076217,97.28590323,178.7211538,87.93103448,341,60.24734982,682,-159744,14848,-144896,-1
229,24,16,14,0.0948616601,0.90513834,69.29933628,74.58830291,133.9388646,60.79166667,253,66.75461741,506,-117248,12288,-104960,-1
2335,325,21,9,0.122180451,0.877819549,745.5972371,910.2040519,1322.881799,1385.233846,2660,63.25802616,5320,-1195520,166400,-1029120,-1
136,29,20,10,0.175757576,0.824242424,47.228094,32.67804974,90.19117647,49.27586207,165,38.64168618,330,-69632,14848,-54784,-1
114,35,20,10,0.234899329,0.765100671,42.22282564,44.15837915,77.92982456,65.45714286,149,22.37237237,298,-58368,17920,-40448,-1
7425,345,25,5,0.0444015444,0.955598456,2233.711507,2270.52413,3925.389899,3027,7770,450.1738123,15540,-3801600,176640,-3624960,-1
80,22,20,10,0.215686275,0.784313725,29.64650064,17.1631091,57.1,31.13636364,102,20.90163934,204,-40960,11264,-29696,-1
3572,228,21,9,0.06,0.94,1087.716474,1209.189567,1915.37262,1667.495614,3800,135.5690332,7600,-1828864,116736,-1712128,-1
9538,441,21,9,0.0441928049,0.955807195,2863.268224,3054.443954,5038.11428,3949.378685,9979,868.4943429,19958,-4883456,225792,-4657664,-1
9566,410,19,11,0.0410986367,0.958901363,2858.839263,3162.417819,5032.560318,3960.497561,9976,1132.349603,19952,-4897792,209920,-4687872,-1
5096,277,21,9,0.0515540666,0.948445933,1553.321793,1450.134484,2709.031397,2281.685921,5373,334.9750623,10746,-2609152,141824,-2467328,-1
6836,1078,19,11,0.136214304,0.863785696,2154.969316,2317.400835,3683.398771,5695.678108,7914,322.7569331,15828,-3500032,551936,-2948096,-1
3046,225,19,11,0.0687863039,0.931213696,930.9589954,1046.218197,1662.153316,1281.942222,3271,302.310536,6542,-1559552,115200,-1444352,-1
4838,233,18,12,0.0459475449,0.954052455,1447.943784,1734.885357,2550.582679,2233.206009,5071,344.9659864,10142,-2477056,119296,-2357760,-1
3708,364,16,14,0.0893909627,0.910609037,1144.92051,1384.734405,2076.981392,1624.123626,4072,165.1257097,8144,-1898496,186368,-1712128,-1
3962,258,21,9,0.0611374408,0.938862559,1211.011721,1313.753841,2120.786219,1952.53876,4220,111.4044351,8440,-2028544,132096,-1896448,-1
5250,290,21,9,0.0523465704,0.94765343,1590.669105,1635.867425,2803.547238,2172.231034,5540,215.9844055,11080,-2688000,148480,-2539520,-1
364,101,16,14,0.217204301,0.782795699,129.4316947,139.4170302,246.7664835,183.3861386,465,43.8265787,930,-186368,51712,-134656,-1
1190,119,20,10,0.0909090909,0.909090909,367.4186135,468.4396765,658.4243697,620.7563025,1309,102.4256651,2618,-609280,60928,-548352,-1
272,60,26,4,0.180722892,0.819277108,92.27605923,104.4564183,159.2647059,199.3,332,11.96396396,664,-139264,30720,-108544,-1
448,100,17,13,0.182481752,0.817518248,151.847939,161.9820394,292.0959821,195.67,548,51.6007533,1096,-229376,51200,-178176,-1
3597,481,20,10,0.117949975,0.882050025,1183.404577,1126.068214,2051.135391,1952.488565,4078,166.1099796,8156,-1841664,246272,-1595392,-1
2343,199,18,12,0.0782848151,0.921715185,716.4826042,912.8654987,1268.8344,1302.884422,2542,47.772975,5084,-1199616,101888,-1097728,-1
2464,252,17,13,0.0927835052,0.907216495,775.6505955,795.7184581,1390.737419,1043.289683,2716,126.6791045,5432,-1261568,129024,-1132544,-1
7563,265,22,8,0.033852836,0.966147164,2249.921125,2466.797318,3932.926881,3388.603774,7828,430.5830583,15656,-3872256,135680,-3736576,-1
3904,397,18,12,0.0923041153,0.907695885,1244.419859,1212.435137,2155.758197,2104.209068,4301,94.79832488,8602,-1998848,203264,-1795584,-1
6441,493,22,8,0.0710989328,0.928901067,1980.185135,2259.479768,3477.754075,3333.53144,6934,261.2660136,13868,-3297792,252416,-3045376,-1
72,29,20,10,0.287128713,0.712871287,29.78611707,25.9164027,54.15277778,43.17241379,101,21.53518124,202,-36864,14848,-22016,-1
2762,298,25,5,0.0973856209,0.902614379,843.8697011,1187.691096,1534.662201,1491.922819,3060,350.5154639,6120,-1414144,152576,-1261568,-1
9154,763,20,10,0.0769385903,0.92306141,2843.567395,3008.186009,4904.539983,5612.377457,9917,401.6605913,19834,-4686848,390656,-4296192,-1
4150,355,19,11,0.0788013319,0.921198668,1273.218694,1571.574117,2269.75759,2057.101408,4505,157.7380952,9010,-2124800,181760,-1943040,-1
3218,347,22,8,0.0973352034,0.902664797,1025.072097,990.1385391,1823.460224,1407.78098,3565,269.0566038,7130,-1647616,177664,-1469952,-1
2176,313,17,13,0.125753315,0.874246685,708.2330661,754.7515763,1215.359835,1451.060703,2489,165.0530504,4978,-1114112,160256,-953856,-1
260,52,18,12,0.166666667,0.833333333,86.75478697,90.00843772,166.3961538,107.0192308,312,36.19489559,624,-133120,26624,-106496,-1
2556,283,20,10,0.099682987,0.900317013,775.6292469,877.4580542,1496.805556,726.3074205,2839,98.85097493,5678,-1308672,144896,-1163776,-1
9050,635,21,9,0.0655653072,0.934434693,2780.706949,2985.429604,4821.038674,5155.992126,9685,204.4974662,19370,-4633600,325120,-4308480,-1
9442,526,25,5,0.0527688604,0.94723114,2867.187184,2998.719879,5016.697204,4406.541825,9968,594.0405244,19936,-4834304,269312,-4564992,-1
94,25,22,8,0.210084034,0.789915966,34.72157249,26.69729574,64.55319149,42.88,119,25.59139785,238,-48128,12800,-35328,-1
3617,204,20,10,0.0533891651,0.946610835,1097.142291,1101.444772,1937.492121,1441.284314,3821,85.3473308,7642,-1851904,104448,-1747456,-1
9632,347,20,10,0.0347730233,0.965226977,2875.465226,3007.022212,5000.668812,4693.855908,9979,1668.729097,19958,-4931584,177664,-4753920,-1
7204,680,21,9,0.0862506342,0.913749366,2225.254865,2431.078453,3825.361049,5183.483824,7884,237.6130199,15768,-3688448,348160,-3340288,-1
1435,312,20,10,0.178591872,0.821408128,493.2469862,539.973444,851.0655052,979.4839744,1747,32.52047655,3494,-734720,159744,-574976,-1
7013,472,22,8,0.0630594522,0.936940548,2118.545426,2628.627716,3699.714388,4386.139831,7485,163.0718954,14970,-3590656,241664,-3348992,-1
8501,1343,20,10,0.136428281,0.863571719,2817.992438,2754.507095,4752.680626,5997.432614,9844,598.4194529,19688,-4352512,687616,-3664896,-1
2490,178,20,10,0.0667166417,0.933283358,756.0086173,939.532961,1326.58755,1445.185393,2668,170.3703704,5336,-1274880,91136,-1183744,-1
2582,397,25,5,0.133266197,0.866733803,844.0251664,957.1636708,1490.326104,1487.879093,2979,63.57234315,5958,-1321984,203264,-1118720,-1
5885,671,21,9,0.102348993,0.897651007,1905.381633,1648.75989,3349.836024,2652.847988,6556,145.3980927,13112,-3013120,343552,-2669568,-1
9487,474,21,9,0.0475855838,0.952414416,2862.046995,2985.770975,5027.198798,4056.341772,9961,503.3350177,19922,-4857344,242688,-4614656,-1
7045,593,22,8,0.0776381252,0.922361875,2179.817527,2478.016181,3806.059191,3979.180438,7638,201.5835313,15276,-3607040,303616,-3303424,-1
5023,406,21,9,0.0747835697,0.92521643,1538.113086,1827.053446,2677.214812,3182.475369,5429,161.1457406,10858,-2571776,207872,-2363904,-1
2783,254,20,10,0.0836351663,0.916364834,860.1625126,1015.590483,1538.927776,1300.65748,3037,107.6950355,6074,-1424896,130048,-1294848,-1
4641,651,22,8,0.123015873,0.876984127,1503.874227,1656.510999,2604.13941,2948.490015,5292,204.7195358,10584,-2376192,333312,-2042880,-1
4135,383,21,9,0.084772023,0.915227977,1271.500912,1509.937535,2208.490447,2810.21671,4518,90.77757685,9036,-2117120,196096,-1921024,-1
1780,158,18,12,0.0815273478,0.918472652,539.7133955,694.5598632,992.797191,707.0379747,1938,72.52994012,3876,-911360,80896,-830464,-1
65,33,21,9,0.336734694,0.663265306,28.56515857,27.64456949,48.56923077,51.33333333,98,5.080352514,196,-33280,16896,-16384,-1
721,77,21,9,0.0964912281,0.903508772,226.8144528,218.6817078,414.0110957,263.6233766,798,27.30071844,1596,-369152,39424,-329728,-1
9227,699,21,9,0.0704211163,0.929578884,2859.813379,2934.027544,4974.658719,4816.201717,9926,694.6116165,19852,-4724224,357888,-4366336,-1
7383,314,19,11,0.040795115,0.959204885,2202.763091,2624.736089,3857.54314,3648.127389,7697,423.6103467,15394,-3780096,160768,-3619328,-1
9479,485,22,8,0.0486752308,0.951324769,2870.055658,2871.817145,5025.256567,4146.851546,9964,1137.442922,19928,-4853248,248320,-4604928,-1
7699,993,19,11,0.114242982,0.885757018,2460.070682,2850.290774,4315.979738,4583.131923,8692,160.5763902,17384,-3941888,508416,-3433472,-1
1833,205,21,9,0.100588813,0.899411187,572.6729595,697.8385374,1035.078014,880.2097561,2038,47.62795046,4076,-938496,104960,-833536,-1
2840,265,21,9,0.0853462158,0.914653784,886.9200914,983.4681995,1564.34507,1431.415094,3105,84.21480879,6210,-1454080,135680,-1318400,-1
3176,534,22,8,0.14393531,0.85606469,1051.435978,972.3007238,1751.328086,2475.069288,3710,112.6290225,7420,-1626112,273408,-1352704,-1
3355,209,22,8,0.0586419753,0.941358025,1015.330306,1166.977901,1805.108495,1419.574163,3564,174.1935484,7128,-1717760,107008,-1610752,-1
2568,231,18,12,0.0825294748,0.917470525,783.5655985,1020.717087,1417.94081,1200.554113,2799,188.993923,5598,-1314816,118272,-1196544,-1
1002,72,17,13,0.0670391061,0.932960894,300.8527198,373.8000305,550.3872255,358.1527778,1074,46.4532872,2148,-513024,36864,-476160,-1
2909,324,21,9,0.100216517,0.899783483,911.3439046,1090.870031,1594.728429,1816.962963,3233,104.1559278,6466,-1489408,165888,-1323520,-1
1170,115,27,3,0.0894941634,0.910505837,365.0977206,387.5360224,626.4273504,811.6086957,1285,142.7777778,2570,-599040,58880,-540160,-1
1987,272,20,10,0.12040726,0.87959274,641.5240898,724.7638589,1131.149472,1121.602941,2259,131.7969662,4518,-1017344,139264,-878080,-1
1386,115,17,13,0.0766155896,0.92338441,425.9492194,513.2098187,749.2128427,772.5391304,1501,133.4222222,3002,-709632,58880,-650752,-1
2918,196,26,4,0.0629415543,0.937058446,877.8847767,1107.526023,1533.320425,1917.479592,3114,156.7186714,6228,-1494016,100352,-1393664,-1
3971,180,25,5,0.043363045,0.956636955,1188.150871,1322.40968,2096.840091,1616.244444,4151,140.568913,8302,-2033152,92160,-1940992,-1
4726,375,22,8,0.0735149971,0.926485003,1461.623553,1539.857299,2585.203978,2119.938667,5101,142.9251891,10202,-2419712,192000,-2227712,-1
58,25,20,10,0.301204819,0.698795181,25.38353249,17.52054794,45.67241379,33.48,83,14.21232877,166,-29696,12800,-16896,-1
9113,783,22,8,0.0791228779,0.920877122,2825.907987,3133.502901,4999.360364,4356.55811,9896,633.1413948,19792,-4665856,400896,-4264960,-1
6507,363,21,9,0.0528384279,0.947161572,1970.965723,2189.781344,3431.669587,3504.162534,6870,177.3818745,13740,-3331584,185856,-3145728,-1
2913,365,21,9,0.111348383,0.888651617,945.5387607,947.7659949,1628.721593,1725.520548,3278,66.43696798,6556,-1491456,186880,-1304576,-1
5910,561,21,9,0.0866944831,0.913305517,1829.12142,2215.553429,3207.933164,3531.677362,6471,149.6184971,12942,-3025920,287232,-2738688,-1
1308,99,21,9,0.0703624733,0.929637527,404.588173,400.0818499,714.7759939,561.6262626,1407,209.063893,2814,-669696,50688,-619008,-1
7053,663,21,9,0.0859253499,0.91407465,2174.989433,2290.113722,3726.043953,5267.568627,7716,167.411586,15432,-3611136,339456,-3271680,-1
9468,480,18,12,0.0482509047,0.951749095,2850.98283,3167.729285,5011.362379,4247.389583,9948,1024.510814,19896,-4847616,245760,-4601856,-1
4693,545,18,12,0.104047346,0.895952654,1518.368028,1374.08648,2672.695717,2161.431193,5238,96.28676471,10476,-2402816,279040,-2123776,-1
1379,129,22,8,0.0855437666,0.914456233,426.6355507,517.2549556,750.5076142,797.1782946,1508,37.87992967,3016,-706048,66048,-640000,-1
2514,226,21,9,0.0824817518,0.917518248,768.5528653,949.0218605,1341.441527,1693.743363,2740,61.71171171,5480,-1287168,115712,-1171456,-1
138,26,19,11,0.158536585,0.841463415,45.67260182,37.4298555,89.55072464,45.07692308,164,36.28318584,328,-70656,13312,-57344,-1
4182,396,20,10,0.0865006553,0.913499345,1290.569473,1609.521772,2280.140842,2388.338384,4578,126.0462555,9156,-2141184,202752,-1938432,-1
6488,697,19,11,0.0970076548,0.902992345,2052.075486,2236.071684,3553.578915,3959.949785,7185,270.3160271,14370,-3321856,356864,-2964992,-1
447,98,20,10,0.179816514,0.820183486,150.2161995,168.7933908,288.6800895,201.4795918,545,77.08628006,1090,-228864,50176,-178688,-1
3426,311,27,3,0.0832218357,0.916778164,1096.033359,816.1497203,1894.233508,1591.025723,3737,88.87039239,7474,-1754112,159232,-1594880,-1
1674,122,21,9,0.0679287305,0.932071269,512.2317615,580.8134095,908.3369176,763.5245902,1796,114.6139119,3592,-857088,62464,-794624,-1
51,24,21,9,0.32,0.68,22.60836181,19.34226626,38.80392157,36.29166667,75,6.297229219,150,-26112,12288,-13824,-1
3636,230,20,10,0.059493016,0.940506984,1097.394097,1367.215684,1923.25495,2095.46087,3866,123.3173844,7732,-1861632,117760,-1743872,-1
9522,462,20,10,0.0462740385,0.953725962,2845.36955,3154.415605,5070.302142,3388.967532,9984,533.3333333,19968,-4875264,236544,-4638720,-1
285,47,19,11,0.141566265,0.858433735,92.34314317,99.13460311,175.3403509,112.893617,332,52.95055821,664,-145920,24064,-121856,-1
47,16,20,10,0.253968254,0.746031746,18.13502497,16.40300563,34.40425532,24.9375,63,12.90983607,126,-24064,8192,-15872,-1
5582,271,21,9,0.0463010422,0.953698958,1685.60759,1681.626796,2953.208527,2387.162362,5853,184.1145014,11706,-2857984,138752,-2719232,-1
75,19,20,10,0.20212766,0.79787234,25.08724687,32.8558507,49.50666667,39.57894737,94,9.853249476,188,-38400,9728,-28672,-1
9491,480,19,11,0.0481396049,0.951860395,2862.65394,3112.180444,5016.597935,4380.989583,9971,1015.376782,19942,-4859392,245760,-4613632,-1
38,16,19,11,0.296296296,0.703703704,14.75123827,16.82446136,29.07894737,23.75,54,9.694793537,108,-19456,8192,-11264,-1
9550,419,17,13,0.0420302939,0.957969706,2870.913843,2949.778144,5014.848586,4304.680191,9969,1560.093897,19938,-4889600,214528,-4675072,-1
123,12,23,7,0.0888888889,0.911111111,38.2942623,38.86541951,70.17073171,45.75,135,29.41176471,270,-62976,6144,-56832,-1
5097,443,22,8,0.0799638989,0.920036101,1579.500534,1682.814979,2826.327644,2128.167043,5540,198.8513999,11080,-2609664,226816,-2382848,-1
4242,515,21,9,0.108261509,0.891738491,1309.777565,1694.374662,2304.961103,2988.850485,4757,299.559194,9514,-2171904,263680,-1908224,-1
8035,1060,22,8,0.116547554,0.883452446,2597.513265,2604.392479,4411.128314,5585.513208,9095,195.6755594,18190,-4113920,542720,-3571200,-1
7315,615,21,9,0.0775535939,0.922446406,2219.273107,2719.683813,3863.577307,5177.8,7930,156.7813365,15860,-3745280,314880,-3430400,-1
9513,456,22,8,0.0457417996,0.9542582,2867.803697,3016.320801,5013.942395,4381.208333,9969,510.1842375,19938,-4870656,233472,-4637184,-1
3597,283,18,12,0.0729381443,0.927061856,1093.59838,1413.651258,1942.411454,1916.204947,3880,74.58669742,7760,-1841664,144896,-1696768,-1
134,29,17,13,0.17791411,0.82208589,44.94803378,39.56610688,89.70895522,46.37931034,163,18.25307951,326,-68608,14848,-53760,-1
69,25,19,11,0.265957447,0.734042553,27.73417792,21.33114155,51.7826087,35.68,94,19.83122363,188,-35328,12800,-22528,-1
3680,326,20,10,0.0813779331,0.918622067,1133.298827,1389.536218,1997.823913,2067.57362,4006,74.02069475,8012,-1884160,166912,-1717248,-1
3939,369,20,10,0.0856545961,0.914345404,1246.596029,1210.634334,2150.88855,2193.051491,4308,205.4363376,8616,-2016768,188928,-1827840,-1
105,13,24,6,0.110169492,0.889830508,32.39361937,45.07403509,60.07619048,54.84615385,118,12.2406639,236,-53760,6656,-47104,-1
2702,248,20,10,0.0840677966,0.915932203,840.7992366,943.8337564,1491.549963,1300.633065,2950,153.0877011,5900,-1383424,126976,-1256448,-1
2450,480,21,9,0.163822526,0.836177474,829.8272217,856.316945,1403.725714,1780.80625,2930,68.57009127,5860,-1254400,245760,-1008640,-1
2308,452,20,10,0.163768116,0.836231884,735.2783095,926.5554483,1289.689341,1844.196903,2760,55.58912387,5520,-1181696,231424,-950272,-1
7043,576,21,9,0.0756004725,0.924399527,2178.655591,2422.576102,3787.773108,4081.777778,7619,156.5119145,15238,-3606016,294912,-3311104,-1
3008,220,17,13,0.0681536555,0.931846344,908.1114016,1209.895442,1611.753989,1652.045455,3228,269,6456,-1540096,112640,-1427456,-1
3200,594,22,8,0.156562994,0.843437006,1087.026867,1111.998662,1855.925625,2121.469697,3794,69.85822132,7588,-1638400,304128,-1334272,-1
148,30,20,10,0.168539326,0.831460674,49.9603655,39.76575858,97.27702703,51.13333333,178,17.78221778,356,-75776,15360,-60416,-1
2377,143,21,9,0.0567460317,0.943253968,723.6935865,776.7751019,1268.051325,1134.979021,2520,122.6874391,5040,-1217024,73216,-1143808,-1
8559,1276,21,9,0.129740722,0.870259278,2916.140915,2225.687152,4968.827667,4577.064263,9835,478.8218111,19670,-4382208,653312,-3728896,-1
8399,1485,20,10,0.150242817,0.849757183,2928.706992,2381.895293,4938.586141,4964.636364,9884,443.2286996,19768,-4300288,760320,-3539968,-1
7188,1414,20,10,0.164380377,0.835619623,2441.455243,2533.089016,4141.236088,5116.193777,8602,189.0134036,17204,-3680256,723968,-2956288,-1
219,52,22,8,0.191881919,0.808118081,74.97135,86.43984766,141.8493151,111.3653846,271,5.018518519,542,-112128,26624,-85504,-1
501,91,18,12,0.153716216,0.846283784,160.8679103,209.5637051,306.5309381,241.2747253,592,10.71493213,1184,-256512,46592,-209920,-1
2792,317,20,10,0.101962046,0.898037954,889.6333025,960.8621107,1546.724928,1627.883281,3109,73.90064179,6218,-1429504,162304,-1267200,-1
8651,440,19,11,0.048399516,0.951600484,2604.389474,2977.22603,4532.422379,4812.954545,9091,202.3820125,18182,-4429312,225280,-4204032,-1
9575,406,20,10,0.0406772868,0.959322713,2859.575124,3160.155833,5037.468407,3895.100985,9981,701.8987342,19962,-4902400,207872,-4694528,-1
3804,174,17,13,0.0437405732,0.956259427,1136.290382,1293.592615,2011.759464,1502.862069,3978,260.5108055,7956,-1947648,89088,-1858560,-1
9560,423,20,10,0.0423720325,0.957627968,2878.785235,2933.328277,5005.611402,4684.375887,9983,307.9272054,19966,-4894720,216576,-4678144,-1
1729,252,20,10,0.127208481,0.872791519,556.0674877,663.9068705,978.4349335,1077.210317,1981,38.66874878,3962,-885248,129024,-756224,-1
95,37,19,11,0.28030303,0.71969697,37.6387759,38.74514508,68.62105263,61.05405405,132,21.01910828,264,-48640,18944,-29696,-1
4223,327,17,13,0.0718681319,0.928131868,1303.164467,1364.262127,2309.872602,1831.599388,4550,156.626506,9100,-2162176,167424,-1994752,-1
6291,507,21,9,0.074580759,0.925419241,1931.268187,2236.041965,3353.246543,3973.426036,6798,246.3043478,13596,-3220992,259584,-2961408,-1
4852,421,21,9,0.0798406979,0.920159302,1491.501229,1624.694303,2565.250824,3463.904988,5273,98.52391629,10546,-2484224,215552,-2268672,-1
1133,146,21,9,0.114151681,0.885848319,364.6197774,392.5818844,651.0962048,553.890411,1279,32.18419728,2558,-580096,74752,-505344,-1
9389,556,20,10,0.0559074912,0.944092509,2831.491992,3399.121796,5012.871019,4299.710432,9945,922.541744,19890,-4807168,284672,-4522496,-1
84,32,18,12,0.275862069,0.724137931,34.19419623,25.73237792,64.41666667,42.96875,116,22.43713733,232,-43008,16384,-26624,-1
3112,370,20,10,0.10626077,0.89373923,987.7191758,1037.558764,1794.968188,1291.789189,3482,116.1440961,6964,-1593344,189440,-1403904,-1
9002,425,27,3,0.0450832715,0.954916729,2711.341181,2883.215087,4736.760609,4231.903529,9427,178.1031551,18854,-4609024,217600,-4391424,-1
6169,568,22,8,0.084310524,0.915689476,1933.921873,2047.159316,3388.670449,3155.360915,6737,123.1627057,13474,-3158528,290816,-2867712,-1
9342,612,21,9,0.061482821,0.938517179,2850.356336,2840.971396,5071.749411,3538.810458,9954,229.5664207,19908,-4783104,313344,-4469760,-1
71,11,21,9,0.134146341,0.865853659,22.11958267,26.13031551,44.14084507,24.45454545,82,15.79961464,164,-36352,5632,-30720,-1
286,48,18,12,0.143712575,0.856287425,91.95564755,100.365199,177.6013986,107.3125,334,66.8,668,-146432,24576,-121856,-1
606,42,21,9,0.0648148148,0.935185185,181.6886234,223.5893915,332.3118812,211.7857143,648,90.12517385,1296,-310272,21504,-288768,-1
57,22,18,12,0.278481013,0.721518987,23.36195316,15.68418954,44.71929825,27.77272727,79,16.05691057,158,-29184,11264,-17920,-1
899,87,27,3,0.0882352941,0.911764706,282.8176985,281.1174694,503.8876529,386.1609195,986,98.99598394,1972,-460288,44544,-415744,-1
3927,341,19,11,0.0798969072,0.920103093,1200.889311,1546.438898,2134.784568,2131.222874,4268,178.0559032,8536,-2010624,174592,-1836032,-1
3396,254,20,10,0.0695890411,0.930410959,1038.916967,1209.224182,1843.257362,1588.082677,3650,278.8388083,7300,-1738752,130048,-1608704,-1
3355,339,21,9,0.0917704385,0.908229561,1050.59152,1206.942739,1837.439642,1947.064897,3694,91.34520277,7388,-1717760,173568,-1544192,-1
1344,175,27,3,0.115207373,0.884792627,437.5412905,435.3106302,748.2410714,850.3085714,1519,79.40407737,3038,-688128,89600,-598528,-1
640,85,18,12,0.117241379,0.882758621,199.4727872,259.3316366,352.7390625,440.2588235,725,29.93393889,1450,-327680,43520,-284160,-1
2761,157,19,11,0.0538039753,0.946196025,824.6837364,1021.917612,1483.179645,1043.070064,2918,253.9599652,5836,-1413632,80384,-1333248,-1
3395,309,21,9,0.0834233261,0.916576674,1075.208303,888.286966,1892.802651,1409.692557,3704,97.42240926,7408,-1738240,158208,-1580032,-1
7708,366,27,3,0.0453306911,0.954669309,2319.191499,2462.790854,4070.315646,3346.398907,8074,210.4248111,16148,-3946496,187392,-3759104,-1
2248,346,20,10,0.133384734,0.866615266,745.7699182,759.1717515,1314.479982,1187.179191,2594,123.5238095,5188,-1150976,177152,-973824,-1
2955,338,21,9,0.102641968,0.897358032,939.8594754,1013.71717,1672.100846,1427.553254,3293,343.3785193,6586,-1512960,173056,-1339904,-1
2687,263,17,13,0.0891525424,0.910847458,831.3809441,1024.486285,1489.712319,1330.296578,2950,55.39906103,5900,-1375744,134656,-1241088,-1
5305,464,21,9,0.0804298839,0.919570116,1661.673454,1631.060876,2927.235815,2402.109914,5769,113.9443018,11538,-2716160,237568,-2478592,-1
266,71,19,11,0.210682493,0.789317507,95.96810989,95.17707112,177.7368421,136.2676056,337,31.05990783,674,-136192,36352,-99840,-1
1718,103,17,13,0.0565623284,0.943437672,514.7722426,621.3287087,927.4231665,637.0679612,1821,75.9382819,3642,-879616,52736,-826880,-1
9411,368,21,9,0.0376316597,0.96236834,2815.611097,3002.02629,4894.814472,4766.877717,9779,303.1308122,19558,-4818432,188416,-4630016,-1
8953,941,23,7,0.0951081464,0.904891854,2814.076496,3228.772438,4942.471127,4995.34644,9894,652.6385224,19788,-4583936,481792,-4102144,-1
908,118,18,12,0.115009747,0.884990253,291.6446322,327.272627,517.6145374,481.8389831,1026,73.86609071,2052,-464896,60416,-404480,-1
5258,772,22,8,0.128026534,0.871973466,1723.2864,1792.980894,2950.26531,3459.805699,6030,115.983843,12060,-2692096,395264,-2296832,-1
1232,112,27,3,0.0833333333,0.916666667,381.862853,436.3976696,681.987013,568.1428571,1344,94.58128079,2688,-630784,57344,-573440,-1
3928,440,20,10,0.100732601,0.899267399,1242.530291,1282.681265,2121.123473,2750.279545,4368,123.2505643,8736,-2011136,225280,-1785856,-1
2464,179,20,10,0.0677260689,0.932273931,750.9770006,912.0154143,1323.104302,1306.798883,2643,135.3995902,5286,-1261568,91648,-1169920,-1
486,42,17,13,0.0795454545,0.920454545,147.8190014,171.0829983,272.7695473,168.8095238,528,101.734104,1056,-248832,21504,-227328,-1
9217,707,21,9,0.0712414349,0.928758565,2868.477741,2816.1554,4958.857763,5009.983027,9924,216.1149826,19848,-4719104,361984,-4357120,-1
2725,371,20,10,0.119832041,0.880167959,894.1466543,873.8914603,1570.518899,1386.770889,3096,83.40517241,6192,-1395200,189952,-1205248,-1
314,30,16,14,0.0872093023,0.912790698,94.96304827,92.76302544,181.6656051,76.56666667,344,75.77092511,688,-160768,15360,-145408,-1
4584,229,21,9,0.0475794723,0.952420528,1375.928948,1485.114101,2440.429756,1737.820961,4813,229.4089609,9626,-2347008,117248,-2229760,-1
707,48,23,7,0.0635761589,0.936423841,213.0006137,227.7155258,388.8076379,218.8125,755,81.88720174,1510,-361984,24576,-337408,-1
9425,492,22,8,0.0496117778,0.950388222,2851.949257,3013.751912,4986.864403,4425.215447,9917,703.8325053,19834,-4825600,251904,-4573696,-1
4785,379,21,9,0.0733927188,0.926607281,1459.171514,1838.120168,2572.139394,2713.306069,5164,342.6675514,10328,-2449920,194048,-2255872,-1
4493,245,21,9,0.0517095821,0.948290418,1357.429945,1540.17738,2375.776319,2254.4,4738,221.9203747,9476,-2300416,125440,-2174976,-1
7821,355,21,9,0.0434197652,0.956580235,2346.995307,2618.657823,4101.321698,3806.025352,8176,174.5889387,16352,-4004352,181760,-3822592,-1
1456,104,20,10,0.0666666667,0.933333333,438.3627025,575.6582564,790.3440934,642.6826923,1560,65.98984772,3120,-745472,53248,-692224,-1
4243,591,22,8,0.122258999,0.877741001,1369.953953,1504.236667,2360.487391,2826.813875,4834,127.6135164,9668,-2172416,302592,-1869824,-1
138,33,16,14,0.192982456,0.807017544,46.70750981,45.05291247,94.24637681,51.51515152,171,33.0754352,342,-70656,16896,-53760,-1
9288,353,21,9,0.0366144591,0.963385541,2765.971665,3186.294936,4832.592485,4515.983003,9641,215.4894949,19282,-4755456,180736,-4574720,-1
37,24,17,13,0.393442623,0.606557377,18.03770096,16.54853971,32.78378378,28.25,61,8.187919463,122,-18944,12288,-6656,-1
8624,1283,24,6,0.129504391,0.870495609,2806.764928,3058.481667,4826.117579,5813.593141,9907,508.0512821,19814,-4415488,656896,-3758592,-1
2001,268,21,9,0.118113706,0.881886294,633.8434953,785.6453946,1119.382309,1251.608209,2269,123.9213545,4538,-1024512,137216,-887296,-1
9547,429,20,10,0.0430032077,0.956996792,2858.589793,3086.946677,5041.900492,3800.121212,9976,461.4246068,19952,-4888064,219648,-4668416,-1
382,96,17,13,0.20083682,0.79916318,133.4512222,154.5643393,241.065445,233.2708333,478,71.02526003,956,-195584,49152,-146432,-1
846,114,25,5,0.11875,0.88125,278.1983122,268.8760643,481.7304965,471.3684211,960,95.80838323,1920,-433152,58368,-374784,-1
2530,241,20,10,0.0869722122,0.913027788,800.688854,779.8554904,1373.534783,1516.858921,2771,189.2759563,5542,-1295360,123392,-1171968,-1
5854,513,27,3,0.0805716978,0.919428302,1859.510822,1568.625745,3192.315682,3089.107212,6367,160.7422368,12734,-2997248,262656,-2734592,-1
1327,121,21,9,0.0835635359,0.916436464,407.3613388,484.6147227,741.1047476,542.3966942,1448,26.63233401,2896,-679424,61952,-617472,-1
3217,279,20,10,0.079805492,0.920194508,997.8439504,1105.900521,1768.618589,1516.523297,3496,94.51203028,6992,-1647104,142848,-1504256,-1
158,16,20,10,0.091954023,0.908045977,48.50402666,37.2683994,92.62025316,36.9375,174,34.86973948,348,-80896,8192,-72704,-1
5195,705,21,9,0.119491525,0.880508475,1692.549077,1743.396567,2905.030799,3285.553191,5900,112.8754544,11800,-2659840,360960,-2298880,-1
9482,485,18,12,0.0486605799,0.95133942,2878.742811,2795.895147,5010.89401,4458.208247,9967,628.4363178,19934,-4854784,248320,-4606464,-1
3808,412,20,10,0.0976303318,0.902369668,1208.400304,1288.329869,2132.115809,1910.711165,4220,89.19890087,8440,-1949696,210944,-1738752,-1
8699,1165,20,10,0.118106245,0.881893755,2822.808654,2877.824365,4815.098287,5809.133047,9864,566.8965517,19728,-4453888,596480,-3857408,-1
9226,707,20,10,0.0711768851,0.928823115,2862.159013,2656.818801,5059.123997,3764.82744,9933,371.0496825,19866,-4723712,361984,-4361728,-1
73,19,20,10,0.206521739,0.793478261,24.33415034,32.48651968,48.63013699,38.31578947,92,10.02178649,184,-37376,9728,-27648,-1
422,28,22,8,0.0622222222,0.937777778,129.1954757,130.8020197,228.7322275,176.7857143,450,8.365867262,900,-216064,14336,-201728,-1
1425,193,20,10,0.119283066,0.880716934,458.9040081,485.5706833,834.36,625.9481865,1618,57.6005696,3236,-729600,98816,-630784,-1
260,38,16,14,0.127516779,0.872483221,81.57078922,73.98026989,160.95,71.15789474,298,46.70846395,596,-133120,19456,-113664,-1
8386,414,27,3,0.0470454545,0.952954545,2517.802609,2758.81522,4452.21524,3352.954106,8800,185.3021689,17600,-4293632,211968,-4081664,-1
2652,213,21,9,0.0743455497,0.92565445,812.209225,822.7394859,1476.031297,897.2300469,2865,82.44604317,5730,-1357824,109056,-1248768,-1
1318,94,17,13,0.066572238,0.933427762,398.6181134,468.4085551,721.6555387,494,1412,198.0364656,2824,-674816,48128,-626688,-1
9354,592,20,10,0.0595214156,0.940478584,2843.130274,3122.758558,5035.578148,3992.623311,9946,547.6872247,19892,-4789248,303104,-4486144,-1
241,23,20,10,0.0871212121,0.912878788,73.19684278,76.11601929,138.7717842,66.7826087,264,70.4,528,-123392,11776,-111616,-1
163,28,20,10,0.146596859,0.853403141,53.17731604,44.67129095,103.5766871,51.89285714,191,14.77184841,382,-83456,14336,-69120,-1
5356,492,22,8,0.0841313269,0.915868673,1674.190171,1812.755924,2900.324122,3187.682927,5848,240.8566722,11696,-2742272,251904,-2490368,-1
2478,231,27,3,0.0852713178,0.914728682,757.0630685,992.499783,1337.492736,1542.805195,2709,67.22084367,5418,-1268736,118272,-1150464,-1
9387,562,25,5,0.0564880893,0.943511911,2845.609894,3276.780275,4985.770108,4795.108541,9949,1176.004728,19898,-4806144,287744,-4518400,-1
9580,401,21,9,0.040176335,0.959823665,2864.225579,3139.504923,5027.316701,4123.38404,9981,1226.167076,19962,-4904960,205312,-4699648,-1
1703,143,21,9,0.0774647887,0.922535211,522.8275847,595.5153875,942.5689959,696.4055944,1846,67.02977487,3692,-871936,73216,-798720,-1
1862,152,21,9,0.0754716981,0.924528302,576.2634012,622.6220705,1019.425349,861.4144737,2014,39.81023918,4028,-953344,77824,-875520,-1
4970,688,21,9,0.121597738,0.878402262,1610.73149,1743.114199,2777.807847,3202.915698,5658,153.75,11316,-2544640,352256,-2192384,-1
551,47,25,5,0.0785953177,0.921404682,168.533017,213.1967532,297.2976407,325.3191489,598,37.87207093,1196,-282112,24064,-258048,-1
248,42,27,3,0.144827586,0.855172414,83.34671908,85.26715387,147.0766129,136.1904762,290,13.61502347,580,-126976,21504,-105472,-1
1140,80,22,8,0.0655737705,0.93442623,350.5184293,369.9620333,614.7008772,550.6375,1220,199.6726678,2440,-583680,40960,-542720,-1
2743,317,20,10,0.103594771,0.896405229,869.6551973,977.7751998,1510.94969,1699.66877,3060,57.88876277,6120,-1404416,162304,-1242112,-1
9488,478,20,10,0.0479630745,0.952036926,2850.081569,3079.660241,5050.27403,3658.077406,9966,1085.620915,19932,-4857856,244736,-4613120,-1
5468,550,25,5,0.0913924892,0.908607511,1699.840722,2062.764409,2990.030724,3203.06,6018,268.1818182,12036,-2799616,281600,-2518016,-1
79,36,15,15,0.313043478,0.686956522,32.01410721,34.21648356,61.78481013,49.69444444,115,21.69811321,230,-40448,18432,-22016,-1
7587,1137,20,10,0.130330124,0.869669876,2442.788902,2682.933696,4183.123237,5559.449428,8724,235.5927626,17448,-3884544,582144,-3302400,-1
9394,555,22,8,0.055784501,0.944215499,2859.382723,2923.289868,5030.355227,4038.05045,9949,1095.704846,19898,-4809728,284160,-4525568,-1
9312,649,20,10,0.065154101,0.934845899,2855.475246,3095.609509,5019.81046,4424.138675,9961,641.4037347,19922,-4767744,332288,-4435456,-1
6249,439,21,9,0.0656399522,0.934360048,1936.833166,1833.445302,3333.542647,3500.473804,6688,144.355709,13376,-3199488,224768,-2974720,-1
1273,122,25,5,0.0874551971,0.912544803,401.2469629,337.1604125,720.5545954,462.6557377,1395,83.93501805,2790,-651776,62464,-589312,-1
3114,176,19,11,0.0534954407,0.946504559,939.5329553,1114.443366,1647.44894,1611.017045,3290,280,6580,-1594368,90112,-1504256,-1
440,50,21,9,0.102040816,0.897959184,136.1141334,181.7697445,245.6704545,244,490,28.67173786,980,-225280,25600,-199680,-1
6843,1011,17,13,0.128724217,0.871275783,2218.855747,2515.319836,3854.110039,4424.243323,7854,165.9763314,15708,-3503616,517632,-2985984,-1
3527,253,20,10,0.0669312169,0.933068783,1077.55368,1202.957786,1917.861355,1509.063241,3780,72.27533461,7560,-1805824,129536,-1676288,-1
58,17,23,7,0.226666667,0.773333333,22.29259007,18.53379967,39.37931034,33.29411765,75,2.15393452,150,-29696,8704,-20992,-1
8517,448,16,14,0.0499721138,0.950027886,2573.567294,2818.957975,4503.801926,4087.53125,8965,173.672995,17930,-4360704,229376,-4131328,-1
8496,568,26,4,0.0626654898,0.93733451,2626.740398,2458.470009,4528.858169,4586.973592,9064,182.1909548,18128,-4349952,290816,-4059136,-1
498,28,21,9,0.0532319392,0.946768061,149.225594,183.2687193,266.7289157,206.0714286,526,43.94319131,1052,-254976,14336,-240640,-1
6371,250,27,3,0.0377586467,0.962241353,1900.077644,2077.454365,3336.214566,2668.432,6621,977.9911374,13242,-3261952,128000,-3133952,-1
9116,822,24,6,0.0827128195,0.917287181,2856.312048,3004.239941,4972.423102,4937.082725,9938,487.1568627,19876,-4667392,420864,-4246528,-1
5970,464,21,9,0.0721168791,0.927883121,1857.397784,1839.29246,3198.598995,3460.6875,6434,149.1077636,12868,-3056640,237568,-2819072,-1
7283,1022,21,9,0.123058399,0.876941601,2237.635448,2403.506791,3851.915557,6298.594912,8305,180.3474484,16610,-3728896,523264,-3205632,-1
2487,255,27,3,0.0929978118,0.907002188,786.8709763,808.7548748,1392.087254,1170.713725,2742,232.3728814,5484,-1273344,130560,-1142784,-1
41,12,22,8,0.226415094,0.773584906,15.06717064,14.39979745,28.82926829,20.75,53,1.387071447,106,-20992,6144,-14848,-1
6456,539,20,10,0.0770550393,0.922944961,1979.742468,2362.701533,3447.969486,4097.252319,6995,161.8463674,13990,-3305472,275968,-3029504,-1
9319,631,21,9,0.0634170854,0.936582915,2850.771008,3076.851266,5026.442429,4223.150555,9950,277.0815929,19900,-4771328,323072,-4448256,-1
9417,547,20,10,0.0548976315,0.945102369,2850.377256,3159.80692,5034.580758,4085.892139,9964,1078.354978,19928,-4821504,280064,-4541440,-1
1725,126,15,15,0.0680713128,0.931928687,522.0674058,613.087987,946.8104348,641.0952381,1851,51.99438202,3702,-883200,64512,-818688,-1
9489,480,19,11,0.0481492627,0.951850737,2864.989679,2948.210122,5035.435873,3987.945833,9969,769.212963,19938,-4858368,245760,-4612608,-1
9249,686,21,9,0.0690488173,0.930951183,2876.352114,2704.934235,5004.550438,4475.208455,9935,863.1624674,19870,-4735488,351232,-4384256,-1
56,11,20,10,0.164179104,0.835820896,18.86174186,12.67065328,37.14285714,18,67,6.146788991,134,-28672,5632,-23040,-1
4351,381,22,8,0.0805156382,0.919484362,1361.44066,1417.106016,2365.504252,2377.871391,4732,163.5107118,9464,-2227712,195072,-2032640,-1
637,89,18,12,0.122589532,0.877410468,198.6754819,260.965015,352.032967,445.5730337,726,27.83742331,1452,-326144,45568,-280576,-1
3408,427,21,9,0.111342894,0.888657106,1085.465207,1230.871331,1882.841256,2198.611241,3835,79.53131481,7670,-1744896,218624,-1526272,-1
9394,561,21,9,0.0563535912,0.943646409,2839.120528,3370.884344,4951.451139,5422.56328,9955,503.0318343,19910,-4809728,287232,-4522496,-1
9671,316,21,9,0.0316411335,0.968358867,2877.789916,3023.094735,5003.693827,4697.325949,9987,689.7099448,19974,-4951552,161792,-4789760,-1
72,13,23,7,0.152941176,0.847058824,23.91056833,25.23287984,44.91666667,32.38461538,85,17.38241309,170,-36864,6656,-30208,-1
5545,536,20,10,0.0881433975,0.911856603,1732.17191,1976.90229,3051.392606,2933.48694,6081,127.9402483,12162,-2839040,274432,-2564608,-1
9560,413,17,13,0.0414118119,0.958588188,2861.127708,3248.84663,5000.533473,4673.731235,9973,824.214876,19946,-4894720,211456,-4683264,-1
2746,239,25,5,0.0800670017,0.919932998,838.9652101,1045.066578,1467.338674,1787.83682,2985,101.7729287,5970,-1405952,122368,-1283584,-1
63,24,18,12,0.275862069,0.724137931,25.56400334,21.3715478,47.46031746,34.91666667,87,16.5085389,174,-32256,12288,-19968,-1
2102,208,21,9,0.09004329,0.90995671,648.7513021,827.4240571,1157.668887,1133.581731,2310,106.6974596,4620,-1076224,106496,-969728,-1
8423,646,17,13,0.0712316683,0.928768332,2591.368458,2886.854048,4492.635759,5087.374613,9069,275.8211679,18138,-4312576,330752,-3981824,-1
225,49,21,9,0.178832117,0.821167883,76.70402903,77.25507441,146.3244444,96.97959184,274,20.14705882,548,-115200,25088,-90112,-1
3114,332,21,9,0.0963435868,0.903656413,971.6752648,1075.077276,1775.16185,1238.936747,3446,251.9005848,6892,-1594368,169984,-1424384,-1
6374,327,20,10,0.0487986868,0.951201313,1912.235107,2176.219092,3391.920144,2553.370031,6701,156.2004662,13402,-3263488,167424,-3096064,-1
4526,348,22,8,0.0713992614,0.928600739,1397.657338,1517.700275,2427.8038,2563.606322,4874,166.8035592,9748,-2317312,178176,-2139136,-1
9542,435,20,10,0.0436002806,0.956399719,2871.685862,2989.682288,5017.891008,4355.257471,9977,1034.958506,19954,-4885504,222720,-4662784,-1
428,99,17,13,0.187855787,0.812144213,142.6134609,167.3340193,281.7757009,187.1515152,527,75.28571429,1054,-219136,50688,-168448,-1
5957,615,20,10,0.0935788192,0.906421181,1887.693509,1932.044659,3241.031224,3726.918699,6572,134.3692496,13144,-3049984,314880,-2735104,-1
3099,284,21,9,0.0839491576,0.916050842,951.3249512,1212.687528,1681.409487,1807.56338,3383,248.56723,6766,-1586688,145408,-1441280,-1
3445,276,22,8,0.0741736092,0.925826391,1059.70441,1240.411484,1859.849927,1875.355072,3721,154.5907769,7442,-1763840,141312,-1622528,-1
47,19,21,9,0.287878788,0.712121212,19.01046863,18.93727801,34.46808511,31.10526316,66,5.759162304,132,-24064,9728,-14336,-1
3704,222,19,11,0.0565461029,0.943453897,1130.726912,1170.92036,1957.107721,2070.153153,3926,333.2767402,7852,-1896448,113664,-1782784,-1
9582,396,21,9,0.0396873121,0.960312688,2864.690572,3087.416269,5028.941661,4035.131313,9978,869.1637631,19956,-4905984,202752,-4703232,-1
425,72,21,9,0.144869215,0.855130785,140.1090775,153.8055907,256.92,202.25,497,25.72463768,994,-217600,36864,-180736,-1
1511,120,23,7,0.0735744942,0.926425506,464.0262966,543.1873523,822.2594308,737.1833333,1631,97.08333333,3262,-773632,61440,-712192,-1
75,24,18,12,0.242424242,0.757575758,28.66643721,21.59459166,55.09333333,34.08333333,99,41.42259414,198,-38400,12288,-26112,-1
5842,278,23,7,0.0454248366,0.954575163,1755.790852,1980.718823,3063.745122,2992.305755,6120,281.7679558,12240,-2991104,142336,-2848768,-1
3106,347,20,10,0.100492326,0.899507674,987.8786805,1071.944916,1732.740502,1675.616715,3453,112.3657664,6906,-1590272,177664,-1412608,-1
2642,293,22,8,0.0998296422,0.900170358,836.1233008,914.5890256,1491.632854,1254.901024,2935,76.01657602,5870,-1352704,150016,-1202688,-1
9582,395,21,9,0.0395910594,0.960408941,2873.670061,2949.210199,5017.460968,4298.587342,9977,1115.995526,19954,-4905984,202240,-4703744,-1
9379,578,22,8,0.0580496133,0.941950387,2879.820751,2708.073916,5017.589189,4352.82699,9957,899.4579946,19914,-4802048,295936,-4506112,-1
6759,536,19,11,0.0734749829,0.926525017,2109.329845,2046.334464,3667.335553,3404.177239,7295,289.484127,14590,-3460608,274432,-3186176,-1
1799,324,20,10,0.152614225,0.847385775,607.3015518,641.7955431,1055.949972,1095.592593,2123,148.3577918,4246,-921088,165888,-755200,-1
9428,529,21,9,0.0531284523,0.946871548,2865.515177,3026.875776,4981.689542,4931.066163,9957,1025.437693,19914,-4827136,270848,-4556288,-1
58,17,23,7,0.226666667,0.773333333,22.46776658,17.69346839,39.46551724,33,75,2.292876796,150,-29696,8704,-20992,-1
914,54,20,10,0.055785124,0.944214876,274.8315653,301.8596454,494.4726477,315.7037037,968,56.24636839,1936,-467968,27648,-440320,-1
9570,405,22,8,0.0406015038,0.959398496,2872.004801,3041.968309,4998.277847,4745.138272,9975,1042.319749,19950,-4899840,207360,-4692480,-1
5918,615,20,10,0.094137456,0.905862544,1876.079003,1977.990758,3268.666779,3250.960976,6533,161.7479574,13066,-3030016,314880,-2715136,-1
9580,398,22,8,0.0398877531,0.960112247,2854.471661,3214.515957,5040.063361,3772.422111,9978,743.5171386,19956,-4904960,203776,-4701184,-1
3693,271,22,8,0.0683652876,0.931634712,1130.936867,1300.094317,1969.481993,2159.900369,3964,216.4937193,7928,-1890816,138752,-1752064,-1
694,34,20,10,0.0467032967,0.953296703,206.9965708,225.980503,371.2636888,226.4411765,728,144.1584158,1456,-355328,17408,-337920,-1
966,106,24,6,0.098880597,0.901119403,302.5352059,335.9271067,551.7867495,397.1886792,1072,97.27767695,2144,-494592,54272,-440320,-1
246,62,20,10,0.201298701,0.798701299,85.73274198,100.2340393,156.2601626,147.516129,308,5.628654971,616,-125952,31744,-94208,-1
77,20,21,9,0.206185567,0.793814433,27.81414355,26.58246603,51.50649351,39.35,97,13.52859135,194,-39424,10240,-29184,-1
3426,286,20,10,0.0770474138,0.922952586,1053.198829,1264.825034,1866.598074,1735.534965,3712,242.2976501,7424,-1754112,146432,-1607680,-1
414,99,17,13,0.192982456,0.807017544,139.5188638,159.0578135,274.8961353,182.1616162,513,29.77365061,1026,-211968,50688,-161280,-1
9486,498,20,10,0.0498798077,0.950120192,2846.852302,3091.38367,5075.01381,3420.761044,9984,566.6288309,19968,-4856832,254976,-4601856,-1
3964,394,21,9,0.0904084442,0.909591556,1243.289269,1397.057192,2174.973259,2225.043147,4358,83.53459843,8716,-2029568,201728,-1827840,-1
3652,323,20,10,0.0812578616,0.918742138,1123.925168,1327.032036,2021.986857,1603.727554,3975,95.39236861,7950,-1869824,165376,-1704448,-1
4225,248,22,8,0.0554437738,0.944556226,1267.578043,1629.814503,2248.784852,2036.229839,4473,89.80124473,8946,-2163200,126976,-2036224,-1
1625,70,20,10,0.0412979351,0.958702065,483.9011755,551.5980724,858.0898462,613.7714286,1695,355.3459119,3390,-832000,35840,-796160,-1
9313,637,22,8,0.0640201005,0.935979899,2845.574961,3153.657672,5024.137657,4264.412873,9950,817.5842235,19900,-4768256,326144,-4442112,-1
3272,269,20,10,0.0759672409,0.924032759,1027.53373,952.8767844,1775.935513,1710.966543,3541,179.4728839,7082,-1675264,137728,-1537536,-1
6492,672,21,9,0.0938023451,0.906197655,1982.82563,2386.360611,3446.028497,4900.912202,7164,149.436796,14328,-3323904,344064,-2979840,-1
9304,636,21,9,0.0639839034,0.936016097,2840.854994,3113.54533,5034.159931,4039.22327,9940,560,19880,-4763648,325632,-4438016,-1
5835,778,19,11,0.117647059,0.882352941,1876.976064,2133.90472,3304.738475,3323.96144,6613,122.7129338,13226,-2987520,398336,-2589184,-1
4469,932,20,10,0.172560637,0.827439363,1370.617848,1556.530968,2391.810248,4183.584764,5401,150.1111729,10802,-2288128,477184,-1810944,-1
431,100,19,11,0.188323917,0.811676083,148.4044053,172.6502392,264.7401392,271.43,531,57.03544576,1062,-220672,51200,-169472,-1
5214,895,23,7,0.146505156,0.853494844,1690.860755,2005.075891,2937.201189,3741.260335,6109,235.1424172,12218,-2669568,458240,-2211328,-1
9352,591,20,10,0.0594388012,0.940561199,2848.742619,3058.381667,5028.021707,4085.510998,9943,587.6477541,19886,-4788224,302592,-4485632,-1
3267,184,22,8,0.0533178789,0.946682121,985.5363514,1070.082715,1751.890419,1266.304348,3451,320.1298701,6902,-1672704,94208,-1578496,-1
9296,431,20,10,0.0443096535,0.955690346,2794.280174,3053.526027,4884.840792,4414.49652,9727,326.6286098,19454,-4759552,220672,-4538880,-1
728,113,19,11,0.134363853,0.865636147,239.02156,261.7037927,427.6236264,378.3274336,841,66.74603175,1682,-372736,57856,-314880,-1
437,103,18,12,0.190740741,0.809259259,147.3313483,171.2479823,286.8924485,200.9514563,540,75.10431154,1080,-223744,52736,-171008,-1
4602,430,25,5,0.0854531002,0.9145469,1440.409179,1574.246313,2525.299218,2422.327907,5032,140.834033,10064,-2356224,220160,-2136064,-1
208,37,19,11,0.151020408,0.848979592,68.40459072,71.26974244,129.8317308,84.59459459,245,41.52542373,490,-106496,18944,-87552,-1
6606,265,21,9,0.038567894,0.961432106,1975.589967,2132.747401,3451.976234,3037.739623,6871,456.8484043,13742,-3382272,135680,-3246592,-1
5071,312,18,12,0.0579602452,0.942039755,1548.678474,1567.672873,2720.159535,2234.317308,5383,248.6374134,10766,-2596352,159744,-2436608,-1
1130,142,22,8,0.11163522,0.88836478,359.6011936,417.5912624,628.6725664,698.7887324,1272,120.9125475,2544,-578560,72704,-505856,-1
9271,668,19,11,0.0672099809,0.932790019,2831.716611,3314.163954,5001.846511,4528.010479,9939,1707.731959,19878,-4746752,342016,-4404736,-1
7179,707,21,9,0.0896525488,0.910347451,2242.31392,2593.973482,3929.57111,4084.936351,7886,365.6003709,15772,-3675648,361984,-3313664,-1
9314,631,19,11,0.0634489693,0.936551031,2823.274238,3451.344673,5010.714194,4416.312203,9945,843.5114504,19890,-4768768,323072,-4445696,-1
1459,165,20,10,0.101600985,0.898399015,464.8326686,488.8974719,800.0075394,922.9636364,1624,106.4918033,3248,-747008,84480,-662528,-1
3577,270,21,9,0.0701845594,0.929815441,1090.885691,1309.54833,1901.997484,2215.492593,3847,151.8752467,7694,-1831424,138240,-1693184,-1
9287,663,23,7,0.0666331658,0.933366834,2853.345299,2833.917096,5066.498008,3700.841629,9950,367.4298375,19900,-4754944,339456,-4415488,-1
3084,184,23,7,0.0563035496,0.94369645,936.1104719,953.5215187,1661.067121,1189.211957,3268,87.61394102,6536,-1579008,94208,-1484800,-1
1114,184,20,10,0.141756549,0.858243451,366.5969887,420.1019033,652.0718133,633.9293478,1298,104.0064103,2596,-570368,94208,-476160,-1
6775,478,27,3,0.065903764,0.934096236,2064.755742,2434.041266,3655.021402,3229.834728,7253,445.5159705,14506,-3468800,244736,-3224064,-1
4573,331,20,10,0.0674959217,0.932504078,1393.068972,1697.232008,2453.60726,2437.202417,4904,222.7066303,9808,-2341376,169472,-2171904,-1
9487,476,21,9,0.0477767741,0.952223226,2858.240572,3007.886935,5037.004849,3885.716387,9963,1099.668874,19926,-4857344,243712,-4613632,-1
58,17,24,6,0.226666667,0.773333333,21.52771076,22.00739102,38.37931034,36.70588235,75,1.813784764,150,-29696,8704,-20992,-1
5965,341,21,9,0.0540754837,0.945924516,1802.944638,2082.831268,3169.327913,2876.627566,6306,438.2209868,12612,-3054080,174592,-2879488,-1
6595,773,18,12,0.104913138,0.895086862,2132.509666,2066.283359,3709.953904,3467.335058,7368,149.9389499,14736,-3376640,395776,-2980864,-1
81,26,20,10,0.242990654,0.757009346,31.73233871,22.99411425,58.50617284,39.96153846,107,23.46491228,214,-41472,13312,-28160,-1
5161,299,23,7,0.0547619048,0.945238095,1563.784403,1717.742364,2755.986049,2290.588629,5460,345.1327434,10920,-2642432,153088,-2489344,-1
3223,201,21,9,0.058703271,0.941296729,978.8307337,1129.177053,1716.578653,1647.099502,3424,145.2078032,6848,-1650176,102912,-1547264,-1
965,145,18,12,0.130630631,0.869369369,312.5021246,356.8819003,568.5689119,468.5241379,1110,90.39087948,2220,-494080,74240,-419840,-1
398,75,18,12,0.158562368,0.841437632,131.6860118,150.6528312,246.2462312,187.9333333,473,42.30769231,946,-203776,38400,-165376,-1
970,62,20,10,0.0600775194,0.939922481,291.3272037,380.726405,520.6608247,451.4032258,1032,88.05460751,2064,-496640,31744,-464896,-1
3847,250,25,5,0.0610202587,0.938979741,1188.165068,1014.627557,2074.964388,1649.46,4097,299.0510949,8194,-1969664,128000,-1841664,-1
9571,403,17,13,0.0404050531,0.959594947,2868.715208,3059.01043,5012.591056,4391.602978,9974,1458.187135,19948,-4900352,206336,-4694016,-1
9626,363,18,12,0.036339974,0.963660026,2865.515105,3197.338215,5029.038749,4092.363636,9989,952.2402288,19978,-4928512,185856,-4742656,-1
5692,369,17,13,0.0608810427,0.939118957,1733.601727,1943.086064,3055.213633,2657.493225,6061,326.3866451,12122,-2914304,188928,-2725376,-1
276,18,21,9,0.0612244898,0.93877551,82.6567887,99.22447739,150.9855072,94.05555556,294,22.25586677,588,-141312,9216,-132096,-1
50,6,25,5,0.107142857,0.892857143,15.653613,17.28599305,29.62,19.16666667,56,1.567310383,112,-25600,3072,-22528,-1
1637,139,22,8,0.0782657658,0.921734234,500.4459547,635.8031172,882.9364692,954.0215827,1776,44.08041698,3552,-838144,71168,-766976,-1
9531,437,21,9,0.0438402889,0.956159711,2863.65194,3049.56477,5022.435736,4157.118993,9968,846.8988955,19936,-4879872,223744,-4656128,-1
184,49,18,12,0.210300429,0.789699571,65.19961148,62.34998823,126.6467391,80.7755102,233,43.30855019,466,-94208,25088,-69120,-1
4216,658,20,10,0.135002052,0.864997948,1430.563868,1228.025416,2467.683586,2244.104863,4874,179.7860568,9748,-2158592,336896,-1821696,-1
4094,315,20,10,0.0714447721,0.928555228,1248.48635,1490.361226,2237.694431,1780.07619,4409,215.2832031,8818,-2096128,161280,-1934848,-1
7164,597,20,10,0.0769230769,0.923076923,2227.137524,2369.391066,3908.366695,3552.599665,7761,229.9555556,15522,-3667968,305664,-3362304,-1
2639,144,20,10,0.0517427237,0.948257276,795.2843541,892.4167163,1407.608185,1105.958333,2783,237.8632479,5566,-1351168,73728,-1277440,-1
5353,581,21,9,0.0979103472,0.902089653,1713.346992,1649.707027,2921.188866,3394.184165,5934,171.6020821,11868,-2740736,297472,-2443264,-1
5592,671,20,10,0.107137155,0.892862845,1802.800253,1558.997784,3245.03809,2189.959762,6263,120.2803918,12526,-2863104,343552,-2519552,-1
137,27,17,13,0.164634146,0.835365854,44.64225461,46.64311575,89.05839416,49.22222222,164,35.04273504,328,-70144,13824,-56320,-1
9120,793,21,9,0.0799959649,0.920004035,2842.17191,2491.036091,5107.597478,3225.034048,9913,733.7527757,19826,-4669440,406016,-4263424,-1
6123,256,20,10,0.0401316821,0.959868318,1829.307871,2084.131067,3203.840928,2858.953125,6379,560.5448155,12758,-3134976,131072,-3003904,-1
9541,428,22,8,0.0429330926,0.957066907,2866.13119,3059.586386,5013.274919,4354.693925,9969,699.088359,19938,-4884992,219136,-4665856,-1
1894,119,23,7,0.0591157476,0.940884252,575.6169101,616.006799,1021.830517,770.9579832,2013,127.8095238,4026,-969728,60928,-908800,-1
9485,471,21,9,0.0473081559,0.952691844,2865.081798,2988.93935,5007.696257,4390.545648,9956,954.5541707,19912,-4856320,241152,-4615168,-1
5901,471,18,12,0.0739171375,0.926082863,1804.157045,2234.726435,3187.187595,3177.88535,6372,119.1473448,12744,-3021312,241152,-2780160,-1
1360,117,20,10,0.0792146242,0.920785376,419.9021241,494.1949959,741.8838235,705.4786325,1477,193.0718954,2954,-696320,59904,-636416,-1
9392,548,19,11,0.0551307847,0.944869215,2849.363104,2966.504248,5037.616695,3820.208029,9940,820.8092486,19880,-4808704,280576,-4528128,-1
9052,415,21,9,0.0438364846,0.956163515,2705.478687,3133.19849,4776.600972,3804.785542,9467,419.0792386,18934,-4634624,212480,-4422144,-1
9322,633,24,6,0.0635861376,0.936413862,2873.941505,2644.3477,5051.484445,3895.816746,9955,617.9391682,19910,-4772864,324096,-4448768,-1
1489,180,22,8,0.107849011,0.892150989,468.0545959,580.6666925,841.2008059,783.7055556,1669,91.00327154,3338,-762368,92160,-670208,-1
579,31,22,8,0.0508196721,0.949180328,173.7376434,210.5887095,307.8566494,261.483871,610,66.44880174,1220,-296448,15872,-280576,-1
295,35,16,14,0.106060606,0.893939394,91.17481282,85.81477918,175.6169492,80.22857143,330,55.55555556,660,-151040,17920,-133120,-1
221,37,20,10,0.143410853,0.856589147,71.98359172,78.26032115,135.7058824,92.43243243,258,30.24618992,516,-113152,18944,-94208,-1
3620,217,18,12,0.0565545999,0.9434454,1100.275457,1148.642244,1943.633702,1508.059908,3837,307.4519231,7674,-1853440,111104,-1742336,-1
6335,261,22,8,0.039569436,0.960430564,1895.774991,2055.231866,3315.125651,2894.961686,6596,225.7357974,13192,-3243520,133632,-3109888,-1
9527,454,21,9,0.0454864242,0.954513576,2879.903973,2895.907569,5004.180015,4714.422907,9981,323.0097087,19962,-4877824,232448,-4645376,-1
6100,286,17,13,0.0447854682,0.955214532,1823.753619,2023.587814,3235.657541,2294.335664,6386,120.5588069,12772,-3123200,146432,-2976768,-1
5634,241,27,3,0.0410212766,0.958978723,1687.263971,1876.688182,2946.649272,2735.80083,5875,123.2431299,11750,-2884608,123392,-2761216,-1
5317,283,21,9,0.0505357143,0.949464286,1596.073909,1758.2929,2845.69889,1951.303887,5600,172.3607264,11200,-2722304,144896,-2577408,-1
9342,601,20,10,0.0604445338,0.939555466,2840.639073,3277.707232,4949.690002,5318.788686,9943,1009.441624,19886,-4783104,307712,-4475392,-1
2904,320,18,12,0.0992555831,0.900744417,918.2832125,988.3259284,1645.163567,1316.078125,3224,97.13769208,6448,-1486848,163840,-1323008,-1
139,13,20,10,0.0855263158,0.914473684,41.98293146,40.75326248,80.50359712,33.69230769,152,16.85144124,304,-71168,6656,-64512,-1
942,95,21,9,0.0916104147,0.908389585,291.1583125,357.2579837,528.6029724,423.7789474,1037,115.4788419,2074,-482304,48640,-433664,-1
1510,105,22,8,0.0650154799,0.93498452,454.7759915,518.6787937,829.2377483,502.5809524,1615,111.1493462,3230,-773120,53760,-719360,-1
394,46,17,13,0.104545455,0.895454545,122.2755427,158.0476062,224.4492386,186.673913,440,20.18348624,880,-201728,23552,-178176,-1
8138,410,21,9,0.0479644361,0.952035564,2458.341896,2640.128171,4282.02986,4125.041463,8548,448.0083857,17096,-4166656,209920,-3956736,-1
3417,272,21,9,0.0737327189,0.926267281,1047.593565,1257.838745,1836.682763,1949.485294,3689,403.1693989,7378,-1749504,139264,-1610240,-1
4813,211,20,10,0.0419984076,0.958001592,1442.908248,1573.514696,2527.083316,2179.848341,5024,157,10048,-2464256,108032,-2356224,-1
6895,661,22,8,0.0874801482,0.912519852,2131.715593,2586.528241,3728.743292,4297.520424,7556,184.6981178,15112,-3530240,338432,-3191808,-1
4275,268,22,8,0.0589918556,0.941008144,1291.902815,1557.099843,2252.095205,2589.511194,4543,142.5925926,9086,-2188800,137216,-2051584,-1
63,30,20,10,0.322580645,0.677419355,28.69487441,21.72238988,49.25396825,42.26666667,93,15.34653465,186,-32256,15360,-16896,-1
1404,111,17,13,0.0732673267,0.926732673,426.7033661,470.4095534,780.3532764,475.2612613,1515,166.4835165,3030,-718848,56832,-662016,-1
9510,455,21,9,0.0456598093,0.954340191,2858.075581,3064.368826,5032.261514,3953.38022,9965,1636.288998,19930,-4869120,232960,-4636160,-1
4440,398,21,9,0.0822653989,0.917734601,1388.570948,1482.33707,2424.192342,2367.153266,4838,170.7730321,9676,-2273280,203776,-2069504,-1
1050,153,20,10,0.127182045,0.872817955,333.4582423,405.1434458,621.7333333,466.5751634,1203,31.10134436,2406,-537600,78336,-459264,-1
9523,457,20,10,0.0457915832,0.954208417,2868.981039,2891.595931,5045.491442,3844.584245,9980,1294.422827,19960,-4875776,233984,-4641792,-1
5132,560,22,8,0.0983836964,0.901616304,1594.794251,2005.234915,2811.595674,3166.373214,5692,185.9523032,11384,-2627584,286720,-2340864,-1
5092,203,21,9,0.0383380548,0.961661945,1518.537561,1703.748809,2665.385899,2211.896552,5295,100.3220917,10590,-2607104,103936,-2503168,-1
3688,881,19,11,0.192821186,0.807178814,1215.188428,1463.032625,2105.437636,3036.675369,4569,238.4655532,9138,-1888256,451072,-1437184,-1
9394,557,19,11,0.0559742739,0.944025726,2854.81074,3154.131128,4984.598893,4830.976661,9951,374.0977444,19902,-4809728,285184,-4524544,-1
5718,661,25,5,0.103621257,0.896378743,1837.364631,1876.500746,3190.169815,3188.531014,6379,255.9791332,12758,-2927616,338432,-2589184,-1
252,21,22,8,0.0769230769,0.923076923,76.58430663,86.24489206,141.3253968,85.0952381,273,14.91803279,546,-129024,10752,-118272,-1
2705,251,20,10,0.0849120433,0.915087957,843.4844334,938.5755636,1493.128651,1320.848606,2956,111.589279,5912,-1384960,128512,-1256448,-1
7782,674,21,9,0.0797067171,0.920293283,2436.025373,2242.578055,4319.959907,3172.504451,8456,191.7025618,16912,-3984384,345088,-3639296,-1
9466,488,18,12,0.0490255174,0.950974483,2864.069443,2979.163229,5010.386224,4339.588115,9954,1014.678899,19908,-4846592,249856,-4596736,-1
676,57,18,12,0.0777626194,0.922237381,206.9382354,205.1337889,380.0133136,212.6666667,733,144.2913386,1466,-346112,29184,-316928,-1
292,40,18,12,0.120481928,0.879518072,89.8420864,122.7946558,172.5753425,122.15,332,53.12,664,-149504,20480,-129024,-1
3810,179,20,10,0.0448734019,0.955126598,1151.359721,1132.867938,2005.341207,1774.888268,3989,79.17824534,7978,-1950720,91648,-1859072,-1
65,21,21,9,0.244186047,0.755813953,24.85995806,23.27914018,45.83076923,36.28571429,86,6.441947566,172,-33280,10752,-22528,-1
9396,563,20,10,0.0565317803,0.94346822,2827.556797,3090.480521,5084.456897,3236.701599,9959,742.1013413,19918,-4810752,288256,-4522496,-1
1176,103,21,9,0.0805316654,0.919468335,361.41873,447.8430469,642.369898,612.9417476,1279,102.5661588,2558,-602112,52736,-549376,-1
67,21,20,10,0.238636364,0.761363636,25.92310029,22.10857561,46.80597015,37.14285714,88,30.44982699,176,-34304,10752,-23552,-1
6921,465,16,14,0.0629569456,0.937043054,2117.804634,2235.51069,3737.432307,3039.617204,7386,448.4517304,14772,-3543552,238080,-3305472,-1
9525,448,20,10,0.0449212875,0.955078713,2863.872922,3079.113387,5024.03643,4199.5625,9973,732.770022,19946,-4876800,229376,-4647424,-1
349,84,23,7,0.193995381,0.806004619,121.6393751,137.2640751,220.2206304,203.6190476,433,15.13456833,866,-178688,43008,-135680,-1
3132,329,19,11,0.0950592314,0.904940769,959.7878018,1315.423073,1734.251596,1700.045593,3461,195.9796149,6922,-1603584,168448,-1435136,-1
4776,413,21,9,0.0795914434,0.920408557,1484.490628,1645.014971,2598.137982,2558.711864,5189,205.7494052,10378,-2445312,211456,-2233856,-1
4159,299,22,8,0.0670704352,0.932929565,1271.413876,1468.942389,2213.984371,2445.317726,4458,158.0290677,8916,-2129408,153088,-1976320,-1
5062,288,22,8,0.0538317757,0.946168224,1530.162548,1691.919461,2705.438562,2149.288194,5350,100.9243539,10700,-2591744,147456,-2444288,-1
341,39,24,6,0.102631579,0.897368421,107.8559366,124.5287501,189.9442815,195.3589744,380,34.63992707,760,-174592,19968,-154624,-1
237,52,20,10,0.179930796,0.820069204,81.60378809,91.2390222,145.5063291,142.6923077,289,8.292682927,578,-121344,26624,-94720,-1
8498,1339,16,14,0.136118735,0.863881265,2812.952751,2911.851148,4810.938221,5604.817028,9837,248.3463772,19674,-4350976,685568,-3665408,-1
8923,978,22,8,0.0987779012,0.901222099,2861.079036,2735.011844,4874.737756,5646.795501,9901,408.2886598,19802,-4568576,500736,-4067840,-1
4951,244,22,8,0.0469682387,0.953031761,1481.337448,1789.677777,2616.928297,2213.92623,5195,97.30286571,10390,-2534912,124928,-2409984,-1
2168,258,21,9,0.106347898,0.893652102,685.145638,816.7817738,1214.336716,1206.468992,2426,52.94631165,4852,-1110016,132096,-977920,-1
2248,144,19,11,0.0602006689,0.939799331,682.8737088,770.2078563,1210.009342,985.6041667,2392,54.5869466,4784,-1150976,73728,-1077248,-1
7991,1934,21,9,0.194861461,0.805138539,2563.179965,2612.937804,4342.914153,7525.102378,9925,592.8912784,19850,-4091392,990208,-3101184,-1
40,12,21,9,0.230769231,0.769230769,15.19012837,13.03733954,28.1,21.16666667,52,18.43971631,104,-20480,6144,-14336,-1
832,118,22,8,0.124210526,0.875789474,269.8332166,299.9586873,481.6442308,432.1779661,950,73.07692308,1900,-425984,60416,-365568,-1
9380,570,20,10,0.0572864322,0.942713568,2854.522196,2909.97532,5046.774947,3802.589474,9950,1165.105386,19900,-4802560,291840,-4510720,-1
3439,414,21,9,0.107448741,0.892551259,1106.921076,1092.091092,1883.993603,2284.243961,3853,101.2083005,7706,-1760768,211968,-1548800,-1
2265,219,19,11,0.0881642512,0.911835749,702.1935629,852.4052932,1249.618543,1168.876712,2484,68.12945694,4968,-1159680,112128,-1047552,-1
6202,706,17,13,0.102200347,0.897799653,1980.53735,2101.459142,3475.107868,3273.466006,6908,145.5848261,13816,-3175424,361472,-2813952,-1
122,31,19,11,0.202614379,0.797385621,42.96081178,34.47830306,84.77868852,46.38709677,153,18.84236453,306,-62464,15872,-46592,-1
5666,292,20,10,0.0490097348,0.950990265,1709.854023,1729.331629,3019.639252,2200.633562,5958,391.7159763,11916,-2900992,149504,-2751488,-1
6902,383,22,8,0.0525737817,0.947426218,2072.421234,2529.404492,3673.814836,3087.689295,7285,455.0281074,14570,-3533824,196096,-3337728,-1
1756,114,21,9,0.0609625668,0.939037433,533.8862263,622.7798074,938.1178815,895.1754386,1870,127.3841962,3740,-899072,58368,-840704,-1
2499,277,17,13,0.0997838617,0.900216138,793.4744411,868.8710996,1385.653061,1414.184116,2776,70.94301048,5552,-1279488,141824,-1137664,-1
3053,165,16,14,0.0512740833,0.948725917,914.4131528,1165.098232,1611.573207,1571.139394,3218,210.0522193,6436,-1563136,84480,-1478656,-1
5199,444,20,10,0.0786815524,0.921318448,1592.782503,2004.005313,2826.960762,2763.912162,5643,194.6533287,11286,-2661888,227328,-2434560,-1
8306,1220,20,10,0.128070544,0.871929456,2682.39164,2581.880272,4510.845654,6483.620492,9526,211.6418574,19052,-4252672,624640,-3628032,-1
9494,473,21,9,0.0474566068,0.952543393,2856.295722,3238.709954,5005.624605,4549.953488,9967,827.8239203,19934,-4860928,242176,-4618752,-1
4786,267,21,9,0.0528398971,0.947160103,1444.247534,1689.969526,2518.856874,2672.966292,5053,154.573264,10106,-2450432,136704,-2313728,-1
1078,171,25,5,0.136909528,0.863090472,355.2013568,380.8931694,610.9591837,713.5146199,1249,67.55002704,2498,-551936,87552,-464384,-1
47,17,19,11,0.265625,0.734375,18.78411338,14.56615977,35.55319149,24.05882353,64,8.590604027,128,-24064,8704,-15360,-1
2366,174,18,12,0.068503937,0.931496063,721.3568684,878.9512577,1270.249366,1273.908046,2540,165.0422352,5080,-1211392,89088,-1122304,-1
714,113,21,9,0.136638452,0.863361548,232.6863307,251.3662817,429.9901961,312.9646018,827,38.09304468,1654,-365568,57856,-307712,-1
360,29,21,9,0.0745501285,0.925449871,109.3082621,131.0748486,199.6777778,136.9310345,389,22.08972175,778,-184320,14848,-169472,-1
47,19,21,9,0.287878788,0.712121212,18.94546748,19.07878403,34.5106383,31,66,11.64021164,132,-24064,9728,-14336,-1
1125,112,27,3,0.090541633,0.909458367,349.5017949,385.1323549,636.2604444,445.625,1237,100.9795918,2474,-576000,57344,-518656,-1
9561,413,21,9,0.0414076599,0.95859234,2859.721975,3107.554735,5034.348395,3902.953995,9974,1003.420523,19948,-4895232,211456,-4683776,-1
6795,512,21,9,0.0700697961,0.929930204,2092.73587,2119.93599,3722.229139,2748.498047,7307,197.5932937,14614,-3479040,262144,-3216896,-1
36,23,17,13,0.389830508,0.610169492,16.99555134,16.85398205,31.38888889,27.82608696,59,20.41522491,118,-18432,11776,-6656,-1
6750,339,21,9,0.0478205671,0.952179433,2039.103556,2129.28404,3569.454222,3058.079646,7089,128.4937466,14178,-3456000,173568,-3282432,-1
463,50,21,9,0.0974658869,0.902534113,141.8508013,177.1651218,265.762419,175.86,513,18.83259912,1026,-237056,25600,-211456,-1
6954,523,20,10,0.06994784,0.93005216,2137.187661,2422.126621,3744.143946,3670.604207,7477,138.079409,14954,-3560448,267776,-3292672,-1
795,91,21,9,0.102708804,0.897291196,249.7137246,302.9952471,445.490566,426.1098901,886,48.04772234,1772,-407040,46592,-360448,-1
592,64,18,12,0.0975609756,0.902439024,181.294882,249.6294828,324.8902027,361.890625,656,28.44752819,1312,-303104,32768,-270336,-1
2140,142,19,11,0.0622261174,0.937773883,647.7147636,781.6142846,1154.42243,946.7535211,2282,168.16507,4564,-1095680,72704,-1022976,-1
9514,460,27,3,0.0461199118,0.953880088,2851.167328,3085.207413,5055.921064,3572.373913,9974,721.70767,19948,-4871168,235520,-4635648,-1
8204,577,21,9,0.0657100558,0.934289944,2504.681254,2841.457603,4439.728181,3698.164645,8781,264.1696751,17562,-4200448,295424,-3905024,-1
3711,225,19,11,0.0571646341,0.942835366,1116.646764,1325.862258,1998.552681,1472.831111,3936,524.1011984,7872,-1900032,115200,-1784832,-1
8755,418,18,12,0.0455685163,0.954431484,2617.874241,3016.244513,4638.915591,3499.629187,9173,393.3533448,18346,-4482560,214016,-4268544,-1
2521,132,20,10,0.0497549943,0.950245006,755.9323242,935.3677428,1327.193971,1323.295455,2653,102.4719969,5306,-1290752,67584,-1223168,-1
8643,566,21,9,0.0614616136,0.938538386,2631.235268,2545.144141,4710.861969,2988.454064,9209,174.3138368,18418,-4425216,289792,-4135424,-1
58,16,23,7,0.216216216,0.783783784,22.12202673,17.00723651,39.17241379,31.4375,74,2.250608273,148,-29696,8192,-21504,-1
181,31,20,10,0.146226415,0.853773585,59.22922553,36.48140376,116.2541436,49.5483871,212,41.16504854,424,-92672,15872,-76800,-1
8936,930,19,11,0.0942631259,0.905736874,2826.41466,3015.977088,4977.355416,4512.110753,9866,663.4835239,19732,-4575232,476160,-4099072,-1
285,29,18,12,0.0923566879,0.907643312,87.20972652,89.12659836,165.1789474,82.03448276,314,47.21804511,628,-145920,14848,-131072,-1
4593,276,20,10,0.056685151,0.943314849,1386.189141,1641.766763,2459.768343,2022.822464,4869,233.8616715,9738,-2351616,141312,-2210304,-1
9521,445,22,8,0.0446518162,0.955348184,2860.781673,3194.467075,4972.755488,5213.38427,9966,697.8991597,19932,-4874752,227840,-4646912,-1
8474,731,21,9,0.0794133623,0.920586638,2614.792083,3107.247445,4600.221501,4635.209302,9205,177.3603083,18410,-4338688,374272,-3964416,-1
1057,178,25,5,0.144129555,0.855870445,346.4794671,410.5359441,614.6944182,637.6292135,1235,45.32110092,2470,-541184,91136,-450048,-1
9144,763,21,9,0.0770162511,0.922983749,2846.971629,2875.861003,5025.387248,4098.475754,9907,517.3368146,19814,-4681728,390656,-4291072,-1
5449,462,21,9,0.0781593639,0.921840636,1667.403691,1919.874896,2884.297853,3801.681818,5911,126.5196918,11822,-2789888,236544,-2553344,-1
5217,539,17,13,0.0936414177,0.906358582,1659.948326,1676.598312,2884.345218,2821.923933,5756,107.2679836,11512,-2671104,275968,-2395136,-1
6947,311,21,9,0.0428492698,0.95715073,2082.56056,2349.765826,3619.865122,3844.720257,7258,443.372022,14516,-3556864,159232,-3397632,-1
7594,636,20,10,0.0772782503,0.92272175,2355.495282,2603.309562,4125.036344,4001.633648,8230,195.8125149,16460,-3888128,325632,-3562496,-1
9333,618,22,8,0.0621043111,0.937895689,2855.939537,2971.236005,5035.659166,4075.030744,9951,1003.125,19902,-4778496,316416,-4462080,-1
489,57,17,13,0.104395604,0.895604396,150.5219022,172.3571328,286.5010225,161.9649123,546,91.30434783,1092,-250368,29184,-221184,-1
5851,633,25,5,0.0976249229,0.902375077,1878.298015,1809.895357,3246.4859,3205.657188,6484,373.7175793,12968,-2995712,324096,-2671616,-1
3303,263,22,8,0.0737521032,0.926247897,1017.586938,1107.529493,1811.88132,1427.060837,3566,152.3931624,7132,-1691136,134656,-1556480,-1
3817,415,20,10,0.0980623819,0.901937618,1175.021259,1462.045899,2052.573749,2704.46747,4232,94.46428571,8464,-1954304,212480,-1741824,-1
3909,527,21,9,0.118800721,0.881199279,1247.235547,1436.731202,2161.828089,2638.86148,4436,83.98333964,8872,-2001408,269824,-1731584,-1
6412,517,21,9,0.0746139414,0.925386059,1967.962063,2152.05265,3540.903462,2523.62089,6929,317.4072377,13858,-3282944,264704,-3018240,-1
9246,680,20,10,0.0685069514,0.931493049,2833.736733,3178.39592,5016.667965,4240.572059,9926,436.3076923,19852,-4733952,348160,-4385792,-1
516,78,21,9,0.131313131,0.868686869,166.7577467,188.5271755,306.8565891,235.6025641,594,34.81828839,1188,-264192,39936,-224256,-1
5522,405,27,3,0.0683313649,0.931668635,1709.097084,1712.386107,2943.621514,3241.851852,5927,219.1127542,11854,-2827264,207360,-2619904,-1
8734,497,21,9,0.0538403207,0.946159679,2667.652206,2539.448605,4650.171628,4015.486922,9231,262.6173542,18462,-4471808,254464,-4217344,-1
4156,728,21,9,0.149058149,0.850941851,1395.317393,1490.110026,2438.164341,2467.251374,4884,94.30391968,9768,-2127872,372736,-1755136,-1
9446,507,19,11,0.0509394153,0.949060585,2846.706927,3176.908403,5028.868833,4010.623274,9953,1081.847826,19906,-4836352,259584,-4576768,-1
2422,183,22,8,0.0702495202,0.92975048,745.972449,778.4997863,1323.466144,1032.131148,2605,288.8026608,5210,-1240064,93696,-1146368,-1
9627,353,20,10,0.0353707415,0.964629259,2867.080574,3154.922601,5016.595201,4278.832861,9980,1102.762431,19960,-4929024,180736,-4748288,-1
7105,620,21,9,0.0802588997,0.9197411,2231.076364,2188.5485,3893.055876,3518.569355,7725,175.6879691,15450,-3637760,317440,-3320320,-1
3621,232,18,12,0.0602128212,0.939787179,1111.068521,1039.524772,1954.641535,1495.577586,3853,172.0857526,7706,-1853952,118784,-1735168,-1
9521,446,21,9,0.0447476673,0.955252333,2851.696417,3126.355466,5042.388825,3737.542601,9967,1003.726083,19934,-4874752,228352,-4646400,-1
7079,1309,20,10,0.156056271,0.843943729,2373.715478,2368.823248,3987.240006,5315.350649,8388,159.9237369,16776,-3624448,670208,-2954240,-1
3883,251,17,13,0.0607160135,0.939283986,1180.545587,1335.615486,2088.442184,1743.521912,4134,326.0252366,8268,-1988096,128512,-1859584,-1
9338,579,22,8,0.0583845921,0.941615408,2865.26861,2715.954942,5005.227458,4213.452504,9917,521.3985279,19834,-4781056,296448,-4484608,-1
6480,285,22,8,0.0421286031,0.957871397,1943.162746,2120.361553,3364.774537,3797.389474,6765,510.9516616,13530,-3317760,145920,-3171840,-1
9558,417,22,8,0.0418045113,0.958195489,2871.689762,2938.8531,5023.44842,4175.491607,9975,378.8454235,19950,-4893696,213504,-4680192,-1
3029,211,17,13,0.0651234568,0.934876543,917.4891927,1138.385691,1605.02311,1842.677725,3240,249.8072475,6480,-1550848,108032,-1442816,-1
3057,387,20,10,0.112369338,0.887630662,979.3980771,1102.977226,1728.563297,1674.604651,3444,101.5330189,6888,-1565184,198144,-1367040,-1
57,16,21,9,0.219178082,0.780821918,21.29960399,16.53299258,39.89473684,26.6875,73,3.562713519,146,-29184,8192,-20992,-1
2079,205,18,12,0.0897548161,0.910245184,654.0260959,701.0515807,1153.609428,1029.834146,2284,400,4568,-1064448,104960,-959488,-1
2337,175,18,12,0.0696656051,0.930334395,711.0319983,857.7954947,1274.315362,1018.588571,2512,141.6807671,5024,-1196544,89600,-1106944,-1
9448,506,21,9,0.0508338356,0.949166164,2863.77463,2984.671523,5009.977773,4371.077075,9954,831.5789474,19908,-4837376,259072,-4578304,-1
3243,152,19,11,0.0447717231,0.955228277,968.5546225,1142.178785,1714.764416,1340.322368,3395,387.1151653,6790,-1660416,77824,-1582592,-1
2245,157,22,8,0.0653621982,0.934637802,681.1814349,818.1046074,1216.861024,981.8471338,2402,203.9049236,4804,-1149440,80384,-1069056,-1
2722,262,21,9,0.0878016086,0.912198391,858.9864534,861.6605004,1511.522777,1294.866412,2984,91.11450382,5968,-1393664,134144,-1259520,-1
5807,397,20,10,0.0639909736,0.936009026,1760.214489,1979.942693,3164.66351,2193.221662,6204,529.8035867,12408,-2973184,203264,-2769920,-1
8318,1103,21,9,0.117078866,0.882921134,2733.808694,2609.778209,4706.450108,4745.311877,9421,173.6589862,18842,-4258816,564736,-3694080,-1
5946,234,19,11,0.0378640777,0.962135922,1770.973988,1991.916623,3114.692062,2475.773504,6180,998.3844911,12360,-3044352,119808,-2924544,-1
9513,462,20,10,0.0463157895,0.953684211,2868.183533,3066.057981,5010.961631,4515.199134,9975,774.4565217,19950,-4870656,236544,-4634112,-1
2682,461,21,9,0.146675151,0.853324849,907.5188483,905.0744219,1565.271066,1611.147505,3143,70.62921348,6286,-1373184,236032,-1137152,-1
1771,142,18,12,0.0742289597,0.92577104,546.0733253,535.8335293,981.6696781,649.3239437,1913,303.1695721,3826,-906752,72704,-834048,-1
4527,422,20,10,0.0852697515,0.914730249,1407.671819,1623.341197,2456.254694,2676.090047,4949,93.53619354,9898,-2317824,216064,-2101760,-1
9416,540,18,12,0.0542386501,0.94576135,2867.799942,2901.493261,5016.622345,4313.759259,9956,430.8091735,19912,-4820992,276480,-4544512,-1
95,29,19,11,0.233870968,0.766129032,35.84020553,19.0015332,70.55789474,36.10344828,124,26.21564482,248,-48640,14848,-33792,-1
3521,222,20,10,0.0593107133,0.940689287,1063.366873,1321.730248,1875.60693,1814.792793,3743,121.7235772,7486,-1802752,113664,-1689088,-1
976,110,20,10,0.101289134,0.898710866,305.6654499,339.1251511,560.835041,389.6909091,1086,40.19245004,2172,-499712,56320,-443392,-1
3051,232,21,9,0.0706670728,0.929332927,930.6887392,1143.978198,1649.409374,1544.560345,3283,69.91056218,6566,-1562112,118784,-1443328,-1
41,12,21,9,0.226415094,0.773584906,15.43202939,13.21273586,28.73170732,21.08333333,53,27.7486911,106,-20992,6144,-14848,-1
4004,608,21,9,0.131830009,0.868169991,1297.636361,1372.856712,2209.311938,2946.534539,4612,92.48044917,9224,-2050048,311296,-1738752,-1
148,25,16,14,0.144508671,0.855491329,47.03770994,51.66005807,93.03378378,51.28,173,33.20537428,346,-75776,12800,-62976,-1
503,106,24,6,0.174055829,0.825944171,170.6361342,197.5887803,308.6302187,287.7735849,609,20.52578362,1218,-257536,54272,-203264,-1
9423,539,22,8,0.0541056013,0.945894399,2869.93336,2823.077986,5033.917967,4065.109462,9962,1259.418458,19924,-4824576,275968,-4548608,-1
1190,71,21,9,0.0563045202,0.94369548,360.1316821,396.9454099,639.6218487,486.4929577,1261,136.6197183,2522,-609280,36352,-572928,-1
7523,618,21,9,0.0759120501,0.92408795,2312.505991,2761.967693,4057.657052,4233.425566,8141,152.0261438,16282,-3851776,316416,-3535360,-1
283,25,21,9,0.0811688312,0.918831169,86.63860931,94.25205356,159.5371025,97.48,308,22.68041237,616,-144896,12800,-132096,-1
3303,514,24,6,0.134660728,0.865339272,1083.033837,1215.945408,1907.49016,1918.702335,3817,109.8733448,7634,-1691136,263168,-1427968,-1
1252,77,18,12,0.0579382995,0.942061701,376.7387826,443.9037376,676.2587859,481.9350649,1329,162.6682987,2658,-641024,39424,-601600,-1
1329,147,27,3,0.0995934959,0.900406504,418.8225877,482.3682154,731.586155,801.0068027,1476,28.45026985,2952,-680448,75264,-605184,-1
1117,113,21,9,0.0918699187,0.908130081,347.8989846,399.8973762,627.6902417,495,1230,136.5149834,2460,-571904,57856,-514048,-1
9395,462,21,9,0.0468702445,0.953129756,2829.089075,3159.198119,4925.117829,5007.945887,9857,265.8306365,19714,-4810240,236544,-4573696,-1
67,28,19,11,0.294736842,0.705263158,28.62789284,23.54552148,50.10447761,42.96428571,95,15.42207792,190,-34304,14336,-19968,-1
504,110,20,10,0.179153094,0.820846906,173.875556,191.5460793,309.9146825,296.4363636,614,21.12143103,1228,-258048,56320,-201728,-1
3415,433,21,9,0.112525988,0.887474012,1093.765297,1219.145366,1899.394436,2122.503464,3848,133.1027326,7696,-1748480,221696,-1526784,-1
2559,204,22,8,0.0738327904,0.92616721,778.3615036,1004.961858,1375.69871,1461.044118,2763,87.24344806,5526,-1310208,104448,-1205760,-1
4614,370,20,10,0.0742375602,0.92576244,1427.372847,1573.562452,2494.685739,2465.243243,4984,165.6364241,9968,-2362368,189440,-2172928,-1
2713,436,21,9,0.138456653,0.861543347,914.9829853,870.6741814,1570.778843,1601.266055,3149,74.47965941,6298,-1389056,223232,-1165824,-1
2337,137,20,10,0.0553759095,0.944624091,701.2519759,906.7748586,1237.734275,1233.50365,2474,100.1619433,4948,-1196544,70144,-1126400,-1
409,69,18,12,0.144351464,0.855648536,132.407805,166.1030394,242.5867971,221.2028986,478,45.69789675,956,-209408,35328,-174080,-1
1189,165,18,12,0.121861152,0.878138848,385.3852547,428.2681955,678.0883095,673.2606061,1354,25.95361319,2708,-608768,84480,-524288,-1
3563,315,22,8,0.0812274368,0.918772563,1095.735412,1317.512887,1911.087847,2260.873016,3878,113.6576788,7756,-1824256,161280,-1662976,-1
94,30,23,7,0.241935484,0.758064516,36.02299986,35.04202239,62.88297872,61.3,124,2.520837569,248,-48128,15360,-32768,-1
5210,511,21,9,0.0893200489,0.910679951,1631.022105,1838.999495,2844.450288,3029.735812,5721,395.3697305,11442,-2667520,261632,-2405888,-1
281,72,21,9,0.203966006,0.796033994,96.40786712,115.1673769,168.5302491,210.0555556,353,11.94585448,706,-143872,36864,-107008,-1
4845,264,21,9,0.0516735173,0.948326483,1459.083877,1532.899184,2598.557276,1755.625,5109,407.0916335,10218,-2480640,135168,-2345472,-1
9271,434,22,8,0.0447192169,0.955280783,2780.299313,3001.444304,4906.732931,3705.170507,9705,800.0824402,19410,-4746752,222208,-4524544,-1
6683,1144,22,8,0.146160726,0.853839274,2288.025971,2081.284441,3894.916654,4025.480769,7827,164.8483572,15654,-3421696,585728,-2835968,-1
4798,283,20,10,0.0556976973,0.944302303,1453.205789,1657.464753,2556.708629,2274.674912,5081,335.8228685,10162,-2456576,144896,-2311680,-1
5204,330,20,10,0.0596313697,0.94036863,1584.210234,1704.119978,2802.083974,2222.121212,5534,262.8978622,11068,-2664448,168960,-2495488,-1
85,25,19,11,0.227272727,0.772727273,32.17448967,17.137281,61.95294118,33.56,110,36.06557377,220,-43520,12800,-30720,-1
2273,355,20,10,0.135083714,0.864916286,759.9346577,707.2224877,1350.888693,1081.509859,2628,107.1341215,5256,-1163776,181760,-982016,-1
492,104,18,12,0.174496644,0.825503356,171.7283747,165.6331783,308.4613821,251.375,596,16.71809257,1192,-251904,53248,-198656,-1
5656,406,21,9,0.0669745958,0.933025404,1726.422148,1864.58108,3090.539427,2209.019704,6062,184.7044485,12124,-2895872,207872,-2688000,-1
9503,483,24,6,0.0483677148,0.951632285,2843.297205,3120.132777,5079.592024,3299.643892,9986,1040.208333,19972,-4865536,247296,-4618240,-1
1509,241,20,10,0.137714286,0.862285714,484.1161314,613.8430404,889.4844268,787.9377593,1750,107.8250154,3500,-772608,123392,-649216,-1
1556,239,20,10,0.133147632,0.866852368,515.9024146,498.3724075,924.9087404,722.8117155,1795,45.23689516,3590,-796672,122368,-674304,-1
6975,363,21,9,0.04946852,0.95053148,2113.104719,2180.361343,3689.506093,3285.085399,7338,256.7529741,14676,-3571200,185856,-3385344,-1
8324,792,21,9,0.0868802106,0.913119789,2596.553378,2748.476175,4661.951946,3471.209596,9116,203.6639857,18232,-4261888,405504,-3856384,-1
2306,126,20,10,0.0518092105,0.948190789,701.5416393,671.2516785,1229.042064,986.9603175,2432,90.5435592,4864,-1180672,64512,-1116160,-1
901,110,19,11,0.108803165,0.891196835,287.049503,322.7355877,513.0887902,447.9363636,1011,19.99209017,2022,-461312,56320,-404992,-1
1534,139,20,10,0.0830842797,0.91691572,475.2271998,560.8756238,835.3468057,855.2446043,1673,113.6548913,3346,-785408,71168,-714240,-1
1893,201,20,10,0.0959885387,0.904011461,595.6531782,621.8832191,1075.784997,781.1144279,2094,46.9717362,4188,-969216,102912,-866304,-1
166,16,23,7,0.0879120879,0.912087912,51.28498084,62.83995047,92.6686747,79.375,182,18.30985915,364,-84992,8192,-76800,-1
3338,187,18,12,0.0530496454,0.946950355,1003.106104,1165.482501,1787.330138,1328.700535,3525,148.483572,7050,-1709056,95744,-1613312,-1
2388,148,20,10,0.0583596215,0.941640379,731.3168657,735.128168,1275.500419,1155.547297,2536,212.3953099,5072,-1222656,75776,-1146880,-1
41,12,21,9,0.226415094,0.773584906,15.43202939,13.21273586,28.73170732,21.08333333,53,12.61904762,106,-20992,6144,-14848,-1
3451,332,21,9,0.0877610362,0.912238964,1076.355203,1241.727799,1898.258766,1826.942771,3783,112.5892857,7566,-1766912,169984,-1596928,-1
2805,109,22,8,0.037405628,0.962594372,838.2004859,899.1999524,1463.954011,1291.412844,2914,524.1007194,5828,-1436160,55808,-1380352,-1
4475,259,19,11,0.0547106041,0.945289396,1345.068954,1609.662538,2397.528268,1848.671815,4734,299.2414665,9468,-2291200,132608,-2158592,-1
9374,580,17,13,0.058268033,0.941731967,2870.545285,2863.051592,5012.071048,4418.760345,9954,1268.025478,19908,-4799488,296960,-4502528,-1
9214,745,19,11,0.0748067075,0.925193292,2826.045385,3184.740705,4882.603755,6184.575839,9959,276.7926626,19918,-4717568,381440,-4336128,-1
2401,128,23,7,0.0506128905,0.94938711,725.7645552,791.7342946,1272.950437,1115.867188,2529,120.8313426,5058,-1229312,65536,-1163776,-1
7495,798,17,13,0.0962257325,0.903774267,2364.208001,2656.433792,4139.733823,4215.245614,8293,197.6877235,16586,-3837440,408576,-3428864,-1
4749,274,24,6,0.0545490743,0.945450926,1441.619876,1494.595759,2542.184249,1988.843066,5023,216.6019836,10046,-2431488,140288,-2291200,-1
1726,305,22,8,0.150172329,0.849827671,582.1581426,608.6445341,1011.752028,1040.039344,2031,106.1128527,4062,-883712,156160,-727552,-1
1581,162,21,9,0.0929432014,0.907056799,500.9541972,524.1898208,872.4130297,867.9691358,1743,102.892562,3486,-809472,82944,-726528,-1
9469,503,21,9,0.0504412355,0.949558765,2860.674767,2929.460267,5052.973281,3735.137177,9972,618.9944134,19944,-4848128,257536,-4590592,-1
4582,383,21,9,0.0771399799,0.92286002,1402.096663,1739.319378,2506.62069,2200.415144,4965,421.4770798,9930,-2345984,196096,-2149888,-1
396,74,25,5,0.157446809,0.842553191,129.3464979,156.0703664,244.9393939,184.9864865,470,8.814703676,940,-202752,37888,-164864,-1
4841,672,21,9,0.121893706,0.878106294,1565.997549,1763.279422,2749.978517,2807.581845,5513,130.4852071,11026,-2478592,344064,-2134528,-1
43,10,22,8,0.188679245,0.811320755,15.43860291,12.23151667,28.69767442,19.7,53,13.69509044,106,-22016,5120,-16896,-1
301,61,19,11,0.168508287,0.831491713,100.9488047,120.4567229,182.0996678,178.5409836,362,13.98763524,724,-154112,31232,-122880,-1
2639,118,22,8,0.0428001451,0.957199855,788.1501252,916.6420829,1390.317545,1125.889831,2757,222.8779305,5514,-1351168,60416,-1290752,-1
3603,219,22,8,0.057299843,0.942700157,1087.435952,1306.315634,1928.524008,1631.420091,3822,159.4493116,7644,-1844736,112128,-1732608,-1
5439,268,27,3,0.0469598738,0.953040126,1638.857463,1731.56677,2879.912116,2328.119403,5707,472.0430108,11414,-2784768,137216,-2647552,-1
2093,232,20,10,0.0997849462,0.900215054,660.5278678,717.9868529,1189.358337,925.2068966,2325,96.91538141,4650,-1071616,118784,-952832,-1
41,20,19,11,0.327868852,0.672131148,15.60834597,21.11492363,31.19512195,30.6,61,12.7348643,122,-20992,10240,-10752,-1
9426,532,20,10,0.0534243824,0.946575618,2865.475126,2955.172381,5016.79164,4318.765038,9958,702.2566996,19916,-4826112,272384,-4553728,-1
2260,206,20,10,0.0835360908,0.916463909,701.4150906,807.0467047,1245.071681,1106.548544,2466,63.75387797,4932,-1157120,105472,-1051648,-1
9311,645,20,10,0.0647850542,0.935214946,2860.777811,2813.930379,5058.908603,3817.748837,9956,382.9230769,19912,-4767232,330240,-4436992,-1
2870,293,23,7,0.0926335757,0.907366424,901.0631972,973.3155178,1551.263415,1883.071672,3163,204.4602456,6326,-1469440,150016,-1319424,-1
2083,144,20,10,0.0646609789,0.935339021,638.762233,606.1745409,1137.369659,775.9513889,2227,58.22222222,4454,-1066496,73728,-992768,-1
127,38,21,9,0.23030303,0.76969697,46.98407052,47.22070535,87.09448819,69.31578947,165,34.95762712,330,-65024,19456,-45568,-1
47,7,24,6,0.12962963,0.87037037,14.79612468,14.55881807,29.42553191,14.57142857,54,1.469787697,108,-24064,3584,-20480,-1
5875,493,20,10,0.0774183417,0.922581658,1791.372746,2231.067641,3237.396085,2554.146045,6368,301.5151515,12736,-3008000,252416,-2755584,-1
9413,529,25,5,0.0532086099,0.94679139,2847.949605,3158.366213,5010.399023,4279.332703,9942,1190.658683,19884,-4819456,270848,-4548608,-1
2149,348,27,3,0.139367241,0.860632759,711.5410829,764.973148,1268.291298,1129.87069,2497,80.78291815,4994,-1100288,178176,-922112,-1
4891,610,17,13,0.110888929,0.889111071,1592.414166,1541.988705,2771.873645,2583.634426,5501,417.3748103,11002,-2504192,312320,-2191872,-1
7075,882,22,8,0.110845796,0.889154204,2307.368213,2211.395584,3984.879293,3931.839002,7957,143.6022379,15914,-3622400,451584,-3170816,-1
6855,323,27,3,0.0449986069,0.955001393,2060.814207,2136.296832,3628.589934,2759.897833,7178,472.2368421,14356,-3509760,165376,-3344384,-1
140,28,24,6,0.166666667,0.833333333,48.32696621,49.09282908,85.39285714,80.03571429,168,3.781228899,336,-71680,14336,-57344,-1
9507,464,22,8,0.0465349514,0.953465049,2863.260989,2938.126424,5043.011044,3817.887931,9971,844.2845047,19942,-4867584,237568,-4630016,-1
4149,3125,20,10,0.429612318,0.570387682,1550.63067,1404.314264,2353.013497,5342.88704,7274,419.9769053,14548,-2124288,1600000,-524288,-1
4063,1217,22,8,0.230492424,0.769507576,1502.946877,1120.12277,2342.837066,3634.258833,5280,110.6222502,10560,-2080256,623104,-1457152,-1
5115,411,18,12,0.0743756786,0.925624321,1576.725921,1794.47691,2745.437341,2988.294404,5526,239.4280763,11052,-2618880,210432,-2408448,-1
9431,519,27,3,0.052160804,0.947839196,2841.644716,3058.967841,5052.727282,3572.165703,9950,461.2888271,19900,-4828672,265728,-4562944,-1
8045,386,25,5,0.0457834183,0.954216582,2423.163898,2533.924926,4251.73785,3471.15285,8431,768.5505925,16862,-4119040,197632,-3921408,-1
2258,257,21,9,0.102186879,0.897813121,706.0772908,880.9870502,1262.656333,1217.089494,2515,99.6039604,5030,-1156096,131584,-1024512,-1
2967,229,20,10,0.0716520651,0.928347935,909.0123131,1083.138058,1596.681159,1622.065502,3196,219.9587061,6392,-1519104,117248,-1401856,-1
1183,121,19,11,0.092791411,0.907208589,369.119086,436.1095374,645.7387997,718.6033058,1304,42.36517219,2608,-605696,61952,-543744,-1
4090,139,20,10,0.0328682904,0.96713171,1217.734266,1290.330489,2122.160636,1904.302158,4229,209.6678235,8458,-2094080,71168,-2022912,-1
445,57,21,9,0.113545817,0.886454183,140.2896422,145.4919696,263.6382022,156.7368421,502,33.11345646,1004,-227840,29184,-198656,-1
9446,516,19,11,0.0517968279,0.948203172,2846.455935,3220.899932,5033.831145,4023.515504,9962,976.6666667,19924,-4836352,264192,-4572160,-1
5745,580,17,13,0.0916996047,0.908300395,1777.752338,2227.672046,3191.675718,2878.962069,6325,195.09562,12650,-2941440,296960,-2644480,-1
115,19,27,3,0.141791045,0.858208955,39.38788161,33.5833193,66.6,72.94736842,134,26.48221344,268,-58880,9728,-49152,-1
483,113,17,13,0.189597315,0.810402685,169.4332757,173.4497517,310.6645963,246.5044248,596,17.20554273,1192,-247296,57856,-189440,-1
6097,741,21,9,0.108365019,0.891634981,1944.955015,2193.038063,3436.672462,3278.203779,6838,213.2875858,13676,-3121664,379392,-2742272,-1
689,117,21,9,0.14516129,0.85483871,231.5983966,236.8667044,398.6211901,432.2307692,806,65.36901865,1612,-352768,59904,-292864,-1
873,103,16,14,0.105532787,0.894467213,276.9750465,235.5438932,512.5612829,284.5631068,976,161.8573798,1952,-446976,52736,-394240,-1
6904,905,21,9,0.11589192,0.88410808,2247.613418,2238.849123,3837.753766,4418.003315,7809,183.1378987,15618,-3534848,463360,-3071488,-1
1411,164,19,11,0.104126984,0.895873016,447.5628361,461.2167612,812.3805811,578.2378049,1575,82.54716981,3150,-722432,83968,-638464,-1
68,23,21,9,0.252747253,0.747252747,25.9933449,26.62893518,47.41176471,41.82608696,91,17.26755218,182,-34816,11776,-23040,-1
5638,263,21,9,0.0445687172,0.955431283,1691.281272,1944.863459,2954.673111,2872.258555,5901,482.8968903,11802,-2886656,134656,-2752000,-1
6366,577,21,9,0.0831052859,0.916894714,1954.03995,2479.269439,3450.039428,3714.289428,6943,148.5451433,13886,-3259392,295424,-2963968,-1
3335,312,21,9,0.0855497669,0.914450233,1057.006853,1005.570516,1828.288756,1778.157051,3647,108.5093722,7294,-1707520,159744,-1547776,-1
67,28,16,14,0.294736842,0.705263158,28.16745743,21.65366892,52.76119403,36.60714286,95,11.00811124,190,-34304,14336,-19968,-1
143,56,19,11,0.281407035,0.718592965,54.33596764,64.71179976,99.96503497,100.0892857,199,36.78373383,398,-73216,28672,-44544,-1
9243,717,22,8,0.0719879518,0.928012048,2831.287992,3131.00966,5077.767608,3726.60251,9960,686.8965517,19920,-4732416,367104,-4365312,-1
8397,1542,22,8,0.155146393,0.844853607,2697.737829,2846.630538,4580.507205,7090.992866,9939,342.8423594,19878,-4299264,789504,-3509760,-1
673,58,19,11,0.0793433653,0.920656635,204.951488,233.7708189,377.4517088,233.1206897,731,129.380531,1462,-344576,29696,-314880,-1
7056,626,21,9,0.0814891955,0.918510804,2196.9477,2385.894127,3798.730159,4323.583067,7682,146.9957903,15364,-3612672,320512,-3292160,-1
3356,163,22,8,0.0463199773,0.953680023,1012.56951,1069.176809,1767.606377,1603.392638,3519,302.3195876,7038,-1718272,83456,-1634816,-1
1625,79,22,8,0.0463615023,0.953638498,486.6413336,525.2610884,865.2356923,590.5316456,1704,153.0997305,3408,-832000,40448,-791552,-1
3068,235,25,5,0.0711474417,0.928852558,934.1320555,1150.751533,1670.39146,1411.893617,3303,233.4275618,6606,-1570816,120320,-1450496,-1
7938,511,21,9,0.0604805302,0.93951947,2419.870069,2400.988503,4304.643109,2987.804305,8449,647.9294479,16898,-4064256,261632,-3802624,-1
1147,140,20,10,0.108780109,0.891219891,365.2376223,409.0323611,654.7314734,556.0785714,1287,92.39052405,2574,-587264,71680,-515584,-1
854,150,23,7,0.14940239,0.85059761,288.261202,255.7516018,527.4672131,360.3533333,1004,26.48377737,2008,-437248,76800,-360448,-1
9206,720,21,9,0.0725367721,0.927463228,2844.09181,3084.654933,4925.830545,5445.145833,9926,607.4663403,19852,-4713472,368640,-4344832,-1
5326,236,21,9,0.0424307803,0.95756922,1594.50066,1823.75645,2791.602891,2553.5,5562,202.6229508,11124,-2726912,120832,-2606080,-1
1627,126,21,9,0.0718767827,0.928123217,488.7033885,688.1209144,882.4603565,806.4920635,1753,85.76320939,3506,-833024,64512,-768512,-1
4956,289,27,3,0.0551000953,0.944899905,1502.419984,1677.108725,2639.435028,2341.15917,5245,382.8467153,10490,-2537472,147968,-2389504,-1
2166,183,19,11,0.0779054917,0.922094508,659.7503837,865.7576485,1177.308403,1147.677596,2349,176.0869565,4698,-1108992,93696,-1015296,-1
9453,494,20,10,0.049663215,0.950336785,2848.774725,3018.109888,5038.810642,3733.807692,9947,544.1466083,19894,-4839936,252928,-4587008,-1
9651,335,20,10,0.0335469658,0.966453034,2878.719097,2984.877516,5002.059372,4746.913433,9986,979.9803729,19972,-4941312,171520,-4769792,-1
393,40,20,10,0.0923787529,0.907621247,120.9137165,120.8574961,227.1145038,117.625,433,76.90941385,866,-201216,20480,-180736,-1
1515,162,25,5,0.0966010733,0.903398927,471.5906773,587.0011613,834.8521452,877.7901235,1677,114.3929059,3354,-775680,82944,-692736,-1
1351,184,16,14,0.119869707,0.880130293,439.7799333,463.7950971,774.8497409,717.7065217,1535,64.27973199,3070,-691712,94208,-597504,-1
1276,134,20,10,0.095035461,0.904964539,395.7273552,496.7702925,698.2217868,774.8059701,1410,118.2885906,2820,-653312,68608,-584704,-1
1444,146,18,12,0.0918238994,0.908176101,453.4363255,499.8303926,805.6024931,695.5821918,1590,30.25114155,3180,-739328,74752,-664576,-1
9525,448,27,3,0.0449212875,0.955078713,2862.027864,2972.857195,5043.612283,3783.357143,9973,644.6670976,19946,-4876800,229376,-4647424,-1
3245,345,22,8,0.0961002786,0.903899721,1019.731582,1168.408233,1813.034515,1630.573913,3590,89.72756811,7180,-1661440,176640,-1484800,-1
2712,396,21,9,0.127413127,0.872586873,867.1283336,1075.450458,1539.707596,1655.805556,3108,130.3144654,6216,-1388544,202752,-1185792,-1
71,27,19,11,0.275510204,0.724489796,28.5128383,24.81260355,53.47887324,39.03703704,98,8.900999092,196,-36352,13824,-22528,-1
71,26,18,12,0.268041237,0.731958763,28.51693588,20.96136203,54.09859155,35.07692308,97,11.2659698,194,-36352,13312,-23040,-1
4172,400,21,9,0.0874890639,0.912510936,1323.498518,1280.478568,2289.344199,2256.835,4572,190.3413822,9144,-2136064,204800,-1931264,-1
2158,109,23,7,0.0480811645,0.951918835,649.0776567,720.7749504,1144.660334,922.9449541,2267,212.0673527,4534,-1104896,55808,-1049088,-1
110,29,20,10,0.208633094,0.791366906,41.0479673,25.79324175,76.02727273,47.13793103,139,29.63752665,278,-56320,14848,-41472,-1
474,61,25,5,0.114018692,0.885981308,150.993563,169.5482877,274.9451477,214.0327869,535,46.72489083,1070,-242688,31232,-211456,-1
4992,246,21,9,0.0469644903,0.95303551,1497.871875,1764.882847,2629.052484,2425.654472,5238,259.3069307,10476,-2555904,125952,-2429952,-1
9468,501,22,8,0.050255793,0.949744207,2856.076213,3148.522655,5028.842205,4156.461078,9969,1382.662968,19938,-4847616,256512,-4591104,-1
2393,278,20,10,0.104080869,0.895919131,758.8597405,846.4873932,1357.58504,1150.197842,2671,160.6133494,5342,-1225216,142336,-1082880,-1
5192,193,21,9,0.0358402971,0.964159703,1548.150589,1701.09472,2701.486518,2464.699482,5385,467.85404,10770,-2658304,98816,-2559488,-1
4184,338,19,11,0.0747456877,0.925254312,1287.701955,1405.706124,2303.760038,1738.37574,4522,393.2173913,9044,-2142208,173056,-1969152,-1
4100,807,20,10,0.164458936,0.835541064,1340.949989,1609.061535,2329.83122,3084.845105,4907,149.9236175,9814,-2099200,413184,-1686016,-1
1469,150,21,9,0.0926497838,0.907350216,460.9770134,479.7028583,830.9496256,604.8333333,1619,117.4891147,3238,-752128,76800,-675328,-1
8639,1216,22,8,0.123389143,0.876610857,2850.551592,2791.451319,4892.570899,5179.703947,9855,420.0767263,19710,-4423168,622592,-3800576,-1
9426,527,22,8,0.0529488596,0.94705114,2848.563025,3043.545656,5043.896032,3780.487666,9953,956.0999039,19906,-4826112,269824,-4556288,-1
6489,410,20,10,0.0594289027,0.940571097,1954.624096,2461.438777,3478.422253,3000.165854,6899,138.4507325,13798,-3322368,209920,-3112448,-1
329,74,17,13,0.183622829,0.816377171,111.2863949,119.4067574,215.4589666,142.1621622,403,44.77777778,806,-168448,37888,-130560,-1
1922,136,18,12,0.0660835763,0.933916424,581.8560722,599.6763425,1059.828304,600.8897059,2058,150.2189781,4116,-984064,69632,-914432,-1
6853,324,21,9,0.0451442107,0.954855789,2060.240725,2179.892865,3623.344375,2862.574074,7177,506.49259,14354,-3508736,165888,-3342848,-1
94,25,23,7,0.210084034,0.789915966,34.5497604,32.5911399,61.92553191,52.76,119,2.411347518,238,-48128,12800,-35328,-1
97,23,19,11,0.191666667,0.808333333,33.58175542,26.76340362,66.48453608,35.26086957,120,15.87301587,240,-49664,11776,-37888,-1
47,20,20,10,0.298507463,0.701492537,19.48448327,18.57982777,35.40425532,30.7,67,9.115646259,134,-24064,10240,-13824,-1
7243,891,19,11,0.109540202,0.890459798,2293.21281,2652.830365,3981.706751,4764.919192,8134,204.3718593,16268,-3708416,456192,-3252224,-1
704,41,27,3,0.055033557,0.944966443,212.2746406,232.8076799,366.6676136,481.7317073,745,34.30018416,1490,-360448,20992,-339456,-1
8471,543,21,9,0.0602396272,0.939760373,2579.501977,2737.61254,4572.81053,3488.631676,9014,198.3278328,18028,-4337152,278016,-4059136,-1
39,19,27,3,0.327586207,0.672413793,11.63870981,17.13430733,22.76923077,43.31578947,58,3.988995873,116,-19968,9728,-10240,-1
2800,161,25,5,0.0543735225,0.945626478,844.898616,1010.74465,1479.493214,1507.204969,2961,105.4111784,5922,-1433600,82432,-1351168,-1
110,39,19,11,0.261744966,0.738255034,41.97135584,42.68558506,80.07272727,60.69230769,149,27.28937729,298,-56320,19968,-36352,-1
1049,86,22,8,0.0757709251,0.924229075,318.2251983,417.9244734,574.5519542,488.0813953,1135,117.8608515,2270,-537088,44032,-493056,-1
2329,375,19,11,0.138683432,0.861316568,766.8928013,804.6479922,1398.159725,1068.922667,2704,61.05215624,5408,-1192448,192000,-1000448,-1
1084,93,19,11,0.0790144435,0.920985556,331.4713035,374.2490396,605.5313653,396.311828,1177,22.11159121,2354,-555008,47616,-507392,-1
34,19,21,9,0.358490566,0.641509434,14.53703063,16.31612903,25.70588235,29.31578947,53,3.766879886,106,-17408,9728,-7680,-1
3729,271,18,12,0.06775,0.93225,1140.739729,1330.596154,1996.170823,2060.070111,4000,129.6596434,8000,-1909248,138752,-1770496,-1
4805,277,27,3,0.0545061,0.9454939,1448.609397,1727.556748,2559.251613,2233.570397,5082,320.8333333,10164,-2460160,141824,-2318336,-1
290,86,20,10,0.228723404,0.771276596,105.5487323,108.3110418,200.7448276,147.2093023,376,21.77185871,752,-148480,44032,-104448,-1
9559,412,20,10,0.0413198275,0.958680173,2868.503587,3032.854389,5012.813788,4363.881068,9971,1018.488253,19942,-4894208,210944,-4683264,-1
4746,302,20,10,0.0598256735,0.940174326,1438.641439,1657.556634,2553.576064,2067.562914,5048,307.6173065,10096,-2429952,154624,-2275328,-1
1504,148,19,11,0.0895883777,0.910411622,466.7324552,523.379545,847.6861702,611.2027027,1652,85.77362409,3304,-770048,75776,-694272,-1
46,14,23,7,0.233333333,0.766666667,16.57377389,19.33116338,31.30434783,27.85714286,60,2.349256069,120,-23552,7168,-16384,-1
44,14,20,10,0.24137931,0.75862069,16.80901163,14.20189697,31.84090909,22.14285714,58,11.81262729,116,-22528,7168,-15360,-1
425,107,20,10,0.20112782,0.79887218,148.0269139,173.8719605,266.48,266.5794393,532,58.91472868,1064,-217600,54784,-162816,-1
3352,315,17,13,0.0859012817,0.914098718,1055.632784,1083.182687,1844.40364,1723.292063,3667,73.85699899,7334,-1716224,161280,-1554944,-1
2473,199,24,6,0.0744760479,0.925523952,759.640754,802.5874726,1368.736757,935.8894472,2672,134.3388638,5344,-1266176,101888,-1164288,-1
6295,692,21,9,0.0990410763,0.900958924,2008.911094,2080.584336,3513.410008,3317.430636,6987,189.0422078,13974,-3223040,354304,-2868736,-1
9336,599,21,9,0.0602918973,0.939708103,2883.375805,2510.42123,5013.861504,4253.203673,9935,1145.905421,19870,-4780032,306688,-4473344,-1
6444,381,20,10,0.0558241758,0.944175824,1952.871672,2115.984103,3455.785382,2689.354331,6825,159.5371669,13650,-3299328,195072,-3104256,-1
1186,157,21,9,0.116902457,0.883097543,384.789642,408.9281698,671.6053963,674.9808917,1343,152.0951302,2686,-607232,80384,-526848,-1
3648,464,21,9,0.112840467,0.887159533,1184.449028,1203.533609,2067.68284,1968.579741,4112,120.8700764,8224,-1867776,237568,-1630208,-1
9444,518,19,11,0.0519975908,0.948002409,2878.792084,2595.423152,5040.440385,3906.918919,9962,417.6939203,19924,-4835328,265216,-4570112,-1
9389,569,21,9,0.0571399879,0.942860012,2845.791411,3243.55654,5019.613164,4317.59754,9958,489.0962672,19916,-4807168,291328,-4515840,-1
4264,257,20,10,0.0568458306,0.943154169,1289.455532,1541.202277,2263.226548,2224.058366,4521,275.8389262,9042,-2183168,131584,-2051584,-1
145,17,19,11,0.104938272,0.895061728,44.26050115,56.44159795,84.91034483,52.41176471,162,6.28394104,324,-74240,8704,-65536,-1
9556,424,21,9,0.0424849699,0.95751503,2863.627114,3161.169317,5022.799812,4262.535377,9980,479.5771264,19960,-4892672,217088,-4675584,-1
8654,683,20,10,0.073149834,0.926850166,2666.356678,3036.486136,4659.673561,4787.171303,9337,172.9074074,18674,-4430848,349696,-4081152,-1
1309,62,21,9,0.0452224654,0.954777535,390.8090174,456.195467,694.144385,514.0483871,1371,61.5902965,2742,-670208,31744,-638464,-1
2528,354,19,11,0.122831367,0.877168633,809.0445715,973.3887841,1426.411392,1549.251412,2882,103.5945363,5764,-1294336,181248,-1113088,-1
3846,453,19,11,0.105373343,0.894626657,1210.908877,1467.421181,2137.056942,2259.887417,4299,109.0839888,8598,-1969152,231936,-1737216,-1
5331,224,23,7,0.0403240324,0.959675968,1592.546537,1846.628658,2776.398237,2816.120536,5555,420.8333333,11110,-2729472,114688,-2614784,-1
4389,1318,22,8,0.230944454,0.769055546,1570.875465,1259.550091,2486.391661,4078.152504,5707,121.2707182,11414,-2247168,674816,-1572352,-1
1549,202,20,10,0.11536265,0.88463735,504.9307337,508.0507637,871.1504196,913.1881188,1751,38.66195628,3502,-793088,103424,-689664,-1
4724,397,20,10,0.0775239211,0.922476079,1450.228678,1778.699392,2561.280059,2557.667506,5121,251.1525257,10242,-2418688,203264,-2215424,-1
4054,497,16,14,0.109206768,0.890793232,1287.867384,1461.505888,2232.790824,2628.454728,4551,101.290897,9102,-2075648,254464,-1821184,-1
1973,122,25,5,0.0582338902,0.94176611,598.1470055,593.8325585,1070.615813,682.2540984,2095,137.4671916,4190,-1010176,62464,-947712,-1
2092,224,27,3,0.0967184801,0.90328152,674.4744893,610.5749389,1157.274379,1169.946429,2316,59.61389961,4632,-1071104,114688,-956416,-1
9512,459,20,10,0.0460334971,0.953966503,2868.764354,2901.316478,5033.42767,4003.141612,9971,619.3167702,19942,-4870144,235008,-4635136,-1
1903,165,17,13,0.079787234,0.920212766,578.3533111,776.1061314,1041.226484,956.9212121,2068,169.5081967,4136,-974336,84480,-889856,-1
2404,145,21,9,0.056885053,0.943114947,726.5777737,869.0978326,1268.993344,1374.586207,2549,75.99880739,5098,-1230848,74240,-1156608,-1
4778,337,25,5,0.065884653,0.934115347,1459.40286,1680.608803,2576.108414,2301.25816,5115,165.802269,10230,-2446336,172544,-2273792,-1
9395,554,21,9,0.0556839883,0.944316012,2864.168873,2998.599195,4966.587227,5117.66787,9949,577.4230992,19898,-4810240,283648,-4526592,-1
4016,576,22,8,0.12543554,0.87456446,1296.61412,1511.885476,2291.708665,2329.90625,4592,106.5429234,9184,-2056192,294912,-1761280,-1
7514,840,21,9,0.100550634,0.899449366,2351.108687,2837.137249,4239.614054,3621.875,8354,198.715509,16708,-3847168,430080,-3417088,-1
4042,285,21,9,0.0658654957,0.934134504,1227.656753,1505.76574,2149.377041,2371.389474,4327,322.4292101,8654,-2069504,145920,-1923584,-1
9563,411,27,3,0.0412071386,0.958792861,2862.900606,3057.494834,5032.147966,3948.647202,9974,668.0509042,19948,-4896256,210432,-4685824,-1
1124,95,23,7,0.0779327317,0.922067268,348.8737725,382.1444173,614.3282918,558.7894737,1219,132.3561346,2438,-575488,48640,-526848,-1
49,26,20,10,0.346666667,0.653333333,20.92064696,22.9194628,37.42857143,39.07692308,75,17.24137931,150,-25088,13312,-11776,-1
1279,158,21,9,0.109951287,0.890048713,411.8919611,393.3775997,741.4089132,537.6012658,1437,28.81491879,2874,-654848,80896,-573952,-1
7648,652,20,10,0.0785542169,0.921445783,2357.130272,2811.603519,4155.044456,4097.193252,8300,257.1251549,16600,-3915776,333824,-3581952,-1
991,73,19,11,0.0686090226,0.931390977,301.4676762,368.5681672,537.7477296,461.260274,1064,88.51913478,2128,-507392,37376,-470016,-1
2407,231,20,10,0.0875663381,0.912433662,757.0406378,806.7042469,1320.440382,1309.701299,2638,121.9602404,5276,-1232384,118272,-1114112,-1
524,44,19,11,0.0774647887,0.922535211,158.4239811,166.5789637,296.0248092,147.25,568,96.27118644,1136,-268288,22528,-245760,-1
9365,578,22,8,0.0581313487,0.941868651,2851.667821,3047.579864,5021.31906,4172.911765,9943,991.3260219,19886,-4794880,295936,-4498944,-1
2710,207,21,9,0.0709633185,0.929036682,833.0939361,826.3434608,1493.765683,1003.855072,2917,62.82575921,5834,-1387520,105984,-1281536,-1
8053,1614,21,9,0.16695976,0.83304024,2541.685458,2615.930612,4330.78182,7344.790582,9667,320.5238727,19334,-4123136,826368,-3296768,-1
3345,302,16,14,0.0828077872,0.917192213,1053.889566,1029.282394,1837.253513,1677.201987,3647,85.65054016,7294,-1712640,154624,-1558016,-1
41,12,20,10,0.226415094,0.773584906,15.44131683,12.97513648,28.82926829,20.75,53,9.532374101,106,-20992,6144,-14848,-1
457,70,23,7,0.132827324,0.867172676,144.0171009,196.0792218,261.1991247,282.2857143,527,13.80303824,1054,-233984,35840,-198144,-1
9207,734,22,8,0.0738356302,0.92616437,2840.41207,3066.437994,5045.044423,4042.216621,9941,489.4633186,19882,-4713984,375808,-4338176,-1
9244,696,17,13,0.0700201207,0.929979879,2858.398795,3010.017623,4962.32183,5079.119253,9940,328.1611093,19880,-4732928,356352,-4376576,-1
658,60,27,3,0.0835654596,0.91643454,206.9951921,206.7504105,356.168693,396.0333333,718,116.5584416,1436,-336896,30720,-306176,-1
7516,379,20,10,0.0480050665,0.951994934,2253.934693,2498.613634,4002.177222,2873.604222,7895,183.989746,15790,-3848192,194048,-3654144,-1
8439,389,21,9,0.0440643407,0.955935659,2541.532182,2630.575487,4440.606825,3848.136247,8828,566.2604233,17656,-4320768,199168,-4121600,-1
1972,214,22,8,0.0978956999,0.9021043,617.8536969,676.8260976,1124.749493,805.5373832,2186,98.11490126,4372,-1009664,109568,-900096,-1
9385,557,18,12,0.0560249447,0.943975055,2841.262523,3311.262715,4960.157912,5162.605027,9942,831.270903,19884,-4805120,285184,-4519936,-1
8782,1103,25,5,0.111583207,0.888416793,2847.929782,2740.651355,4831.512412,5830.655485,9885,465.6146962,19770,-4496384,564736,-3931648,-1
206,41,17,13,0.165991903,0.834008097,68.17395812,70.46390007,132.7378641,80.09756098,247,24.40711462,494,-105472,20992,-84480,-1
37,14,20,10,0.274509804,0.725490196,13.80062564,16.80864695,26.59459459,24.42857143,51,0.94619666,102,-18944,7168,-11776,-1
9418,555,21,9,0.0556502557,0.944349744,2841.810584,2997.805723,5084.650032,3329.940541,9973,542.3056009,19946,-4822016,284160,-4537856,-1
3496,556,21,9,0.13721619,0.86278381,1141.071081,1274.259591,1967.294622,2398.769784,4052,159.7162002,8104,-1789952,284672,-1505280,-1
4407,2022,20,10,0.314512366,0.685487634,1765.049657,1535.864634,2705.010438,4326.535114,6429,165.4400412,12858,-2256384,1035264,-1221120,-1
37,16,18,12,0.301886792,0.698113208,15.53106644,14.06555522,28.59459459,23.3125,53,2.122547056,106,-18944,8192,-10752,-1
7543,409,20,10,0.0514336016,0.948566398,2276.085946,2314.860139,4042.280525,2763.339853,7952,186.0116959,15904,-3862016,209408,-3652608,-1
1771,168,16,14,0.0866425993,0.913357401,552.0478168,633.4622049,974.2529644,925.1666667,1939,144.5935869,3878,-906752,86016,-820736,-1
1284,187,27,3,0.127124405,0.872875595,434.060402,352.5726761,738.9649533,715.6417112,1471,54.40088757,2942,-657408,95744,-561664,-1
7735,569,21,9,0.0685211946,0.931478805,2357.444679,2700.667231,4224.189916,3177.945518,8304,197.573162,16608,-3960320,291328,-3668992,-1
6206,324,20,10,0.0496171516,0.950382848,1877.13776,1968.79124,3290.812278,2780.660494,6530,536.5653246,13060,-3177472,165888,-3011584,-1
1062,121,19,11,0.102282333,0.897717667,331.3266995,385.9832824,609.9774011,434.214876,1183,94.11296738,2366,-543744,61952,-481792,-1
9527,438,22,8,0.0439538384,0.956046162,2858.050066,3120.442627,5024.632728,4077.440639,9965,1415.482955,19930,-4877824,224256,-4653568,-1
9506,463,21,9,0.0464439763,0.953556024,2862.403239,2972.979837,5038.34515,3889.75378,9969,932.5537886,19938,-4867072,237056,-4630016,-1
1363,172,19,11,0.112052117,0.887947883,437.2306102,453.1144599,789.3044754,599.1744186,1535,50.77737347,3070,-697856,88064,-609792,-1
1016,95,21,9,0.0855085509,0.914491449,314.5779172,342.3327703,570.7972441,397.7473684,1111,45.0344548,2222,-520192,48640,-471552,-1
459,82,21,9,0.151571165,0.848428835,148.1071031,184.4037935,260.4335512,330.1463415,541,38.94888409,1082,-235008,41984,-193024,-1
9060,626,21,9,0.064629362,0.935370638,2740.56432,3414.76714,4791.380022,5597.824281,9686,191.460763,19372,-4638720,320512,-4318208,-1
9398,551,20,10,0.0553824505,0.94461755,2851.113876,3165.878425,5004.465844,4472.422868,9949,440.4161133,19898,-4811776,282112,-4529664,-1
9439,519,27,3,0.0521188994,0.947881101,2863.43163,2929.506605,5028.848501,4082.003854,9958,1384.979138,19916,-4832768,265728,-4567040,-1
3615,202,21,9,0.0529211423,0.947078858,1084.360424,1261.65036,1939.156846,1369.311881,3817,98.22439527,7634,-1850880,103424,-1747456,-1
2085,265,21,9,0.112765957,0.887234043,669.0689554,736.4584391,1190.933333,1054.071698,2350,85.76642336,4700,-1067520,135680,-931840,-1
7355,638,17,13,0.0798198424,0.920180158,2313.357016,2236.732182,4001.29327,3947.50627,7993,423.3580508,15986,-3765760,326656,-3439104,-1
1629,195,27,3,0.106907895,0.893092105,510.5024173,644.9497312,914.3087784,897.3897436,1824,44.67303453,3648,-834048,99840,-734208,-1
1265,162,22,8,0.113524877,0.886475123,406.7723602,449.2386526,710.3604743,742.4197531,1427,74.32291667,2854,-647680,82944,-564736,-1
6665,414,21,9,0.0584828366,0.941517163,2034.247964,2139.339242,3567.533083,3096.743961,7079,190.551817,14158,-3412480,211968,-3200512,-1
305,56,20,10,0.155124654,0.844875346,103.6671832,97.91512718,188.3344262,141.0535714,361,41.78240741,722,-156160,28672,-127488,-1
9626,357,19,11,0.0357607933,0.964239207,2873.62684,3061.504718,5008.584978,4544.809524,9983,1501.203008,19966,-4928512,182784,-4745728,-1
2377,261,20,10,0.0989385898,0.90106141,756.4162142,794.4586763,1334.010097,1187.35249,2638,66.56573303,5276,-1217024,133632,-1083392,-1
2771,195,20,10,0.0657451113,0.934254889,841.5060199,1041.683501,1487.057019,1432.953846,2966,165.9764969,5932,-1418752,99840,-1318912,-1
8977,482,27,3,0.0509567608,0.949043239,2693.97066,2912.545304,4815.495154,3137.697095,9459,625.5952381,18918,-4596224,246784,-4349440,-1
9396,560,21,9,0.056247489,0.943752511,2833.194173,3338.609311,5037.151341,3994.414286,9956,775.9937646,19912,-4810752,286720,-4524032,-1
461,113,19,11,0.196864111,0.803135889,159.2443913,189.4941604,289.7527115,278.3097345,574,65.37585421,1148,-236032,57856,-178176,-1
4830,286,20,10,0.0559030493,0.944096951,1460.523442,1722.84433,2567.307039,2409.765734,5116,139.7050792,10232,-2472960,146432,-2326528,-1
2559,317,19,11,0.110222531,0.889777469,808.5876312,980.11004,1452.800313,1323.059937,2876,80.94567971,5752,-1310208,162304,-1147904,-1
112,22,19,11,0.164179104,0.835820896,37.35327482,33.24974368,72.90178571,40,134,47.5177305,268,-57344,11264,-46080,-1
6437,476,22,8,0.068855779,0.931144221,1968.788008,2327.158267,3461.951841,3390.035714,6913,127.2175193,13826,-3295744,243712,-3052032,-1
9616,367,21,9,0.0367624962,0.963237504,2874.506634,3012.365635,5013.754992,4421.983651,9983,1135.722412,19966,-4923392,187904,-4735488,-1
3129,507,20,10,0.139438944,0.860561056,1046.230883,1064.91614,1802.356663,1918.130178,3636,91.88779378,7272,-1602048,259584,-1342464,-1
3544,171,25,5,0.0460296097,0.95397039,1067.984591,1119.055461,1872.520316,1557.064327,3715,233.5009428,7430,-1814528,87552,-1726976,-1
9391,555,21,9,0.0558013272,0.944198673,2860.847417,3036.527371,4982.316686,4824.315315,9946,1034.96358,19892,-4808192,284160,-4524032,-1
2672,167,18,12,0.0588235294,0.941176471,807.7218522,948.2301845,1437.197605,1144.838323,2839,320.0676437,5678,-1368064,85504,-1282560,-1
9405,571,20,10,0.0572373697,0.94276263,2893.221587,2618.435274,4964.690058,5380.676007,9976,535.193133,19952,-4815360,292352,-4523008,-1
1754,299,20,10,0.145640526,0.854359474,591.7545603,596.9165185,1032.334094,995.7090301,2053,72.23786066,4106,-898048,153088,-744960,-1
9219,722,20,10,0.0726285082,0.927371492,2851.323551,2973.472393,5035.771667,4143.950139,9941,294.7227987,19882,-4720128,369664,-4350464,-1
9487,483,21,9,0.048445336,0.951554664,2879.092002,2849.898053,4996.414989,4771.109731,9970,505.3218449,19940,-4857344,247296,-4610048,-1
9461,516,20,10,0.0517189536,0.948281046,2859.857439,3224.054425,4998.525209,4814.352713,9977,366.8014706,19954,-4844032,264192,-4579840,-1
3238,316,27,3,0.0889138998,0.9110861,1022.977956,1055.935008,1777.295244,1779.598101,3554,111.1667188,7108,-1657856,161792,-1496064,-1
5703,240,17,13,0.0403836446,0.959616355,1702.075127,1962.787105,2989.91373,2546.325,5943,750.3787879,11886,-2919936,122880,-2797056,-1
6020,634,17,13,0.095281034,0.904718966,1865.630282,2338.723001,3282.127076,3758.328076,6654,141.3639261,13308,-3082240,324608,-2757632,-1
9577,403,21,9,0.0403807615,0.959619238,2862.529205,3128.632543,5032.33027,3996.434243,9980,727.9358133,19960,-4903424,206336,-4697088,-1
668,63,24,6,0.0861833105,0.913816689,208.8894605,227.2344174,370.4041916,319.3015873,731,54.38988095,1462,-342016,32256,-309760,-1
868,86,18,12,0.0901467505,0.909853249,269.7376572,324.5474915,473.6682028,516.1744186,954,48.18181818,1908,-444416,44032,-400384,-1
9488,486,19,11,0.0487266894,0.951273311,2850.399532,3068.977329,5059.864987,3574.744856,9974,914.2071494,19948,-4857856,248832,-4609024,-1
77,22,23,7,0.222222222,0.777777778,28.12837113,29.95247613,50.74025974,47.40909091,99,16.83673469,198,-39424,11264,-28160,-1
1172,79,23,7,0.0631494804,0.93685052,353.1126388,397.2400719,641.6578498,393.7088608,1251,86.27586207,2502,-600064,40448,-559616,-1
1471,130,27,3,0.0811992505,0.91880075,453.2237215,550.3099895,796.0516655,856.9923077,1601,303.7950664,3202,-753152,66560,-686592,-1
1874,304,23,7,0.139577594,0.860422406,619.8354742,680.9517765,1087.962113,1098.980263,2178,64.70588235,4356,-959488,155648,-803840,-1
9446,521,22,8,0.0522724992,0.947727501,2850.74003,2990.192259,5061.582257,3577.393474,9967,513.4981968,19934,-4836352,266752,-4569600,-1
293,32,17,13,0.0984615385,0.901538462,90.03304124,87.25928944,172.0170648,80.4375,325,41.1913815,650,-150016,16384,-133632,-1
9398,548,20,10,0.0550975266,0.944902473,2852.420648,2949.443669,5040.182805,3829.914234,9946,747.8195489,19892,-4811776,280576,-4531200,-1
9529,444,22,8,0.0445202046,0.955479795,2869.889165,2858.299517,5037.662609,3899.693694,9973,879.4532628,19946,-4878848,227328,-4651520,-1
62,20,20,10,0.243902439,0.756097561,23.87327801,20.82180348,44.25806452,32.95,82,1.546586194,164,-31744,10240,-21504,-1
564,79,17,13,0.122861586,0.877138414,179.8499798,221.9566519,324.0265957,307.5316456,643,116.6969147,1286,-288768,40448,-248320,-1
48,14,22,8,0.225806452,0.774193548,18.05258523,17.0983052,32.25,28.92857143,62,7.515151515,124,-24576,7168,-17408,-1
3580,188,21,9,0.0498938429,0.950106157,1081.468382,1200.512617,1883.375978,1905.904255,3768,68.97309171,7536,-1832960,96256,-1736704,-1
2958,246,20,10,0.0767790262,0.923220974,926.6756692,855.6356902,1625.681204,1323.760163,3204,142.463317,6408,-1514496,125952,-1388544,-1
655,50,26,4,0.0709219858,0.929078014,202.2972508,216.4207716,355.3938931,321.64,705,51.83823529,1410,-335360,25600,-309760,-1
2901,308,22,8,0.0959800561,0.904019944,922.8171492,891.4461914,1640.710445,1268.649351,3209,114.6480886,6418,-1485312,157696,-1327616,-1
8187,323,25,5,0.0379553467,0.962044653,2436.817195,2755.620923,4292.178942,3325.80805,8510,1067.754078,17020,-4191744,165376,-4026368,-1
2016,186,21,9,0.0844686649,0.915531335,620.8095107,777.2955353,1105.59871,1057.075269,2202,168.8650307,4404,-1032192,95232,-936960,-1
119,33,17,13,0.217105263,0.782894737,42.39784867,41.96964227,82.6302521,54.39393939,152,32.68817204,304,-60928,16896,-44032,-1
7871,543,22,8,0.0645352983,0.935464702,2398.516656,2800.757055,4235.992504,3794.489871,8414,447.077577,16828,-4029952,278016,-3751936,-1
1423,104,27,3,0.0681074001,0.9318926,441.2742972,416.7473888,772.6380885,645.8076923,1527,39.18398768,3054,-728576,53248,-675328,-1
2785,209,19,11,0.0698062792,0.930193721,856.0521572,954.8492359,1508.756553,1347.502392,2994,209.6638655,5988,-1425920,107008,-1318912,-1
8736,498,21,9,0.0539311241,0.946068876,2652.152209,2882.885952,4604.922505,4838.136546,9234,358.880684,18468,-4472832,254976,-4217856,-1
7197,711,22,8,0.089908953,0.910091047,2280.553652,2259.278068,3911.026122,4394.558368,7908,191.4306463,15816,-3684864,364032,-3320832,-1
9414,547,21,9,0.0549141652,0.945085835,2854.031524,3009.497609,5046.08583,3860.857404,9961,815.1391162,19922,-4819968,280064,-4539904,-1
63,26,20,10,0.292134831,0.707865169,26.37586145,23.73373002,46.11111111,42.30769231,89,18.89596603,178,-32256,13312,-18944,-1
4675,366,20,10,0.0726046419,0.927395358,1428.51517,1720.101331,2492.566631,2884.185792,5041,186.7037037,10082,-2393600,187392,-2206208,-1
1159,97,19,11,0.0772292994,0.922770701,353.9242639,452.3970528,626.1354616,656.7525773,1256,99.92044551,2512,-593408,49664,-543744,-1
7336,561,22,8,0.0710396353,0.928960365,2263.146982,2278.043565,4022.291985,2990.586453,7897,217.6081565,15794,-3756032,287232,-3468800,-1
9307,616,20,10,0.0620780006,0.937921999,2852.599214,2833.250034,5032.456323,3897.491883,9923,528.3812567,19846,-4765184,315392,-4449792,-1
47,11,20,10,0.189655172,0.810344828,16.22183808,13.97281895,32.14893617,18.18181818,58,2.968270215,116,-24064,5632,-18432,-1
7278,436,21,9,0.0565206119,0.943479388,2197.519556,2526.265059,3907.631767,3020.667431,7714,283.6029412,15428,-3726336,223232,-3503104,-1
9251,683,22,8,0.0687537749,0.931246225,2862.167687,2931.842757,4950.451843,5198.41142,9934,620.4871955,19868,-4736512,349696,-4386816,-1
790,129,17,13,0.140369967,0.859630033,262.0501397,238.6608244,483.4012658,316.6899225,919,65.31627576,1838,-404480,66048,-338432,-1
7474,699,27,3,0.0855255108,0.914474489,2366.075654,2274.571958,4066.491437,4306.286123,8173,186.7260681,16346,-3826688,357888,-3468800,-1
6884,751,21,9,0.0983628029,0.901637197,2196.674022,2268.656789,3827.197705,3733.689747,7635,330.233564,15270,-3524608,384512,-3140096,-1
1307,109,22,8,0.0769774011,0.923022599,398.0267705,502.5106774,719.3810252,578.0275229,1416,221.25,2832,-669184,55808,-613376,-1
5781,435,25,5,0.069980695,0.930019305,1784.131137,1873.168673,3140.928732,2677.533333,6216,202.739726,12432,-2959872,222720,-2737152,-1
461,77,20,10,0.143122677,0.856877323,155.6720965,151.2785562,273.143167,247.6883117,538,21.0485133,1076,-236032,39424,-196608,-1
1871,81,20,10,0.0414959016,0.958504098,557.7874879,663.4912278,983.2148584,821.3950617,1952,78.3935743,3904,-957952,41472,-916480,-1
7002,419,21,9,0.0564613933,0.943538607,2132.59592,2156.701137,3757.068837,2941.133652,7421,497.7196512,14842,-3585024,214528,-3370496,-1
4032,302,22,8,0.0696815874,0.930318413,1228.637046,1457.860954,2198.507688,1753.516556,4334,117.6438654,8668,-2064384,154624,-1909760,-1
9387,570,21,9,0.0572461585,0.942753842,2870.803085,2790.979743,5031.955577,4106.905263,9957,375.5941154,19914,-4806144,291840,-4514304,-1
223,46,19,11,0.171003717,0.828996283,75.20399306,73.19199769,144.367713,89.58695652,269,24.14721724,538,-114176,23552,-90624,-1
6530,475,20,10,0.0678087081,0.932191292,1983.3228,2409.925581,3457.457121,4129.094737,7005,407.9790332,14010,-3343360,243200,-3100160,-1
2426,141,16,14,0.0549279314,0.945072069,726.7745301,953.4701192,1284.1723,1281.035461,2567,224.1921397,5134,-1242112,72192,-1169920,-1
9349,586,19,11,0.058983392,0.941016608,2867.053401,2804.747588,5008.524976,4321.467577,9935,994.4944945,19870,-4786688,300032,-4486656,-1
2685,389,17,13,0.126545218,0.873454782,871.9188376,970.2114586,1512.53892,1709.789203,3074,145.7562826,6148,-1374720,199168,-1175552,-1
3032,263,21,9,0.0798179059,0.920182094,936.7287172,1066.009066,1624.027375,1924.368821,3295,291.3351017,6590,-1552384,134656,-1417728,-1
2697,497,20,10,0.155604258,0.844395742,896.8970945,976.22277,1532.978124,1947.631791,3194,65.72016461,6388,-1380864,254464,-1126400,-1
6592,549,22,8,0.0768799888,0.923120011,2049.040249,2188.670975,3549.728459,3826.413479,7141,209.5978867,14282,-3375104,281088,-3094016,-1
277,32,25,5,0.103559871,0.896440129,85.99702042,97.35580283,161.3176895,100.3125,309,9.112356237,618,-141824,16384,-125440,-1
3497,449,21,9,0.113786113,0.886213887,1137.335472,1129.274449,2001.539319,1755.11804,3946,78.26259421,7892,-1790464,229888,-1560576,-1
767,105,17,13,0.120412844,0.879587156,247.486146,278.8539412,440.6831812,405.9428571,872,58.44504021,1744,-392704,53760,-338944,-1
266,34,27,3,0.113333333,0.886666667,86.92888034,83.92578386,150.0714286,153.8529412,300,30.92783505,600,-136192,17408,-118784,-1
6973,655,22,8,0.0858678553,0.914132145,2192.42404,2300.75859,3820.188154,3753.945038,7628,150.8105971,15256,-3570176,335360,-3234816,-1
2961,982,21,9,0.249048948,0.750951052,980.8228236,1024.590964,1650.466396,2941.51222,3943,76.90657304,7886,-1516032,502784,-1013248,-1
1642,257,21,9,0.135334387,0.864665613,539.7639421,589.0994678,965.9939099,847.8132296,1899,64.19878296,3798,-840704,131584,-709120,-1
6210,443,17,13,0.0665865023,0.933413498,1912.963182,1860.684475,3381.894525,2557.485327,6653,224.7635135,13306,-3179520,226816,-2952704,-1
800,49,22,8,0.0577149588,0.942285041,239.5378901,257.4426031,436.54125,236.5714286,849,122.6878613,1698,-409600,25088,-384512,-1
9301,636,20,10,0.0640032203,0.93599678,2819.279194,3503.407588,4953.571766,5194.625786,9937,294.9539923,19874,-4762112,325632,-4436480,-1
3973,431,19,11,0.0978655767,0.902134423,1253.196656,1412.600752,2181.207652,2398.774942,4404,235.7601713,8808,-2034176,220672,-1813504,-1
42,17,20,10,0.288135593,0.711864407,17.09908433,16.36372899,31.38095238,26.58823529,59,2.154070829,118,-21504,8704,-12800,-1
9566,411,20,10,0.0411947479,0.958805252,2865.388568,3130.684303,5017.61844,4322.907543,9977,981.0226155,19954,-4897792,210432,-4687360,-1
2292,227,20,10,0.090115125,0.909884875,712.5787898,842.6936424,1276.579407,1092.599119,2519,161.474359,5038,-1173504,116224,-1057280,-1
5204,412,18,12,0.0733618234,0.926638177,1589.592468,1960.462583,2828.185626,2559.849515,5616,181.453958,11232,-2664448,210944,-2453504,-1
8868,1044,22,8,0.105326877,0.894673123,2775.831198,3469.717468,4901.582657,5422.981801,9912,822.5726141,19824,-4540416,534528,-4005888,-1
2157,314,20,10,0.127074059,0.872925941,696.8648657,805.7923091,1254.690774,1107.605096,2471,50.5730659,4942,-1104384,160768,-943616,-1
7238,516,19,11,0.0665462987,0.933453701,2200.713207,2712.047256,3879.72147,3846.339147,7754,247.4944143,15508,-3705856,264192,-3441664,-1
118,33,27,3,0.218543046,0.781456954,42.16104676,48.25266375,75.23728814,78.72727273,151,10.42097999,302,-60416,16896,-43520,-1
8417,697,18,12,0.0764757516,0.923524248,2608.324966,2889.254506,4564.619817,4471.520803,9114,264.4038294,18228,-4309504,356864,-3952640,-1
5477,668,20,10,0.108706265,0.891293735,1778.973715,1726.258108,3088.970787,2942.053892,6145,116.7363222,12290,-2804224,342016,-2462208,-1
550,165,19,11,0.230769231,0.769230769,199.5004861,226.6492098,364.2854545,337.0484848,715,16.4556962,1430,-281600,84480,-197120,-1
2585,449,21,9,0.147989453,0.852010547,877.0425159,844.5611434,1484.767892,1705.946548,3034,104.368765,6068,-1323520,229888,-1093632,-1
2490,317,20,10,0.112931956,0.887068044,805.3216629,842.8928469,1415.658635,1312.422713,2807,102.2586521,5614,-1274880,162304,-1112576,-1
9410,541,27,3,0.0543663953,0.945633605,2851.717242,3090.78443,5025.337407,4117.839187,9951,1060.8742,19902,-4817920,276992,-4540928,-1
3104,397,22,8,0.113396173,0.886603827,990.8104883,1151.073605,1740.971649,1829.40806,3501,89.33401378,7002,-1589248,203264,-1385984,-1
9087,827,21,9,0.0834173896,0.91658261,2839.190031,2994.797468,4887.468692,5726.997582,9914,474.5811393,19828,-4652544,423424,-4229120,-1
6589,361,23,7,0.051942446,0.948057554,2008.718278,1935.032811,3492.626195,3162.911357,6950,210.4147744,13900,-3373568,184832,-3188736,-1
9176,749,20,10,0.075465995,0.924534005,2837.22537,3183.202487,4951.001199,5109.99733,9925,835.4377104,19850,-4698112,383488,-4314624,-1
9374,577,21,9,0.0579841222,0.942015878,2849.292949,3227.852994,4976.091103,4974.519931,9951,856.3683305,19902,-4799488,295424,-4504064,-1
797,69,22,8,0.0796766744,0.920323326,249.6888556,214.6427178,444.6976161,304.1594203,866,83.51012536,1732,-408064,35328,-372736,-1
6411,510,17,13,0.0736887733,0.926311227,1964.932192,2273.732754,3513.218219,2804.586275,6921,256.3333333,13842,-3282432,261120,-3021312,-1
3212,247,18,12,0.0714079214,0.928592079,995.6066317,1017.684319,1744.275529,1544.360324,3459,161.862424,6918,-1644544,126464,-1518080,-1
514,96,27,3,0.157377049,0.842622951,172.0143316,187.1152116,295.2198444,360.5416667,610,31.77083333,1220,-263168,49152,-214016,-1
58,17,23,7,0.226666667,0.773333333,22.52524677,17.44234199,39.46551724,33,75,2.25090036,150,-29696,8704,-20992,-1
319,28,17,13,0.0806916427,0.919308357,96.21606159,94.49724648,182.3949843,78.35714286,347,86.96741855,694,-163328,14336,-148992,-1
9488,492,20,10,0.0492985972,0.950701403,2874.937498,2933.721755,5020.995573,4402.406504,9980,265.0026553,19960,-4857856,251904,-4605952,-1
8667,389,19,11,0.042954947,0.957045053,2598.225733,2848.448298,4561.958348,3783.041131,9056,373.1355583,18112,-4437504,199168,-4238336,-1
1496,139,27,3,0.0850152905,0.914984709,463.0289784,529.9796041,833.8997326,646.8776978,1635,38.45249294,3270,-765952,71168,-694784,-1
9482,494,23,7,0.0495188452,0.950481155,2865.379772,3144.133269,4987.305421,5011.42915,9976,507.4262462,19952,-4854784,252928,-4601856,-1
3398,350,27,3,0.0933831377,0.906616862,1067.965909,1201.01681,1888.42525,1739.305714,3748,70.14785701,7496,-1739776,179200,-1560576,-1
7099,902,20,10,0.112735908,0.887264092,2307.744743,2172.195727,3901.805606,4781.68847,8001,166.8613139,16002,-3634688,461824,-3172864,-1
2112,253,20,10,0.106976744,0.893023256,657.9893106,765.3542539,1138.133523,1557.537549,2365,131.8283166,4730,-1081344,129536,-951808,-1
2130,339,18,12,0.137302552,0.862697448,707.5245487,736.618752,1251.139906,1133.589971,2469,100.6522625,4938,-1090560,173568,-916992,-1
9324,597,20,10,0.0601753855,0.939824614,2833.840301,3125.302995,5026.50665,3937.911223,9921,629.9047619,19842,-4773888,305664,-4468224,-1
2808,269,21,9,0.0874228144,0.912577186,869.8723231,1052.356232,1551.573718,1407.747212,3077,239.8285269,6154,-1437696,137728,-1299968,-1
656,81,17,13,0.10990502,0.89009498,211.3482839,176.5655567,385.0213415,239.2469136,737,72.32580962,1474,-335872,41472,-294400,-1
1042,72,18,12,0.0646319569,0.935368043,313.7916019,361.5313855,571.5758157,353.7916667,1114,48.83822885,2228,-533504,36864,-496640,-1
4545,370,20,10,0.0752797558,0.924720244,1412.071636,1494.864445,2448.808141,2570.910811,4915,117.8939794,9830,-2327040,189440,-2137600,-1
335,41,20,10,0.109042553,0.890957447,104.0102714,117.7021367,197.2955224,116.6341463,376,31.22923588,752,-171520,20992,-150528,-1
9511,457,22,8,0.0458467095,0.954153291,2859.780239,3013.787758,5038.314268,3864.527352,9968,713.018598,19936,-4869632,233984,-4635648,-1
101,34,22,8,0.251851852,0.748148148,39.53101698,36.19799694,70.56435644,60.38235294,135,30.20134228,270,-51712,17408,-34304,-1
1479,302,27,3,0.169567659,0.830432341,502.9962651,550.7831976,867.1494253,1007.804636,1781,38.96302778,3562,-757248,154624,-602624,-1
7855,362,27,3,0.0440550079,0.955944992,2355.47385,2544.670608,4150.566391,3207.055249,8217,302.9867257,16434,-4021760,185344,-3836416,-1
5059,309,20,10,0.0575633383,0.942436662,1539.917934,1487.695235,2733.331291,1885.02589,5368,349.7068404,10736,-2590208,158208,-2432000,-1
3181,442,22,8,0.121998344,0.878001656,1030.190248,1135.449106,1786.330399,1996.739819,3623,155.0941781,7246,-1628672,226304,-1402368,-1
8498,645,19,11,0.0705457727,0.929454227,2605.071407,3046.89878,4555.377501,4791.004651,9143,315.9295093,18286,-4350976,330240,-4020736,-1
4906,383,22,8,0.0724144451,0.927585555,1500.613046,1822.670155,2633.202201,2796.122715,5289,255.6307395,10578,-2511872,196096,-2315776,-1
6609,619,21,9,0.085639181,0.914360819,2068.801776,2266.887603,3610.460433,3657.630048,7228,220.9721798,14456,-3383808,316928,-3066880,-1
937,46,21,9,0.0467955239,0.953204476,279.0684648,364.7544873,490.2379936,527.8913043,983,100.3061224,1966,-479744,23552,-456192,-1
353,61,17,13,0.147342995,0.852657005,116.991444,96.20957707,222.1898017,122.4918033,414,48.64864865,828,-180736,31232,-149504,-1
7480,809,21,9,0.0975992279,0.902400772,2352.762072,2733.450241,4133.800401,4248.551298,8289,305.4163596,16578,-3829760,414208,-3415552,-1
419,37,21,9,0.0811403509,0.918859649,127.9006715,163.6696596,231.797136,191.1621622,456,44.27184466,912,-214528,18944,-195584,-1
5070,529,21,9,0.0944811573,0.905518843,1597.001663,1790.65294,2800.630966,2793.952741,5599,178.4257489,11198,-2595840,270848,-2324992,-1
4743,371,20,10,0.0725459523,0.927454048,1443.18891,1733.514838,2509.289268,3173.843666,5114,98.51666346,10228,-2428416,189952,-2238464,-1
7505,424,21,9,0.053474587,0.946525413,2283.668109,2345.168219,3987.2004,3572.042453,7929,469.7274882,15858,-3842560,217088,-3625472,-1
3697,436,20,10,0.105492378,0.894507622,1167.043541,1371.446878,2095.205843,1827.832569,4133,281.7314247,8266,-1892864,223232,-1669632,-1
6475,386,18,12,0.0562600204,0.94373998,1956.341871,2274.120994,3465.416834,2853.670984,6861,566.5565648,13722,-3315200,197632,-3117568,-1
9504,470,19,11,0.0471225185,0.952877481,2854.193937,3201.116554,5034.485795,4037.387234,9974,660.0926539,19948,-4866048,240640,-4625408,-1
6952,987,18,12,0.124322963,0.875677037,2199.462849,2525.221712,3791.936853,5224.199595,7939,151.65234,15878,-3559424,505344,-3054080,-1
2545,309,22,8,0.108269096,0.891730904,799.6655688,998.6611035,1435.790963,1359.213592,2854,74.45864858,5708,-1303040,158208,-1144832,-1
4242,373,22,8,0.080823402,0.919176598,1308.227082,1540.281776,2337.606789,1971.292225,4615,185.2669611,9230,-2171904,190976,-1980928,-1
48,15,21,9,0.238095238,0.761904762,18.09349513,17.61009811,33.52083333,27.13333333,63,9.117221418,126,-24576,7680,-16896,-1
9494,472,21,9,0.0473610275,0.952638973,2873.25508,2950.006638,4983.643564,4980.612288,9966,1403.661972,19932,-4860928,241664,-4619264,-1
5805,566,21,9,0.0888400565,0.911159943,1821.402469,2011.842337,3182.731438,3219.522968,6371,117.8069527,12742,-2972160,289792,-2682368,-1
9652,335,18,12,0.0335436067,0.966456393,2875.760806,3046.405625,5010.434314,4520.495522,9987,977.2015656,19974,-4941824,171520,-4770304,-1
6814,416,27,3,0.057538036,0.942461964,2080.908554,2183.392947,3622.262107,3504.737981,7230,267.8769915,14460,-3488768,212992,-3275776,-1
5827,425,21,9,0.067978247,0.932021753,1763.887088,2286.478005,3138.893084,2956.583529,6252,117.3643702,12504,-2983424,217600,-2765824,-1
6599,343,20,10,0.0494093921,0.950590608,1986.902669,2081.008344,3522.095469,2498.090379,6942,345.2013923,13884,-3378688,175616,-3203072,-1
5464,215,27,3,0.037858778,0.962141222,1629.155111,1784.369994,2862.946559,2256.837209,5679,364.0384615,11358,-2797568,110080,-2687488,-1
5395,382,21,9,0.066124286,0.933875714,1650.883479,1825.856973,2922.130491,2421.096859,5777,209.6914701,11554,-2762240,195584,-2566656,-1
7044,539,19,11,0.0710800475,0.928919953,2168.543821,2437.286579,3801.818995,3663.679035,7583,600.3958828,15166,-3606528,275968,-3330560,-1
4132,541,19,11,0.115771453,0.884228547,1325.881764,1431.04107,2276.21757,2801.238447,4673,154.3772712,9346,-2115584,276992,-1838592,-1
3875,254,20,10,0.0615161056,0.938483894,1178.034118,1324.368461,2091.146065,1666.11811,4129,159.6674401,8258,-1984000,130048,-1853952,-1
67,14,20,10,0.172839506,0.827160494,23.09192069,18.82139469,44.04477612,26.42857143,81,11.87683284,162,-34304,7168,-27136,-1
64,22,18,12,0.255813953,0.744186047,24.81555003,22.65027867,46.53125,34.68181818,86,15.83793738,172,-32768,11264,-21504,-1
8087,579,17,13,0.0668128318,0.933187168,2463.028537,2978.013957,4315.404971,4586.236615,8666,215.0905932,17332,-4140544,296448,-3844096,-1
7302,479,22,8,0.0615602108,0.938439789,2223.852904,2357.676029,3827.192824,4863.693111,7781,220.9883556,15562,-3738624,245248,-3493376,-1
537,96,21,9,0.151658768,0.848341232,181.7101096,188.0153646,318.8212291,306.8125,633,45.70397112,1266,-274944,49152,-225792,-1
6979,939,22,8,0.118590553,0.881409447,2268.658579,2327.082025,3880.90844,4543.621938,7918,153.0048309,15836,-3573248,480768,-3092480,-1
9381,582,22,8,0.0584161397,0.94158386,2867.838882,2921.791379,5024.441211,4297.908935,9963,382.8977709,19926,-4803072,297984,-4505088,-1
4122,319,16,14,0.0718306688,0.928169331,1279.589546,1312.728043,2219.757642,2237.053292,4441,122.679558,8882,-2110464,163328,-1947136,-1
9385,568,21,9,0.0570682206,0.942931779,2845.017241,2995.069134,5058.981993,3622.420775,9953,784.3183609,19906,-4805120,290816,-4514304,-1
39,20,19,11,0.338983051,0.661016949,17.65797486,15.4970965,31.12820513,27.8,59,6.965761511,118,-19968,10240,-9728,-1
9602,376,27,3,0.0376829024,0.962317098,2868.398992,3085.875149,5017.623412,4271.305851,9978,1525.688073,19956,-4916224,192512,-4723712,-1
8792,1014,21,9,0.103406078,0.896593922,2764.264982,3040.921921,4749.399568,6239.64497,9806,190.5187488,19612,-4501504,519168,-3982336,-1
78,24,19,11,0.235294118,0.764705882,29.78160976,16.69580786,57.65384615,31.5,102,20.4,204,-39936,12288,-27648,-1
5737,386,20,10,0.063040993,0.936959007,1730.796831,2024.150788,3125.091511,2124.290155,6123,547.1849866,12246,-2937344,197632,-2739712,-1
148,50,20,10,0.252525253,0.747474747,54.87467751,60.37596873,105.1824324,82.68,198,18.8034188,396,-75776,25600,-50176,-1
9624,358,26,4,0.0358645562,0.964135444,2873.56734,3041.224501,5011.174252,4462.603352,9982,616.1728395,19964,-4927488,183296,-4744192,-1
9595,390,19,11,0.0390585879,0.960941412,2855.569214,3257.915187,5041.554977,3798.423077,9985,329.8645524,19970,-4912640,199680,-4712960,-1
2594,297,19,11,0.102732618,0.897267382,818.4681999,959.7181578,1455.550116,1362.589226,2891,160.6111111,5782,-1328128,152064,-1176064,-1
9532,440,20,10,0.0441235459,0.955876454,2871.491817,2956.173077,5016.495909,4336.679545,9972,811.3913751,19944,-4880384,225280,-4655104,-1
2807,156,21,9,0.0526493419,0.947350658,846.1650928,988.3001808,1492.250802,1297.551282,2963,234.7860539,5926,-1437184,79872,-1357312,-1
9238,709,19,11,0.0712777722,0.928722228,2875.587258,2623.098926,5049.965469,3984.198872,9947,561.3431151,19894,-4729856,363008,-4366848,-1
540,95,17,13,0.149606299,0.850393701,176.8579328,203.807565,329.7777778,251.0526316,635,53.76799323,1270,-276480,48640,-227840,-1
2818,312,17,13,0.0996805112,0.900319489,881.0548431,1085.652391,1567.625976,1546.298077,3130,215.862069,6260,-1442816,159744,-1283072,-1
76,20,20,10,0.208333333,0.791666667,25.6502789,33.03524633,50.77631579,39.85,96,8.046940486,192,-38912,10240,-28672,-1
2689,190,20,10,0.0659951372,0.934004863,809.5918808,1063.728951,1423.480848,1673.789474,2879,181.5258512,5758,-1376768,97280,-1279488,-1
3802,267,27,3,0.065618088,0.934381912,1169.470864,1229.546331,2021.459232,2227.816479,4069,224.9309011,8138,-1946624,136704,-1809920,-1
1730,128,21,9,0.0688912809,0.931108719,526.1940624,653.384412,923.6393064,1008.710938,1858,34.87891872,3716,-885760,65536,-820224,-1
9430,529,20,10,0.0531177829,0.946882217,2846.664465,2982.270767,5061.92895,3519.52741,9959,851.1965812,19918,-4828160,270848,-4557312,-1
3046,288,17,13,0.0863827235,0.913617277,931.8178169,1165.328039,1706.040381,1259.881944,3334,443.3510638,6668,-1559552,147456,-1412096,-1
3260,354,27,3,0.0979524073,0.902047593,1033.781325,1115.102032,1824.28773,1652.90113,3614,137.8337147,7228,-1669120,181248,-1487872,-1
6175,311,18,12,0.0479494295,0.95205057,1860.004917,1987.427172,3277.205992,2574.257235,6486,433.5561497,12972,-3161600,159232,-3002368,-1
9110,409,21,9,0.0429666982,0.957033302,2736.495012,2989.700791,4763.310099,4686.271394,9519,433.0755232,19038,-4664320,209408,-4454912,-1
1041,70,17,13,0.0630063006,0.936993699,314.2838502,328.4335391,571.3688761,327.4428571,1111,147.1523179,2222,-532992,35840,-497152,-1
1755,141,20,10,0.0743670886,0.925632911,540.9788212,620.5096221,946.7019943,970.8794326,1896,62.08251473,3792,-898560,72192,-826368,-1
395,28,22,8,0.0661938534,0.933806147,119.664789,128.2787741,217.6455696,132.3571429,423,11.72719712,846,-202240,14336,-187904,-1
4922,317,21,9,0.0605077305,0.93949227,1501.847151,1666.46374,2616.820805,2669.362776,5239,144.8437932,10478,-2520064,162304,-2357760,-1
1403,74,27,3,0.0501015572,0.949898443,422.3043388,453.8054397,749.4497505,540.8783784,1477,110.1416853,2954,-718336,37888,-680448,-1
3008,189,21,9,0.0591179231,0.940882077,914.0965197,1045.632595,1606.613032,1477.835979,3197,123.4839706,6394,-1540096,96768,-1443328,-1
7431,373,21,9,0.0477960021,0.952203998,2231.443293,2621.276837,3885.969587,4231.823056,7804,282.3444284,15608,-3804672,190976,-3613696,-1
8184,382,22,8,0.0445949101,0.95540509,2473.553737,2420.20052,4302.668377,3872.835079,8566,576.8350168,17132,-4190208,195584,-3994624,-1
490,39,27,3,0.0737240076,0.926275992,151.9688066,134.0053921,271.9346939,177.8717949,529,65.55142503,1058,-250880,19968,-230912,-1
8126,500,23,7,0.057964294,0.942035706,2483.725073,2394.240699,4372.757199,3350.452,8626,693.4083601,17252,-4160512,256000,-3904512,-1
2424,187,23,7,0.0716200689,0.928379931,746.573909,838.0736428,1311.217409,1238.368984,2611,344.4591029,5222,-1241088,95744,-1145344,-1
5650,919,21,9,0.139899528,0.860100472,1755.635766,2296.670773,3101.506549,4413.115343,6569,120.6427916,13138,-2892800,470528,-2422272,-1
3934,398,21,9,0.0918744229,0.908125577,1237.619737,1371.458239,2169.107524,2140.726131,4332,252.8896673,8664,-2014208,203776,-1810432,-1
430,99,16,14,0.187145558,0.812854442,145.0749666,155.6433184,284.6581395,179.6161616,529,48.75576037,1058,-220160,50688,-169472,-1
104,23,20,10,0.181102362,0.818897638,34.8039615,43.88255506,64.85576923,60.13043478,127,6.482899438,254,-53248,11776,-41472,-1
5495,1531,22,8,0.217904925,0.782095075,1812.455392,2011.967178,3083.879891,5055.4742,7026,129.012119,14052,-2813440,783872,-2029568,-1
9552,418,21,9,0.0419257773,0.958074223,2872.715647,2950.749973,5008.282245,4464.88756,9970,705.0919378,19940,-4890624,214016,-4676608,-1
1303,126,16,14,0.0881735479,0.911826452,406.4049155,354.5432028,743.6438987,418.7857143,1429,91.48527529,2858,-667136,64512,-602624,-1
5883,598,21,9,0.0922697115,0.907730289,1836.84296,2170.836249,3257.81455,3075.58194,6481,165.0369239,12962,-3012096,306176,-2705920,-1
3762,205,18,12,0.0516763297,0.94832367,1132.943102,1347.900761,1988.08453,1909.043902,3967,151.4700267,7934,-1926144,104960,-1821184,-1
7967,521,20,10,0.0613807729,0.938619227,2430.921594,2729.128592,4245.490021,4229.360845,8488,279.2105263,16976,-4079104,266752,-3812352,-1
2208,384,21,9,0.148148148,0.851851852,747.218308,733.9277856,1324.328804,1136.484375,2592,66.71814672,5184,-1130496,196608,-933888,-1
5217,294,16,14,0.0533478498,0.94665215,1574.149804,1857.898416,2763.607054,2621.013605,5511,240.7601573,11022,-2671104,150528,-2520576,-1
9128,654,25,5,0.0668574934,0.933142507,2797.419384,3105.016473,4847.500548,5505.608563,9782,351.4911966,19564,-4673536,334848,-4338688,-1
412,46,20,10,0.100436681,0.899563319,127.2092534,162.522328,234.9951456,180.2826087,458,12.80760626,916,-210944,23552,-187392,-1
2648,219,21,9,0.0763864667,0.923613533,819.0373092,921.3372654,1440.756798,1352.30137,2867,109.5529232,5734,-1355776,112128,-1243648,-1
3438,182,27,3,0.0502762431,0.949723757,1039.614101,1114.875196,1823.276323,1569.153846,3620,96.32783395,7240,-1760256,93184,-1667072,-1
32,20,17,13,0.384615385,0.615384615,14.51827378,15.73173544,26.96875,25.75,52,15.95092025,104,-16384,10240,-6144,-1
3205,416,22,8,0.114885391,0.885114609,1030.215248,1151.71966,1821.413105,1730.774038,3621,111.587057,7242,-1640960,212992,-1427968,-1
5844,398,17,13,0.0637616149,0.936238385,1779.230359,2091.893513,3138.098049,2877.78392,6242,143.7586366,12484,-2992128,203776,-2788352,-1
58,16,23,7,0.216216216,0.783783784,22.12202673,17.00723651,39.17241379,31.4375,74,2.222222222,148,-29696,8192,-21504,-1
3437,310,21,9,0.0827328529,0.917267147,1047.479618,1260.689119,1820.215595,2470.312903,3747,76.08121827,7494,-1759744,158720,-1601024,-1
1633,157,19,11,0.0877094972,0.912290503,512.9559652,549.8470338,902.044703,827.4267516,1790,128.0400572,3580,-836096,80384,-755712,-1
4812,438,19,11,0.0834285714,0.916571429,1488.427597,1589.717296,2554.458645,3405.981735,5250,124.2897727,10500,-2463744,224256,-2239488,-1
1155,151,20,10,0.115620214,0.884379786,361.721668,474.9036898,660.2207792,602.0927152,1306,136.7539267,2612,-591360,77312,-514048,-1
823,145,22,8,0.149793388,0.850206612,273.9381084,302.4169153,494.6476306,426.9034483,968,77.25458899,1936,-421376,74240,-347136,-1
7970,450,21,9,0.0534441805,0.946555819,2398.642069,2624.085522,4283.364492,2919.988889,8420,296.6878083,16840,-4080640,230400,-3850240,-1
335,25,18,12,0.0694444444,0.930555556,100.9263097,119.9894395,185.3970149,114.88,360,90.45226131,720,-171520,12800,-158720,-1
1064,111,18,12,0.0944680851,0.905531915,334.2356731,376.2333345,595.3637218,517.4144144,1175,39.69594595,2350,-544768,56832,-487936,-1
4979,331,17,13,0.0623352166,0.937664783,1520.889947,1576.395611,2696.956417,2031.900302,5310,173.4727213,10620,-2549248,169472,-2379776,-1
2834,238,25,5,0.0774739583,0.922526042,870.6618044,991.0899868,1566.907198,1174.42437,3072,80.50314465,6144,-1451008,121856,-1329152,-1
201,23,19,11,0.102678571,0.897321429,61.84034173,47.29455621,120.2139303,45.08695652,224,22.42242242,448,-102912,11776,-91136,-1
695,41,19,11,0.0557065217,0.944293478,209.7979646,242.2586707,372.7669065,296.1707317,736,18.52038249,1472,-355840,20992,-334848,-1
368,84,17,13,0.185840708,0.814159292,127.7410077,134.4186963,235.8396739,185.5833333,452,20.93561834,904,-188416,43008,-145408,-1
3254,150,19,11,0.0440658049,0.955934195,971.6674492,1173.633505,1712.95421,1475.713333,3404,234.1127923,6808,-1666048,76800,-1589248,-1
8219,1662,21,9,0.168201599,0.831798401,2810.793912,2884.37357,4758.264509,5844.672082,9881,437.5996457,19762,-4208128,850944,-3357184,-1
356,27,20,10,0.0704960836,0.929503916,107.0781752,107.4382331,199.5561798,92.37037037,383,72.40075614,766,-182272,13824,-168448,-1
8752,828,20,10,0.0864300626,0.913569937,2733.524964,2943.967874,4707.618716,5666.559179,9580,227.986673,19160,-4481024,423936,-4057088,-1
9551,429,19,11,0.0429859719,0.957014028,2855.949433,3114.924208,5049.354308,3680.202797,9980,941.509434,19960,-4890112,219648,-4670464,-1
1283,106,19,11,0.0763138949,0.923686105,391.9282254,493.2190552,700.1964147,632.1037736,1389,245.4063604,2778,-656896,54272,-602624,-1
9617,361,19,11,0.0361795951,0.963820405,2862.989559,3212.274207,5019.026308,4202.922438,9978,1128.733032,19956,-4923904,184832,-4739072,-1
5357,267,21,9,0.0474751067,0.952524893,1617.976935,1727.177946,2817.920478,2703.745318,5624,105.0625817,11248,-2742784,136704,-2606080,-1
9453,520,20,10,0.0521407801,0.94785922,2846.762867,3118.840504,5061.058606,3640.7,9973,527.951297,19946,-4839936,266240,-4573696,-1
595,157,20,10,0.208776596,0.791223404,213.105309,230.5328821,381.5647059,357.3057325,752,58.70413739,1504,-304640,80384,-224256,-1
5567,385,18,12,0.0646841398,0.93531586,1701.809092,1901.889311,2951.005209,3345.148052,5952,176.3555556,11904,-2850304,197120,-2653184,-1
4405,704,20,10,0.137796046,0.862203954,1430.534843,1609.647161,2462.366402,3134.617898,5109,94.34903047,10218,-2255360,360448,-1894912,-1
9486,477,21,9,0.0478771454,0.952122855,2859.377882,3143.305755,5008.665402,4451.710692,9963,1116.928251,19926,-4856832,244224,-4612608,-1
9650,335,22,8,0.0335503255,0.966449675,2870.952084,3135.432675,5013.988083,4388.41791,9985,1110.678532,19970,-4940800,171520,-4769280,-1
3905,291,22,8,0.0693517636,0.930648236,1192.65228,1266.081207,2147.53137,1440.536082,4196,373.6420303,8392,-1999360,148992,-1850368,-1
5477,532,22,8,0.0885338659,0.911466134,1722.557743,1854.548975,3005.223297,3002.701128,6009,176.8393172,12018,-2804224,272384,-2531840,-1
119,29,21,9,0.195945946,0.804054054,41.46839751,46.64707986,76.48739496,66.34482759,148,20.55555556,296,-60928,14848,-46080,-1
9370,582,21,9,0.0584807074,0.941519293,2838.84539,3332.153703,5008.469691,4461.798969,9952,826.5780731,19904,-4797440,297984,-4499456,-1
865,98,18,12,0.101765317,0.898234683,274.2024623,275.660748,497.0982659,348.7346939,963,116.1640531,1926,-442880,50176,-392704,-1
292,62,19,11,0.175141243,0.824858757,100.1988637,95.08345641,188.5787671,125.3225806,354,7.104154124,708,-149504,31744,-117760,-1
3349,498,22,8,0.129451521,0.870548479,1089.030023,1245.32378,1920.822932,1945.365462,3847,102.5046629,7694,-1714688,254976,-1459712,-1
2315,236,19,11,0.0925127401,0.90748726,723.8378177,801.2586733,1303.531749,1005.932203,2551,66.036759,5102,-1185280,120832,-1064448,-1
9616,368,23,7,0.0368589744,0.963141026,2863.01941,3201.174973,5028.689892,4046.842391,9984,832.6939116,19968,-4923392,188416,-4734976,-1
73,24,17,13,0.24742268,0.75257732,27.15865274,23.50221621,54.50684932,32.25,97,34.64285714,194,-37376,12288,-25088,-1
8565,560,22,8,0.061369863,0.938630137,2637.800282,2494.776582,4604.120841,3934.071429,9125,234.8777349,18250,-4385280,286720,-4098560,-1
60,17,25,5,0.220779221,0.779220779,23.01989478,18.62003981,40.13333333,35,77,2.321374736,154,-30720,8704,-22016,-1
9266,668,21,9,0.0672438091,0.932756191,2872.849499,2771.405315,4992.878804,4615.464072,9934,920.6672845,19868,-4744192,342016,-4402176,-1
472,105,20,10,0.181975737,0.818024263,162.3111081,180.1244216,297.0190678,252.952381,577,43.81169324,1154,-241664,53760,-187904,-1
9549,425,22,8,0.042610788,0.957389212,2870.566735,2924.690044,5027.826055,4081.444706,9974,1185.969084,19948,-4889088,217600,-4671488,-1
2432,243,20,10,0.0908411215,0.909158879,751.2106633,929.5499598,1359.797697,1119.843621,2675,53.97497982,5350,-1245184,124416,-1120768,-1
8531,709,21,9,0.0767316017,0.923268398,2629.041566,3090.483365,4614.534638,4692.277856,9240,185.840708,18480,-4367872,363008,-4004864,-1
4087,218,24,6,0.0506387921,0.949361208,1236.818488,1349.003554,2152.312699,2165.885321,4305,113.49855,8610,-2092544,111616,-1980928,-1
118,15,17,13,0.112781955,0.887218045,36.39507691,29.99288805,72.00847458,27.6,133,17.34028683,266,-60416,7680,-52736,-1
9377,572,22,8,0.0574932154,0.942506785,2864.948044,2882.630496,5021.060467,4219.914336,9949,567.8652968,19898,-4801024,292864,-4508160,-1
8253,393,16,14,0.0454545455,0.954545455,2470.850176,2971.112352,4318.170362,4435.422392,8646,191.4950166,17292,-4225536,201216,-4024320,-1
6755,874,20,10,0.114562852,0.885437148,2108.957437,2689.26711,3711.096521,4618.052632,7629,181.2975285,15258,-3458560,447488,-3011072,-1
44,23,16,14,0.343283582,0.656716418,18.591562,20.43357998,35.38636364,31.34782609,67,19.94047619,134,-22528,11776,-10752,-1
592,71,14,16,0.107088989,0.892911011,184.7399014,216.4398803,343.6925676,234.5070423,663,101.221374,1326,-303104,36352,-266752,-1
1943,94,17,13,0.0461462936,0.953853706,582.3224446,648.7130088,1030.864642,773.7553191,2037,175.6034483,4074,-994816,48128,-946688,-1
2400,336,27,3,0.122807018,0.877192982,750.880219,1010.961937,1391.302083,1205.627976,2736,62.93995859,5472,-1228800,172032,-1056768,-1
120,21,22,8,0.14893617,0.85106383,40.63401695,36.32674845,74.1,53.28571429,141,31.68539326,282,-61440,10752,-50688,-1
1668,150,22,8,0.0825082508,0.917491749,524.2999332,521.3708989,917.9244604,815.82,1818,129.6718973,3636,-854016,76800,-777216,-1
664,98,21,9,0.128608924,0.871391076,208.9871242,258.9626014,365.6430723,488.9387755,762,26.80267323,1524,-339968,50176,-289792,-1
4313,427,17,13,0.0900843882,0.909915612,1335.975244,1655.250721,2358.571528,2490.985948,4740,348.785872,9480,-2208256,218624,-1989632,-1
9434,482,20,10,0.0486083098,0.95139169,2851.275321,2846.671569,5016.316091,3826.887967,9916,423.2180965,19832,-4830208,246784,-4583424,-1
9624,362,20,10,0.0362507511,0.963749249,2870.046598,3087.749635,5024.670407,4164.814917,9986,761.1280488,19972,-4927488,185344,-4742144,-1
3218,295,19,11,0.0839738116,0.916026188,1001.947703,1130.785122,1768.559043,1630.908475,3513,80.18717188,7026,-1647616,151040,-1496576,-1
905,89,19,11,0.0895372233,0.910462777,280.7489007,341.9068785,494.2607735,530.4382022,994,19.63650731,1988,-463360,45568,-417792,-1
9306,623,22,8,0.062745493,0.937254507,2849.129321,2935.089912,5031.814958,3966.958266,9929,622.1177945,19858,-4764672,318976,-4445696,-1
9559,409,25,5,0.0410313002,0.9589687,2869.226778,3061.663299,4990.325348,4848.352078,9968,1067.237687,19936,-4894208,209408,-4684800,-1
1587,154,22,8,0.088454911,0.911545089,486.2000801,632.2413169,884.0365469,736.6558442,1741,79.97243914,3482,-812544,78848,-733696,-1
4167,254,19,11,0.0574530649,0.942546935,1256.910482,1470.968347,2241.636189,1708.397638,4421,89.85772358,8842,-2133504,130048,-2003456,-1
9467,501,21,9,0.0502608347,0.949739165,2837.824278,3075.415436,5075.426112,3266.341317,9968,641.0289389,19936,-4847104,256512,-4590592,-1
9234,690,20,10,0.069528416,0.930471584,2814.724794,3417.864986,5004.052198,4406.423188,9924,825.6239601,19848,-4727808,353280,-4374528,-1
1321,100,20,10,0.0703729768,0.929627023,398.5138569,540.0436296,708.1302044,748.91,1421,173.7163814,2842,-676352,51200,-625152,-1
9472,493,21,9,0.049473156,0.950526844,2853.343484,3059.669974,5044.714105,3797.288032,9965,1219.706242,19930,-4849664,252416,-4597248,-1
9544,431,21,9,0.0432080201,0.95679198,2854.163528,3100.64413,5048.871647,3640.067285,9975,290.7315651,19950,-4886528,220672,-4665856,-1
963,130,17,13,0.118938701,0.881061299,309.9630578,346.314585,556.290758,478.1769231,1093,31.3449957,2186,-493056,66560,-426496,-1
8993,920,21,9,0.0928074246,0.907192575,2807.151972,3138.911509,4843.563105,6065.845652,9913,408.1103335,19826,-4604416,471040,-4133376,-1
9385,553,21,9,0.055644999,0.944355001,2827.73514,3460.865245,4942.162067,5433.453888,9938,530.5926321,19876,-4805120,283136,-4521984,-1
3717,588,19,11,0.136585366,0.863414634,1235.929486,1283.306106,2162.702717,2091.664966,4305,84.11488863,8610,-1903104,301056,-1602048,-1
67,29,16,14,0.302083333,0.697916667,28.91894172,20.33576654,53.56716418,36.79310345,96,12.66490765,192,-34304,14848,-19456,-1
39,12,20,10,0.235294118,0.764705882,14.91743659,12.61915431,27.66666667,20.58333333,51,17.5862069,102,-19968,6144,-13824,-1
2016,204,21,9,0.0918918919,0.908108108,633.8661713,691.0619219,1124.547123,971.6813725,2220,189.7435897,4440,-1032192,104448,-927744,-1
2449,203,20,10,0.076546003,0.923453997,746.5743323,885.8329302,1357.129032,956.9901478,2652,53.61908613,5304,-1253888,103936,-1149952,-1
9420,536,20,10,0.0538368823,0.946163118,2856.160121,2979.003992,5038.807856,3918.61194,9956,913.3944954,19912,-4823040,274432,-4548608,-1
9362,585,21,9,0.058811702,0.941188298,2817.447731,3623.93966,4984.306024,4809.068376,9947,854.5532646,19894,-4793344,299520,-4493824,-1
46,6,25,5,0.115384615,0.884615385,14.24052433,15.01573249,28.10869565,14.16666667,52,1.58778626,104,-23552,3072,-20480,-1
4519,342,17,13,0.0703558938,0.929644106,1373.055518,1571.626273,2487.839788,1679.950292,4861,156.8570507,9722,-2313728,175104,-2138624,-1
2930,298,25,5,0.0923172243,0.907682776,931.2140253,937.0532136,1618.599659,1574.191275,3228,230.9012876,6456,-1500160,152576,-1347584,-1
9326,624,25,5,0.0627135678,0.937286432,2833.885922,3064.050739,5070.246837,3559.459936,9950,1407.355021,19900,-4774912,319488,-4455424,-1
4790,482,19,11,0.0914264036,0.908573596,1517.040299,1569.143037,2638.803758,2613.605809,5272,257.421875,10544,-2452480,246784,-2205696,-1
4420,670,20,10,0.131630648,0.868369352,1420.535451,1462.259656,2407.708371,3454.513433,5090,115.602998,10180,-2263040,343040,-1920000,-1
63,24,20,10,0.275862069,0.724137931,25.48022022,22.13155113,47.11111111,35.83333333,87,24.50704225,174,-32256,12288,-19968,-1
9246,624,20,10,0.0632218845,0.936778116,2835.338236,3026.00906,4959.133355,4585.317308,9870,239.0988372,19740,-4733952,319488,-4414464,-1
33,23,17,13,0.410714286,0.589285714,15.72700998,16.76908669,28.54545455,28.43478261,56,1.090342679,112,-16896,11776,-5120,-1
9541,433,21,9,0.0434128735,0.956587127,2866.399497,2999.768617,5030.024211,4050.494226,9974,1048.790747,19948,-4884992,221696,-4663296,-1
4758,584,20,10,0.109322351,0.890677649,1537.552133,1578.644282,2672.849096,2660.508562,5342,129.9440525,10684,-2436096,299008,-2137088,-1
5956,809,21,9,0.119586105,0.880413895,1855.729308,1989.108445,3178.22683,4890.57602,6765,365.0836481,13530,-3049472,414208,-2635264,-1
416,88,19,11,0.174603175,0.825396825,136.0796979,167.2079914,267.0576923,183.6818182,504,34.97571131,1008,-212992,45056,-167936,-1
4910,325,18,12,0.0620821394,0.937917861,1511.945932,1498.549142,2613.603666,2684.418462,5235,103.2544379,10470,-2513920,166400,-2347520,-1
2136,243,19,11,0.102143758,0.897856242,678.3732714,709.1577586,1218.387172,940.473251,2379,194.3627451,4758,-1093632,124416,-969216,-1
1186,77,25,5,0.0609659541,0.939034046,360.6851285,400.8381887,639.9468803,509.5974026,1263,48.91556933,2526,-607232,39424,-567808,-1
4894,413,21,9,0.0778217449,0.922178255,1506.675368,1763.751095,2685.181651,2284.501211,5307,125.4313401,10614,-2505728,211456,-2294272,-1
5046,425,20,10,0.077682325,0.922317675,1561.229338,1760.566801,2757.414982,2481.741176,5471,109.2888534,10942,-2583552,217600,-2365952,-1
2835,201,22,8,0.0662055336,0.933794466,867.2679954,987.8436905,1527.510758,1391.40796,3036,63.76811594,6072,-1451520,102912,-1348608,-1
52,27,19,11,0.341772152,0.658227848,23.9843622,19.7859603,41.98076923,36.18518519,79,8.110882957,158,-26624,13824,-12800,-1
9556,421,21,9,0.0421970532,0.957802947,2866.796123,3140.202295,5006.836961,4584.130641,9977,902.8959276,19954,-4892672,215552,-4677120,-1
5645,348,19,11,0.0580677457,0.941932254,1735.771577,1556.261948,3026.811515,2513.41954,5993,292.6269531,11986,-2890240,178176,-2712064,-1
9419,535,20,10,0.0537472373,0.946252763,2845.497146,3182.008442,5031.307251,4030.190654,9954,735.155096,19908,-4822528,273920,-4548608,-1
7743,515,22,8,0.0623637685,0.937636232,2363.534139,2550.878705,4180.541134,3362.099029,8258,161.6046967,16516,-3964416,263680,-3700736,-1
9647,339,22,8,0.0339475265,0.966052473,2870.443409,3144.332315,5016.186587,4347.902655,9986,396.5845909,19972,-4939264,173568,-4765696,-1
6232,375,21,9,0.056757984,0.943242016,1875.53617,2320.790381,3333.044929,2821.312,6607,405.3374233,13214,-3190784,192000,-2998784,-1
63,29,19,11,0.315217391,0.684782609,27.68351353,21.48837586,50.50793651,37.79310345,92,18.96907216,184,-32256,14848,-17408,-1
9533,439,22,8,0.0440232651,0.955976735,2863.899702,3069.673434,5024.319207,4165.246014,9972,969.0962099,19944,-4880896,224768,-4656128,-1
1838,217,21,9,0.105596107,0.894403893,580.7888862,689.598403,1028.866703,1020.658986,2055,92.2766053,4110,-941056,111104,-829952,-1
2311,207,17,13,0.0822081017,0.917791898,707.5987674,913.5757412,1255.132843,1308.256039,2518,215.7669237,5036,-1183232,105984,-1077248,-1
1873,324,25,5,0.147473828,0.852526172,634.7100407,630.7869589,1094.651361,1124.138889,2197,61.12966055,4394,-958976,165888,-793088,-1
923,101,19,11,0.0986328125,0.901367188,293.8791997,301.5130664,520.383532,440.4554455,1024,27.1546009,2048,-472576,51712,-420864,-1
2374,266,20,10,0.100757576,0.899242424,752.2249186,823.1883121,1340.84246,1138.947368,2640,145.1346894,5280,-1215488,136192,-1079296,-1
186,27,20,10,0.126760563,0.873239437,59.97621147,47.3844273,114.1774194,57.55555556,213,30.42857143,426,-95232,13824,-81408,-1
8818,1059,22,8,0.107218791,0.892781209,2846.661463,2788.458272,4853.213994,5653.316336,9877,475.0841751,19754,-4514816,542208,-3972608,-1
6068,1372,20,10,0.184408602,0.815591398,2117.713759,2217.895332,3616.332235,4181.206997,7440,141.3105413,14880,-3106816,702464,-2404352,-1
9421,537,27,3,0.0539264913,0.946073509,2851.530859,3085.532336,5036.666384,3976.586592,9958,892.2939068,19916,-4823552,274944,-4548608,-1
48,15,20,10,0.238095238,0.761904762,18.10612044,16.55885128,34.20833333,24.93333333,63,10.3960396,126,-24576,7680,-16896,-1
45,23,16,14,0.338235294,0.661764706,18.48242408,21.24170026,36.33333333,30.91304348,68,8.153477218,136,-23040,11776,-11264,-1
4436,357,22,8,0.0744836219,0.925516378,1362.942316,1615.42793,2389.072588,2495.504202,4793,112.4589395,9586,-2271232,182784,-2088448,-1
9477,486,21,9,0.0487804878,0.951219512,2868.728401,2870.517881,5028.230769,4080.5,9963,1008.40081,19926,-4852224,248832,-4603392,-1
40,12,22,8,0.230769231,0.769230769,14.31989438,16.28628428,27.875,21.91666667,52,5.77136515,104,-20480,6144,-14336,-1
3636,266,20,10,0.0681701691,0.931829831,1110.710937,1101.109533,2003.223322,1244.484962,3902,215.6992814,7804,-1861632,136192,-1725440,-1
9599,378,22,8,0.0378871404,0.96211286,2867.373046,3168.080521,5002.243984,4652.679894,9977,1312.763158,19954,-4914688,193536,-4721152,-1
1535,164,23,7,0.096527369,0.903472631,479.040754,578.6511941,859.8065147,758.2134146,1699,31.18575624,3398,-785920,83968,-701952,-1
1412,159,22,8,0.101209421,0.898790579,452.1626214,366.4252751,816.6126062,514.1446541,1571,134.6186804,3142,-722944,81408,-641536,-1
6743,396,20,10,0.0554699538,0.944530046,2044.199188,2313.468741,3556.138069,3806.037879,7139,234.6040092,14278,-3452416,202752,-3249664,-1
9325,638,22,8,0.0640369367,0.935963063,2904.159187,2425.715549,4990.007292,4864.965517,9963,376.6729679,19926,-4774400,326656,-4447744,-1
5680,299,21,9,0.0500083626,0.949991637,1710.530004,1984.870183,3001.299472,2775.347826,5979,116.2325039,11958,-2908160,153088,-2755072,-1
9350,596,19,11,0.0599235874,0.940076413,2849.874781,3062.284358,4919.034545,5827.949664,9946,737.2868792,19892,-4787200,305152,-4482048,-1
5259,280,20,10,0.0505506409,0.949449359,1571.578795,2003.346908,2748.325917,3177.085714,5539,203.266055,11078,-2692608,143360,-2549248,-1
695,111,18,12,0.137717122,0.862282878,230.9596456,240.1286374,409.1381295,368.1981982,806,56.52173913,1612,-355840,56832,-299008,-1
9418,541,21,9,0.0543227232,0.945677277,2859.588512,3072.644822,5013.240391,4401.334566,9959,701.8322763,19918,-4822016,276992,-4545024,-1
9497,468,20,10,0.0469643753,0.953035625,2849.062381,3061.342643,5052.854375,3565.463675,9965,717.4226062,19930,-4862464,239616,-4622848,-1
2117,140,22,8,0.0620292424,0.937970758,648.4345977,635.0358988,1147.370808,851.2071429,2257,196.9458988,4514,-1083904,71680,-1012224,-1
3827,179,20,10,0.0446829755,0.955317024,1147.624165,1329.983836,2005.732427,1955.77095,4006,467.4445741,8012,-1959424,91648,-1867776,-1
2641,226,22,8,0.0788280433,0.921171957,824.7832232,785.4387262,1462.811814,1097.309735,2867,441.7565485,5734,-1352192,115712,-1236480,-1
9222,700,21,9,0.0705502923,0.929449708,2854.748997,2976.369626,4943.612557,5197.154286,9922,778.1960784,19844,-4721664,358400,-4363264,-1
2443,235,20,10,0.0877520538,0.912247946,755.0795354,933.2228929,1349.799836,1232.425532,2678,106.7783094,5356,-1250816,120320,-1130496,-1
1640,132,22,8,0.0744920993,0.925507901,508.079613,522.7483809,900.3810976,714.0378788,1772,141.6466827,3544,-839680,67584,-772096,-1
9439,518,22,8,0.0520237019,0.947976298,2837.676704,3168.894554,5055.238267,3589.785714,9957,781.5541601,19914,-4832768,265216,-4567552,-1
1031,162,27,3,0.135792121,0.864207879,349.1059176,310.2980332,602.6614937,560.9691358,1193,55.00230521,2386,-527872,82944,-444928,-1
4757,380,21,9,0.0739731361,0.926026864,1458.178879,1745.401425,2549.597435,2811.889474,5137,92.69216889,10274,-2435584,194560,-2241024,-1
4890,271,21,9,0.0525092036,0.947490796,1470.10802,1788.594182,2595.787321,2314.173432,5161,299.5356936,10322,-2503680,138752,-2364928,-1
650,90,21,9,0.121621622,0.878378378,202.6462212,270.1485209,360.7523077,440.9,740,30.62913907,1480,-332800,46080,-286720,-1
9198,724,21,9,0.0729691594,0.927030841,2877.116909,2671.361014,4988.617743,4616.984807,9922,1104.899777,19844,-4709376,370688,-4338688,-1
708,105,27,3,0.129151292,0.870848708,230.7001791,255.5557725,400.3615819,451.7619048,813,69.19148936,1626,-362496,53760,-308736,-1
9101,817,20,10,0.0823754789,0.917624521,2796.157772,3385.42955,4875.465663,5895.603427,9918,689.7079277,19836,-4659712,418304,-4241408,-1
2961,196,21,9,0.0620842572,0.937915743,895.9849957,985.6903154,1612.825735,1067.989796,3157,175.3888889,6314,-1516032,100352,-1415680,-1
7640,1298,20,10,0.145222645,0.854777355,2603.865939,2347.418785,4367.200524,5071.632512,8938,170.247619,17876,-3911680,664576,-3247104,-1
1437,129,22,8,0.0823754789,0.917624521,447.6689261,497.2860294,786.3924843,751.2790698,1566,38.37294781,3132,-735744,66048,-669696,-1
3937,375,27,3,0.0869666048,0.913033395,1249.250036,1195.189922,2151.049022,2213.728,4312,91.60824304,8624,-2015744,192000,-1823744,-1
4080,305,27,3,0.0695553022,0.930444698,1255.494415,1389.478609,2182.6375,2331.619672,4385,235.6260075,8770,-2088960,156160,-1932800,-1
2123,196,20,10,0.0845191893,0.915480811,662.2784248,716.4719812,1177.238342,973.2806122,2319,81.05557497,4638,-1086976,100352,-986624,-1
33,24,17,13,0.421052632,0.578947368,16.54828481,16.3152536,29.18181818,28.75,57,16.05633803,114,-16896,12288,-4608,-1
4825,277,22,8,0.0542924343,0.945707566,1448.897099,1801.423042,2572.508601,2185.555957,5102,360.565371,10204,-2470400,141824,-2328576,-1
4121,422,20,10,0.0928901607,0.907109839,1274.840272,1623.170744,2281.689638,2177.376777,4543,91.09685181,9086,-2109952,216064,-1893888,-1
101,37,20,10,0.268115942,0.731884058,39.84323265,38.93678269,72.10891089,62.37837838,138,21.26348228,276,-51712,18944,-32768,-1
7418,349,20,10,0.0449336938,0.955066306,2220.164148,2409.12559,3936.57684,2766.47851,7767,312.1784566,15534,-3798016,178688,-3619328,-1
3110,281,20,10,0.0828664111,0.917133589,962.8859521,1053.868689,1733.885531,1276.697509,3391,69.51619516,6782,-1592320,143872,-1448448,-1
222,50,25,5,0.183823529,0.816176471,78.15445452,75.86100184,141.7432432,113.22,272,22.24039248,544,-113664,25600,-88064,-1
9544,421,20,10,0.0422478675,0.957752132,2851.462363,3196.904805,5032.698554,3856.342043,9965,790.2458366,19930,-4886528,215552,-4670976,-1
451,93,17,13,0.170955882,0.829044118,150.02731,169.9582226,287.3037694,200.7096774,544,79.18486172,1088,-230912,47616,-183296,-1
5087,227,22,8,0.0427173504,0.95728265,1528.677906,1623.561804,2670.145469,2374.118943,5314,155.6531927,10628,-2604544,116224,-2488320,-1
1848,85,19,11,0.0439730988,0.956026901,551.321361,643.696216,977.8609307,730.8705882,1933,79.6784831,3866,-946176,43520,-902656,-1
1489,64,20,10,0.0412105602,0.95878944,444.9234146,498.3176754,783.3955675,628.203125,1553,167.7105832,3106,-762368,32768,-729600,-1
732,89,21,9,0.108404385,0.891595615,231.7185578,270.2844747,417.7773224,355.258427,821,51.44110276,1642,-374784,45568,-329216,-1
4182,258,21,9,0.0581081081,0.941891892,1274.754725,1376.410259,2231.989718,2034.25969,4440,419.2634561,8880,-2141184,132096,-2009088,-1
42,16,21,9,0.275862069,0.724137931,16.5613167,17.19692923,29.64285714,29.125,58,8.504398827,116,-21504,8192,-13312,-1
686,112,25,5,0.140350877,0.859649123,225.773685,246.5174659,388.6720117,465.8214286,798,17.26525314,1596,-351232,57344,-293888,-1
9566,413,16,14,0.0413869125,0.958613087,2859.074381,3138.799753,5038.563663,3865.157385,9979,1012.068966,19958,-4897792,211456,-4686336,-1
5192,195,25,5,0.0361982551,0.963801745,1545.967896,1712.407926,2712.041025,2213.646154,5387,196.1048416,10774,-2658304,99840,-2558464,-1
942,191,19,11,0.168578994,0.831421006,323.7847419,342.2736126,563.470276,584.408377,1133,89.07232704,2266,-482304,97792,-384512,-1
9249,464,19,11,0.0477710285,0.952228971,2781.604477,3125.540097,4894.133095,4116.818966,9713,427.8854626,19426,-4735488,237568,-4497920,-1
2692,277,25,5,0.0932974065,0.906702593,848.2741622,858.9707497,1522.003715,1125.382671,2969,98.86779887,5938,-1378304,141824,-1236480,-1
4553,946,27,3,0.172031278,0.827968722,1644.396976,1252.559756,2701.859214,2981.696617,5499,133.373757,10998,-2331136,484352,-1846784,-1
261,46,21,9,0.149837134,0.850162866,88.21112595,81.3082538,160.6130268,116.4782609,307,7.839632278,614,-133632,23552,-110080,-1
121,17,21,9,0.123188406,0.876811594,38.08200793,32.48028414,74.60330579,33.17647059,138,31.57894737,276,-61952,8704,-53248,-1
795,97,18,12,0.108744395,0.891255605,252.9628478,288.7182216,451.5484277,405.1237113,892,22.20562609,1784,-407040,49664,-357376,-1
6885,1144,20,10,0.142483497,0.857516503,2276.299659,2402.889388,3882.204503,4814.210664,8029,158.4879589,16058,-3525120,585728,-2939392,-1
6864,511,21,9,0.0692881356,0.930711864,2102.548445,2397.815081,3649.63447,4203.344423,7375,142.8709802,14750,-3514368,261632,-3252736,-1
7380,404,20,10,0.0519013361,0.948098664,2225.548134,2588.318044,3909.883469,3574.950495,7784,516.1803714,15568,-3778560,206848,-3571712,-1
9395,569,20,10,0.0571055801,0.94289442,2865.747174,2948.924626,5027.418946,4240.824253,9964,615.4416306,19928,-4810240,291328,-4518912,-1
73,22,21,9,0.231578947,0.768421053,28.08391575,17.50566614,52.75342466,32.22727273,95,10.41666667,190,-37376,11264,-26112,-1
4264,440,21,9,0.093537415,0.906462585,1322.45882,1662.395362,2348.413696,2392.1,4704,114.3134872,9408,-2183168,225280,-1957888,-1
1282,119,20,10,0.0849393291,0.915060671,395.1865304,490.2239168,705.7870515,649.4285714,1401,89.52076677,2802,-656384,60928,-595456,-1
9577,408,21,9,0.0408612919,0.959138708,2872.763923,3027.929789,5020.820299,4339.973039,9985,889.1362422,19970,-4903424,208896,-4694528,-1
8710,1106,21,9,0.112673187,0.887326813,2640.064769,3059.961686,4591.801033,7402.575949,9816,195.5378486,19632,-4459520,566272,-3893248,-1
5088,379,20,10,0.0693250412,0.930674959,1564.613852,1750.149859,2732.71875,2751.200528,5467,133.2439678,10934,-2605056,194048,-2411008,-1
3209,464,22,8,0.126327253,0.873672747,1049.011739,1098.320781,1798.142412,2105.737069,3673,153.6177332,7346,-1643008,237568,-1405440,-1
2066,148,16,14,0.0668473351,0.933152665,626.5282922,773.9421765,1119.894966,934.472973,2214,216.4222874,4428,-1057792,75776,-982016,-1
109,35,20,10,0.243055556,0.756944444,40.88788994,43.20075585,74.18348624,67.25714286,144,11.5848753,288,-55808,17920,-37888,-1
9368,582,18,12,0.0584924623,0.941507538,2867.646011,2939.493877,4987.735589,4778.553265,9950,668.2337139,19900,-4796416,297984,-4498432,-1
9111,659,22,8,0.0674513818,0.932548618,2795.141729,3135.235268,4905.534738,4608.509863,9770,238.9337246,19540,-4664832,337408,-4327424,-1
2934,395,21,9,0.118654251,0.881345749,947.7597544,1040.336415,1686.498296,1505.313924,3329,104.7843878,6658,-1502208,202240,-1299968,-1
4960,332,21,9,0.0627362056,0.937263794,1518.139755,1658.405574,2654.966129,2520.018072,5292,182.0433437,10584,-2539520,169984,-2369536,-1
6127,503,20,10,0.07586727,0.92413273,1885.159855,2139.467597,3264.568467,3935.892644,6630,146.4222615,13260,-3137024,257536,-2879488,-1
82,30,19,11,0.267857143,0.732142857,33.54446249,22.35841875,62.15853659,41.03333333,112,25.80645161,224,-41984,15360,-26624,-1
3536,312,23,7,0.0810810811,0.918918919,1095.004461,1160.334176,1969.494061,1414.567308,3848,232.0868516,7696,-1810432,159744,-1650688,-1
1433,139,20,10,0.0884223919,0.911577608,447.3238294,513.3535071,781.8346127,834.5971223,1572,56.42498205,3144,-733696,71168,-662528,-1
9219,723,19,11,0.0727217864,0.927278214,2870.223265,2847.406452,4996.940124,4647.112033,9942,210.9036911,19884,-4720128,370176,-4349952,-1
8264,598,20,10,0.0674791244,0.932520876,2536.09354,2845.912479,4436.148233,4367.264214,8862,183.4023179,17724,-4231168,306176,-3924992,-1
4492,279,18,12,0.0584783064,0.941521694,1348.186368,1729.068995,2411.806768,1970.501792,4771,377.7513856,9542,-2299904,142848,-2157056,-1
9490,474,20,10,0.0475712565,0.952428743,2862.27148,2926.437898,5038.672392,3857.867089,9964,500.2008032,19928,-4858880,242688,-4616192,-1
2799,195,21,9,0.0651302605,0.934869739,862.2388392,880.345484,1507.695606,1351.153846,2994,132.595217,5988,-1433088,99840,-1333248,-1
9363,586,22,8,0.058900392,0.941099608,2850.98367,3044.132466,5032.798248,4051.510239,9949,201.928151,19898,-4793856,300032,-4493824,-1
998,73,21,9,0.0681605976,0.931839402,304.0880006,354.7036574,543.8587174,428.5616438,1071,116.0346696,2142,-510976,37376,-473600,-1
8965,386,22,8,0.0412790076,0.958720992,2693.335907,2751.963293,4704.998327,4002.502591,9351,684.0526701,18702,-4590080,197632,-4392448,-1
3254,171,20,10,0.0499270073,0.950072993,973.3422573,1228.973599,1702.62354,1910.45614,3425,231.1066127,6850,-1666048,87552,-1578496,-1
6438,1094,22,8,0.145246946,0.854753054,2059.468427,2284.919535,3524.754893,5189.127971,7532,168.2000893,15064,-3296256,560128,-2736128,-1
709,87,21,9,0.109296482,0.890703518,223.2976146,273.4875192,393.3723554,440.2873563,796,80.32290616,1592,-363008,44544,-318464,-1
148,31,16,14,0.173184358,0.826815642,49.47895237,49.13804378,96.90540541,57.03225806,179,26.51851852,358,-75776,15872,-59904,-1
3356,151,22,8,0.0430567437,0.956943256,1004.666785,1139.545107,1765.834923,1490.966887,3507,257.4889868,7014,-1718272,77312,-1640960,-1
2132,157,20,10,0.0685889035,0.931411097,645.9210861,834.7705496,1140.855535,1201.280255,2289,90.08264463,4578,-1091584,80384,-1011200,-1
6662,1186,20,10,0.151121305,0.848878695,2258.381011,2079.870405,3761.447763,4840.397133,7848,163.9097744,15696,-3410944,607232,-2803712,-1
34,19,19,11,0.358490566,0.641509434,14.00889485,17.05165689,25.52941176,29.63157895,53,6.272189349,106,-17408,9728,-7680,-1
9504,461,19,11,0.0462619167,0.953738083,2869.484703,2870.078133,5027.59638,4063.598698,9965,634.7133758,19930,-4866048,236032,-4630016,-1
6792,379,18,12,0.052851764,0.947148236,2056.493776,2280.444746,3602.315518,3293.612137,7171,494.210889,14342,-3477504,194048,-3283456,-1
8202,379,21,9,0.0441673465,0.955832654,2466.896656,2598.044611,4322.307974,3613.459103,8581,312.7186589,17162,-4199424,194048,-4005376,-1
1933,274,21,9,0.12415043,0.87584957,636.9427154,627.9992322,1119.118469,997.3430657,2207,202.2914757,4414,-989696,140288,-849408,-1
9380,580,21,9,0.0582329317,0.941767068,2849.418351,3099.352616,5041.932623,3986.986207,9960,859.3615186,19920,-4802560,296960,-4505600,-1
57,34,18,12,0.373626374,0.626373626,26.0278753,26.62789858,46.66666667,44.88235294,91,1.97697154,182,-29184,17408,-11776,-1
412,45,23,7,0.0984682713,0.901531729,127.4381468,159.5189466,223.7014563,277.5111111,457,12.61733849,914,-210944,23040,-187904,-1
7679,1416,20,10,0.15568994,0.84431006,2408.886993,2701.723368,4150.350957,6704.459746,9095,200.110011,18190,-3931648,724992,-3206656,-1
2020,175,17,13,0.0797266515,0.920273349,632.6402661,635.207595,1107.348515,990.0914286,2195,173.5177866,4390,-1034240,89600,-944640,-1
9406,553,25,5,0.0555276634,0.944472337,2841.269798,3087.995246,5060.81767,3605.368897,9959,536.0064586,19918,-4815872,283136,-4532736,-1
9488,483,21,9,0.0484404774,0.951559523,2857.716408,3225.617236,5008.690767,4540.26501,9971,700.7027407,19942,-4857856,247296,-4610560,-1
4963,360,21,9,0.0676310351,0.932368965,1504.697818,1917.338133,2651.298811,2809.527778,5323,175.9669421,10646,-2541056,184320,-2356736,-1
9417,535,19,11,0.0537580386,0.946241961,2864.66148,2974.668461,5003.368907,4503.557009,9952,1100.884956,19904,-4821504,273920,-4547584,-1
1803,190,20,10,0.0953336678,0.904666332,579.2045629,533.3847696,1003.378258,936.4736842,1993,157.4249605,3986,-923136,97280,-825856,-1
72,19,20,10,0.208791209,0.791208791,24.07578297,32.06814075,48.09722222,38.05263158,91,9.439834025,182,-36864,9728,-27136,-1
9316,618,21,9,0.0622105899,0.93778941,2838.422597,3272.64025,4956.051846,5140.074434,9934,664.4816054,19868,-4769792,316416,-4453376,-1
5847,812,19,11,0.121940231,0.878059769,1895.752855,2094.670042,3355.052506,3149.603448,6659,143.2967506,13318,-2993664,415744,-2577920,-1
1905,307,21,9,0.138788427,0.861211573,640.1713952,600.6600184,1134.109711,935.1758958,2212,103.1235431,4424,-975360,157184,-818176,-1
9443,513,21,9,0.0515267176,0.948473282,2840.996284,3372.56595,4946.616965,5565.384016,9956,605.5961071,19912,-4834816,262656,-4572160,-1
3619,369,21,9,0.0925275827,0.907472417,1136.295543,1264.208744,1970.252003,2232.314363,3988,226.8486917,7976,-1852928,188928,-1664000,-1
9505,464,18,12,0.0465442873,0.953455713,2855.191681,3023.087097,5048.917833,3675.648707,9969,1087.131952,19938,-4866560,237568,-4628992,-1
3317,198,25,5,0.0563300142,0.943669986,999.5763191,1217.65683,1771.845945,1526.045455,3515,72.48917303,7030,-1698304,101376,-1596928,-1
6945,1053,20,10,0.131657914,0.868342086,2299.054096,2251.64689,3893.991649,4695.374169,7998,155.8456742,15996,-3555840,539136,-3016704,-1
9448,517,21,9,0.0518815855,0.948118414,2866.1818,2999.296714,5015.745766,4384.582205,9965,306.8986757,19930,-4837376,264704,-4572672,-1
9546,428,20,10,0.0429115701,0.95708843,2859.785706,3199.713122,5019.816572,4266.719626,9974,938.2878645,19948,-4887552,219136,-4668416,-1
288,38,21,9,0.116564417,0.883435583,91.67851558,77.42126731,173.3298611,89,326,10.45542014,652,-147456,19456,-128000,-1
451,75,21,9,0.142585551,0.857414449,142.8515292,187.7378342,254.0776053,320.16,526,35.83106267,1052,-230912,38400,-192512,-1
45,12,20,10,0.210526316,0.789473684,16.6725323,9.486832981,31.93333333,18,57,15.2,114,-23040,6144,-16896,-1
6945,264,21,9,0.0366208906,0.963379109,2074.781725,2236.557876,3600.446652,3724.784091,7209,601.7529215,14418,-3555840,135168,-3420672,-1
40,15,21,9,0.272727273,0.727272727,15.84763389,15.28775836,29.45,24.13333333,55,5.397448479,110,-20480,7680,-12800,-1
5311,516,20,10,0.0885532864,0.911446714,1691.100681,1522.230612,2955.497835,2486.877907,5827,115.1808658,11654,-2719232,264192,-2455040,-1
6196,812,23,7,0.11586758,0.88413242,1978.444824,2156.614183,3394.063589,4347.189655,7008,155.4914577,14016,-3172352,415744,-2756608,-1
757,119,21,9,0.135844749,0.864155251,241.7436983,302.3664122,425.7939234,519.3277311,876,67.80185759,1752,-387584,60928,-326656,-1
9264,520,16,14,0.0531479967,0.946852003,2793.672076,3259.887518,4928.132664,4257.690385,9784,333.1290432,19568,-4743168,266240,-4476928,-1
2088,298,20,10,0.124895222,0.875104778,694.1741227,644.0385593,1182.05364,1273.701342,2386,52.75259783,4772,-1069056,152576,-916480,-1
75,23,18,12,0.234693878,0.765306122,28.48919951,16.45260134,55.45333333,30.08695652,98,30.72100313,196,-38400,11776,-26624,-1
3420,209,21,9,0.057591623,0.942408377,1032.420068,1267.155437,1809.520468,1904.665072,3629,68.51047763,7258,-1751040,107008,-1644032,-1
5528,693,22,8,0.111396882,0.888603118,1768.022378,1954.614565,3163.263748,2694.096681,6221,190.0702719,12442,-2830336,354816,-2475520,-1
1836,186,27,3,0.0919881306,0.908011869,569.6897555,679.0116372,1030.605664,822.9086022,2022,91.783931,4044,-940032,95232,-844800,-1
9364,585,19,11,0.0587998794,0.941200121,2849.133514,3177.402157,5005.266339,4490.531624,9949,431.8142361,19898,-4794368,299520,-4494848,-1
4628,671,16,14,0.126627666,0.873372334,1501.877191,1702.883172,2630.052506,2787.581222,5299,106.0648519,10598,-2369536,343552,-2025984,-1
2312,213,18,12,0.0843564356,0.915643564,715.7402874,858.4663068,1265.439879,1236.516432,2525,296.7097532,5050,-1183744,109056,-1074688,-1
2231,260,21,9,0.104375753,0.895624247,711.2124747,690.2624553,1286.867772,895.3230769,2491,204.8519737,4982,-1142272,133120,-1009152,-1
9496,473,22,8,0.047447086,0.952552914,2853.717429,3025.740595,5051.975358,3640.395349,9969,670.8613728,19938,-4861952,242176,-4619776,-1
6575,366,22,8,0.0527301542,0.947269846,2003.025037,1992.158987,3487.6327,3172.202186,6941,432.1917808,13882,-3366400,187392,-3179008,-1
365,43,26,4,0.105392157,0.894607843,117.0361581,122.2284033,206.7643836,185.2790698,408,14.61841634,816,-186880,22016,-164864,-1
2900,151,25,5,0.0494919698,0.95050803,877.7261381,918.1096325,1535.475172,1344.02649,3051,222.2141296,6102,-1484800,77312,-1407488,-1
1962,276,16,14,0.123324397,0.876675603,634.5667243,722.1689342,1122.269113,1099.815217,2238,61.60198183,4476,-1004544,141312,-863232,-1
97,37,17,13,0.276119403,0.723880597,36.7996041,40.71135187,72.21649485,55.13513514,134,24.54212454,268,-49664,18944,-30720,-1
9567,415,19,11,0.0415748347,0.958425165,2856.195081,3164.426265,5045.954009,3736.171084,9982,328.3552632,19964,-4898304,212480,-4685824,-1
6464,379,18,12,0.055385065,0.944614935,1964.720739,1952.033828,3473.277537,2547.440633,6843,159.9205422,13686,-3309568,194048,-3115520,-1
7606,541,22,8,0.0664048116,0.933595188,2340.615386,2460.010438,4106.216803,3621.05915,8147,228.3352018,16294,-3894272,276992,-3617280,-1
9550,423,20,10,0.0424145192,0.957585481,2871.647256,2985.02057,5011.788901,4427.345154,9973,896.0467206,19946,-4889600,216576,-4673024,-1
3944,827,17,13,0.173338923,0.826661077,1347.660236,1358.539093,2260.112069,2986.365175,4771,107.5518485,9542,-2019328,423424,-1595904,-1
4133,258,20,10,0.0587565475,0.941243453,1256.074158,1427.471258,2207.152674,2017.341085,4391,201.4220183,8782,-2116096,132096,-1984000,-1
6991,522,20,10,0.0694795687,0.930520431,2132.090757,2546.847989,3798.548276,3200.555556,7513,379.4444444,15026,-3579392,267264,-3312128,-1
1430,89,19,11,0.0585911784,0.941408822,429.7691156,518.4142009,772.8517483,553.505618,1519,287.1455577,3038,-732160,45568,-686592,-1
9378,572,21,9,0.0574874372,0.942512563,2833.175579,3211.750773,5050.314459,3748.909091,9950,242.2103213,19900,-4801536,292864,-4508672,-1
438,111,16,14,0.202185792,0.797814208,147.9167966,188.5881022,285.9155251,231.9279279,549,10.2943934,1098,-224256,56832,-167424,-1
8990,449,20,10,0.0475685984,0.952431402,2703.970205,3104.318879,4731.156062,4496.63029,9439,397.7665402,18878,-4602880,229888,-4372992,-1
106,22,25,5,0.171875,0.828125,37.70465692,27.45605053,67.98113208,47.72727273,128,4.46615492,256,-54272,11264,-43008,-1
1048,93,21,9,0.0815074496,0.91849255,322.9470946,382.2107053,579.3673664,476.7096774,1141,83.89705882,2282,-536576,47616,-488960,-1
3291,128,21,9,0.0374378473,0.962562153,979.438544,1102.312923,1724.294743,1342.46875,3419,521.1890244,6838,-1684992,65536,-1619456,-1
1695,165,21,9,0.0887096774,0.911290323,528.5264066,616.4205282,928.720354,948.7818182,1860,85.51724138,3720,-867840,84480,-783360,-1
3976,465,21,9,0.104706147,0.895293853,1262.036262,1418.588318,2192.667505,2463.258065,4441,119.1574993,8882,-2035712,238080,-1797632,-1
4357,519,22,8,0.106439705,0.893560295,1411.827916,1370.237743,2432.145742,2491.843931,4876,155.2371856,9752,-2230784,265728,-1965056,-1
9528,440,21,9,0.044141252,0.955858748,2864.319515,3096.600134,5010.501994,4421.438636,9968,970.593963,19936,-4878336,225280,-4653056,-1
479,40,19,11,0.0770712909,0.922928709,144.6544818,148.3390963,270.960334,128.75,519,49.85590778,1038,-245248,20480,-224768,-1
243,39,19,11,0.138297872,0.861702128,78.36919764,64.65432282,152.5185185,72.84615385,282,49.64788732,564,-124416,19968,-104448,-1
4367,199,27,3,0.0435830048,0.956416995,1313.626403,1360.980354,2300.347378,1913.788945,4566,324.5202559,9132,-2235904,101888,-2134016,-1
2013,415,21,9,0.17092257,0.82907743,688.2377402,624.57327,1133.430204,1607.737349,2428,46.31819916,4856,-1030656,212480,-818176,-1
9475,485,20,10,0.0486947791,0.951305221,2869.556442,2934.202609,5007.437467,4454.247423,9960,989.0764647,19920,-4851200,248320,-4602880,-1
6629,227,22,8,0.0331096849,0.966890315,1971.865022,2148.176535,3441.264897,3055.731278,6856,505.2321297,13712,-3394048,116224,-3277824,-1
9354,589,20,10,0.0592376546,0.940762345,2855.901672,3061.017186,4997.756789,4562.952462,9943,588.3431953,19886,-4789248,301568,-4487680,-1
1352,145,27,3,0.0968603874,0.903139613,426.4710602,478.9002496,754.4341716,698.3310345,1497,130.9711286,2994,-692224,74240,-617984,-1
9365,570,21,9,0.057372924,0.942627076,2835.1409,3054.594408,5050.995302,3604.401754,9935,286.7243867,19870,-4794880,291840,-4503040,-1
653,93,21,9,0.124664879,0.875335121,210.4973993,233.2153837,384.2434916,298.0645161,746,52.16783217,1492,-334336,47616,-286720,-1
1232,101,16,14,0.0757689422,0.924231058,375.796439,465.8666217,676.5267857,550.7920792,1333,80.2045728,2666,-630784,51712,-579072,-1
700,108,25,5,0.133663366,0.866336634,224.6502931,280.2478566,399.1514286,439.1666667,808,35.56338028,1616,-358400,55296,-303104,-1
1245,165,21,9,0.117021277,0.882978723,405.4863844,414.0853749,697.9421687,762.5272727,1410,97.24137931,2820,-637440,84480,-552960,-1
1773,103,21,9,0.0549040512,0.945095949,532.8060607,635.1337582,951.3384095,717.5048544,1876,84.69525959,3752,-907776,52736,-855040,-1
3964,248,17,13,0.0588793922,0.941120608,1202.182889,1417.205601,2105.903128,2116.040323,4212,308.797654,8424,-2029568,126976,-1902592,-1
83,26,20,10,0.23853211,0.76146789,32.49208843,19.71051592,60.40963855,37.73076923,109,22.38193018,218,-42496,13312,-29184,-1
7944,675,21,9,0.0783153498,0.92168465,2419.086598,3189.897738,4311.392497,4293.611852,8619,298.9594173,17238,-4067328,345600,-3721728,-1
1961,316,22,8,0.138779095,0.861220905,658.6429504,649.0000618,1139.097909,1138.392405,2277,90.78947368,4554,-1004032,161792,-842240,-1
9410,540,20,10,0.0542713568,0.945728643,2859.25327,3058.543357,5000.479809,4540.203704,9950,1002.014099,19900,-4817920,276480,-4541440,-1
5859,284,27,3,0.046231483,0.953768517,1759.441881,2019.03667,3085.430108,2794.933099,6143,206.9046817,12286,-2999808,145408,-2854400,-1
9189,739,19,11,0.0744359388,0.925564061,2873.601731,2553.927695,5047.338666,3934.453315,9928,704.6132009,19856,-4704768,378368,-4326400,-1
5565,456,21,9,0.0757349278,0.924265072,1698.702613,1971.068569,3080.969632,2157.094298,6021,420.1674808,12042,-2849280,233472,-2615808,-1
597,128,20,10,0.176551724,0.823448276,202.9009101,214.5591921,382.5025126,272.0390625,725,117.8861789,1450,-305664,65536,-240128,-1
4008,544,22,8,0.119507909,0.880492091,1274.792386,1541.469449,2236.352545,2572.292279,4552,88.61203037,9104,-2052096,278528,-1773568,-1
8990,945,21,9,0.0951182687,0.904881731,2769.634472,3340.958599,4815.09911,6422.580952,9935,406.3394683,19870,-4602880,483840,-4119040,-1
2925,252,23,7,0.0793201133,0.920679887,922.1626347,832.4941029,1605.621538,1396.071429,3177,69.54903678,6354,-1497600,129024,-1368576,-1
8069,759,22,8,0.0859764386,0.914023561,2539.850184,2632.258826,4399.060974,4578.633729,8828,170.9858609,17656,-4131328,388608,-3742720,-1
5523,465,22,8,0.0776553106,0.922344689,1704.586789,1727.598411,3074.629911,2042.763441,5988,196.7148489,11976,-2827776,238080,-2589696,-1
3595,338,20,10,0.0859394864,0.914060514,1121.483104,1273.359174,1969.344645,1942.06213,3933,146.9730942,7866,-1840640,173056,-1667584,-1
3454,341,21,9,0.0898550725,0.910144928,1078.55742,1254.394283,1899.484076,1882.967742,3795,226.9736842,7590,-1768448,174592,-1593856,-1
86,28,19,11,0.245614035,0.754385965,32.63724609,27.8932687,62.86046512,41.03571429,114,11.78903826,228,-44032,14336,-29696,-1
597,82,27,3,0.120765832,0.879234168,194.8738726,178.2931104,352.7922948,246.8658537,679,31.24712379,1358,-305664,41984,-263680,-1
9562,415,27,3,0.04159567,0.95840433,2868.948693,2973.63768,5030.001778,4044.279518,9977,1193.421053,19954,-4895744,212480,-4683264,-1
34,21,17,13,0.381818182,0.618181818,15.73471687,15.85535525,29.35294118,25.80952381,55,8.607198748,110,-17408,10752,-6656,-1
87,25,20,10,0.223214286,0.776785714,33.219055,22.98750965,60.98850575,40.88,112,25.57077626,224,-44544,12800,-31744,-1
465,109,24,6,0.18989547,0.81010453,160.6100074,185.8514928,287.516129,287.4311927,574,61.85344828,1148,-238080,55808,-182272,-1
3592,231,21,9,0.060423751,0.939576249,1089.212129,1128.486531,1953.124443,1272.52381,3823,332.4347826,7646,-1839104,118272,-1720832,-1
6581,310,20,10,0.0449862139,0.955013786,1977.05239,2126.93283,3477.263334,2782.309677,6891,492.5661187,13782,-3369472,158720,-3210752,-1
7866,628,19,11,0.073934542,0.926065458,2420.211928,2762.567812,4203.978897,4792.622611,8494,232.3304158,16988,-4027392,321536,-3705856,-1
4875,887,22,8,0.153939604,0.846060396,1670.933278,1590.052493,2828.731282,3171.519729,5762,130.0383661,11524,-2496000,454144,-2041856,-1
305,59,19,11,0.162087912,0.837912088,101.241135,95.41349856,196.2491803,111.4237288,364,48.79356568,728,-156160,30208,-125952,-1
2041,165,19,11,0.0747960109,0.925203989,632.5758265,642.0432748,1122.534052,868.0545455,2206,60.93922652,4412,-1044992,84480,-960512,-1
9387,578,23,7,0.0580030105,0.941996989,2832.865481,3083.33571,5083.49739,3350.873702,9965,1236.352357,19930,-4806144,295936,-4510208,-1
4287,249,17,13,0.0548941799,0.94510582,1294.099787,1539.03643,2258.217168,2445.538153,4536,316.5387299,9072,-2194944,127488,-2067456,-1
5077,1320,21,9,0.206346725,0.793653275,1861.374709,1564.565113,2998.09612,3971.718939,6397,123.256262,12794,-2599424,675840,-1923584,-1
4798,277,17,13,0.0545812808,0.945418719,1437.258353,1881.276252,2534.908712,2591.545126,5075,102.8160454,10150,-2456576,141824,-2314752,-1
2455,312,19,11,0.112757499,0.887242501,782.4732149,909.3983092,1398.017108,1273.705128,2767,60.90688972,5534,-1256960,159744,-1097216,-1
2781,229,19,11,0.0760797342,0.923920266,850.7746389,1063.227887,1510.073355,1449.960699,3010,224.4593587,6020,-1423872,117248,-1306624,-1
8098,454,21,9,0.0530869972,0.946913003,2453.215639,2558.686884,4328.588664,3347.394273,8552,520.8282582,17104,-4146176,232448,-3913728,-1
2716,251,22,8,0.0845972363,0.915402764,857.6079524,796.2108312,1459.136598,1753.039841,2967,62.26652676,5934,-1390592,128512,-1262080,-1
1664,208,22,8,0.111111111,0.888888889,536.0295976,546.0685425,957.4080529,769.2355769,1872,137.6470588,3744,-851968,106496,-745472,-1
9542,431,20,10,0.043216685,0.956783315,2860.226895,3079.85907,5035.04957,3923.220418,9973,1088.755459,19946,-4885504,220672,-4664832,-1
7377,406,27,3,0.0521649749,0.947835025,2243.703594,2296.643806,3900.056798,3745.608374,7783,374.9036609,15566,-3777024,207872,-3569152,-1
9566,411,20,10,0.0411947479,0.958805252,2872.485423,2945.397149,5022.676981,4205.170316,9977,832.1100917,19954,-4897792,210432,-4687360,-1
1474,238,17,13,0.139018692,0.860981308,492.1711485,489.5085535,836.912483,977.8109244,1712,120.7334274,3424,-754688,121856,-632832,-1
716,41,22,8,0.0541611625,0.945838838,214.1061865,252.4653668,386.349162,250.6585366,757,84.96071829,1514,-366592,20992,-345600,-1
4981,902,21,9,0.153323134,0.846676866,1577.870681,1637.562591,2684.893395,4361.78714,5883,111.9505233,11766,-2550272,461824,-2088448,-1
6966,438,20,10,0.0591572123,0.940842788,2104.225291,2595.075984,3686.545076,3956.248858,7404,370.9418838,14808,-3566592,224256,-3342336,-1
9535,438,27,3,0.0439185802,0.95608142,2879.827534,2795.696637,5014.074777,4397.598174,9973,978.7046124,19946,-4881920,224256,-4657664,-1
3875,256,19,11,0.0619704672,0.938029533,1165.708613,1337.819205,2115.117677,1322.519531,4131,191.3385827,8262,-1984000,131072,-1852928,-1
60,16,24,6,0.210526316,0.789473684,22.70521232,17.35610483,40.2,32.125,76,2.018056293,152,-30720,8192,-22528,-1
8716,1135,21,9,0.115216729,0.884783271,2886.086453,2389.773753,5013.687816,4252.619383,9851,327.4933511,19702,-4462592,581120,-3881472,-1
4166,310,21,9,0.0692582663,0.930741734,1282.702421,1334.636832,2271.694911,1792.403226,4476,200.1788909,8952,-2132992,158720,-1974272,-1
6298,820,21,9,0.115200899,0.884799101,2031.915847,2161.196875,3495.939187,4047.678049,7118,134.3779498,14236,-3224576,419840,-2804736,-1
1673,160,19,11,0.0872885979,0.912711402,521.1282901,606.4461724,915.6658697,930.95,1833,47.02411493,3666,-856576,81920,-774656,-1
3497,238,20,10,0.0637215529,0.936278447,1061.983241,1292.496758,1870.929082,1824.962185,3735,88.17280453,7470,-1790464,121856,-1668608,-1
5406,637,21,9,0.10541122,0.89458878,1729.485481,1831.368306,2981.687199,3364.120879,6043,119.167817,12086,-2767872,326144,-2441728,-1
527,62,21,9,0.105263158,0.894736842,165.006927,202.1501513,289.6072106,340.8387097,589,66.70441676,1178,-269824,31744,-238080,-1
6196,688,26,4,0.0999418942,0.900058106,1942.286715,2212.195767,3357.821659,4205.097384,6884,152.7062999,13768,-3172352,352256,-2820096,-1
9369,561,27,3,0.0564954683,0.943504532,2849.138251,3138.52636,4955.733056,5128.613191,9930,891.3824057,19860,-4796928,287232,-4509696,-1
4994,615,27,3,0.109645213,0.890354787,1600.203015,1714.561691,2755.962355,3203.201626,5609,102.9930224,11218,-2556928,314880,-2242048,-1
1801,211,21,9,0.104870775,0.895129225,566.6790999,683.8036484,1016.540255,920.8009479,2012,154.7692308,4024,-922112,108032,-814080,-1
1727,189,19,11,0.0986430063,0.901356994,536.6609729,683.1032953,964.1928199,906.4814815,1916,66.09175578,3832,-884224,96768,-787456,-1
9449,501,21,9,0.0503517588,0.949648241,2877.636643,2687.210441,5010.248492,4320.133733,9950,1008.10537,19900,-4837888,256512,-4581376,-1
6720,521,21,9,0.0719513879,0.928048612,2066.589616,2297.297392,3576.009524,4201.299424,7241,197.8955999,14482,-3440640,266752,-3173888,-1
5585,501,18,12,0.0823200789,0.917679921,1735.706441,1960.038193,3020.907431,3295.355289,6086,283.5973905,12172,-2859520,256512,-2603008,-1
1652,110,21,9,0.0624290579,0.937570942,498.7914371,590.908491,897.1125908,647.0272727,1762,181.4624099,3524,-845824,56320,-789504,-1
9469,492,21,9,0.0493926313,0.950607369,2841.480036,3281.542399,5037.465202,3894.27439,9961,687.4396135,19922,-4848128,251904,-4596224,-1
8591,570,21,9,0.0622202816,0.937779718,2604.997726,2867.753372,4669.547666,3246.415789,9161,233.5202651,18322,-4398592,291840,-4106752,-1
3037,207,20,10,0.063810111,0.936189889,928.0977681,1018.197576,1639.829437,1368.251208,3244,106.7807768,6488,-1554944,105984,-1448960,-1
2316,233,21,9,0.0914083954,0.908591605,721.5102305,839.3291793,1295.21848,1074.030043,2549,189.0949555,5098,-1185792,119296,-1066496,-1
1959,228,22,8,0.104252401,0.895747599,614.9513752,739.6384445,1112.075549,938.6929825,2187,48.26749062,4374,-1003008,116736,-886272,-1
48,11,21,9,0.186440678,0.813559322,16.93569332,10.50855614,32.875,17.45454545,59,12.1399177,118,-24576,5632,-18944,-1
3359,291,22,8,0.0797260274,0.920273973,1030.360079,1254.344862,1851.440607,1526.068729,3650,89.74674207,7300,-1719808,148992,-1570816,-1
9507,474,19,11,0.0474902314,0.952509769,2847.213157,3128.345614,5066.817713,3470.327004,9981,1129.072398,19962,-4867584,242688,-4624896,-1
8010,428,16,14,0.0507229201,0.94927708,2415.845315,2738.775236,4245.425843,3734.299065,8438,737.5874126,16876,-4101120,219136,-3881984,-1
2775,239,20,10,0.0792966158,0.920703384,866.5355637,908.0079978,1502.446126,1566.179916,3014,87.79493155,6028,-1420800,122368,-1298432,-1
8663,302,20,10,0.0336865588,0.966313441,2582.752783,2720.143962,4492.236061,4218.059603,8965,543.3333333,17930,-4435456,154624,-4280832,-1
5771,563,22,8,0.0888853805,0.91111462,1810.570983,1991.050324,3147.394732,3373.587922,6334,126.3766959,12668,-2954752,288256,-2666496,-1
42,16,21,9,0.275862069,0.724137931,16.26643596,17.48168685,30.78571429,26.125,58,1.161393672,116,-21504,8192,-13312,-1
7889,725,20,10,0.0841653123,0.915834688,2439.675719,2949.30516,4312.278109,4255.507586,8614,306.9850321,17228,-4039168,371200,-3667968,-1
6533,429,27,3,0.0616202241,0.938379776,1994.492477,2143.984808,3520.360784,2889.710956,6962,147.8759558,13924,-3344896,219648,-3125248,-1
2935,243,19,11,0.0764631844,0.923536816,897.485307,967.2946773,1636.080409,1026.893004,3178,60.76481836,6356,-1502720,124416,-1378304,-1
3014,253,20,10,0.0774410774,0.922558923,926.1026431,1123.189627,1640.458859,1557.055336,3267,230.0704225,6534,-1543168,129536,-1413632,-1
44,14,20,10,0.24137931,0.75862069,16.88627187,14.37685214,31.61363636,22.85714286,58,12.69146608,116,-22528,7168,-15360,-1
8870,365,19,11,0.0395235517,0.960476448,2651.457709,2929.203223,4643.346561,4002.043836,9235,862.2782446,18470,-4541440,186880,-4354560,-1
249,28,27,3,0.101083032,0.898916968,79.36089817,73.71916512,134.4618474,179.3571429,277,55.4,554,-127488,14336,-113152,-1
3757,139,20,10,0.0356776181,0.964322382,1117.943504,1249.481115,1960.655044,1619.964029,3896,382.3356232,7792,-1923584,71168,-1852416,-1
8449,395,19,11,0.0446630484,0.955336952,2549.772798,2500.990903,4458.480294,3652.886076,8844,650.7726269,17688,-4325888,202240,-4123648,-1
90,40,20,10,0.307692308,0.692307692,35.76877906,41.19875605,65.83333333,64.75,130,10.7615894,260,-46080,20480,-25600,-1
5109,503,16,14,0.0896293656,0.910370634,1605.649844,1655.036418,2862.629869,2236.385686,5612,124.4897959,11224,-2615808,257536,-2358272,-1
1054,114,17,13,0.0976027397,0.90239726,321.2271601,427.1545241,601.7808349,424.7280702,1168,26.64233577,2336,-539648,58368,-481280,-1
730,75,17,13,0.0931677019,0.906832298,222.4498297,292.2270667,413.9739726,296.1866667,805,15.30127352,1610,-373760,38400,-335360,-1
370,31,22,8,0.0773067332,0.922693267,111.9882438,132.3647013,207.3,125.8064516,401,60.02994012,802,-189440,15872,-173568,-1
9505,469,21,9,0.0470222579,0.952977742,2861.287079,3174.578429,5013.945923,4451.533049,9974,481.8357488,19948,-4866560,240128,-4626432,-1
58,16,23,7,0.216216216,0.783783784,22.12738093,16.7742362,39.29310345,31,74,2.217560683,148,-29696,8192,-21504,-1
87,30,21,9,0.256410256,0.743589744,34.29065262,31.35249414,61.2183908,52.56666667,117,18.69009585,234,-44544,15360,-29184,-1
502,80,17,13,0.137457045,0.862542955,163.8949314,189.033628,296.3207171,261.25,582,46.67201283,1164,-257024,40960,-216064,-1
1926,165,20,10,0.0789096126,0.921090387,594.9160603,697.1613389,1046.768432,1037.030303,2091,194.330855,4182,-986112,84480,-901632,-1
79,32,16,14,0.288288288,0.711711712,32.87026642,24.66905957,61.7721519,41.75,111,24.72160356,222,-40448,16384,-24064,-1
1671,98,20,10,0.0553985302,0.94460147,501.8429206,537.6045202,905.0789946,542.6326531,1769,72.05702648,3538,-855552,50176,-805376,-1
1415,257,21,9,0.153708134,0.846291866,472.9515741,532.749388,839.135689,821.9883268,1672,124.6830723,3344,-724480,131584,-592896,-1
9473,495,21,9,0.0496589085,0.950341091,2864.728631,3052.229651,5015.441571,4392.359596,9968,888.4135472,19936,-4850176,253440,-4596736,-1
3644,404,21,9,0.0998023715,0.900197628,1161.948021,1218.462654,2039.300494,1891.002475,4048,113.4529148,8096,-1865728,206848,-1658880,-1
9505,462,22,8,0.0463529648,0.953647035,2870.013594,2920.867605,5020.756339,4227.790043,9967,697.9691877,19934,-4866560,236544,-4630016,-1
9416,541,20,10,0.0543336346,0.945666365,2859.239189,2803.135743,5056.238212,3634.683919,9957,510.877373,19914,-4820992,276992,-4544000,-1
4224,373,21,9,0.0811398738,0.918860126,1305.758368,1435.455021,2347.992661,1744.187668,4597,256.6722501,9194,-2162688,190976,-1971712,-1
3850,513,20,10,0.117579647,0.882420353,1226.644239,1449.427244,2142.754805,2476.530214,4363,103.1685978,8726,-1971200,262656,-1708544,-1
8268,535,19,11,0.0607747359,0.939225264,2524.842649,2758.587206,4379.464441,4750.269159,8803,275.0078101,17606,-4233216,273920,-3959296,-1
5219,383,20,10,0.0683684398,0.93163156,1597.641212,1724.582477,2851.38494,2121.736292,5602,450.6838294,11204,-2672128,196096,-2476032,-1
5198,257,27,3,0.0471127406,0.952887259,1565.487955,1745.419489,2734.790689,2590.653696,5455,515.108593,10910,-2661376,131584,-2529792,-1
9555,422,22,8,0.0422972838,0.957702716,2860.597948,3153.002066,5029.776557,4065.729858,9977,1030.681818,19954,-4892160,216064,-4676096,-1
549,98,18,12,0.151468315,0.848531685,179.4554772,213.3736908,334.867031,263.122449,647,43.98368457,1294,-281088,50176,-230912,-1
9252,693,20,10,0.0696832579,0.930316742,2888.951124,2503.406611,5028.248271,4235.399711,9945,496.0099751,19890,-4737024,354816,-4382208,-1
246,58,20,10,0.190789474,0.809210526,86.93174162,87.47528273,157.9512195,129.3793103,304,20.95106823,608,-125952,29696,-96256,-1
9398,557,21,9,0.055951783,0.944048217,2845.625608,2970.499889,5062.4319,3553.420108,9955,410.8543128,19910,-4811776,285184,-4526592,-1
412,111,20,10,0.212237094,0.787762906,144.6201081,172.1329749,264.815534,251.5495495,523,44.96990542,1046,-210944,56832,-154112,-1
8112,1754,19,11,0.177782283,0.822217717,2774.498206,2802.995482,4644.82717,6268.570696,9866,348.3757062,19732,-4153344,898048,-3255296,-1
50,31,18,12,0.382716049,0.617283951,23.43860917,23.07193655,42.54,38.51612903,81,9.299655568,162,-25600,15872,-9728,-1
4301,368,22,8,0.078817734,0.921182266,1341.669677,1415.714719,2341.275052,2261.660326,4669,157.5236167,9338,-2202112,188416,-2013696,-1
6462,1062,19,11,0.141148325,0.858851675,2118.189635,2137.739197,3572.752089,4917.067797,7524,157.2742475,15048,-3308544,543744,-2764800,-1
850,78,20,10,0.0840517241,0.915948276,264.7891736,294.147682,469.5023529,409.9871795,928,31.72649573,1856,-435200,39936,-395264,-1
1623,154,21,9,0.086662915,0.913337085,504.3980007,589.3915575,881.0264941,973.0324675,1777,106.4071856,3554,-830976,78848,-752128,-1
9570,404,18,12,0.0405053138,0.959494686,2869.215545,3040.92588,5013.934065,4361.326733,9974,885.0044366,19948,-4899840,206848,-4692992,-1
9449,512,18,12,0.0514004618,0.948599538,2854.009583,2955.449644,5051.910784,3672.335938,9961,320.2893891,19922,-4837888,262144,-4575744,-1
59,16,24,6,0.213333333,0.786666667,22.41912273,17.33572449,39.57627119,32.1875,75,2.178332849,150,-30208,8192,-22016,-1
6387,463,21,9,0.0675912409,0.932408759,1955.514658,2257.982163,3426.957257,3405.397408,6850,134.5511687,13700,-3270144,237056,-3033088,-1
1912,250,22,8,0.115633673,0.884366327,624.41529,618.352955,1089.561192,1019.848,2162,178.8254756,4324,-978944,128000,-850944,-1
1510,173,27,3,0.102792632,0.897207368,494.4193529,370.6101735,824.7437086,992.6184971,1683,72.98352125,3366,-773120,88576,-684544,-1
639,56,21,9,0.0805755396,0.91942446,195.9168894,190.0505094,361.4068858,195.0178571,695,36.27348643,1390,-327168,28672,-298496,-1
8093,1654,20,10,0.169693239,0.830306761,2566.080676,2795.815229,4394.882985,7218.31318,9747,205.2432091,19494,-4143616,846848,-3296768,-1
4807,533,20,10,0.0998127341,0.900187266,1531.492091,1627.519383,2662.665488,2741.157598,5340,114.9870801,10680,-2461184,272896,-2188288,-1
3296,279,21,9,0.078041958,0.921958042,1004.592641,1303.308437,1774.849515,1943.354839,3575,314.7007042,7150,-1687552,142848,-1544704,-1
8747,375,21,9,0.0411094058,0.958890594,2616.582456,2990.69728,4569.515377,4374.538667,9122,177.2638943,18244,-4478464,192000,-4286464,-1
3615,435,21,9,0.107407407,0.892592593,1148.106232,1307.980044,1997.4213,2258.843678,4050,162.4548736,8100,-1850880,222720,-1628160,-1
5579,553,20,10,0.0901826484,0.909817352,1751.206082,1840.000188,3005.149848,3685.437613,6132,116.8890583,12264,-2856448,283136,-2573312,-1
1895,189,21,9,0.0906909789,0.909309021,580.5236073,777.3206114,1034.269657,1125.021164,2084,208.1918082,4168,-970240,96768,-873472,-1
662,90,18,12,0.119680851,0.880319149,206.7143902,264.7104209,364.1480363,467.3555556,752,30.11613937,1504,-338944,46080,-292864,-1
4010,595,20,10,0.129207383,0.870792617,1337.685038,1255.887691,2275.280549,2489.815126,4605,119.3623639,9210,-2053120,304640,-1748480,-1
8859,560,22,8,0.0594542945,0.940545705,2702.038777,2903.137274,4749.8326,4079.8625,9419,858.6144029,18838,-4535808,286720,-4249088,-1
5965,1096,18,12,0.155218808,0.844781192,2080.58163,1777.740352,3494.233864,3731.100365,7061,175.0805852,14122,-3054080,561152,-2492928,-1
903,123,23,7,0.119883041,0.880116959,284.8165921,359.4238479,524.1982281,434.9593496,1026,62.14415506,2052,-462336,62976,-399360,-1
7025,283,19,11,0.0387246853,0.961275315,2095.985759,2353.393318,3677.440854,3085.031802,7308,155.1592357,14616,-3596800,144896,-3451904,-1
1899,137,22,8,0.0672888016,0.932711198,571.8864071,751.4157321,1031.661927,836.0583942,2036,151.4880952,4072,-972288,70144,-902144,-1
2632,138,15,15,0.0498194946,0.950180505,790.2980452,872.5167978,1406.014058,994.2463768,2770,282.9417773,5540,-1347584,70656,-1276928,-1
5234,213,17,13,0.039104094,0.960895906,1563.344882,1723.714652,2741.84295,2285.549296,5447,194.3275062,10894,-2679808,109056,-2570752,-1
9089,864,20,10,0.0868079976,0.913192002,2816.446311,3356.499064,4920.635163,5569.939815,9953,809.8454028,19906,-4653568,442368,-4211200,-1
8597,856,17,13,0.0905532635,0.909446736,2738.337345,2631.514047,4729.294754,4703.953271,9453,177.9555723,18906,-4401664,438272,-3963392,-1
7355,556,21,9,0.070281886,0.929718114,2251.853751,2666.128432,3965.872604,3825.401079,7911,632.88,15822,-3765760,284672,-3481088,-1
9289,627,21,9,0.0632311416,0.936768858,2842.852535,3106.079732,4988.231349,4518.030303,9916,620.9142142,19832,-4755968,321024,-4434944,-1
4800,257,27,3,0.0508206447,0.949179355,1452.889998,1565.212054,2541.645208,2292.824903,5057,243.7108434,10114,-2457600,131584,-2326016,-1
415,86,17,13,0.171656687,0.828343313,136.8552664,155.3776506,267.146988,173.0813953,501,78.52664577,1002,-212480,44032,-168448,-1
266,53,19,11,0.166144201,0.833855799,91.50727191,79.30950677,169.4962406,112.3396226,319,11.43369176,638,-136192,27136,-109056,-1
6184,348,21,9,0.0532761788,0.946723821,1876.845215,2030.109147,3274.494664,3124.433908,6532,126.1490923,13064,-3166208,178176,-2988032,-1
6802,650,20,10,0.0872249061,0.912775094,2143.936687,2184.995566,3765.263158,3320.858462,7452,152.1748009,14904,-3482624,332800,-3149824,-1
8047,380,18,12,0.045093153,0.954906847,2422.337998,2572.975191,4241.665217,3628.152632,8427,920.9836066,16854,-4120064,194560,-3925504,-1
7588,730,22,8,0.0877614811,0.912238519,2377.564031,2630.677099,4146.71679,4292.375342,8318,228.4537215,16636,-3885056,373760,-3511296,-1
1344,177,19,11,0.116370809,0.883629191,422.4995615,540.8445087,749.4456845,848.7344633,1521,43.13669881,3042,-688128,90624,-597504,-1
652,98,18,12,0.130666667,0.869333333,202.4408804,266.2826526,358.2377301,490.3469388,750,14.90164912,1500,-333824,50176,-283648,-1
503,84,17,13,0.143100511,0.856899489,162.2336653,186.2905619,308.1232604,209.4285714,587,53.95220588,1174,-257536,43008,-214528,-1
240,52,26,4,0.178082192,0.821917808,83.7719597,83.36514063,151.1458333,125.0576923,292,26.66666667,584,-122880,26624,-96256,-1
933,226,20,10,0.194995686,0.805004314,322.8738845,360.5185268,554.5401929,685.1061947,1159,80.76655052,2318,-477696,115712,-361984,-1
309,63,18,12,0.169354839,0.830645161,100.6210602,135.7396208,187.0647249,183.7301587,372,40.78947368,744,-158208,32256,-125952,-1
1263,165,20,10,0.115546218,0.884453782,399.2631769,490.2514287,726.858274,619.9030303,1428,29.01259651,2856,-646656,84480,-562176,-1
465,63,26,4,0.119318182,0.880681818,144.393885,194.2018843,257.4193548,316.7619048,528,14.82313307,1056,-238080,32256,-205824,-1
6689,454,20,10,0.0635587288,0.936441271,2034.091457,2381.698944,3538.249963,4069.255507,7143,168.2685512,14286,-3424768,232448,-3192320,-1
207,36,21,9,0.148148148,0.851851852,69.75536044,54.88092469,129.5700483,78.47222222,243,47.74066798,486,-105984,18432,-87552,-1
4853,208,21,9,0.0410985971,0.958901403,1453.952481,1605.115828,2522.997733,2717.706731,5061,315.3271028,10122,-2484736,106496,-2378240,-1
948,106,18,12,0.10056926,0.89943074,293.9243833,350.5410167,544.2700422,377.5188679,1054,30.63953488,2108,-485376,54272,-431104,-1
3307,264,27,3,0.0739288715,0.926071129,1022.594512,1128.622651,1783.062897,1822.791667,3571,75.94640578,7142,-1693184,135168,-1558016,-1
1552,80,16,14,0.0490196078,0.950980392,463.2244342,529.1691075,831.1559278,532.175,1632,173.6170213,3264,-794624,40960,-753664,-1
9426,542,20,10,0.0543739968,0.945626003,2855.854456,3048.558,5044.358795,3943.487085,9968,956.621881,19936,-4826112,277504,-4548608,-1
9356,592,20,10,0.0595094491,0.940490551,2852.579138,2943.333243,5044.92454,3861.506757,9948,1245.05632,19896,-4790272,303104,-4487168,-1
96,39,17,13,0.288888889,0.711111111,39.16116983,34.87539574,73.58333333,54.25641026,135,22.72727273,270,-49152,19968,-29184,-1
4033,570,20,10,0.123832283,0.876167717,1317.6859,1331.51197,2242.793702,2720.910526,4603,90.44999017,9206,-2064896,291840,-1773056,-1
7041,480,20,10,0.0638213004,0.9361787,2169.050932,2000.799442,3821.550348,2872.802083,7521,462.5461255,15042,-3604992,245760,-3359232,-1
2759,139,22,8,0.0479641132,0.952035887,826.2611964,1020.030104,1449.517216,1449.158273,2898,179.6652201,5796,-1412608,71168,-1341440,-1
1909,121,27,3,0.0596059113,0.940394089,580.5353164,591.896126,996.6715558,1312.553719,2030,147.6363636,4060,-977408,61952,-915456,-1
110,24,19,11,0.179104478,0.820895522,37.549236,28.36490276,74.01818182,37.625,134,37.85310734,268,-56320,12288,-44032,-1
9237,694,27,3,0.0698821871,0.930117813,2835.141245,3246.899373,4945.312764,5241.342939,9931,852.4463519,19862,-4729344,355328,-4374016,-1
2462,583,24,6,0.191461412,0.808538588,858.3760199,935.7390819,1476.110479,1721.013722,3045,56.03606919,6090,-1260544,298496,-962048,-1
9427,539,17,13,0.0540838852,0.945916115,2854.373382,3209.301202,5010.677204,4508.176252,9966,526.4659271,19932,-4826624,275968,-4550656,-1
1886,228,25,5,0.107852412,0.892147588,584.3942276,674.3647961,1105.027572,664.3552632,2114,125.4599407,4228,-965632,116736,-848896,-1
2998,176,25,5,0.0554505356,0.944549464,914.617669,939.7076841,1592.451301,1503.159091,3174,168.5608072,6348,-1534976,90112,-1444864,-1
225,50,25,5,0.181818182,0.818181818,78.7410112,79.46945073,142.24,118.92,275,24.42273535,550,-115200,25600,-89600,-1
4113,904,21,9,0.180187363,0.819812637,1421.845793,1418.480828,2378.401653,3103.193584,5017,128.2792125,10034,-2105856,462848,-1643008,-1
5817,1141,21,9,0.163983903,0.836016097,1814.436162,2097.217613,3147.803679,5170.540754,6958,140.7077856,13916,-2978304,584192,-2394112,-1
121,21,21,9,0.147887324,0.852112676,39.37927466,36.39503592,76.81818182,40.85714286,142,18.15856777,284,-61952,10752,-51200,-1
4271,1095,19,11,0.204062616,0.795937384,1453.778924,1499.19124,2425.983376,3687.93242,5366,99.49935101,10732,-2186752,560640,-1626112,-1
3243,176,27,3,0.0514770401,0.94852296,984.757532,1027.068953,1710.196423,1706.380682,3419,98.75794339,6838,-1660416,90112,-1570304,-1
3775,305,21,9,0.074754902,0.925245098,1152.202967,1428.332832,2063.169536,1759.918033,4080,292.2636103,8160,-1932800,156160,-1776640,-1
8657,1217,22,8,0.123252988,0.876747012,2857.390942,2795.644311,4958.020677,4791.528348,9874,275.1184174,19748,-4432384,623104,-3809280,-1
9489,485,22,8,0.0486264287,0.951373571,2861.485057,2988.004346,5045.568658,3851.389691,9974,1375.724138,19948,-4858368,248320,-4610048,-1
646,109,20,10,0.144370861,0.855629139,213.0651122,236.7381157,387.7894737,319.9816514,755,59.87311657,1510,-330752,55808,-274944,-1
1527,113,19,11,0.068902439,0.931097561,468.5395761,526.506146,827.3261297,728.2566372,1640,99.15356711,3280,-781824,57856,-723968,-1
9590,392,19,11,0.0392706872,0.960729313,2864.513285,3114.767286,5031.509593,4012.693878,9982,1276.470588,19964,-4910080,200704,-4709376,-1
4297,680,20,10,0.136628491,0.863371509,1358.458891,1537.140885,2335.904119,3456.430882,4977,223.6853933,9954,-2200064,348160,-1851904,-1
3659,418,24,6,0.102526367,0.897473633,1145.955421,1418.999469,2043.040995,2003.626794,4077,127.8056426,8154,-1873408,214016,-1659392,-1
9345,610,22,8,0.0612757408,0.938724259,2876.593167,2808.915971,4999.816265,4643.781967,9955,769.9149265,19910,-4784640,312320,-4472320,-1
9570,418,20,10,0.0418502203,0.95814978,2867.474089,3041.650071,5040.223302,3947.677033,9988,1111.012236,19976,-4899840,214016,-4685824,-1
571,70,24,6,0.109204368,0.890795632,176.6669812,239.4975932,316.3905429,358.6,641,17.83031989,1282,-292352,35840,-256512,-1
2294,198,16,14,0.0794542536,0.920545746,714.3837859,759.9154857,1259.059285,1100.989899,2492,148.0689245,4984,-1174528,101376,-1073152,-1
4148,570,22,8,0.120813904,0.879186096,1368.755076,1268.557668,2316.596673,2671.715789,4718,94.11530022,9436,-2123776,291840,-1831936,-1
9521,446,20,10,0.0447476673,0.955252333,2869.64221,3019.294053,4997.929209,4686.64574,9967,1452.915452,19934,-4874752,228352,-4646400,-1
7376,406,21,9,0.0521716782,0.947828322,2230.026279,2438.968131,3926.858731,3249.12069,7782,145.7030519,15564,-3776512,207872,-3568640,-1
2646,169,20,10,0.060035524,0.939964476,803.6288757,937.5878179,1402.185941,1499.029586,2815,137.5183195,5630,-1354752,86528,-1268224,-1
6166,2216,21,9,0.264376044,0.735623956,1935.553201,1839.206633,3301.379014,6668.25361,8382,173.4326505,16764,-3156992,1134592,-2022400,-1
432,19,27,3,0.0421286031,0.957871397,129.3138225,148.3367062,226.4884259,214.8947368,451,8.415749207,902,-221184,9728,-211456,-1
683,101,18,12,0.128826531,0.871173469,214.9403251,271.7302863,377.7994143,491.9108911,784,33.03834808,1568,-349696,51712,-297984,-1
6735,561,19,11,0.0768914474,0.923108553,2084.569946,2315.756244,3616.472309,4033.003565,7296,345.12772,14592,-3448320,287232,-3161088,-1
7115,269,22,8,0.0364301192,0.963569881,2117.429143,2375.660754,3718.475755,3005.446097,7384,135.2133309,14768,-3642880,137728,-3505152,-1
3714,287,19,11,0.071732067,0.928267933,1155.586049,1144.369456,2007.035541,1922.89547,4001,79.51112878,8002,-1901568,146944,-1754624,-1
8272,366,22,8,0.0423709192,0.957629081,2475.294621,2713.098624,4360.8044,3385.97541,8638,239.2797784,17276,-4235264,187392,-4047872,-1
8340,600,19,11,0.067114094,0.932885906,2530.114269,3196.211112,4456.233094,4668.81,8940,196.2678375,17880,-4270080,307200,-3962880,-1
3051,409,21,9,0.118208092,0.881791908,991.4989748,1008.087041,1692.729269,2012.256724,3460,64.96432595,6920,-1562112,209408,-1352704,-1
68,22,19,11,0.244444444,0.755555556,26.45780737,21.27627204,48.88235294,35.04545455,90,14.70588235,180,-34816,11264,-23552,-1
9189,731,21,9,0.0736895161,0.926310484,2882.28805,2554.456254,5004.456633,4407.94528,9920,340.8934708,19840,-4704768,374272,-4330496,-1
2164,442,17,13,0.169608596,0.830391404,745.5419528,758.4130804,1266.176525,1486.233032,2606,51.14818449,5212,-1107968,226304,-881664,-1
9528,450,21,9,0.0450992183,0.954900782,2867.077171,2976.555417,5036.975546,3984.284444,9978,941.3207547,19956,-4878336,230400,-4647936,-1
8459,407,27,3,0.0459057072,0.954094293,2557.258245,2519.706443,4464.270363,3793.97543,8866,611.026878,17732,-4331008,208384,-4122624,-1
1462,146,19,11,0.0907960199,0.90920398,446.4716585,612.4369754,800.2804378,846.7534247,1608,55.08735868,3216,-748544,74752,-673792,-1
97,23,19,11,0.191666667,0.808333333,33.61751501,26.97622001,66.40206186,35.60869565,120,30.92783505,240,-49664,11776,-37888,-1
1041,204,17,13,0.163855422,0.836144578,365.8178974,317.0237174,635.5629203,558.8921569,1245,23.6332574,2490,-532992,104448,-428544,-1
4996,436,27,3,0.0802650957,0.919734904,1551.328413,1731.155382,2695.849279,2953.130734,5432,249.8620055,10864,-2557952,223232,-2334720,-1
1368,176,22,8,0.113989637,0.886010363,438.9035795,471.4159796,790.9685673,628.9488636,1544,33.16863588,3088,-700416,90112,-610304,-1
9583,404,16,14,0.0404525884,0.959547412,2858.419694,3255.791421,5036.494313,3986.022277,9987,1110.901001,19974,-4906496,206848,-4699648,-1
8997,923,20,10,0.0930443548,0.906955645,2766.899026,3396.673925,4823.244081,6298.410618,9920,934.9670123,19840,-4606464,472576,-4133888,-1
4226,830,20,10,0.164161392,0.835838608,1394.165505,1514.585611,2369.288452,3339.136145,5056,98.38489979,10112,-2163712,424960,-1738752,-1
2816,168,22,8,0.0563002681,0.943699732,851.3716823,1006.788979,1499.942827,1367.744048,2984,126.3871241,5968,-1441792,86016,-1355776,-1
1558,174,21,9,0.100461894,0.899538106,488.2541026,594.745193,867.3799743,858.6206897,1732,53.07998774,3464,-797696,89088,-708608,-1
5292,482,20,10,0.0834776585,0.916522342,1640.617791,1875.835145,2927.517952,2448.13278,5774,249.2015537,11548,-2709504,246784,-2462720,-1
9171,766,18,12,0.0770856395,0.92291436,2807.351119,3511.8054,4987.935013,4742.298956,9937,610.0061387,19874,-4695552,392192,-4303360,-1
880,91,19,11,0.0937178167,0.906282183,266.3687348,386.9083122,481.0409091,533.956044,971,86.54188948,1942,-450560,46592,-403968,-1
2305,292,18,12,0.112437428,0.887562572,748.3176944,752.081794,1312.410412,1193.140411,2597,66.38548057,5194,-1180160,149504,-1030656,-1
4284,1242,19,11,0.2247557,0.7752443,1590.852472,1597.690896,2712.389122,2939.795491,5526,104.6789165,11052,-2193408,635904,-1557504,-1
4443,262,21,9,0.055685441,0.944314559,1349.739324,1470.859582,2368.226874,2094.782443,4705,343.6815194,9410,-2274816,134144,-2140672,-1
8858,1028,20,10,0.103985434,0.896014566,2801.476061,3140.553824,4843.227704,5807.519455,9886,532.9380054,19772,-4535296,526336,-4008960,-1
7939,347,21,9,0.0418778663,0.958122134,2389.858201,2374.042269,4167.534324,3593.619597,8286,677.5143091,16572,-4064768,177664,-3887104,-1
34,17,20,10,0.333333333,0.666666667,14.82142842,14.37293689,26.82352941,24.35294118,51,5.561613959,102,-17408,8704,-8704,-1
1839,163,16,14,0.0814185814,0.918581419,567.9814271,673.5351113,993.468733,1092.110429,2002,149.6263079,4004,-941568,83456,-858112,-1
9494,481,20,10,0.0482205514,0.951779449,2861.274262,3076.174179,5034.837792,4063.513514,9975,713.0092924,19950,-4860928,246272,-4614656,-1
9575,399,20,10,0.0400040104,0.95999599,2862.121242,3093.460918,5029.929713,3969.293233,9974,1416.761364,19948,-4902400,204288,-4698112,-1
9471,495,17,13,0.0496688742,0.950331126,2869.207347,2962.408664,5013.670573,4406.236364,9966,649.2508143,19932,-4849152,253440,-4595712,-1
3276,383,27,3,0.104673408,0.895326592,1029.839916,1252.029994,1845.478938,1697.600522,3659,67.80948851,7318,-1677312,196096,-1481216,-1
1277,421,20,10,0.247938751,0.752061249,493.3330089,480.4382548,850.4455756,846.631829,1698,31.69684525,3396,-653824,215552,-438272,-1
4227,469,21,9,0.0998722317,0.900127768,1324.565597,1521.314075,2293.456825,2844.592751,4696,145.0725981,9392,-2164224,240128,-1924096,-1
9551,421,19,11,0.042218211,0.957781789,2869.982935,2995.742189,5015.27683,4333.655582,9972,1257.503153,19944,-4890112,215552,-4674560,-1
7733,569,21,9,0.0685377018,0.931462298,2364.851258,2764.499616,4179.402431,3772.29174,8302,179.3088553,16604,-3959296,291328,-3667968,-1
2703,221,21,9,0.0755813953,0.924418605,834.9626466,931.3196034,1448.331853,1635.78733,2924,144.25259,5848,-1383936,113152,-1270784,-1
9238,695,22,8,0.0699687909,0.930031209,2842.524661,3173.32594,4981.649924,4772.271942,9933,628.2732448,19866,-4729856,355840,-4374016,-1
1864,244,17,13,0.115749526,0.884250474,610.8600081,585.8220473,1063.533798,985.4877049,2108,77.75728513,4216,-954368,124928,-829440,-1
329,53,17,13,0.138743455,0.861256545,104.8722865,123.3961485,201.1276596,131.7358491,382,36.4851958,764,-168448,27136,-141312,-1
5062,1008,18,12,0.166062603,0.833937397,1635.896708,1825.257823,2797.100751,4232.699405,6070,141.9550982,12140,-2591744,516096,-2075648,-1
9485,483,20,10,0.0484550562,0.951544944,2855.585551,3016.557264,5048.292145,3731.770186,9968,1403.943662,19936,-4856320,247296,-4609024,-1
9208,721,25,5,0.0726155706,0.927384429,2846.021878,3108.079251,4978.350348,4794.500693,9929,760.8429119,19858,-4714496,369152,-4345344,-1
5465,276,20,10,0.0480752482,0.951924752,1640.903169,1832.490533,2904.359012,2210.467391,5741,200.8044771,11482,-2798080,141312,-2656768,-1
77,32,18,12,0.293577982,0.706422018,30.86588708,31.93646035,57.7012987,48.5,109,7.853025937,218,-39424,16384,-23040,-1
3100,433,19,11,0.122558732,0.877441268,1009.723295,1089.409407,1762.701935,1797.771363,3533,130.0810015,7066,-1587200,221696,-1365504,-1
7588,392,20,10,0.049122807,0.950877193,2297.647585,2385.330425,4009.979178,3613.438776,7980,172.8395062,15960,-3885056,200704,-3684352,-1
9470,495,21,9,0.0496738585,0.950326141,2862.572194,3130.069766,4990.767899,4834.389899,9965,1125.988701,19930,-4848640,253440,-4595200,-1
204,32,21,9,0.13559322,0.86440678,67.70361713,46.50024151,126.2794118,68.90625,236,32.73231623,472,-104448,16384,-88064,-1
9495,461,27,3,0.0463037364,0.953696264,2877.99368,2791.564551,4978.891311,4970.440347,9956,1122.435175,19912,-4861440,236032,-4625408,-1
47,23,20,10,0.328571429,0.671428571,20.47518345,19.35080583,36.85106383,32.73913043,70,21.34146341,140,-24064,11776,-12288,-1
4399,187,20,10,0.0407762756,0.959223724,1315.365082,1501.469389,2300.196863,2135.962567,4586,179.0706755,9172,-2252288,95744,-2156544,-1
9470,482,22,8,0.0484324759,0.951567524,2866.113503,3002.970021,4975.581098,4994.553942,9952,696.4310707,19904,-4848640,246784,-4601856,-1
485,54,20,10,0.100185529,0.899814471,149.1994569,190.9664684,277.6536082,201.2592593,539,73.53342428,1078,-248320,27648,-220672,-1
3800,217,20,10,0.0540204132,0.945979587,1146.800049,1349.621391,2020.178684,1813.24424,4017,240.5389222,8034,-1945600,111104,-1834496,-1
2143,232,27,3,0.0976842105,0.902315789,683.3815878,687.5846657,1204.381241,1036.685345,2375,59.62842079,4750,-1097216,118784,-978432,-1
9111,805,21,9,0.0811819282,0.918818072,2835.23014,3147.972512,4976.044013,4759.936646,9916,726.4468864,19832,-4664832,412160,-4252672,-1
9480,488,22,8,0.0489566613,0.951043339,2833.45282,3600.437856,5007.238397,4542.778689,9968,977.254902,19936,-4853760,249856,-4603904,-1
500,37,20,10,0.0689013035,0.931098696,150.6021986,161.595962,278.076,146.3513514,537,25.01164415,1074,-256000,18944,-237056,-1
9475,483,27,3,0.0485037156,0.951496284,2858.723002,2926.205321,5040.18723,3789,9958,922.8915663,19916,-4851200,247296,-4603904,-1
59,16,24,6,0.213333333,0.786666667,22.4320225,17.30065028,39.55932203,32.25,75,2.222880854,150,-30208,8192,-22016,-1
128,29,19,11,0.184713376,0.815286624,43.98046164,32.35941881,87.015625,43.62068966,157,38.7654321,314,-65536,14848,-50688,-1
8692,1210,18,12,0.122197536,0.877802464,2831.206364,2607.845776,4745.944087,6428.104959,9902,201.8756371,19804,-4450304,619520,-3830784,-1
9539,432,21,9,0.0433256444,0.956674356,2870.622934,3000.027709,5008.999057,4478.157407,9971,849.318569,19942,-4883968,221184,-4662784,-1
5045,412,22,8,0.0754993586,0.924500641,1543.175827,1833.745072,2682.835084,3294.296117,5457,144.5945946,10914,-2583040,210944,-2372096,-1
607,68,17,13,0.100740741,0.899259259,188.9576307,215.8760873,349.4283361,235.9852941,675,88.69908016,1350,-310784,34816,-275968,-1
9422,535,21,9,0.0537310435,0.946268957,2843.549468,3101.137884,5051.96869,3693.93271,9957,678.2697548,19914,-4824064,273920,-4550144,-1
5919,362,18,12,0.0576341347,0.942365865,1792.290322,1806.195985,3207.538604,2053.038674,6281,470.1347305,12562,-3030528,185344,-2845184,-1
168,27,20,10,0.138461538,0.861538462,54.86974081,36.59825267,105.9107143,48.77777778,195,42.95154185,390,-86016,13824,-72192,-1
9276,660,21,9,0.0664251208,0.933574879,2826.828321,3222.369595,4894.427447,6009.556061,9936,738.7360595,19872,-4749312,337920,-4411392,-1
296,32,20,10,0.0975609756,0.902439024,93.61218626,85.14316987,170.6486486,107.625,328,16.37543684,656,-151552,16384,-135168,-1
3493,205,21,9,0.0554353705,0.94456463,1068.994559,1038.479085,1854.440882,1765.312195,3698,195.8686441,7396,-1788416,104960,-1683456,-1
9190,737,21,9,0.0742419664,0.925758034,2828.464187,3203.064454,5023.508596,4221.959294,9927,629.4863665,19854,-4705280,377344,-4327936,-1
2217,91,21,9,0.0394280763,0.960571924,661.6116511,740.8705651,1163.077582,945.5274725,2308,428.2003711,4616,-1135104,46592,-1088512,-1
4834,512,23,7,0.0957725402,0.90422746,1513.513811,1653.550544,2601.869466,3349.792969,5346,107.8910192,10692,-2475008,262144,-2212864,-1
4709,184,25,5,0.0376047415,0.962395259,1406.758742,1534.957289,2455.771077,2222.527174,4893,544.8775056,9786,-2411008,94208,-2316800,-1
9544,426,21,9,0.0427281846,0.957271815,2876.820596,2859.350685,5008.248009,4475.859155,9970,579.6511628,19940,-4886528,218112,-4668416,-1
501,93,24,6,0.156565657,0.843434343,166.5813964,194.423308,293.6487026,318.2473118,594,40.57377049,1188,-256512,47616,-208896,-1
112,13,21,9,0.104,0.896,34.89779972,31.56809115,66.52678571,32.61538462,125,14.51800232,250,-57344,6656,-50688,-1
2358,355,23,7,0.130851456,0.869148544,785.3044723,763.2308236,1343.935963,1443.774648,2713,153.0174845,5426,-1207296,181760,-1025536,-1
5224,447,19,11,0.0788220772,0.921177923,1589.529034,1970.48388,2772.909265,3573.328859,5671,166.7941176,11342,-2674688,228864,-2445824,-1
155,27,22,8,0.148351648,0.851648352,50.80549103,52.19994271,96.74193548,61.40740741,182,26.03719599,364,-79360,13824,-65536,-1
1331,173,22,8,0.115026596,0.884973404,425.8277712,470.8281585,770.6363636,612.9653179,1504,37.4501992,3008,-681472,88576,-592896,-1
3262,307,22,8,0.0860184926,0.913981507,1031.831977,855.2150521,1833.961373,1264.765472,3569,142.3046252,7138,-1670144,157184,-1512960,-1
3851,327,27,3,0.0782671135,0.921732887,1193.748003,1254.668881,2128.520904,1629.960245,4178,102.3267205,8356,-1971712,167424,-1804288,-1
5981,756,22,8,0.11221612,0.88778388,1940.215692,1972.422014,3347.413476,3539.779101,6737,138.5358832,13474,-3062272,387072,-2675200,-1
9232,706,19,11,0.0710404508,0.928959549,2875.317553,2757.59458,4997.12305,4608.287535,9938,367.8016284,19876,-4726784,361472,-4365312,-1
9093,822,20,10,0.0829046899,0.91709531,2837.289106,3095.124264,4995.12867,4547.281022,9915,476.6826923,19830,-4655616,420864,-4234752,-1
8697,1169,17,13,0.118487736,0.881512264,2884.542131,2355.401554,5060.206048,3990.846022,9866,241.5177479,19732,-4452864,598528,-3854336,-1
141,31,19,11,0.180232558,0.819767442,49.29791774,31.19573332,94.58865248,49.70967742,172,39.63133641,344,-72192,15872,-56320,-1
2028,152,17,13,0.0697247706,0.930275229,616.8822706,746.2230906,1105.978797,883.9802632,2180,211.856171,4360,-1038336,77824,-960512,-1
6396,922,20,10,0.125990708,0.874009292,2097.619008,2087.050985,3560.255629,4347.967462,7318,159.6074155,14636,-3274752,472064,-2802688,-1
7046,294,27,3,0.0400544959,0.959945504,2103.882163,2367.712478,3644.614107,4290.880952,7340,745.177665,14680,-3607552,150528,-3457024,-1
121,25,20,10,0.171232877,0.828767123,39.03941185,53.59767159,75.59504132,63.36,146,21.72619048,292,-61952,12800,-49152,-1
5980,575,27,3,0.0877192982,0.912280702,1879.529451,2006.29,3299.550334,3053.876522,6555,233.1081081,13110,-3061760,294400,-2767360,-1
6965,912,21,9,0.115780119,0.884219881,2264.851595,2155.057682,3826.168557,4800.700658,7877,167.7385009,15754,-3566080,466944,-3099136,-1
597,59,20,10,0.0899390244,0.910060976,182.1945922,167.6573433,346.0703518,150.7118644,656,114.2857143,1312,-305664,30208,-275456,-1
6514,622,21,9,0.0871636771,0.912836323,2002.989762,2562.65956,3539.433835,3872.900322,7136,201.8099548,14272,-3335168,318464,-3016704,-1
3270,351,20,10,0.0969345485,0.903065452,1050.576861,986.0955358,1797.671254,1935.173789,3621,85.30035336,7242,-1674240,179712,-1494528,-1
7149,1010,21,9,0.12378968,0.87621032,2360.390144,2279.989127,4024.017765,4476.254455,8159,181.3111111,16318,-3660288,517120,-3143168,-1
694,78,21,9,0.101036269,0.898963731,214.0852822,282.6741587,379.8775216,445.4230769,772,91.79548157,1544,-355328,39936,-315392,-1
559,47,20,10,0.0775577558,0.922442244,171.7856859,182.1277018,311.745975,205.4255319,606,11.42964919,1212,-286208,24064,-262144,-1
8887,1013,21,9,0.102323232,0.897676768,2801.197268,3297.497449,4914.956003,5262.325765,9900,542.1686747,19800,-4550144,518656,-4031488,-1
1898,137,27,3,0.0673218673,0.932678133,576.1526232,707.4820615,1006.597998,1175.963504,2035,48.45238095,4070,-971776,70144,-901632,-1
42,17,21,9,0.288135593,0.711864407,17.30978581,15.67401482,31.54761905,26.17647059,59,1.659634318,118,-21504,8704,-12800,-1
9466,491,24,6,0.0493120418,0.950687958,2866.389963,2963.072336,5009.41686,4392.592668,9957,307.5046325,19914,-4846592,251392,-4595200,-1
922,49,22,8,0.0504634398,0.94953656,277.0093022,310.5786259,492.6832972,360.244898,971,111.9953864,1942,-472064,25088,-446976,-1
3806,201,22,8,0.0501622161,0.949837784,1150.375535,1267.729603,1999.373095,2091.61194,4007,144.2924019,8014,-1948672,102912,-1845760,-1
288,45,17,13,0.135135135,0.864864865,92.42789565,87.98769835,178.2222222,95.17777778,333,66.46706587,666,-147456,23040,-124416,-1
429,74,20,10,0.147117296,0.852882704,140.5364476,159.4514708,261.2750583,198.2297297,503,36.50217707,1006,-219648,37888,-181760,-1
4500,496,22,8,0.0992794235,0.900720576,1431.232842,1516.244542,2471.330222,2745,4996,128.8957688,9992,-2304000,253952,-2050048,-1
7530,373,24,6,0.0471972669,0.952802733,2272.178237,2434.916969,3969.002125,3608.766756,7903,197.9213624,15806,-3855360,190976,-3664384,-1
9508,467,20,10,0.0468170426,0.953182957,2873.366443,2980.066878,5005.51199,4631.460385,9975,823.019802,19950,-4868096,239104,-4628992,-1
6884,306,21,9,0.0425591099,0.95744089,2065.504955,2218.482655,3620.272952,3038.189542,7190,291.0931174,14380,-3524608,156672,-3367936,-1
106,27,19,11,0.203007519,0.796992481,38.41628515,22.67537959,74.01886792,39.44444444,133,37.57062147,266,-54272,13824,-40448,-1
9317,624,22,8,0.062770345,0.937229655,2865.546829,2929.815682,4977.079425,4880.227564,9941,962.3426912,19882,-4770304,319488,-4450816,-1
3692,486,22,8,0.1163236,0.8836764,1194.085743,1293.585038,2088.547129,2096.738683,4178,77.442076,8356,-1890304,248832,-1641472,-1
222,46,22,8,0.171641791,0.828358209,72.67554613,76.7552391,145.6396396,80.73913043,268,7.870778267,536,-113664,23552,-90112,-1
9612,372,22,8,0.0372596154,0.962740385,2875.419659,3049.901616,4990.270703,5050.102151,9984,443.5362061,19968,-4921344,190464,-4730880,-1
8196,323,27,3,0.0379152483,0.962084752,2449.10677,2605.651876,4287.830649,3553.80805,8519,609.8067287,17038,-4196352,165376,-4030976,-1
632,150,26,4,0.191815857,0.808184143,225.2278617,215.3640545,375.5917722,458.5266667,782,36.52498832,1564,-323584,76800,-246784,-1
2724,178,20,10,0.061337009,0.938662991,827.4637371,902.3808836,1475.958884,1077.196629,2902,70.45399369,5804,-1394688,91136,-1303552,-1
1957,107,18,12,0.0518410853,0.948158915,590.9642328,663.3626809,1040.118038,893.1682243,2064,158.6471945,4128,-1001984,54784,-947200,-1
3330,231,19,11,0.0648694187,0.935130581,1006.470532,1272.405755,1798.531532,1528.272727,3561,306.9827586,7122,-1704960,118272,-1586688,-1
8978,914,20,10,0.0923978973,0.907602103,2832.690538,2997.042564,4881.390956,5586.050328,9892,771.005456,19784,-4596736,467968,-4128768,-1
3055,175,25,5,0.0541795666,0.945820433,920.7192899,1030.06037,1639.586252,1195.022857,3230,208.5216269,6460,-1564160,89600,-1474560,-1
5056,754,21,9,0.129776248,0.870223752,1566.049844,1728.005182,2697.087421,4303.025199,5810,112.4226006,11620,-2588672,386048,-2202624,-1
9575,405,19,11,0.0405811623,0.959418838,2866.480942,3136.364077,5017.765849,4345.881481,9980,244.3682664,19960,-4902400,207360,-4695040,-1
2215,244,20,10,0.0992273282,0.900772672,701.0928959,784.8775634,1230.726862,1223.401639,2459,69.81828507,4918,-1134080,124928,-1009152,-1
9494,475,21,9,0.0476477079,0.952352292,2863.238819,3084.122045,5017.426796,4336.873684,9969,999.8996991,19938,-4860928,243200,-4617728,-1
51,19,21,9,0.271428571,0.728571429,19.8224142,21.03591442,36.33333333,33.26315789,70,6.26118068,140,-26112,9728,-16384,-1
391,74,16,14,0.159139785,0.840860215,128.346633,144.6105599,245.6035806,166.4054054,465,111.2440191,930,-200192,37888,-162304,-1
1648,207,19,11,0.111590296,0.888409704,531.2305103,568.1824225,929.2651699,917.9275362,1855,41.84525152,3710,-843776,105984,-737792,-1
58,28,19,11,0.325581395,0.674418605,25.52064283,22.23996563,46.27586207,37.75,86,14.50252951,172,-29696,14336,-15360,-1
4223,439,21,9,0.0941655942,0.905834406,1322.282024,1518.082578,2298.639356,2647.605923,4662,260.4469274,9324,-2162176,224768,-1937408,-1
7602,1039,22,8,0.120240713,0.879759287,2499.587258,2354.534088,4231.22744,4977.834456,8641,181.4192736,17282,-3892224,531968,-3360256,-1
110,41,18,12,0.271523179,0.728476821,42.91368331,44.53896288,78.71818182,68.70731707,151,28.49056604,302,-56320,20992,-35328,-1
974,106,21,9,0.0981481481,0.901851852,303.2480512,266.1310789,568.7145791,281.245283,1080,24.67443454,2160,-498688,54272,-444416,-1
69,20,21,9,0.224719101,0.775280899,25.13535716,27.14221804,46.15942029,41,89,16.88804554,178,-35328,10240,-25088,-1
956,90,18,12,0.086042065,0.913957935,292.5400352,388.0056199,524.2845188,515.1666667,1046,105.8704453,2092,-489472,46080,-443392,-1
6948,615,26,4,0.0813169377,0.918683062,2155.298932,2475.557654,3789.691134,3695.108943,7563,143.211513,15126,-3557376,314880,-3242496,-1
546,74,18,12,0.119354839,0.880645161,172.4336085,214.1421178,317.6336996,257.8648649,620,53.31040413,1240,-279552,37888,-241664,-1
9523,453,22,8,0.0454089816,0.954591018,2869.775706,2974.222057,5026.309146,4193.673289,9976,703.5260931,19952,-4875776,231936,-4643840,-1
9254,583,21,9,0.0592660364,0.940733964,2812.859863,3109.954427,4864.346229,5786.523156,9837,415.9408034,19674,-4738048,298496,-4439552,-1
4639,258,22,8,0.0526853175,0.947314682,1404.776079,1540.669465,2463.727527,2184.189922,4897,179.6404989,9794,-2375168,132096,-2243072,-1
363,84,18,12,0.187919463,0.812080537,122.5626962,152.8194894,227.8264463,207.4642857,447,18.53233831,894,-185856,43008,-142848,-1
67,23,20,10,0.255555556,0.744444444,26.04935597,24.95993008,47.40298507,39.95652174,90,17.17557252,180,-34304,11776,-22528,-1
9556,418,21,9,0.0419089633,0.958091037,2871.430969,2958.438329,5019.685747,4251.69378,9974,604.1187159,19948,-4892672,214016,-4678656,-1
8915,994,17,13,0.100312847,0.899687153,2884.302025,2636.761953,4949.672911,5002.777666,9909,300.6371359,19818,-4564480,508928,-4055552,-1
9195,742,18,12,0.0746704237,0.925329576,2816.231506,3442.770575,4988.440348,4728.091644,9937,671.8728871,19874,-4707840,379904,-4327936,-1
2239,221,22,8,0.0898373984,0.910162602,698.671449,815.239198,1235.979902,1174.9819,2460,98.71589085,4920,-1146368,113152,-1033216,-1
4591,305,21,9,0.0622957516,0.937704248,1401.960539,1553.483665,2465.159007,2197.740984,4896,250.1788452,9792,-2350592,156160,-2194432,-1
8426,1233,21,9,0.127652966,0.872347034,2764.537234,2921.253693,4778.283052,5183.420114,9659,182.9356061,19318,-4314112,631296,-3682816,-1
2254,265,21,9,0.105200476,0.894799524,708.9243987,851.1305999,1241.638864,1416.173585,2519,77.89115646,5038,-1154048,135680,-1018368,-1
2496,185,21,9,0.0690041029,0.930995897,762.5870681,905.5906294,1332.478766,1455.967568,2681,207.6684741,5362,-1277952,94720,-1183232,-1
5290,404,20,10,0.0709518792,0.929048121,1620.426043,1684.911536,2915.697543,1954.517327,5694,187.3026316,11388,-2708480,206848,-2501632,-1
5774,476,22,8,0.07616,0.92384,1768.954146,2186.355988,3130.242639,3067.970588,6250,455.2075747,12500,-2956288,243712,-2712576,-1
663,101,21,9,0.132198953,0.867801047,215.8018473,248.6499361,385.3665158,363.6831683,764,17.06118803,1528,-339456,51712,-287744,-1
8743,1114,20,10,0.113016131,0.886983869,2813.76929,2919.031331,4809.963857,5863.2307,9857,595.2294686,19714,-4476416,570368,-3906048,-1
8321,556,25,5,0.0626337727,0.937366227,2544.510154,2763.378794,4475.064415,3899.266187,8877,329.2655786,17754,-4260352,284672,-3975680,-1
1250,81,20,10,0.0608564989,0.939143501,374.9719095,467.092202,678.2224,477.382716,1331,86.99346405,2662,-640000,41472,-598528,-1
5453,480,22,8,0.0809034215,0.919096578,1700.474419,1841.292796,2978.142674,2840.414583,5933,261.2505504,11866,-2791936,245760,-2546176,-1
1598,234,23,7,0.127729258,0.872270742,524.8840461,554.213748,911.9818523,947.3547009,1832,142.4572317,3664,-818176,119808,-698368,-1
4221,546,22,8,0.114537445,0.885462555,1362.791878,1453.01236,2414.921109,2144.956044,4767,120.9284627,9534,-2161152,279552,-1881600,-1
4742,305,22,8,0.0604319398,0.93956806,1448.198953,1415.785993,2568.662801,1829.603279,5047,189.3098275,10094,-2427904,156160,-2271744,-1
3940,266,19,11,0.0632429862,0.936757014,1217.922383,1142.036021,2115.670812,1923.225564,4206,218.3800623,8412,-2017280,136192,-1881088,-1
7052,1149,22,8,0.140104865,0.859895135,2315.658187,2438.692517,3939.3019,5093.423847,8201,174.2668933,16402,-3610624,588288,-3022336,-1
9524,449,17,13,0.0450215582,0.954978442,2871.153392,3010.980069,5006.22879,4579.126949,9973,1468.777614,19946,-4876288,229888,-4646400,-1
9293,645,22,8,0.0649023948,0.935097605,2835.494871,3227.553431,4919.505434,5689.809302,9938,703.3262562,19876,-4758016,330240,-4427776,-1
1909,323,15,15,0.144713262,0.855286738,629.2938444,726.6897738,1118.726035,1103.343653,2232,133.0948122,4464,-977408,165376,-812032,-1
3241,242,17,13,0.069480333,0.930519667,995.5076125,1078.921621,1766.260722,1417.086777,3483,262.6696833,6966,-1659392,123904,-1535488,-1
2879,417,22,8,0.12651699,0.87348301,923.1283084,1124.225118,1660.810351,1563.508393,3296,71.73014146,6592,-1474048,213504,-1260544,-1
1959,172,27,3,0.0807132802,0.91928672,609.974757,671.4214659,1065.29709,1074.005814,2131,149.5438596,4262,-1003008,88064,-914944,-1
1616,136,22,8,0.0776255708,0.922374429,496.764407,598.7299049,881.8966584,812.375,1752,84.59681313,3504,-827392,69632,-757760,-1
220,34,19,11,0.133858268,0.866141732,69.75642688,69.01206579,136.5,69.26470588,254,26.26680455,508,-112640,17408,-95232,-1
9295,646,20,10,0.0649834021,0.935016598,2833.543858,3346.877225,4967.75191,5017.735294,9941,702.5441696,19882,-4759040,330752,-4428288,-1
3477,872,22,8,0.200505863,0.799494137,1062.65614,1303.726994,1886.217141,3326.488532,4349,172.6478761,8698,-1780224,446464,-1333760,-1
1737,194,18,12,0.10046608,0.89953392,555.800682,563.869212,976.070236,875.8350515,1931,40.97178018,3862,-889344,99328,-790016,-1
521,47,17,13,0.0827464789,0.917253521,158.0732326,164.6106563,296.9692898,146.2765957,568,135.2380952,1136,-266752,24064,-242688,-1
8672,1181,21,9,0.119861971,0.880138029,2853.753752,2773.947232,4924.218865,4947.421677,9853,463.4524929,19706,-4440064,604672,-3835392,-1
695,125,16,14,0.152439024,0.847560976,230.4912352,262.3267256,420.1280576,356.968,820,47.18066743,1640,-355840,64000,-291840,-1
175,34,21,9,0.162679426,0.837320574,60.07859505,39.63470745,113.3885714,61.82352941,209,41.46825397,418,-89600,17408,-72192,-1
9502,466,17,13,0.0467495987,0.953250401,2862.867958,2953.540307,5038.481057,3883.796137,9968,998.7975952,19936,-4865024,238592,-4626432,-1
2471,231,17,13,0.085492228,0.914507772,776.1740517,749.4394141,1381.208418,1033.709957,2702,286.5323436,5404,-1265152,118272,-1146880,-1
5408,598,22,8,0.0995670996,0.9004329,1660.066798,1812.936172,2855.787537,4339.334448,6006,177.5872265,12012,-2768896,306176,-2462720,-1
9558,416,22,8,0.0417084419,0.958291558,2860.318055,3211.396232,5016.803411,4314.225962,9974,1044.397906,19948,-4893696,212992,-4680704,-1
5860,390,22,8,0.0624,0.9376,1780.819948,2123.125628,3131.273038,3038.75641,6250,118.9117199,12500,-3000320,199680,-2800640,-1
1187,188,20,10,0.136727273,0.863272727,391.6941032,386.5631163,715.2072452,516.2180851,1375,101.7011834,2750,-607744,96256,-511488,-1
1955,203,21,9,0.094068582,0.905931418,612.7614591,697.9562475,1094.26445,937.3103448,2158,63.50794585,4316,-1000960,103936,-897024,-1
3353,327,24,6,0.0888586957,0.911141304,1045.532567,1220.516211,1844.456606,1799.929664,3680,166.0649819,7360,-1716736,167424,-1549312,-1
3354,318,20,10,0.0866013072,0.913398693,1049.789645,1161.327567,1831.977639,1884.198113,3672,101.464493,7344,-1717248,162816,-1554432,-1
4377,466,20,10,0.0962213504,0.90377865,1361.378091,1663.620043,2384.469043,2774.517167,4843,89.10763569,9686,-2241024,238592,-2002432,-1
5066,307,20,10,0.0571375395,0.94286246,1533.314177,1781.988285,2708.464074,2332.807818,5373,177.737347,10746,-2593792,157184,-2436608,-1
3851,252,21,9,0.0614184743,0.938581526,1181.886681,1218.339492,2058.542197,1952.02381,4103,345.6613311,8206,-1971712,129024,-1842688,-1
2218,303,21,9,0.120190401,0.879809599,711.0291618,834.945329,1249.123535,1347.937294,2521,129.2157868,5042,-1135616,155136,-980480,-1
55,27,20,10,0.329268293,0.670731707,25.28155503,18.49687624,44.54545455,35.2962963,82,23.22946176,164,-28160,13824,-14336,-1
9457,510,21,9,0.0511688572,0.948831143,2866.396758,3019.890291,5013.339643,4439.95098,9967,413.9119601,19934,-4841984,261120,-4580864,-1
3443,186,27,3,0.0512537889,0.948746211,1041.664379,948.2553868,1849.421435,1177.833333,3629,313.6560069,7258,-1762816,95232,-1667584,-1
6534,727,20,10,0.10012395,0.89987605,2090.461508,2124.396175,3662.924549,3344.074278,7261,194.7170823,14522,-3345408,372224,-2973184,-1
68,20,19,11,0.227272727,0.772727273,25.84028583,16.24584562,49.01470588,29.15,88,16.73003802,176,-34816,10240,-24576,-1
3603,420,22,8,0.104399702,0.895600298,1130.341919,1363.183383,1977.141826,2311.033333,4023,99.90067047,8046,-1844736,215040,-1629696,-1
9152,463,16,14,0.0481539262,0.951846074,2754.943138,3067.561227,4844.722465,4082.116631,9615,360.9234234,19230,-4685824,237056,-4448768,-1
5773,236,17,13,0.0392744217,0.960725578,1723.374494,1902.631056,3028.456608,2431.207627,6009,570.6552707,12018,-2955776,120832,-2834944,-1
9357,581,21,9,0.0584624673,0.941537533,2841.922725,3148.450434,5023.202308,4104.624785,9938,848.676345,19876,-4790784,297472,-4493312,-1
6157,462,21,9,0.0697990633,0.930200937,1887.104289,2197.008117,3299.663148,3447.757576,6619,423.7516005,13238,-3152384,236544,-2915840,-1
643,57,17,13,0.0814285714,0.918571429,197.6389137,207.5050015,361.8242613,222.754386,700,94.85094851,1400,-329216,29184,-300032,-1
1912,138,19,11,0.0673170732,0.932682927,584.3467568,642.7472619,1042.326883,792.3623188,2050,167.4836601,4100,-978944,70656,-908288,-1
4920,593,20,10,0.10756394,0.89243606,1546.501262,1900.437106,2722.508537,3043.168634,5513,535.7628766,11026,-2519040,303616,-2215424,-1
5318,1098,21,9,0.171134663,0.828865337,1793.000113,1823.319121,3006.919519,4184.825137,6416,220.1784489,12832,-2722816,562176,-2160640,-1
5909,278,27,3,0.0449329239,0.955067076,1780.731584,1780.748819,3123.824167,2460.07554,6187,347.9752531,12374,-3025408,142336,-2883072,-1
3818,194,22,8,0.0483549352,0.951645065,1146.150551,1330.187077,2023.439235,1673.128866,4012,327.5102041,8024,-1954816,99328,-1855488,-1
4673,215,21,9,0.04398527,0.95601473,1402.778762,1460.730621,2471.596191,1855.567442,4888,280.4360298,9776,-2392576,110080,-2282496,-1
8666,641,20,10,0.0688728914,0.931127109,2643.301754,3122.411546,4598.893723,5399.00936,9307,240.8643892,18614,-4436992,328192,-4108800,-1
719,59,21,9,0.0758354756,0.924164524,224.1479338,225.5715267,393.0013908,346.8305085,778,45.8456099,1556,-368128,30208,-337920,-1
61,34,19,11,0.357894737,0.642105263,25.69531855,30.09483281,46.52459016,50.64705882,95,10.57906459,190,-31232,17408,-13824,-1
4222,149,23,7,0.0340883093,0.965911691,1256.276759,1382.555235,2195.479394,1917.395973,4371,490.5723906,8742,-2161664,76288,-2085376,-1
1883,75,18,12,0.0383043922,0.961695608,561.5691279,619.1298051,987.2734997,784.3333333,1958,183.3333333,3916,-964096,38400,-925696,-1
131,22,17,13,0.14379085,0.85620915,42.50852035,41.27422905,82.16030534,46.27272727,153,37.31707317,306,-67072,11264,-55808,-1
3956,851,20,10,0.177033493,0.822966507,1381.305276,1350.098816,2320.142568,2793.823737,4807,99.33870634,9614,-2025472,435712,-1589760,-1
9549,428,20,10,0.0428986669,0.957101333,2858.240124,3147.154303,5036.84679,3921.502336,9977,329.165292,19954,-4889088,219136,-4669952,-1
3752,242,18,12,0.0605908863,0.939409114,1131.152532,1403.114181,2020.313966,1643.789256,3994,293.2452276,7988,-1921024,123904,-1797120,-1
9078,329,23,7,0.0349739556,0.965026044,2708.623125,2846.576299,4723.840934,4156.534954,9407,187.8019565,18814,-4647936,168448,-4479488,-1
1375,95,25,5,0.0646258503,0.93537415,417.150074,517.3525097,736.2974545,723.9578947,1470,53.76737381,2940,-704000,48640,-655360,-1
3891,390,21,9,0.0911002102,0.90889979,1228.931781,1287.89791,2122.395271,2326.617949,4281,82.59695157,8562,-1992192,199680,-1792512,-1
3948,303,23,7,0.0712773465,0.928722653,1202.826902,1461.131195,2098.189716,2488.359736,4251,96.3727046,8502,-2021376,155136,-1866240,-1
1257,105,27,3,0.077092511,0.922907489,392.9187485,353.916769,695.7979316,510.3333333,1362,101.793722,2724,-643584,53760,-589824,-1
153,45,16,14,0.227272727,0.772727273,55.3962144,59.94264749,104.3202614,83.11111111,198,15.68938193,396,-78336,23040,-55296,-1
165,32,20,10,0.162436548,0.837563452,54.81365578,30.98027346,109.4363636,45.1875,197,41.91489362,394,-84480,16384,-68096,-1
3796,240,20,10,0.0594648167,0.940535183,1159.316215,1247.822129,2025.424658,1908.975,4036,140.6271777,8072,-1943552,122880,-1820672,-1
780,112,22,8,0.125560538,0.874439462,250.6658378,280.6841994,461.024359,345.3482143,892,74.5819398,1784,-399360,57344,-342016,-1
2984,334,22,8,0.10066305,0.89933695,940.5110125,1017.455395,1614.988941,2057.167665,3318,70.73118738,6636,-1527808,171008,-1356800,-1
9581,396,20,10,0.03969129,0.96030871,2859.168067,3165.024837,5033.107296,3921.848485,9977,606.8734793,19954,-4905472,202752,-4702720,-1
3548,436,24,6,0.109437751,0.890562249,1137.11544,1190.711657,2036.845265,1631.635321,3984,125.2436341,7968,-1816576,223232,-1593344,-1
9052,871,27,3,0.0877758742,0.912224126,2881.42793,2654.913496,4926.709236,5328.764638,9923,231.4132463,19846,-4634624,445952,-4188672,-1
9627,353,25,5,0.0353707415,0.964629259,2875.363171,3006.880496,5003.981199,4622.84136,9980,1135.381115,19960,-4929024,180736,-4748288,-1
5831,277,16,14,0.0453503602,0.95464964,1742.42177,2148.72388,3062.175785,2892.920578,6108,526.0981912,12216,-2985472,141824,-2843648,-1
9042,873,22,8,0.0880484115,0.911951589,2858.258142,2902.827366,4959.428113,4943.208477,9915,343.0795848,19830,-4629504,446976,-4182528,-1
2165,175,25,5,0.0747863248,0.925213675,673.5910458,629.1438252,1194.125635,878.2171429,2340,81.78958406,4680,-1108480,89600,-1018880,-1
2046,247,19,11,0.107719145,0.892280855,654.2196861,719.5281729,1154.662268,1083.530364,2293,78.66209262,4586,-1047552,126464,-921088,-1
917,81,15,15,0.0811623246,0.918837675,280.4881586,353.8741924,506.4591058,420.7160494,998,27.03141928,1996,-469504,41472,-428032,-1
2245,135,22,8,0.0567226891,0.943277311,684.0779534,725.6951481,1197.182628,1079.37037,2380,471.2871287,4760,-1149440,69120,-1080320,-1
124,31,19,11,0.2,0.8,44.90354155,34.02025472,84.27419355,52.90322581,155,41.77897574,310,-63488,15872,-47616,-1
5423,455,21,9,0.0774072814,0.922592719,1679.134357,1885.122805,2955.141435,2753.074725,5878,192.0915033,11756,-2776576,232960,-2543616,-1
8630,571,20,10,0.0620584719,0.937941528,2626.013452,2974.07419,4550.885747,5358.418564,9201,186.4059968,18402,-4418560,292352,-4126208,-1
235,53,21,9,0.184027778,0.815972222,80.19393153,74.73632302,156.4808511,91.37735849,288,29.66014418,576,-120320,27136,-93184,-1
1814,107,20,10,0.0557001562,0.944299844,549.5017234,603.1182753,972.1973539,771.1682243,1921,58.40681058,3842,-928768,54784,-873984,-1
9197,619,21,9,0.0630603097,0.93693969,2803.828092,2883.594596,5005.371643,3469.197092,9816,467.2060923,19632,-4708864,316928,-4391936,-1
9079,830,21,9,0.0837622364,0.916237764,2840.008585,3032.743686,4999.743364,4465.572289,9909,600.5454545,19818,-4648448,424960,-4223488,-1
4837,1065,21,9,0.180447306,0.819552694,1705.787458,1589.50294,2834.440976,3483.156808,5902,108.4527747,11804,-2476544,545280,-1931264,-1
1198,122,22,8,0.0924242424,0.907575758,379.162964,381.8312075,671.7721202,549.8114754,1320,199.6974281,2640,-613376,62464,-550912,-1
1609,190,22,8,0.10561423,0.89438577,518.7336243,488.4310214,921.2908639,719.7,1799,142.8911835,3598,-823808,97280,-726528,-1
1223,112,27,3,0.0838951311,0.916104869,382.4067903,373.6841556,684.1185609,491.9910714,1335,47.10656316,2670,-626176,57344,-568832,-1
9505,456,21,9,0.0457785363,0.954221464,2852.487984,3232.546482,5016.250921,4246.219298,9961,1065.347594,19922,-4866560,233472,-4633088,-1
880,71,20,10,0.0746582545,0.925341746,270.6201354,311.5551778,481.3306818,409.9295775,951,102.9220779,1902,-450560,36352,-414208,-1
5374,344,20,10,0.0601608954,0.939839105,1615.987069,2065.112823,2889.167659,2396.02907,5718,446.71875,11436,-2751488,176128,-2575360,-1
2269,252,21,9,0.0999603332,0.900039667,724.8470475,737.9697365,1276.97532,1117.15873,2521,75.88801927,5042,-1161728,129024,-1032704,-1
5068,376,20,10,0.0690668626,0.930933137,1544.625278,1849.089445,2692.010852,3133.454787,5444,120.6560284,10888,-2594816,192512,-2402304,-1
9464,498,21,9,0.0499899619,0.950010038,2861.656267,3024.74517,5023.204459,4188.947791,9962,1264.213198,19924,-4845568,254976,-4590592,-1
4816,523,19,11,0.0979584192,0.902041581,1504.896584,1801.743473,2709.741487,2304.043977,5339,177.0225464,10678,-2465792,267776,-2198016,-1
148,29,20,10,0.163841808,0.836158192,49.05519832,46.6525855,95.88513514,53.86206897,177,29.11184211,354,-75776,14848,-60928,-1
4660,227,20,10,0.0464497647,0.953550235,1398.819025,1526.01662,2472.139485,1866.334802,4887,297.6248477,9774,-2385920,116224,-2269696,-1
2759,105,21,9,0.0366620112,0.963337989,822.9419638,896.089427,1440.538238,1221.285714,2864,66.00599216,5728,-1412608,53760,-1358848,-1
2556,385,20,10,0.130907854,0.869092146,829.6335627,967.624609,1473.205008,1456.361039,2941,56.38420245,5882,-1308672,197120,-1111552,-1
2166,149,22,8,0.064362851,0.935637149,655.9281574,794.6618319,1173.310249,935.4362416,2315,50.77867953,4630,-1108992,76288,-1032704,-1
1193,139,20,10,0.104354354,0.895645646,381.9061012,406.183777,665.9052808,671.6043165,1332,87.11576194,2664,-610816,71168,-539648,-1
9426,531,21,9,0.0533293161,0.946670684,2855.009137,2816.394093,5062.045194,3504.830508,9957,189.9828277,19914,-4826112,271872,-4554240,-1
2962,268,21,9,0.0829721362,0.917027864,928.2084237,866.5950502,1654.733964,1181.876866,3230,148.9165514,6460,-1516544,137216,-1379328,-1
39,17,16,14,0.303571429,0.696428571,17.06875912,10.49633319,31.79487179,20.94117647,56,2.427394885,112,-19968,8704,-11264,-1
60,22,19,11,0.268292683,0.731707317,24.65041694,16.58486814,45.41666667,30.81818182,82,2.762803235,164,-30720,11264,-19456,-1
45,12,21,9,0.210526316,0.789473684,16.41041524,12.38166207,31.62222222,19.16666667,57,12.05073996,114,-23040,6144,-16896,-1
871,70,26,4,0.0743889479,0.925611052,272.1380723,265.106015,471.978186,458.8285714,941,87.04902868,1882,-445952,35840,-410112,-1
1575,138,22,8,0.0805604203,0.91943958,487.0552433,568.630251,862.6952381,792,1713,136.7118915,3426,-806400,70656,-735744,-1
61,24,19,11,0.282352941,0.717647059,25.68823689,19.07423364,46.18032787,34.91666667,85,17.67151767,170,-31232,12288,-18944,-1
4186,303,27,3,0.0674983292,0.932501671,1293.192835,1330.858334,2249.17678,2187.29703,4489,200.9400179,8978,-2143232,155136,-1988096,-1
2638,230,21,9,0.080195258,0.919804742,815.2307923,924.7723456,1456.527672,1181.852174,2868,148.7551867,5736,-1350656,117760,-1232896,-1
109,8,25,5,0.0683760684,0.931623932,32.74762385,37.32438044,60.8440367,33.875,117,12.42038217,234,-55808,4096,-51712,-1
441,103,16,14,0.189338235,0.810661765,148.6999637,170.2097058,289.5918367,199.3203883,544,76.19047619,1088,-225792,52736,-173056,-1
7639,457,21,9,0.0564476285,0.943552372,2322.352047,2556.870009,4064.334599,3783.816193,8096,245.8548436,16192,-3911168,233984,-3677184,-1
8071,484,17,13,0.0565751023,0.943424898,2445.899443,2523.597782,4353.371949,3021.126033,8555,592.4515235,17110,-4132352,247808,-3884544,-1
125,20,26,4,0.137931034,0.862068966,42.13242818,38.07791355,74.864,61.35,145,6.846081209,290,-64000,10240,-53760,-1
9374,486,22,8,0.0492900609,0.950709939,2826.085025,3211.794729,4932.618839,4889.631687,9860,188.9975081,19720,-4799488,248832,-4550656,-1
5328,1050,21,9,0.16462841,0.83537159,1635.317136,2094.81199,2897.222785,4672.598095,6378,125.1569859,12756,-2727936,537600,-2190336,-1
9419,541,20,10,0.0543172691,0.945682731,2855.835573,2904.858178,5054.625863,3689.942699,9960,899.7289973,19920,-4822528,276992,-4545536,-1
3613,218,22,8,0.0569042026,0.943095797,1093.287132,1297.414348,1915.87711,1918.036697,3831,299.5308835,7662,-1849856,111616,-1738240,-1
1261,147,18,12,0.104403409,0.895596591,402.2416682,440.9424357,704.5368755,704.1836735,1408,44.55696203,2816,-645632,75264,-570368,-1
460,83,21,9,0.152854512,0.847145488,147.5438106,188.9566152,260.9934783,333,543,31.69877408,1086,-235520,42496,-193024,-1
5929,383,22,8,0.0606780735,0.939321926,1793.093847,1844.033235,3234.293304,1952.227154,6312,117.3016168,12624,-3035648,196096,-2839552,-1
9242,707,21,9,0.0710624183,0.928937582,2863.19981,2779.664383,5055.225601,3926.280057,9949,677.7247956,19898,-4731904,361984,-4369920,-1
2121,202,19,11,0.0869565217,0.913043478,648.2604299,862.1523506,1173.380009,1042.509901,2323,106.0246463,4646,-1085952,103424,-982528,-1
6329,251,16,14,0.0381458967,0.961854103,1885.369437,2114.737505,3317.525517,2609.047809,6580,562.8742515,13160,-3240448,128512,-3111936,-1
3051,160,21,9,0.0498287138,0.950171286,920.5667213,983.6017289,1623.419207,1273.8375,3211,143.1564868,6422,-1562112,81920,-1480192,-1
5242,382,20,10,0.0679231863,0.932076814,1605.033923,1852.006862,2801.518504,2963.193717,5624,173.4731647,11248,-2683904,195584,-2488320,-1
9547,425,24,6,0.0426193341,0.957380666,2852.268301,3372.423792,5010.836388,4439.818824,9972,448.9869428,19944,-4888064,217600,-4670464,-1
9500,471,20,10,0.0472369873,0.952763013,2866.4005,2913.519192,5038.669895,3923.656051,9971,742.4422934,19942,-4864000,241152,-4622848,-1
668,70,23,7,0.0948509485,0.905149051,206.6430521,244.6682869,380.0284431,269.0285714,738,121.9834711,1476,-342016,35840,-306176,-1
9589,386,27,3,0.0386967419,0.961303258,2871.261207,2962.743471,5020.92189,4170.15544,9975,837.5314861,19950,-4909568,197632,-4711936,-1
2724,178,21,9,0.061337009,0.938662991,830.6547029,916.2329555,1464.642805,1250.370787,2902,110.6366756,5804,-1394688,91136,-1303552,-1
8594,614,20,10,0.0666811468,0.933318853,2609.917106,3258.767832,4603.224343,4622.355049,9208,302.1988841,18416,-4400128,314368,-4085760,-1
1111,49,21,9,0.0422413793,0.957758621,331.0888503,368.3250075,588.3951395,401.4897959,1160,150.8452536,2320,-568832,25088,-543744,-1
7655,523,21,9,0.0639520665,0.936047933,2340.319801,2570.915462,4129.810581,3499.48566,8178,173.7781555,16356,-3919360,267776,-3651584,-1
4768,1947,20,10,0.289947878,0.710052122,2099.055707,1239.740685,3084.300545,4028.261428,6715,123.1884058,13430,-2441216,996864,-1444352,-1
159,41,17,13,0.205,0.795,56.85202793,44.15349625,110.1886792,62.92682927,200,36.76470588,400,-81408,20992,-60416,-1
5029,208,23,7,0.0397173955,0.960282605,1501.519989,1679.702725,2637.681845,2167.3125,5237,340.9505208,10474,-2574848,106496,-2468352,-1
1629,118,17,13,0.0675443618,0.932455638,496.3311472,532.0523413,893.9748312,598.2457627,1747,278.1847134,3494,-834048,60416,-773632,-1
4533,443,20,10,0.0890273312,0.910972669,1424.449401,1553.313487,2484.508934,2529.3386,4976,99.73942674,9952,-2320896,226816,-2094080,-1
1304,165,20,10,0.112321307,0.887678693,417.4493855,444.2775216,754.3834356,581.8121212,1469,37.28426396,2938,-667648,84480,-583168,-1
9365,582,21,9,0.0585101035,0.941489896,2858.122028,3042.952983,5001.933369,4524.522337,9947,1192.685851,19894,-4794880,297984,-4496896,-1
8458,633,20,10,0.0696293037,0.930370696,2611.621393,2787.043207,4553.142823,4450.559242,9091,186.4055772,18182,-4330496,324096,-4006400,-1
3226,159,25,5,0.046971935,0.953028065,966.0970653,1179.509949,1692.987911,1693.245283,3385,68.30104923,6770,-1651712,81408,-1570304,-1
9085,705,22,8,0.0720122574,0.927987743,2779.867567,3221.636644,4822.634232,5834.486525,9790,417.1282488,19580,-4651520,360960,-4290560,-1
9553,420,21,9,0.042113707,0.957886293,2856.752301,3155.25549,5034.714226,3901.728571,9973,904.1704442,19946,-4891136,215040,-4676096,-1
9482,485,21,9,0.0486605799,0.95133942,2859.956527,3117.984768,5019.047775,4298.797938,9967,1014.96945,19934,-4854784,248320,-4606464,-1
2102,376,22,8,0.15173527,0.84826473,716.7083047,707.004972,1234.635109,1266.696809,2478,52.23440135,4956,-1076224,192512,-883712,-1
9464,497,21,9,0.0498945889,0.950105411,2866.464516,2969.32367,5014.905959,4335.354125,9961,626.4779874,19922,-4845568,254464,-4591104,-1
8642,527,17,13,0.0574762788,0.942523721,2616.976253,3069.450447,4608.981601,4191.73814,9169,324.796316,18338,-4424704,269824,-4154880,-1
78,29,19,11,0.271028037,0.728971963,31.67623649,21.60927488,59.97435897,37.93103448,107,26.09756098,214,-39936,14848,-25088,-1
333,26,18,12,0.0724233983,0.927576602,100.5125421,125.3867154,184.2402402,125.6923077,359,83.48837209,718,-170496,13312,-157184,-1
535,48,23,7,0.0823327616,0.917667238,163.391571,153.0484318,305.0448598,146.6041667,583,104.8561151,1166,-273920,24576,-249344,-1
5339,442,22,8,0.0764573603,0.92354264,1681.980636,1498.927355,2884.848661,2965.303167,5781,165.5498282,11562,-2733568,226304,-2507264,-1
1901,247,22,8,0.114990689,0.885009311,616.8980095,643.8994541,1075.853235,1064.08502,2148,94.6672543,4296,-973312,126464,-846848,-1
9218,707,20,10,0.0712342569,0.928765743,2835.765212,2986.311822,5052.655023,3794.06082,9925,714.028777,19850,-4719616,361984,-4357632,-1
9320,610,20,10,0.0614300101,0.93856999,2830.270408,2969.087886,5066.930687,3415.772131,9930,230.5013928,19860,-4771840,312320,-4459520,-1
228,49,26,4,0.176895307,0.823104693,79.16363944,80.13255886,143.6315789,117.4489796,277,25.69573284,554,-116736,25088,-91648,-1
6163,298,22,8,0.0461228912,0.953877109,1848.131561,2173.632338,3242.512088,2992.916107,6461,156.0628019,12922,-3155456,152576,-3002880,-1
406,107,19,11,0.208576998,0.791423002,142.4013246,167.9083175,257.6551724,254.5140187,513,26.10687023,1026,-207872,54784,-153088,-1
495,185,23,7,0.272058824,0.727941176,210.6961934,150.4288382,345.2929293,327.6756757,680,29.09713308,1360,-253440,94720,-158720,-1
7289,420,27,3,0.0544817745,0.945518225,2210.441091,2356.656479,3896.547949,3133.945238,7709,209.2562432,15418,-3731968,215040,-3516928,-1
9560,421,22,8,0.0421801423,0.957819858,2861.54114,3297.573693,4991.215167,4986.114014,9981,864.1558442,19962,-4894720,215552,-4679168,-1
1493,306,27,3,0.170094497,0.829905503,520.4177035,498.1791699,876.3958473,1015.166667,1799,66.8524712,3598,-764416,156672,-607744,-1
9449,507,21,9,0.0509240659,0.949075934,2876.598312,2798.601233,4999.06879,4595.157791,9956,688.9965398,19912,-4837888,259584,-4578304,-1
1203,252,19,11,0.173195876,0.826804124,418.0139931,428.2624984,734.1546135,698.6190476,1455,32.63795424,2910,-615936,129024,-486912,-1
3373,1125,19,11,0.250111161,0.749888839,1106.859477,1222.85896,1887.328787,3335.369778,4498,199.4678492,8996,-1726976,576000,-1150976,-1
5499,281,21,9,0.048615917,0.951384083,1670.522293,1628.518832,2893.030187,2840.985765,5780,122.848034,11560,-2815488,143872,-2671616,-1
465,67,24,6,0.12593985,0.87406015,145.7719059,194.2194275,260.3634409,309.0895522,532,14.65968586,1064,-238080,34304,-203776,-1
9608,373,21,9,0.0373710049,0.962628995,2873.511883,3025.096749,5011.862406,4453.61126,9981,917.3713235,19962,-4919296,190976,-4728320,-1
1513,390,17,13,0.204939569,0.795060431,492.4861738,547.4516281,841.3165896,1381.394872,1903,63.94489247,3806,-774656,199680,-574976,-1
5039,392,21,9,0.0721782361,0.927821764,1568.743191,1554.154341,2720.936098,2652.548469,5431,102.3751178,10862,-2579968,200704,-2379264,-1
5686,502,21,9,0.0811247576,0.918875242,1755.361737,2103.783447,3087.410658,3174.798805,6188,337.7729258,12376,-2911232,257024,-2654208,-1
8110,416,20,10,0.0487919306,0.951208069,2442.328862,2797.038496,4273.817016,4062.367788,8526,224.1324921,17052,-4152320,212992,-3939328,-1
163,36,19,11,0.180904523,0.819095477,56.65769361,44.26718122,108.3558282,62.16666667,199,33.7860781,398,-83456,18432,-65024,-1
3303,476,21,9,0.125959248,0.874040752,1069.025039,1232.063006,1889.993945,1890.042017,3779,88.43903581,7558,-1691136,243712,-1447424,-1
9208,725,19,11,0.0729890265,0.927010974,2794.622067,3611.855057,4918.408558,5584.144828,9933,808.2180635,19866,-4714496,371200,-4343296,-1
436,77,18,12,0.150097466,0.849902534,144.845037,164.2444936,259.9885321,240.0779221,513,40.36191975,1026,-223232,39424,-183808,-1
5618,697,23,7,0.11037213,0.88962787,1816.015264,1830.849072,3207.04272,2762.703013,6315,196.4230171,12630,-2876416,356864,-2519552,-1
6125,387,21,9,0.0594287469,0.940571253,1856.869973,2168.101453,3283.37698,2831.121447,6512,174.071104,13024,-3136000,198144,-2937856,-1
58,16,23,7,0.216216216,0.783783784,22.12202673,17.00723651,39.17241379,31.4375,74,2.206320811,148,-29696,8192,-21504,-1
5325,450,22,8,0.0779220779,0.922077922,1646.010402,1877.198555,2864.745728,3163.175556,5775,139.560174,11550,-2726400,230400,-2496000,-1
3727,369,17,13,0.0900878906,0.909912109,1170.386598,1258.685061,2078.307754,1747.433604,4096,326.8954509,8192,-1908224,188928,-1719296,-1
506,49,21,9,0.0882882883,0.911711712,154.7865318,206.9812177,280.0335968,257,555,68.68811881,1110,-259072,25088,-233984,-1
1200,52,27,3,0.0415335463,0.958466454,360.1302418,370.4599452,631.675,507.0769231,1252,161.9663648,2504,-614400,26624,-587776,-1
5511,1423,22,8,0.205220652,0.794779348,1860.811762,1665.911818,3046.893849,5096.425158,6934,127.0661536,13868,-2821632,728576,-2093056,-1
3256,165,20,10,0.0482315113,0.951768489,972.403457,1096.550551,1740.620086,1126.49697,3421,159.9345489,6842,-1667072,84480,-1582592,-1
3084,558,20,10,0.153212521,0.846787479,1027.008698,1142.945,1774.796368,2079.625448,3642,68.48439263,7284,-1579008,285696,-1293312,-1
227,50,26,4,0.180505415,0.819494585,79.13188625,80.86072965,143.2555066,119.68,277,24.06602954,554,-116224,25600,-90624,-1
855,126,20,10,0.128440367,0.871559633,277.2517848,320.460952,492.2690058,482.3888889,981,58.88355342,1962,-437760,64512,-373248,-1
1570,94,21,9,0.0564903846,0.943509615,475.9343243,516.4940105,843.3159236,651.8510638,1664,52.90937997,3328,-803840,48128,-755712,-1
3201,242,17,13,0.0702875399,0.92971246,977.1867678,1186.719163,1731.082162,1601.867769,3443,69.71046771,6886,-1638912,123904,-1515008,-1
1862,180,21,9,0.0881488737,0.911851126,588.0716605,594.0002581,1031.498926,918.0666667,2042,180.8680248,4084,-953344,92160,-861184,-1
577,84,15,15,0.127080182,0.872919818,182.2448166,191.7660889,350.9878683,193.702381,661,83.98983482,1322,-295424,43008,-252416,-1
2004,149,21,9,0.0692057594,0.930794241,603.1540575,650.9969712,1113.923653,580.3892617,2153,218.5786802,4306,-1026048,76288,-949760,-1
224,50,25,5,0.182481752,0.817518248,78.33057188,78.6158788,142.5089286,115.06,274,24.29078014,548,-114688,25600,-89088,-1
1440,74,20,10,0.0488771466,0.951122853,432.2086632,500.8923141,764.9479167,612.5675676,1514,135.7847534,3028,-737280,37888,-699392,-1
667,113,18,12,0.144871795,0.855128205,224.4966946,218.1629557,401.4467766,325.8849558,780,37.82735209,1560,-341504,57856,-283648,-1
9562,411,20,10,0.0412112704,0.95878873,2851.734724,3221.40709,5039.235725,3771.725061,9973,513.2784354,19946,-4895744,210432,-4685312,-1
9496,457,22,8,0.0459158043,0.954084196,2865.685467,2993.140549,4997.513374,4550.752735,9953,988.3813307,19906,-4861952,233984,-4627968,-1
9154,773,21,9,0.0778684396,0.92213156,2826.021642,3276.739078,4995.197509,4594.553687,9927,758.9449541,19854,-4686848,395776,-4291072,-1
148,61,20,10,0.291866029,0.708133971,60.32679903,59.73973832,107.9594595,97.81967213,209,7.854190154,418,-75776,31232,-44544,-1
2002,153,23,7,0.0709976798,0.92900232,618.203215,663.8796131,1085.150849,984.4313725,2155,193.2735426,4310,-1025024,78336,-946688,-1
2046,218,22,8,0.0962897527,0.903710247,644.0301431,716.73668,1149.894917,969.2431193,2264,186.3374486,4528,-1047552,111616,-935936,-1
9369,615,20,10,0.0615985577,0.938401442,2803.675732,3562.873878,4893.81695,6495.852033,9984,608.4095064,19968,-4796928,314880,-4482048,-1
9596,388,21,9,0.0388621795,0.961137821,2863.120741,3214.885024,5025.010004,4188.463918,9984,582.4970828,19968,-4913152,198656,-4714496,-1
41,19,21,9,0.316666667,0.683333333,17.33036247,17.2422852,31,29.42105263,60,4.101161996,120,-20992,9728,-11264,-1
4031,236,21,9,0.055308179,0.944691821,1214.167175,1500.711147,2132.357728,2162.050847,4267,78.37986774,8534,-2063872,120832,-1943040,-1
7698,603,20,10,0.0726418504,0.92735815,2347.300043,2947.26899,4139.642505,4295.991708,8301,263.7750238,16602,-3941376,308736,-3632640,-1
6167,461,20,10,0.0695534098,0.93044659,1897.943484,1941.978247,3373.720123,2522.286334,6628,211.0156001,13256,-3157504,236032,-2921472,-1
6532,611,22,8,0.0855382892,0.914461711,2003.305705,2581.587395,3538.714942,3927.839607,7143,328.8674033,14286,-3344384,312832,-3031552,-1
8275,440,27,3,0.0504876649,0.949512335,2500.168778,2793.001323,4360.990937,4301.75,8715,163.0190797,17430,-4236800,225280,-4011520,-1
2762,327,19,11,0.105859501,0.894140499,883.1421216,899.0376217,1583.038016,1223.712538,3089,133.3765112,6178,-1414144,167424,-1246720,-1
4945,341,22,8,0.0645100265,0.935489974,1506.622926,1680.667199,2683.138322,2068.686217,5286,185.8649789,10572,-2531840,174592,-2357248,-1
6607,329,26,4,0.0474336794,0.952566321,1981.163729,2382.222859,3461.477372,3609.528875,6936,465.5033557,13872,-3382784,168448,-3214336,-1
9221,731,19,11,0.0734525723,0.926547428,2892.001026,2602.20576,4999.728446,4683.491108,9952,365.2110092,19904,-4721152,374272,-4346880,-1
4708,391,22,8,0.0766817023,0.923318298,1448.004154,1713.515728,2528.500212,2808.877238,5099,92.38992571,10198,-2410496,200192,-2210304,-1
1032,76,20,10,0.0685920578,0.931407942,311.0195152,374.5136206,568.3013566,367.0921053,1108,199.6396396,2216,-528384,38912,-489472,-1
7222,400,20,10,0.0524796641,0.947520336,2177.23007,2537.359305,3837.071587,3349.805,7622,491.4248872,15244,-3697664,204800,-3492864,-1
2873,342,21,9,0.106376361,0.893623639,907.976637,1078.917334,1598.237383,1690.011696,3215,111.0151934,6430,-1470976,175104,-1295872,-1
8709,342,20,10,0.03778588,0.96221412,2599.407979,2885.771142,4546.250316,4010.327485,9051,327.6973208,18102,-4459008,175104,-4283904,-1
843,109,26,4,0.114495798,0.885504202,270.9500015,281.4357376,462.8161329,582.3302752,952,23.71699053,1904,-431616,55808,-375808,-1
354,47,17,13,0.117206983,0.882793017,111.7083035,96.84653918,214.059322,102.6382979,401,26.71552298,802,-181248,24064,-157184,-1
8624,927,19,11,0.0970578997,0.9029421,2688.076204,3327.908852,4759.775974,4926.934196,9551,180.8901515,19102,-4415488,474624,-3940864,-1
3773,208,25,5,0.0522481788,0.947751821,1145.341628,1211.856907,1997.199841,1878.538462,3981,250.6926952,7962,-1931776,106496,-1825280,-1
2298,169,26,4,0.0685042562,0.931495744,701.6401348,705.230082,1266.68799,789.5207101,2467,110.479176,4934,-1176576,86528,-1090048,-1
9419,530,21,9,0.0532716856,0.946728314,2842.585393,3346.526127,4985.887992,4781.501887,9949,669.5154778,19898,-4822528,271360,-4551168,-1
9523,456,23,7,0.0456959615,0.954304038,2858.478009,3152.140448,5037.346949,4001.217105,9979,1038.397503,19958,-4875776,233472,-4642304,-1
4592,320,20,10,0.0651465798,0.93485342,1403.795372,1575.200755,2434.829486,2767.471875,4912,172.5324903,9824,-2351104,163840,-2187264,-1
9621,363,22,8,0.0363581731,0.963641827,2874.084121,3046.08099,5011.238749,4495.84573,9984,1394.413408,19968,-4925952,185856,-4740096,-1
2810,213,23,7,0.0704598081,0.929540192,866.8176231,913.1425343,1530.182206,1272.131455,3023,253.1825796,6046,-1438720,109056,-1329664,-1
222,45,21,9,0.168539326,0.831460674,75.01050612,74.30136831,142.2027027,93.53333333,267,20.41284404,534,-113664,23040,-90624,-1
3173,284,20,10,0.082152155,0.917847845,989.2506664,1075.937576,1744.195714,1559.225352,3457,117.9058663,6914,-1624576,145408,-1479168,-1
2079,280,17,13,0.118694362,0.881305638,665.7033711,777.8055978,1166.407407,1280.925,2359,214.2597639,4718,-1064448,143360,-921088,-1
6900,259,20,10,0.0361782372,0.963821763,2054.710701,2357.472155,3585.395797,3436.250965,7159,653.7899543,14318,-3532800,132608,-3400192,-1
2524,160,21,9,0.0596125186,0.940387481,765.5069853,819.8164665,1366.633518,961.79375,2684,215.9292035,5368,-1292288,81920,-1210368,-1
7566,1632,22,8,0.177429876,0.822570124,2474.26864,2459.281413,4148.880915,6688.583333,9198,166.1188369,18396,-3873792,835584,-3038208,-1
147,54,18,12,0.268656716,0.731343284,58.6031818,50.30563992,109.0204082,79.16666667,201,38.95348837,402,-75264,27648,-47616,-1
9640,346,21,9,0.0346485079,0.965351492,2875.285932,3059.176384,5006.809544,4622.679191,9986,739.7037037,19972,-4935680,177152,-4758528,-1
57,22,20,10,0.278481013,0.721518987,23.62340473,18.48010992,42.92982456,32.40909091,79,20.84432718,158,-29184,11264,-17920,-1
148,26,19,11,0.149425287,0.850574713,48.05622534,38.49752163,95.19594595,43.69230769,174,46.64879357,348,-75776,13312,-62464,-1
9612,367,17,13,0.0367772322,0.963222768,2863.74384,3159.405643,5024.871099,4076.700272,9979,645.8899676,19958,-4921344,187904,-4733440,-1
5904,420,17,13,0.0664136622,0.933586338,1802.908385,2103.61525,3179.891768,2918.021429,6324,502.7027027,12648,-3022848,215040,-2807808,-1
2039,346,21,9,0.145073375,0.854926625,674.9219067,756.9993684,1208.679745,1100.598266,2385,151.910828,4770,-1043968,177152,-866816,-1
1874,166,22,8,0.081372549,0.918627451,579.1075722,671.0865699,1034.064568,867.3674699,2040,39.75833171,4080,-959488,84992,-874496,-1
1616,151,17,13,0.0854555744,0.914544426,497.7224875,625.3577795,879.5346535,931.7880795,1767,143.1928687,3534,-827392,77312,-750080,-1
9390,561,22,8,0.0563762436,0.943623756,2857.252883,3062.943682,4942.024175,5544.686275,9951,599.0969296,19902,-4807680,287232,-4520448,-1
9557,417,22,8,0.0418087026,0.958191297,2864.828567,3187.2191,4994.854452,4818.947242,9974,865.7986111,19948,-4893184,213504,-4679680,-1
4153,541,21,9,0.115253515,0.884746485,1306.962008,1590.784047,2281.739225,2852.314233,4694,180.6079261,9388,-2126336,276992,-1849344,-1
255,62,18,12,0.195583596,0.804416404,89.41290505,93.29759486,166.6470588,127.5483871,317,50.07898894,634,-130560,31744,-98816,-1
245,20,24,6,0.0754716981,0.924528302,75.45317538,77.32593355,136.3469388,92,265,54.63917526,530,-125440,10240,-115200,-1
9391,564,18,12,0.0566549473,0.943345053,2858.831172,2905.161676,5043.049622,3894.87766,9955,1128.684807,19910,-4808192,288768,-4519424,-1
3904,411,27,3,0.0952491309,0.904750869,1235.348323,1304.158972,2188.561988,1867.698297,4315,117.3511014,8630,-1998848,210432,-1788416,-1
4932,532,21,9,0.0973645681,0.902635432,1564.519102,1666.379715,2702.798459,3007.853383,5464,198.6186841,10928,-2525184,272384,-2252800,-1
5297,295,21,9,0.0527539342,0.947246066,1604.649932,1697.219486,2825.254295,2280.189831,5592,297.9222163,11184,-2712064,151040,-2561024,-1
4471,325,21,9,0.067764804,0.932235196,1361.040717,1673.033219,2402.523373,2343.150769,4796,94.13150147,9592,-2289152,166400,-2122752,-1
302,34,16,14,0.101190476,0.898809524,93.3700836,88.90567394,177.8245033,85.67647059,336,41.17647059,672,-154624,17408,-137216,-1
439,108,16,14,0.197440585,0.802559415,147.8922031,175.0533495,292.0888383,200.4722222,547,68.20448878,1094,-224768,55296,-169472,-1
32,19,18,12,0.37254902,0.62745098,14.63714773,14.68468213,27.0625,24.21052632,51,16.19047619,102,-16384,9728,-6656,-1
5681,452,23,7,0.0736996576,0.926300342,1730.67295,2190.874961,3044.719944,3347.028761,6133,156.3344379,12266,-2908672,231424,-2677248,-1
2615,102,23,7,0.037541406,0.962458594,777.8016024,932.095577,1355.612237,1445.852941,2717,168.0272109,5434,-1338880,52224,-1286656,-1
36,15,20,10,0.294117647,0.705882353,14.56496197,14.7957952,27.02777778,23.53333333,51,7.359307359,102,-18432,7680,-10752,-1
3189,226,27,3,0.0661786237,0.933821376,970.5483317,1043.879989,1745.753214,1175.278761,3415,273.8572574,6830,-1632768,115712,-1517056,-1
9400,549,27,3,0.0551814253,0.944818575,2846.480723,3125.678817,5031.204255,4012.668488,9949,722.5127088,19898,-4812800,281088,-4531712,-1
4741,394,27,3,0.076728335,0.923271665,1455.650578,1763.862923,2581.814385,2401.771574,5135,314.6446078,10270,-2427392,201728,-2225664,-1
4554,430,20,10,0.0862760835,0.913723917,1445.55699,1364.596794,2493.688625,2479.911628,4984,259.3132154,9968,-2331648,220160,-2111488,-1
8722,392,19,11,0.0430107527,0.956989247,2611.728055,2993.985629,4577.381564,4115.135204,9114,419.0344828,18228,-4465664,200704,-4264960,-1
5962,321,27,3,0.0510902435,0.948909756,1800.093395,1978.751983,3170.271889,2616.900312,6283,376.2275449,12566,-3052544,164352,-2888192,-1
3960,284,19,11,0.0669180019,0.933081998,1217.328531,1292.117122,2100.886869,2423.866197,4244,257.3681019,8488,-2027520,145408,-1882112,-1
3001,176,19,11,0.0553981744,0.944601826,901.3379134,1139.444959,1578.779074,1763.278409,3177,274.3523316,6354,-1536512,90112,-1446400,-1
5561,267,17,13,0.045813315,0.954186685,1666.462231,1887.393231,2943.402266,2312.531835,5828,418.3776023,11656,-2847232,136704,-2710528,-1
1376,154,24,6,0.100653595,0.899346405,438.9402391,361.7336229,796.5755814,487.8376623,1530,37.27161998,3060,-704512,78848,-625664,-1
6707,1252,21,9,0.157306194,0.842693806,2309.368626,2102.895886,3851.155807,4670.222045,7959,157.9480056,15918,-3433984,641024,-2792960,-1
1302,152,27,3,0.104539202,0.895460798,414.100394,461.9592242,733.5552995,675.6315789,1454,117.7327935,2908,-666624,77824,-588800,-1
9526,441,21,9,0.0442460118,0.955753988,2865.683818,3082.615182,5004.622297,4538.539683,9967,985.8555885,19934,-4877312,225792,-4651520,-1
6501,387,18,12,0.056184669,0.943815331,1971.993309,2208.437492,3420.820489,3842.27907,6888,304.1059603,13776,-3328512,198144,-3130368,-1
9426,486,27,3,0.049031477,0.950968523,2856.799722,2947.414371,4959.86272,4891.279835,9912,531.7596567,19824,-4826112,248832,-4577280,-1
130,29,22,8,0.182389937,0.817610063,45.73240988,31.28059501,86.97692308,48.72413793,159,27.70034843,318,-66560,14848,-51712,-1
967,124,21,9,0.113657195,0.886342805,307.4409219,355.6014444,557.5522234,455.9112903,1091,76.29370629,2182,-495104,63488,-431616,-1
694,153,20,10,0.180637544,0.819362456,249.0373294,181.0664147,449.9106628,306.4705882,847,15.71428571,1694,-355328,78336,-276992,-1
9502,467,21,9,0.0468452202,0.95315478,2863.110311,3080.054113,5019.306462,4286.970021,9969,873.7072743,19938,-4865024,239104,-4625920,-1
9200,475,21,9,0.0490956072,0.950904393,2764.844043,3037.064745,4901.689239,3604.44,9675,253.205967,19350,-4710400,243200,-4467200,-1
8666,1178,22,8,0.119666802,0.880333198,2795.020851,2928.812793,4769.780406,6045.987267,9844,718.540146,19688,-4436992,603136,-3833856,-1
9344,611,23,7,0.0613761929,0.938623807,2869.839888,2889.19063,5010.021618,4488.294599,9955,704.0311174,19910,-4784128,312832,-4471296,-1
5569,316,21,9,0.0536958369,0.946304163,1682.538103,1956.051211,2952.905908,2768.424051,5885,318.2801514,11770,-2851328,161792,-2689536,-1
3988,448,24,6,0.100991885,0.899008115,1260.740444,1436.80557,2234.951605,2072.051339,4436,102.3298731,8872,-2041856,229376,-1812480,-1
637,66,21,9,0.093883357,0.906116643,202.3927458,202.0728328,356.9167975,304.5454545,703,50.83152567,1406,-326144,33792,-292352,-1
8102,573,22,8,0.0660518732,0.933948127,2462.559546,2970.081559,4295.963836,4932.375218,8675,406.8949343,17350,-4148224,293376,-3854848,-1
3925,190,22,8,0.0461725395,0.953827461,1178.218759,1318.65627,2076.025223,1685.636842,4115,152.690167,8230,-2009600,97280,-1912320,-1
2529,308,20,10,0.108565386,0.891434614,828.0617997,738.5723426,1413.501779,1464.146104,2837,122.1791559,5674,-1294848,157696,-1137152,-1
1164,153,21,9,0.116173121,0.883826879,369.1123904,454.045015,663.7920962,622.5424837,1317,113.7305699,2634,-595968,78336,-517632,-1
6559,332,27,3,0.0481787839,0.951821216,1984.218036,1993.229672,3476.442293,2844.581325,6891,127.3281596,13782,-3358208,169984,-3188224,-1
4867,499,21,9,0.0929929184,0.907007082,1512.258645,1751.444224,2747.521266,2059.068136,5366,104.7842218,10732,-2491904,255488,-2236416,-1
268,62,18,12,0.187878788,0.812121212,92.52236609,92.44058896,176.4402985,118.2096774,330,45.39202201,660,-137216,31744,-105472,-1
530,79,21,9,0.129720854,0.870279146,165.7959819,212.7529272,317.8773585,218.6075949,609,14.04196449,1218,-271360,40448,-230912,-1
58,16,23,7,0.216216216,0.783783784,22.12202673,17.00723651,39.17241379,31.4375,74,2.230931565,148,-29696,8192,-21504,-1
3565,232,24,6,0.0611008691,0.938899131,1081.235467,1303.192116,1900.3223,1878.681034,3797,72.53104107,7594,-1825280,118784,-1706496,-1
8216,388,21,9,0.0450953045,0.954904695,2477.118914,2457.755019,4344.447055,3414.260309,8604,160.9126613,17208,-4206592,198656,-4007936,-1
133,31,18,12,0.18902439,0.81097561,44.60573827,49.50199441,88.69172932,55.93548387,164,3.52688172,328,-68096,15872,-52224,-1
3355,220,18,12,0.0615384615,0.938461538,1014.451678,1270.062717,1788.548435,1779.636364,3575,98.48484848,7150,-1717760,112640,-1605120,-1
9514,460,22,8,0.0461199118,0.953880088,2862.550272,3038.625828,5035.645049,3991.734783,9974,1499.849624,19948,-4871168,235520,-4635648,-1
6291,501,18,12,0.0737632509,0.926236749,1940.263093,2200.756567,3399.055317,3364.413174,6792,175.640031,13584,-3220992,256512,-2964480,-1
4909,1154,20,10,0.190334818,0.809665182,1655.011616,1452.339806,2708.880016,4406.519931,6063,120.849113,12126,-2513408,590848,-1922560,-1
1832,320,16,14,0.148698885,0.851301115,625.0708257,598.7042511,1077.804585,1069.03125,2152,99.26199262,4304,-937984,163840,-774144,-1
9164,775,19,11,0.0779756515,0.922024349,2848.861645,3038.900622,5019.280554,4387.28129,9939,819.3734542,19878,-4691968,396800,-4295168,-1
4924,273,26,4,0.0525303059,0.947469694,1485.944964,1529.436077,2643.559504,1795.296703,5197,374.6935833,10394,-2521088,139776,-2381312,-1
2848,168,21,9,0.0557029178,0.944297082,863.5725744,982.6947992,1507.629916,1523.25,3016,160.7675906,6032,-1458176,86016,-1372160,-1
3217,306,21,9,0.0868577917,0.913142208,1013.659871,1051.364898,1760.46534,1778.133987,3523,80.89552239,7046,-1647104,156672,-1490432,-1
9620,362,21,9,0.0362652775,0.963734723,2876.548919,2969.975876,5009.920998,4501.969613,9982,1241.542289,19964,-4925440,185344,-4740096,-1
8332,661,22,8,0.0735016124,0.926498388,2604.371171,2471.550705,4519.371339,4215.006051,8993,237.407603,17986,-4265984,338432,-3927552,-1
164,24,21,9,0.127659574,0.872340426,52.44321984,41.93627358,101.3597561,47.625,188,41.13785558,376,-83968,12288,-71680,-1
3998,257,22,8,0.06039953,0.93960047,1220.280295,1210.393805,2164.845673,1554.81323,4255,281.9748178,8510,-2046976,131584,-1915392,-1
1021,76,21,9,0.0692798541,0.930720146,310.30973,355.7585832,560.8756121,389.4605263,1097,101.2927054,2194,-522752,38912,-483840,-1
7121,500,18,12,0.0656081879,0.934391812,2174.453181,2530.220527,3822.5818,3646.052,7621,198.360229,15242,-3645952,256000,-3389952,-1
9453,503,20,10,0.0505222981,0.949477702,2861.473844,3088.386155,4992.940125,4707.12326,9956,1055.779427,19912,-4839936,257536,-4582400,-1
994,64,19,11,0.0604914934,0.939508507,300.4959493,331.3772482,540.2716298,362.203125,1058,160.5462822,2116,-508928,32768,-476160,-1
6448,1383,20,10,0.176605797,0.823394203,2247.261445,2310.63443,3871.617556,4122.925524,7831,144.6168052,15662,-3301376,708096,-2593280,-1
3874,471,16,14,0.10840046,0.89159954,1254.204077,1218.581198,2207.470057,1889.481953,4345,135.1057214,8690,-1983488,241152,-1742336,-1
4656,366,22,8,0.0728793309,0.927120669,1441.692717,1387.719271,2563.469931,1850.374317,5022,238.2352941,10044,-2383872,187392,-2196480,-1
1163,169,23,7,0.126876877,0.873123123,375.7685832,436.9342631,673.5588994,617.9230769,1332,111.9327731,2664,-595456,86528,-508928,-1
6617,1056,18,12,0.13762544,0.86237456,2171.759479,2399.066553,3750.656944,4378.034091,7673,183.0827965,15346,-3387904,540672,-2847232,-1
2782,239,18,12,0.0791128765,0.920887123,867.7331473,920.0016062,1514.969087,1464.799163,3021,114.1723356,6042,-1424384,122368,-1302016,-1
1275,127,22,8,0.0905848787,0.909415121,401.5093316,340.7813712,727.2831373,442.6535433,1402,104.8616305,2804,-652800,65024,-587776,-1
54,10,23,7,0.15625,0.84375,18.2090908,11.26277053,35.27777778,17.5,64,17.15817694,128,-27648,5120,-22528,-1
5487,310,20,10,0.0534759358,0.946524064,1645.254914,2053.701203,2925.868052,2423.435484,5797,458.6234177,11594,-2809344,158720,-2650624,-1
6325,431,21,9,0.0637951451,0.936204855,1915.398156,2346.375237,3343.767273,3888.208817,6756,367.173913,13512,-3238400,220672,-3017728,-1
6969,671,17,13,0.0878272251,0.912172775,2158.269628,2599.819534,3775.016215,4292.894188,7640,252.8963919,15280,-3568128,343552,-3224576,-1
1936,99,20,10,0.0486486486,0.951351351,578.6443381,685.3223132,1031.779442,748.5353535,2035,117.6300578,4070,-991232,50688,-940544,-1
4361,331,21,9,0.0705456095,0.92945439,1324.154022,1691.175365,2331.121532,2549.114804,4692,148.152826,9384,-2232832,169472,-2063360,-1
249,58,18,12,0.188925081,0.811074919,84.7002464,92.12798864,164.0281124,110.9482759,307,27.04845815,614,-127488,29696,-97792,-1
3078,201,21,9,0.0612991766,0.938700823,938.0144994,1066.27062,1635.166342,1714.0199,3279,243.7918216,6558,-1575936,102912,-1473024,-1
6674,427,18,12,0.0601323757,0.939867624,2026.756862,2382.006901,3553.441265,3512.843091,7101,363.59447,14202,-3417088,218624,-3198464,-1
1864,302,20,10,0.139427516,0.860572484,610.8317078,685.7652323,1057.102468,1246.430464,2166,50.46598322,4332,-954368,154624,-799744,-1
1818,253,20,10,0.122163206,0.877836794,582.4415215,676.6698446,1058.654565,873.2094862,2071,114.9916713,4142,-930816,129536,-801280,-1
2816,241,20,10,0.0788354596,0.92116454,883.0112903,870.4607884,1537.257102,1432.518672,3057,80.21516662,6114,-1441792,123392,-1318400,-1
7007,553,20,10,0.0731481481,0.926851852,2166.39882,2250.001803,3838.420437,3046.596745,7560,138.7665198,15120,-3587584,283136,-3304448,-1
500,113,25,5,0.184339315,0.815660685,174.7013729,178.5915274,318.048,258.1150442,613,43.53693182,1226,-256000,57856,-198144,-1
9579,395,25,5,0.0396029677,0.960397032,2871.46368,2950.883552,5020.519261,4186.762025,9974,1030.371901,19948,-4904448,202240,-4702208,-1
9290,641,20,10,0.064545363,0.935454637,2848.037695,2731.585601,5067.513563,3494.765991,9931,1205.218447,19862,-4756480,328192,-4428288,-1
7395,491,20,10,0.0622622369,0.937737763,2247.565778,2581.800488,3988.400676,3267.246436,7886,227.0659372,15772,-3786240,251392,-3534848,-1
7076,352,21,9,0.0473882606,0.952611739,2124.5705,2468.170162,3692.932872,4148.048295,7428,191.0493827,14856,-3622912,180224,-3442688,-1
1572,128,17,13,0.0752941176,0.924705882,481.0202448,587.1213436,859.1533079,744.2265625,1700,118.9643107,3400,-804864,65536,-739328,-1
2969,318,19,11,0.0967447521,0.903255248,918.1469665,1190.850498,1657.609296,1516.937107,3287,90.67586207,6574,-1520128,162816,-1357312,-1
79,42,18,12,0.347107438,0.652892562,36.37781766,29.56184186,66.29113924,51.04761905,121,14.70230863,242,-40448,21504,-18944,-1
2846,253,19,11,0.0816392385,0.918360762,870.6052378,1077.12222,1579.098384,1222.671937,3099,81.01960784,6198,-1457152,129536,-1327616,-1
9528,433,21,9,0.0434695312,0.956530469,2866.960891,2980.192219,5011.309509,4314.050808,9961,752.9100529,19922,-4878336,221696,-4656640,-1
9471,515,22,8,0.0515722011,0.948427799,2862.520566,3163.598381,5028.418435,4351.339806,9986,867.593397,19972,-4849152,263680,-4585472,-1
4135,337,17,13,0.0753577818,0.924642218,1268.394797,1432.37042,2281.063362,1689.706231,4472,295.3764861,8944,-2117120,172544,-1944576,-1
8492,994,19,11,0.104786,0.895214,2668.272606,3124.225167,4634.097504,5678.153924,9486,239.4245331,18972,-4347904,508928,-3838976,-1
467,51,14,16,0.0984555985,0.901544402,144.5759191,185.2016078,263.3961456,223.8235294,518,27.67094017,1036,-239104,26112,-212992,-1
4262,275,21,9,0.0606127397,0.93938726,1291.041677,1511.589087,2295.77405,1854.050909,4537,153.9009498,9074,-2182144,140800,-2041344,-1
1879,108,25,5,0.0543532964,0.945646704,565.0747761,595.8907008,1015.119212,626.5648148,1987,47.0407197,3974,-962048,55296,-906752,-1
7510,896,20,10,0.106590531,0.893409469,2377.988251,2354.549238,4032.392144,5637.674107,8406,215.5384615,16812,-3845120,458752,-3386368,-1
6437,286,21,9,0.0425405325,0.957459467,1924.589778,2165.368984,3392.269535,2680.723776,6723,515.9631619,13446,-3295744,146432,-3149312,-1
3608,209,21,9,0.0547550432,0.945244957,1089.097028,1301.80708,1911.89745,1858.980861,3817,330.4761905,7634,-1847296,107008,-1740288,-1
81,30,19,11,0.27027027,0.72972973,33.27764896,26.89157241,58.92592593,48.1,111,23.6673774,222,-41472,15360,-26112,-1
5660,298,20,10,0.0500167842,0.949983216,1707.618058,1913.429966,2963.418021,3284.949664,5958,485.9706362,11916,-2897920,152576,-2745344,-1
4444,256,22,8,0.0544680851,0.945531915,1346.660976,1521.633669,2350.216922,2355.414063,4700,470.4704705,9400,-2275328,131072,-2144256,-1
3381,547,22,8,0.139256619,0.860743381,1119.026408,1046.411405,1869.79089,2549.895795,3928,117.8517852,7856,-1731072,280064,-1451008,-1
1279,204,25,5,0.137559002,0.862440998,420.8336212,444.2711258,765.2322127,596.3431373,1483,47.56254009,2966,-654848,104448,-550400,-1
3184,354,27,3,0.100056529,0.899943471,1004.052641,1124.364234,1737.211997,2059.909605,3538,260.3384842,7076,-1630208,181248,-1448960,-1
55,21,18,12,0.276315789,0.723684211,21.32503282,22.68096788,40.45454545,33.38095238,76,2.709447415,152,-28160,10752,-17408,-1
61,17,25,5,0.217948718,0.782051282,22.47466249,22.54177207,40.06557377,37.47058824,78,1.863799283,156,-31232,8704,-22528,-1
9482,483,27,3,0.0484696438,0.951530356,2870.746693,2933.139184,5011.871124,4416.217391,9965,640.8360129,19930,-4854784,247296,-4607488,-1
328,32,17,13,0.0888888889,0.911111111,100.7636198,92.19728762,189.2987805,90.3125,360,35.64356436,720,-167936,16384,-151552,-1
2417,178,21,9,0.0685934489,0.931406551,745.4766426,790.5533735,1305.096814,1201.634831,2595,72.64837626,5190,-1237504,91136,-1146368,-1
3750,171,21,9,0.0436113236,0.956388676,1129.621449,1136.971988,1975.1896,1649.824561,3921,208.0106101,7842,-1920000,87552,-1832448,-1
8223,822,20,10,0.0908789386,0.909121061,2580.238881,2882.828805,4491.689894,4836.215328,9045,256.3049022,18090,-4210176,420864,-3789312,-1
4211,419,17,13,0.0904967603,0.90950324,1321.957941,1460.536297,2335.301116,2116.49642,4630,110.0023759,9260,-2156032,214528,-1941504,-1
9407,544,20,10,0.0546678726,0.945332127,2856.156875,2924.177945,5040.857553,3854.465074,9951,834.1156748,19902,-4816384,278528,-4537856,-1
3103,222,23,7,0.0667669173,0.933233083,945.4163201,1121.559386,1678.086368,1452.130631,3325,196.8620485,6650,-1588736,113664,-1475072,-1
6131,304,16,14,0.0472416472,0.952758353,1830.632818,2271.102648,3244.535802,2682.832237,6435,589.8258478,12870,-3139072,155648,-2983424,-1
3592,342,20,10,0.0869344179,0.913065582,1114.225738,1334.735848,1956.58686,2082.119883,3934,311.7274168,7868,-1839104,175104,-1664000,-1
9166,759,20,10,0.0764735516,0.923526448,2842.93322,3117.971542,4953.215907,5081.156785,9925,507.9324463,19850,-4692992,388608,-4304384,-1
103,28,19,11,0.213740458,0.786259542,37.79938711,21.56607668,73.50485437,38.39285714,131,27.34864301,262,-52736,14336,-38400,-1
5735,491,20,10,0.0788628333,0.921137167,1763.375986,2139.134794,3134.429991,2869.032587,6226,423.2494901,12452,-2936320,251392,-2684928,-1
4174,582,21,9,0.122371741,0.877628259,1350.786584,1518.880166,2364.994729,2475.357388,4756,237.8,9512,-2137088,297984,-1839104,-1
9503,439,21,9,0.0441561054,0.955843895,2852.508886,3158.526459,5001.060507,4331.605923,9942,768.3153014,19884,-4865536,224768,-4640768,-1
9020,938,21,9,0.0941956216,0.905804378,2858.365967,2995.385034,4936.630931,5391.73774,9958,247.7114428,19916,-4618240,480256,-4137984,-1
4575,313,21,9,0.0640343699,0.93596563,1390.460707,1682.820709,2441.528087,2487.939297,4888,454.2750929,9776,-2342400,160256,-2182144,-1
6663,440,20,10,0.0619456568,0.938054343,2019.601908,2450.859771,3572.178298,3246.436364,7103,161.1388385,14206,-3411456,225280,-3186176,-1
9429,525,19,11,0.052742616,0.947257384,2854.70036,3086.956557,5021.483614,4187.554286,9954,718.700361,19908,-4827648,268800,-4558848,-1
8930,969,21,9,0.0978886756,0.902111324,2824.034661,3120.494827,4994.4,4540.823529,9899,411.0880399,19798,-4572160,496128,-4076032,-1
2334,141,25,5,0.056969697,0.943030303,711.0924908,766.4367461,1241.085261,1186.929078,2475,187.784522,4950,-1195008,72192,-1122816,-1
4206,331,23,7,0.0729556976,0.927044302,1312.281677,1270.25898,2259.288873,2392.398792,4537,113.3683158,9074,-2153472,169472,-1984000,-1
3623,249,17,13,0.0643078512,0.935692149,1094.011688,1294.060218,1975.191278,1373.534137,3872,325.9259259,7744,-1854976,127488,-1727488,-1
3051,195,21,9,0.0600739372,0.939926063,920.5504822,1158.4962,1631.131105,1504.102564,3246,169.947644,6492,-1562112,99840,-1462272,-1
1485,274,17,13,0.155770324,0.844229676,487.721273,604.9819792,881.2835017,873.0437956,1759,38.70187019,3518,-760320,140288,-620032,-1
1798,336,20,10,0.157450797,0.842549203,620.68424,589.6591957,1072.963849,1038.261905,2134,40.57034221,4268,-920576,172032,-748544,-1
5259,311,20,10,0.0558348294,0.944165171,1589.622932,1890.501033,2787.093174,2758.559486,5570,111.2887113,11140,-2692608,159232,-2533376,-1
1210,136,27,3,0.101040119,0.898959881,387.2963915,393.2612457,681.0512397,606.3161765,1346,106.6561014,2692,-619520,69632,-549888,-1
3185,202,20,10,0.0596397992,0.940360201,950.2130366,1056.256881,1744.610047,896.0148515,3387,272.705314,6774,-1630720,103424,-1527296,-1
4085,814,22,8,0.166156358,0.833843642,1412.903499,1360.477052,2375.465606,2824.045455,4899,119.0811862,9798,-2091520,416768,-1674752,-1
4791,227,21,9,0.0452371463,0.954762854,1438.175086,1651.613182,2506.581716,2571.092511,5018,270.5121294,10036,-2452992,116224,-2336768,-1
2190,158,20,10,0.0672913118,0.932708688,664.8725453,812.6362307,1188.40137,981.8164557,2348,67.37446198,4696,-1121280,80896,-1040384,-1
9589,384,20,10,0.0385039607,0.961496039,2862.006389,3150.008751,5022.03139,4112.21875,9973,902.5339367,19946,-4909568,196608,-4712960,-1
5922,2029,21,9,0.255188027,0.744811973,2411.517462,1623.968501,3675.357481,4853.479054,7951,172.5477431,15902,-3032064,1038848,-1993216,-1
4973,741,18,12,0.129681484,0.870318516,1650.869424,1551.51644,2783.544138,3353.832659,5714,189.0175323,11428,-2546176,379392,-2166784,-1
2080,293,17,13,0.123472398,0.876527602,659.1988244,842.4210165,1197.255288,1114.197952,2373,118.1184669,4746,-1064960,150016,-914944,-1
9376,587,21,9,0.0589179966,0.941082003,2842.576835,2989.540473,5075.96779,3481.076661,9963,463.3953488,19926,-4800512,300544,-4499968,-1
959,90,21,9,0.0857959962,0.914204004,290.2390716,396.3259086,535.6663191,411.3444444,1049,19.22301631,2098,-491008,46080,-444928,-1
3525,522,25,5,0.128984433,0.871015567,1166.578601,1146.741687,2062.219291,1765.909962,4047,137.5127421,8094,-1804800,267264,-1537536,-1
282,65,24,6,0.187319885,0.812680115,95.64461654,111.8060239,166.287234,207.4615385,347,12.41947029,694,-144384,33280,-111104,-1
140,35,17,13,0.2,0.8,48.11922693,44.15155716,96.8,52.8,175,49.15730337,350,-71680,17920,-53760,-1
1437,308,25,5,0.176504298,0.823495702,499.874409,495.7406889,841.5866388,1019.561688,1745,38.62328464,3490,-735744,157696,-578048,-1
303,37,26,4,0.108823529,0.891176471,96.83205302,107.7703711,169.2277228,180.9189189,340,35.49060543,680,-155136,18944,-136192,-1
5404,496,22,8,0.0840677966,0.915932203,1682.532881,1913.71743,2949.059771,2966.191532,5900,149.0651844,11800,-2766848,253952,-2512896,-1
4700,308,20,10,0.0615015974,0.938498403,1444.658456,1391.694107,2532.782553,2072.915584,5008,263.5789474,10016,-2406400,157696,-2248704,-1
3280,260,21,9,0.0734463277,0.926553672,1003.557722,1144.349355,1804.9375,1336.057692,3540,308.6312119,7080,-1679360,133120,-1546240,-1
8054,447,23,7,0.0525820492,0.947417951,2421.323364,2977.957653,4259.851751,4091.510067,8501,388.883806,17002,-4123648,228864,-3894784,-1
5891,277,19,11,0.0449092088,0.955090791,1766.293028,1940.337518,3116.361229,2406.902527,6168,832.388664,12336,-3016192,141824,-2874368,-1
2276,135,22,8,0.0559933637,0.944006636,686.2138268,756.1003392,1227.614675,841.5925926,2411,154.6504169,4822,-1165312,69120,-1096192,-1
1347,143,23,7,0.0959731544,0.904026846,427.3975208,350.596423,774.7772829,469.7202797,1490,139.1223156,2980,-689664,73216,-616448,-1
7432,724,21,9,0.0887690044,0.911230996,2343.732527,2432.057006,4043.140339,4441.473757,8156,164.9676375,16312,-3805184,370688,-3434496,-1
2984,262,21,9,0.0807147258,0.919285274,927.2808089,1041.524289,1625.341153,1602.530534,3246,138.7772552,6492,-1527808,134144,-1393664,-1
9410,540,21,9,0.0542713568,0.945728643,2852.760842,3164.119736,4999.801807,4552.018519,9950,827.0989194,19900,-4817920,276480,-4541440,-1
4955,311,21,9,0.0590581086,0.940941891,1510.124497,1659.114741,2646.110999,2432.575563,5266,157.7591372,10532,-2536960,159232,-2377728,-1
5692,294,20,10,0.0491146007,0.950885399,1711.927715,2013.482203,2990.775474,3046.248299,5986,126.9834535,11972,-2914304,150528,-2763776,-1
4868,334,22,8,0.0642060746,0.935793925,1491.746132,1445.070983,2652.936935,1851.814371,5202,391.7168675,10404,-2492416,171008,-2321408,-1
4888,238,20,10,0.0464299649,0.953570035,1463.422223,1778.884535,2568.730565,2456.07563,5126,363.2884479,10252,-2502656,121856,-2380800,-1
899,58,18,12,0.0606060606,0.939393939,270.8468568,278.5734623,492.2113459,274.2241379,957,147.4576271,1914,-460288,29696,-430592,-1
7277,1546,21,9,0.175223847,0.824776153,2638.141084,2020.245856,4329.953415,4798.192109,8823,176.5659396,17646,-3725824,791552,-2934272,-1
2408,260,21,9,0.0974512744,0.902548726,751.9234217,917.5087446,1344.122924,1245.376923,2668,55.3526971,5336,-1232896,133120,-1099776,-1
6748,442,19,11,0.0614742698,0.93852573,2052.272925,2368.937151,3569.756669,3988.522624,7190,297.9693328,14380,-3454976,226304,-3228672,-1
107,30,19,11,0.218978102,0.781021898,37.29876685,42.58163402,73.74766355,52.06666667,137,2.563143124,274,-54784,15360,-39424,-1
6617,298,23,7,0.0430947216,0.956905278,1992.306323,2075.429229,3464.411969,3315.624161,6915,461.6154873,13830,-3387904,152576,-3235328,-1
4803,183,17,13,0.0367027677,0.963297232,1430.748499,1611.952798,2506.455965,2153.459016,4986,725.7641921,9972,-2459136,93696,-2365440,-1
5370,429,18,12,0.0739782721,0.926021728,1659.362837,1847.249901,2896.640596,2942.051282,5799,177.4479804,11598,-2749440,219648,-2529792,-1
9313,631,23,7,0.06345535,0.93654465,2821.05306,3241.936055,5062.667776,3641.703645,9944,1139.06071,19888,-4768256,323072,-4445184,-1
5520,1728,22,8,0.238410596,0.761589404,1767.185261,1837.402907,3013.000181,5577.902199,7248,146.9288465,14496,-2826240,884736,-1941504,-1
1064,136,22,8,0.113333333,0.886666667,343.9770712,363.8873386,603.7453008,575.1102941,1200,128.0683031,2400,-544768,69632,-475136,-1
351,34,20,10,0.0883116883,0.911688312,107.0098046,100.5748744,202.9344729,90.44117647,385,118.8271605,770,-179712,17408,-162304,-1
117,36,18,12,0.235294118,0.764705882,43.37320945,35.49529398,85.14529915,50.52777778,153,15.88785047,306,-59904,18432,-41472,-1
7815,555,20,10,0.0663082437,0.933691756,2370.504787,2932.886402,4224.132566,3641.511712,8370,213.5748916,16740,-4001280,284160,-3717120,-1
9280,650,21,9,0.0654582075,0.934541793,2854.194628,2890.691707,5028.643319,4064.007692,9930,888.9883617,19860,-4751360,332800,-4418560,-1
7335,604,20,10,0.0760801108,0.923919889,2265.985728,2572.536223,3950.17546,4210.75,7939,197.8813559,15878,-3755520,309248,-3446272,-1
1930,247,27,3,0.113458888,0.886541112,607.7648738,766.9509927,1098.711917,1013.11336,2177,53.27949094,4354,-988160,126464,-861696,-1
603,57,22,8,0.0863636364,0.913636364,186.9496657,219.4127056,326.039801,377.6842105,660,47.34576758,1320,-308736,29184,-279552,-1
1330,217,27,3,0.140271493,0.859728507,434.409734,503.1201575,757.4135338,875.6589862,1547,38.82057716,3094,-680960,111104,-569856,-1
1883,104,17,13,0.0523402114,0.947659789,566.7704388,615.9542231,1010.181094,701.0288462,1987,271.8194254,3974,-964096,53248,-910848,-1
9061,739,19,11,0.0754081633,0.924591837,2784.616852,3310.085617,4875.372034,5208.598106,9800,311.3087675,19600,-4639232,378368,-4260864,-1
700,91,21,9,0.115044248,0.884955752,223.6098304,261.4398872,397.8957143,381.4175824,791,90.29680365,1582,-358400,46592,-311808,-1
3449,300,21,9,0.080021339,0.919978661,1061.77379,1294.464419,1876.053349,1862.89,3749,339.8912058,7498,-1765888,153600,-1612288,-1
8769,506,22,8,0.0545552561,0.945444744,2648.363078,3126.285903,4653.954727,4361.503953,9275,485.8564694,18550,-4489728,259072,-4230656,-1
1166,130,20,10,0.100308642,0.899691358,372.2944007,362.7314553,663.6912521,512.2461538,1296,84.65055519,2592,-596992,66560,-530432,-1
6552,526,20,10,0.0743147782,0.925685222,2006.208359,2297.452604,3471.960165,4380.794677,7078,142.2713568,14156,-3354624,269312,-3085312,-1
9542,424,23,7,0.0425446518,0.957455348,2875.697778,2894.082703,4994.273737,4741.040094,9966,430.3108808,19932,-4885504,217088,-4668416,-1
4018,269,22,8,0.0627478423,0.937252158,1233.655931,1293.447277,2140.910403,2190.148699,4287,178.9232053,8574,-2057216,137728,-1919488,-1
5335,636,22,8,0.106514822,0.893485178,1695.084782,1759.917263,2892.140206,3773.330189,5971,358.1883623,11942,-2731520,325632,-2405888,-1
1512,109,20,10,0.0672424429,0.932757557,460.4646306,552.4756188,817.9768519,714.2201835,1621,95.97394908,3242,-774144,55808,-718336,-1
72,19,19,11,0.208791209,0.791208791,24.06735661,32.07556867,48.11111111,38,91,9.00990099,182,-36864,9728,-27136,-1
9337,480,21,9,0.0488947744,0.951105226,2825.602483,2921.879334,4941.096069,4284.664583,9817,685.5446927,19634,-4780544,245760,-4534784,-1
5803,447,17,13,0.07152,0.92848,1781.60798,1780.379906,3204.681544,2097.557047,6250,262.0545073,12500,-2971136,228864,-2742272,-1
9411,421,21,9,0.0428193653,0.957180635,2814.018744,3281.840576,4942.293805,4339.907363,9832,550.8123249,19664,-4818432,215552,-4602880,-1
37,18,20,10,0.327272727,0.672727273,15.8686169,15.82280352,28.56756757,26.83333333,55,7.692307692,110,-18944,9216,-9728,-1
9101,475,21,9,0.0496031746,0.950396825,2744.070991,2865.445786,4852.283705,3566.404211,9576,240.1203611,19152,-4659712,243200,-4416512,-1
4714,380,17,13,0.0745975658,0.925402434,1469.915393,1458.603959,2565.949936,2318.623684,5094,128.7664307,10188,-2413568,194560,-2219008,-1
939,51,21,9,0.0515151515,0.948484848,282.3397166,307.6035186,503.544196,347.3921569,990,65.82446809,1980,-480768,26112,-454656,-1
1246,75,27,3,0.0567751703,0.94322483,375.5298082,396.601011,675.4598716,420.7733333,1321,181.2071331,2642,-637952,38400,-599552,-1
9452,514,21,9,0.0515753562,0.948424644,2874.095008,2790.06808,5030.653724,4116.385214,9966,852.5235244,19932,-4839424,263168,-4576256,-1
9322,620,21,9,0.0623616978,0.937638302,2864.193691,2955.584732,4968.110384,5022.464516,9942,261.6315789,19884,-4772864,317440,-4455424,-1
125,22,19,11,0.149659864,0.850340136,40.97534556,29.09179686,80.584,36.59090909,147,38.68421053,294,-64000,11264,-52736,-1
5421,350,22,8,0.0606480679,0.939351932,1654.756947,1799.436873,2907.015311,2560.502857,5771,227.2047244,11542,-2775552,179200,-2596352,-1
1076,71,22,8,0.0619006103,0.93809939,328.6639511,365.3670244,572.4330855,597.7464789,1147,70.19583843,2294,-550912,36352,-514560,-1
9514,452,20,10,0.0453542043,0.954645796,2868.18299,2926.506588,5024.254888,4125.663717,9966,519.0625,19932,-4871168,231424,-4639744,-1
9368,581,22,8,0.0583978289,0.941602171,2851.340248,3152.12428,5003.34778,4517.922547,9949,876.5638767,19898,-4796416,297472,-4498944,-1
9413,546,17,13,0.0548247816,0.945175218,2855.516755,3149.585339,5008.849145,4482.642857,9959,649.6412264,19918,-4819456,279552,-4539904,-1
3859,525,21,9,0.11975365,0.88024635,1251.34605,1363.838104,2200.945582,2130.420952,4384,257.1260997,8768,-1975808,268800,-1707008,-1
6001,376,21,9,0.0589618943,0.941038106,1816.542398,2169.100665,3169.344276,3502.707447,6377,137.0808255,12754,-3072512,192512,-2880000,-1
5327,356,21,9,0.0626429703,0.93735703,1647.093227,1520.106771,2857.62324,2608.22191,5683,303.5790598,11366,-2727424,182272,-2545152,-1
2075,224,22,8,0.0974336668,0.902566333,646.8485064,776.1404056,1171.066506,954.8526786,2299,155.2329507,4598,-1062400,114688,-947712,-1
208,46,20,10,0.181102362,0.818897638,70.45511113,70.37752638,137.0721154,84.2173913,254,29.33025404,508,-106496,23552,-82944,-1
4265,334,20,10,0.0726244836,0.927375516,1303.520554,1529.996036,2336.267526,1836.883234,4599,150.9848982,9198,-2183680,171008,-2012672,-1
1868,288,20,10,0.133580705,0.866419295,603.4187623,689.7017742,1114.364561,845.8784722,2156,62.61980831,4312,-956416,147456,-808960,-1
9129,785,22,8,0.0791809562,0.920819044,2839.061986,3046.568116,4903.716836,5582.96051,9914,382.0423892,19828,-4674048,401920,-4272128,-1
1698,108,21,9,0.0598006645,0.940199336,513.8921659,545.274503,922.5906949,603.3518519,1806,181.3253012,3612,-869376,55296,-814080,-1
220,49,19,11,0.182156134,0.817843866,74.8377025,75.92680445,144.4318182,92.65306122,269,22.17642209,538,-112640,25088,-87552,-1
1694,156,21,9,0.0843243243,0.915675676,531.8109891,554.3797157,930.9132231,866.7179487,1850,91.49357072,3700,-867328,79872,-787456,-1
4577,240,27,3,0.0498235416,0.950176458,1381.549284,1541.127712,2418.463841,2228.516667,4817,299.5646766,9634,-2343424,122880,-2220544,-1
4581,434,21,9,0.0865403789,0.913459621,1428.380659,1630.145144,2522.359528,2356.430876,5015,130.9741447,10030,-2345472,222208,-2123264,-1
2962,254,21,9,0.0789800995,0.9210199,906.2049993,1122.579148,1585.798109,1873.23622,3216,125.7723895,6432,-1516544,130048,-1386496,-1
2325,161,19,11,0.064762671,0.935237329,702.910012,903.7715187,1245.023656,1221.496894,2486,179.8842258,4972,-1190400,82432,-1107968,-1
4905,465,21,9,0.0865921788,0.913407821,1525.111851,1771.329227,2660.059735,2953.853763,5370,169.3472091,10740,-2511360,238080,-2273280,-1
5999,548,21,9,0.0837024591,0.916297541,1859.575593,2195.098638,3272.071345,3295.113139,6547,300.1834021,13094,-3071488,280576,-2790912,-1
7012,1509,20,10,0.177091891,0.822908109,2484.408182,2253.856832,4136.701369,4838.589132,8521,156.6648281,17042,-3590144,772608,-2817536,-1
1163,55,21,9,0.0451559934,0.954844007,347.7040835,396.9396299,616.6242476,458.8545455,1218,33.41563786,2436,-595456,28160,-567296,-1
5233,680,21,9,0.115000846,0.884999154,1662.950553,1959.0061,2900.105293,3394.838235,5913,215.8029197,11826,-2679296,348160,-2331136,-1
8682,701,17,13,0.0747095812,0.925290419,2723.145784,2520.522836,4698.837595,4607.315264,9383,190.9442409,18766,-4445184,358912,-4086272,-1
1988,86,17,13,0.0414657666,0.958534233,591.8099934,676.6274414,1050.246982,742.8372093,2074,218.3157895,4148,-1017856,44032,-973824,-1
9405,578,27,3,0.0578984273,0.942101573,2872.836286,3008.860582,5010.408187,4692.468858,9983,546.4148878,19966,-4815360,295936,-4519424,-1
2045,164,21,9,0.0742417383,0.925758262,626.5750075,712.5062107,1126.003423,843.097561,2209,132.8322309,4418,-1047040,83968,-963072,-1
4173,260,18,12,0.0586510264,0.941348974,1261.350168,1508.661081,2237.032111,1895.484615,4433,340.7378939,8866,-2136576,133120,-2003456,-1
458,56,20,10,0.108949416,0.891050584,142.4600344,189.947367,257.9432314,253.875,514,37.51824818,1028,-234496,28672,-205824,-1
632,137,20,10,0.178153446,0.821846554,218.915712,235.6572044,385.1629747,384.2481752,769,62.26720648,1538,-323584,70144,-253440,-1
9375,570,21,9,0.0573152338,0.942684766,2870.160781,2882.574425,4972.591787,4979.714035,9945,722.2222222,19890,-4800000,291840,-4508160,-1
85,23,18,12,0.212962963,0.787037037,30.24015525,33.24316096,56.63529412,46.60869565,108,27,216,-43520,11776,-31744,-1
432,57,22,8,0.116564417,0.883435583,133.445649,184.2156457,239.3842593,287.5614035,489,13.87234043,978,-221184,29184,-192000,-1
2036,252,20,10,0.11013986,0.88986014,649.7842764,732.3166894,1157.952849,1035.809524,2288,152.9411765,4576,-1042432,129024,-913408,-1
5181,719,17,13,0.121864407,0.878135593,1720.330559,1572.489143,2941.213279,3017.418637,5900,148.8020177,11800,-2652672,368128,-2284544,-1
9499,463,19,11,0.0464766111,0.953523389,2866.301161,3038.32869,5000.270976,4596.390929,9962,1364.657534,19924,-4863488,237056,-4626432,-1
1406,415,26,4,0.22789676,0.77210324,471.4449507,581.5710352,820.6628734,1217.057831,1821,95.19079979,3642,-719872,212480,-507392,-1
9506,458,20,10,0.0459654757,0.954034524,2848.800485,3372.909019,5001.997791,4577.81441,9964,782.717989,19928,-4867072,234496,-4632576,-1
4694,383,20,10,0.0754382509,0.924561749,1446.20847,1674.841037,2524.311248,2719.023499,5077,219.2141623,10154,-2403328,196096,-2207232,-1
6903,614,21,9,0.0816815219,0.918318478,2154.18615,2336.722518,3748.258149,3879.767101,7517,348.6549165,15034,-3534336,314368,-3219968,-1
4590,315,18,12,0.0642201835,0.935779817,1390.863251,1693.5213,2479.802397,2062.450794,4905,247.3524962,9810,-2350080,161280,-2188800,-1
4973,367,21,9,0.0687265918,0.931273408,1514.675986,1865.336534,2663.849789,2760.613079,5340,297.8248745,10680,-2546176,187904,-2358272,-1
4596,425,21,9,0.0846444931,0.915355507,1448.058254,1452.89851,2527.116188,2336.717647,5021,218.3043478,10042,-2353152,217600,-2135552,-1
1524,62,19,11,0.0390920555,0.960907945,454.4150075,513.1652496,799.5544619,644.6774194,1586,72.18934911,3172,-780288,31744,-748544,-1
961,147,21,9,0.13267148,0.86732852,309.9979783,377.6111748,556.9240375,538.6530612,1108,88.00635425,2216,-492032,75264,-416768,-1
972,149,26,4,0.132917038,0.867082962,315.9835563,362.7629668,550.9866255,626.3221477,1121,37.5167336,2242,-497664,76288,-421376,-1
1114,107,27,3,0.0876330876,0.912366912,348.9221872,368.1831634,622.0861759,495.5794393,1221,91.11940299,2442,-570368,54784,-515584,-1
8918,975,17,13,0.0985545335,0.901445466,2901.401975,2399.214295,4951.225387,4908.351795,9893,542.6769062,19786,-4566016,499200,-4066816,-1
5135,652,22,8,0.112666321,0.887333679,1576.478334,2121.464575,2794.2037,3679.972393,5787,105.9308072,11574,-2629120,333824,-2295296,-1
8207,605,22,8,0.0686563777,0.931343622,2537.582084,2625.062452,4399.766053,4497.847934,8812,291.4021164,17624,-4201984,309760,-3892224,-1
6576,529,25,5,0.0744546094,0.925545391,2057.213047,1932.931936,3583.479623,3174.10775,7105,390.3846154,14210,-3366912,270848,-3096064,-1
153,29,18,12,0.159340659,0.840659341,49.38562178,66.74504707,91.62745098,90.82758621,182,14.16342412,364,-78336,14848,-63488,-1
65,25,19,11,0.277777778,0.722222222,26.69962657,23.00733796,47.73846154,39.68,90,24.52316076,180,-33280,12800,-20480,-1
1754,168,20,10,0.087408949,0.912591051,540.0437909,679.6552341,950.304447,1078.386905,1922,83.930131,3844,-898048,86016,-812032,-1
3053,227,19,11,0.0692073171,0.930792683,932.635085,1118.994796,1644.932525,1580.885463,3280,216.7878387,6560,-1563136,116224,-1446912,-1
9533,442,17,13,0.0443107769,0.955689223,2868.116344,2974.581842,5030.01007,4081.932127,9975,809.6590909,19950,-4880896,226304,-4654592,-1
3967,238,20,10,0.0565992866,0.943400713,1198.059258,1425.137841,2119.32367,1830.915966,4205,137.6882777,8410,-2031104,121856,-1909248,-1
1828,311,18,12,0.145395044,0.854604956,598.8800445,688.2583646,1038.33698,1256.109325,2139,54.30312262,4278,-935936,159232,-776704,-1
9658,331,19,11,0.0331364501,0.96686355,2874.580312,3090.848415,5012.609132,4481.196375,9989,916.4220183,19978,-4944896,169472,-4775424,-1
6222,389,22,8,0.0588413251,0.941158675,1880.40882,2168.065267,3354.515429,2530.002571,6611,264.0175719,13222,-3185664,199168,-2986496,-1
2376,218,16,14,0.0840400925,0.915959907,727.8870678,936.9291231,1309.875842,1162.614679,2594,100.8945935,5188,-1216512,111616,-1104896,-1
2767,481,27,3,0.148091133,0.851908867,927.9522201,902.7710776,1558.765811,2002.642412,3248,61.36406575,6496,-1416704,246272,-1170432,-1
268,39,20,10,0.127035831,0.872964169,85.04525506,97.51672086,160.9514925,106.2307692,307,11.42113095,614,-137216,19968,-117248,-1
4396,301,21,9,0.0640834575,0.935916542,1331.613261,1666.338342,2357.204277,2229.179402,4697,349.7393894,9394,-2250752,154112,-2096640,-1
1489,175,27,3,0.105168269,0.894831731,470.2680428,554.8305939,825.0463398,895.92,1664,126.539924,3328,-762368,89600,-672768,-1
9448,513,22,8,0.0515008533,0.948499147,2863.480092,2987.689899,5022.364627,4219.181287,9961,1200.120482,19922,-4837376,262656,-4574720,-1
2569,326,18,12,0.112607945,0.887392055,821.8686421,890.8750799,1413.021798,1723.641104,2895,77.48929336,5790,-1315328,166912,-1148416,-1
8248,411,19,11,0.0474650653,0.952534935,2485.762493,2738.513987,4347.996969,3968.83455,8659,190.9792678,17318,-4222976,210432,-4012544,-1
9348,598,21,9,0.0601246732,0.939875327,2854.933119,3070.260208,5005.714698,4469.916388,9946,1030.673575,19892,-4786176,306176,-4480000,-1
1337,224,17,13,0.143497758,0.856502242,452.9687391,413.0509814,802.8130142,650.8035714,1561,125.0801282,3122,-684544,114688,-569856,-1
1806,205,21,9,0.101939334,0.898060666,576.563897,609.8350149,1013.974529,935.7463415,2011,106.8544102,4022,-924672,104960,-819712,-1
305,33,20,10,0.0976331361,0.902366864,94.25163013,102.5633178,176.6852459,103.0909091,338,25.84097859,676,-156160,16896,-139264,-1
4608,244,25,5,0.0502885408,0.949711459,1390.501541,1500.424648,2452.072483,1943.557377,4852,309.044586,9704,-2359296,124928,-2234368,-1
1752,176,17,13,0.0912863071,0.908713693,552.3847172,585.9503784,975.2408676,857.5795455,1928,105.2401747,3856,-897024,90112,-806912,-1
9419,544,21,9,0.0546020275,0.945397972,2850.47522,3042.818182,5051.93322,3771.152574,9963,837.9310345,19926,-4822528,278528,-4544000,-1
2605,128,24,6,0.0468349799,0.95316502,785.0104065,822.7723739,1379.841075,1105.664063,2733,211.5325077,5466,-1333760,65536,-1268224,-1
6052,279,22,8,0.0440688675,0.955931133,1812.033425,2137.437941,3167.148711,3141.082437,6331,319.2637418,12662,-3098624,142848,-2955776,-1
3828,364,19,11,0.0868320611,0.913167939,1194.712039,1328.005676,2123.856061,1808.81044,4192,189.5974672,8384,-1959936,186368,-1773568,-1
8980,928,21,9,0.0936616875,0.906338312,2868.123514,2781.848559,4959.356682,4907.503233,9908,297.5375375,19816,-4597760,475136,-4122624,-1
2337,183,22,8,0.0726190476,0.927380952,709.285882,898.6060239,1278.215233,1034.26776,2520,237.5117813,5040,-1196544,93696,-1102848,-1
2056,173,23,7,0.0776132795,0.922386721,634.1167656,734.5298139,1125.321984,992.3294798,2229,254.1619156,4458,-1052672,88576,-964096,-1
2413,240,20,10,0.0904636261,0.909536374,749.3874904,910.0468253,1317.889764,1418.595833,2653,121.9770115,5306,-1235456,122880,-1112576,-1
3531,2532,22,8,0.417615042,0.582384958,1948.07014,1044.658517,2498.147267,3776.484202,6063,131.2337662,12126,-1807872,1296384,-511488,-1
9531,447,21,9,0.0447985568,0.955201443,2860.267877,3088.231032,5040.208163,3908.293065,9978,943.9924314,19956,-4879872,228864,-4651008,-1
8302,1420,17,13,0.146060481,0.853939519,2790.038574,2650.275294,4675.078294,5951.410563,9722,221.9634703,19444,-4250624,727040,-3523584,-1
578,55,20,10,0.0868878357,0.913112164,176.8609444,216.9610499,325.384083,228.8909091,633,77.00729927,1266,-295936,28160,-267776,-1
3405,173,19,11,0.0483510341,0.951648966,1021.985962,1209.97913,1799.82232,1586.33526,3578,166.2639405,7156,-1743360,88576,-1654784,-1
275,48,22,8,0.148606811,0.851393189,93.29132219,91.9269954,164.2218182,149.2708333,323,18.47826087,646,-140800,24576,-116224,-1
6077,572,21,9,0.0860279741,0.913972026,1875.880554,2207.694213,3257.361198,4043.603147,6649,202.5281754,13298,-3111424,292864,-2818560,-1
3245,286,19,11,0.0809968847,0.919003115,1005.832116,1157.45825,1774.024037,1674.958042,3531,234.4621514,7062,-1661440,146432,-1515008,-1
6269,356,21,9,0.0537358491,0.946264151,1892.061553,2238.592979,3306.528473,3426.960674,6625,208.0062794,13250,-3209728,182272,-3027456,-1
437,93,16,14,0.175471698,0.824528302,143.6422321,190.2676326,268.5354691,251.2365591,530,9.996227839,1060,-223744,47616,-176128,-1
4540,586,21,9,0.114319157,0.885680843,1451.081391,1630.22002,2511.539648,2966.059727,5126,196.6244726,10252,-2324480,300032,-2024448,-1
2720,263,21,9,0.0881662756,0.911833724,837.3208046,1020.349032,1523.773162,1163.395437,2983,60.32355915,5966,-1392640,134656,-1257984,-1
6378,323,20,10,0.0482017609,0.951798239,1919.98129,2163.152331,3370.826905,2959.495356,6701,310.2314815,13402,-3265536,165376,-3100160,-1
5253,394,22,8,0.0697715601,0.93022844,1609.581939,1667.138303,2887.329336,1979.662437,5647,104.6515938,11294,-2689536,201728,-2487808,-1
3894,381,21,9,0.089122807,0.910877193,1181.233192,1528.791925,2072.601438,2806.404199,4275,81.56840298,8550,-1993728,195072,-1798656,-1
9595,391,20,10,0.0391548167,0.960845183,2854.571496,3275.329661,5043.132048,3775.547315,9986,1076.077586,19972,-4912640,200192,-4712448,-1
5168,491,21,9,0.086764446,0.913235554,1607.360914,1882.799703,2817.396285,2962.659878,5659,218.157286,11318,-2646016,251392,-2394624,-1
4687,342,22,8,0.0680055677,0.931994432,1431.089573,1433.056125,2580.707489,1614.5,5029,213.8180272,10058,-2399744,175104,-2224640,-1
8430,894,21,9,0.0958815959,0.904118404,2681.631395,2734.825721,4610.015184,5157.407159,9324,201.3822894,18648,-4316160,457728,-3858432,-1
2854,250,21,9,0.0805412371,0.919458763,888.6355435,930.9953435,1527.702172,1835.592,3104,321.3250518,6208,-1461248,128000,-1333248,-1
31,20,18,12,0.392156863,0.607843137,14.28147254,15.31494368,26.67741935,24.95,51,5.019685039,102,-15872,10240,-5632,-1
9221,699,21,9,0.0704637097,0.92953629,2855.699331,2965.748799,4955.188266,5030.570815,9920,858.1314879,19840,-4721152,357888,-4363264,-1
369,88,19,11,0.192560175,0.807439825,124.5617211,158.9409159,227.3387534,235.9659091,457,28.97907419,914,-188928,45056,-143872,-1
2739,123,20,10,0.0429769392,0.957023061,825.6540099,829.8758829,1436.612267,1317.658537,2862,78.1540142,5724,-1402368,62976,-1339392,-1
1529,86,17,13,0.053250774,0.946749226,456.6672785,515.561895,825.9960759,488.0465116,1615,215.3333333,3230,-782848,44032,-738816,-1
5747,646,20,10,0.101048021,0.898951979,1823.761489,2027.778616,3190.610753,3253.840557,6393,275.7981018,12786,-2942464,330752,-2611712,-1
758,101,21,9,0.11757858,0.88242142,237.743311,305.2954064,420.6583113,500.1089109,859,36.47558386,1718,-388096,51712,-336384,-1
3313,229,17,13,0.0646527386,0.935347261,1001.463432,1229.329285,1797.376094,1397.144105,3542,189.8177921,7084,-1696256,117248,-1579008,-1
9208,714,20,10,0.0719612981,0.928038702,2852.496005,2933.655505,4910.674957,5616.957983,9922,538.0694143,19844,-4714496,365568,-4348928,-1
87,30,18,12,0.256410256,0.743589744,33.87463774,25.4078728,65.48275862,40.2,117,26.65148064,234,-44544,15360,-29184,-1
8454,356,22,8,0.0404086266,0.959591373,2541.527286,2499.30398,4432.450201,3765.508427,8810,169.0978887,17620,-4328448,182272,-4146176,-1
9492,476,17,13,0.047752809,0.952247191,2843.749146,3322.307743,5035.695849,3963.594538,9968,1341.588156,19936,-4859904,243712,-4616192,-1
3090,305,21,9,0.0898379971,0.910162003,953.875274,1172.7822,1668.526537,1996.6,3395,126.3490882,6790,-1582080,156160,-1425920,-1
2263,158,23,7,0.0652622883,0.934737712,694.8732115,711.2110593,1227.895714,969.0063291,2421,115.0665399,4842,-1158656,80896,-1077760,-1
1535,145,20,10,0.0863095238,0.913690476,479.049902,519.2315356,855.07557,686.2,1680,136.8078176,3360,-785920,74240,-711680,-1
7662,342,21,9,0.0427286357,0.957271364,2283.093629,2632.334379,4051.046855,2914.880117,8004,458.1568403,16008,-3922944,175104,-3747840,-1
99,41,17,13,0.292857143,0.707142857,39.78540795,41.67224313,71.98989899,66.90243902,140,16.03665521,280,-50688,20992,-29696,-1
3085,208,20,10,0.0631642879,0.936835712,942.8033049,974.3067889,1674.185089,1243.798077,3293,292.7111111,6586,-1579520,106496,-1473024,-1
3855,365,21,9,0.086492891,0.913507109,1192.926485,1458.721144,2110.505318,2110.443836,4220,81.90993789,8440,-1973760,186880,-1786880,-1
3707,737,22,8,0.165841584,0.834158416,1274.657094,1242.403197,2139.711357,2638.914518,4444,92.71854788,8888,-1897984,377344,-1520640,-1
3344,389,20,10,0.104205733,0.895794267,1068.154983,1151.397229,1878.134868,1771.280206,3733,337.8280543,7466,-1712128,199168,-1512960,-1
9086,800,22,8,0.0809225167,0.919077483,2831.895255,3040.416592,4991.065155,4403.27875,9886,337.5213383,19772,-4652032,409600,-4242432,-1
1489,89,27,3,0.056400507,0.943599493,452.2846948,490.6398418,782.1423774,912.5955056,1578,71.62959601,3156,-762368,45568,-716800,-1
3378,431,21,9,0.113153059,0.886846941,1089.103355,1161.967286,1881.483718,2089.310905,3809,158.7083333,7618,-1729536,220672,-1508864,-1
9508,464,20,10,0.0465302848,0.953469715,2851.557245,3312.354726,5020.142512,4297.118534,9972,479.6536797,19944,-4868096,237568,-4630528,-1
279,62,20,10,0.181818182,0.818181818,94.18288279,114.1588486,167.2616487,187.8225806,341,9.006867406,682,-142848,31744,-111104,-1
3783,275,18,12,0.0677673731,0.932232627,1151.29383,1392.313135,2049.049432,1760.570909,4058,188.2189239,8116,-1936896,140800,-1796096,-1
2700,271,22,8,0.0912150791,0.908784921,853.935119,889.8637475,1494.077037,1405.527675,2971,104.7971781,5942,-1382400,138752,-1243648,-1
3714,350,26,4,0.0861220472,0.913877953,1165.028593,1256.059358,2029.952073,2059.537143,4064,181.915846,8128,-1901568,179200,-1722368,-1
2361,273,21,9,0.103644647,0.896355353,742.4149608,900.7861749,1316.377382,1327.208791,2634,148.3108108,5268,-1208832,139776,-1069056,-1
8912,886,22,8,0.0904266177,0.909573382,2710.443705,3090.724492,4687.032428,7036.645598,9798,210.8003442,19596,-4562944,453632,-4109312,-1
1786,172,22,8,0.0878447395,0.91215526,559.9074245,556.0539696,1004.25196,722.4825581,1958,135.0344828,3916,-914432,88064,-826368,-1
1587,235,17,13,0.128979144,0.871020856,518.1182875,533.8985471,941.4373031,709.3276596,1822,39.65179543,3644,-812544,120320,-692224,-1
9452,514,20,10,0.0515753562,0.948424644,2878.546435,2780.828948,5015.859183,4388.44358,9966,725.3275109,19932,-4839424,263168,-4576256,-1
286,47,17,13,0.141141141,0.858858859,91.66849974,97.42555747,177.6013986,102.4893617,333,51.15207373,666,-146432,24064,-122368,-1
215,60,15,15,0.218181818,0.781818182,74.36484483,90.11969818,145.5906977,110.8,275,5.050505051,550,-110080,30720,-79360,-1
517,59,27,3,0.102430556,0.897569444,166.1673677,162.5052484,292.7678917,251.1016949,576,52.31607629,1152,-264704,30208,-234496,-1
905,85,17,13,0.0858585859,0.914141414,275.5407912,377.8390741,496.6232044,483.5411765,990,93.92789374,1980,-463360,43520,-419840,-1
3852,247,21,9,0.0602585997,0.9397414,1163.416871,1288.119294,2092.515576,1386.963563,4099,167.1015084,8198,-1972224,126464,-1845760,-1
9557,423,22,8,0.0423847695,0.95761523,2885.227526,2751.094715,5008.766872,4577.789598,9980,937.0892019,19960,-4893184,216576,-4676608,-1
5202,1365,19,11,0.207857469,0.792142531,1904.952813,1859.579701,3273.142253,3325.378755,6567,126.3856813,13134,-2663424,698880,-1964544,-1
5072,352,19,11,0.0648967552,0.935103245,1554.580643,1689.45927,2733.790221,2405.727273,5424,122.0522052,10848,-2596864,180224,-2416640,-1
3376,439,20,10,0.115072084,0.884927916,1084.718801,1180.990948,1946.055391,1615.346241,3815,93.185149,7630,-1728512,224768,-1503744,-1
3588,197,16,14,0.0520475561,0.947952444,1079.329636,1219.355973,1918.824693,1422.649746,3785,511.4864865,7570,-1837056,100864,-1736192,-1
503,107,24,6,0.175409836,0.824590164,170.2482902,198.573481,311.8787276,275.5140187,610,62.30847804,1220,-257536,54784,-202752,-1
1189,254,27,3,0.176022176,0.823977824,403.3458402,470.0192422,710.8402019,774.2401575,1443,31.78414097,2886,-608768,130048,-478720,-1
5837,1057,22,8,0.153321729,0.846678271,1934.370362,2015.260219,3272.132088,4415.922422,6894,148.194325,13788,-2988544,541184,-2447360,-1
7845,1985,22,8,0.201932859,0.798067141,2913.044587,2461.390384,4795.671256,5389.080101,9830,251.3423677,19660,-4016640,1016320,-3000320,-1
2015,197,22,8,0.0890596745,0.910940325,617.0122973,822.9031919,1114.397519,1025.720812,2212,99.63963964,4424,-1031680,100864,-930816,-1
2833,240,21,9,0.078099577,0.921900423,874.3308942,969.7240449,1564.227674,1215.6,3073,56.99183976,6146,-1450496,122880,-1327616,-1
3843,383,20,10,0.0906294368,0.909370563,1223.469287,1156.541628,2089.425709,2355.060052,4226,185.4322071,8452,-1967616,196096,-1771520,-1
9435,504,23,7,0.0507093269,0.949290673,2856.584764,3084.562054,4956.890832,5215.406746,9939,311.860684,19878,-4830720,258048,-4572672,-1
3497,295,20,10,0.0777953586,0.922204641,1075.622272,1213.828553,1934.025736,1451.661017,3792,79.38036425,7584,-1790464,151040,-1639424,-1
9447,528,21,9,0.0529323308,0.947067669,2834.705364,3425.860135,5046.03599,3949.617424,9975,567.4061433,19950,-4836864,270336,-4566528,-1
1219,172,20,10,0.123652049,0.876347951,403.1653736,388.3801766,700.5200984,663.9651163,1391,53.85210995,2782,-624128,88064,-536064,-1
5592,232,27,3,0.0398351648,0.960164835,1676.825356,1724.551302,2931.136266,2463.301724,5824,196.8897904,11648,-2863104,118784,-2744320,-1
61,16,24,6,0.207792208,0.792207792,22.97005049,17.46592665,40.81967213,32.0625,77,2.224790523,154,-31232,8192,-23040,-1
528,81,20,10,0.133004926,0.866995074,169.7163548,196.3351938,316.1268939,232.4691358,609,18.83116883,1218,-270336,41472,-228864,-1
9242,721,21,9,0.0723677607,0.927632239,2860.544747,2804.220736,5075.538953,3782.988904,9963,337.2714963,19926,-4731904,369152,-4362752,-1
2260,320,20,10,0.124031008,0.875968992,739.6462502,772.3354087,1305.039823,1187.8125,2580,110.7771576,5160,-1157120,163840,-993280,-1
1462,122,20,10,0.077020202,0.922979798,443.7595963,584.3696327,783.2250342,903.647541,1584,31.73076923,3168,-748544,62464,-686080,-1
4999,495,26,4,0.090098289,0.909901711,1564.028877,1788.63871,2736.145029,2862.173737,5494,117.3430158,10988,-2559488,253440,-2306048,-1
3587,298,21,9,0.0767052767,0.923294723,1098.475085,1348.292277,1961.758294,1717.208054,3885,141.3755459,7770,-1836544,152576,-1683968,-1
150,53,18,12,0.261083744,0.738916256,60.42255061,49.83430716,107.5733333,86.22641509,203,29.50581395,406,-76800,27136,-49664,-1
5495,537,20,10,0.0890251989,0.910974801,1729.844438,1844.686235,3034.123385,2836.163873,6032,121.6129032,12064,-2813440,274944,-2538496,-1
3316,212,19,11,0.0600907029,0.939909297,1004.499132,1139.842309,1790.744873,1353.990566,3528,430.2439024,7056,-1697792,108544,-1589248,-1
5703,960,20,10,0.144079244,0.855920756,1868.58689,2163.561131,3253.4559,3798.601042,6663,161.9198056,13326,-2919936,491520,-2428416,-1
1216,140,27,3,0.103244838,0.896755162,384.8836635,443.2843697,681.8758224,649.1785714,1356,120.855615,2712,-622592,71680,-550912,-1
3527,597,19,11,0.144762367,0.855237633,1189.964773,1193.613298,2061.479161,2068.530988,4124,113.2034038,8248,-1805824,305664,-1500160,-1
7333,513,20,10,0.065383635,0.934616365,2248.799594,2413.364133,3883.638756,4493.290448,7846,296.8596292,15692,-3754496,262656,-3491840,-1
842,164,27,3,0.163021869,0.836978131,277.2240853,350.1147307,505.8574822,491.3963415,1006,25.46190838,2012,-431104,83968,-347136,-1
621,90,21,9,0.126582278,0.873417722,198.7847131,241.5746147,361.7246377,316.5,711,83.84433962,1422,-317952,46080,-271872,-1
2062,250,20,10,0.108131488,0.891868512,655.5818341,705.2576394,1124.686227,1418.9,2312,88.65030675,4624,-1055744,128000,-927744,-1
42,20,20,10,0.322580645,0.677419355,18.5339671,16.33669183,32.33333333,29.75,62,12.3752495,124,-21504,10240,-11264,-1
1381,167,19,11,0.107881137,0.892118863,436.3381578,525.5852574,776.6842867,756.4371257,1548,116.7420814,3096,-707072,85504,-621568,-1
9556,417,19,11,0.0418128948,0.958187105,2867.010909,3022.530134,5023.38897,4153.107914,9973,1103.207965,19946,-4892672,213504,-4679168,-1
1734,158,20,10,0.0835095137,0.916490486,523.7320945,744.5886259,954.0011534,864.1772152,1892,34.86272342,3784,-887808,80896,-806912,-1
3779,279,21,9,0.0687530803,0.93124692,1152.496206,1399.448811,2036.708918,1931.856631,4058,211.7954071,8116,-1934848,142848,-1792000,-1
7010,314,21,9,0.0428727471,0.957127253,2092.906823,2313.47724,3708.942939,2625.66879,7324,235.7257805,14648,-3589120,160768,-3428352,-1
4371,389,21,9,0.0817226891,0.918277311,1378.354511,1304.284195,2400.535804,2155.367609,4760,182.30563,9520,-2237952,199168,-2038784,-1
3212,269,17,13,0.0772766446,0.922723355,978.3916659,1278.878676,1744.096824,1704.022305,3481,96.9637883,6962,-1644544,137728,-1506816,-1
306,89,18,12,0.225316456,0.774683544,106.428766,136.1501349,201.8300654,184.8314607,395,22.96511628,790,-156672,45568,-111104,-1
52,12,25,5,0.1875,0.8125,18.13448283,19.18694579,33.57692308,27.83333333,64,7.087486157,128,-26624,6144,-20480,-1
138,21,24,6,0.132075472,0.867924528,46.04385917,33.85208589,84.1884058,52.47619048,159,20.12658228,318,-70656,10752,-59904,-1
3842,241,19,11,0.0590252265,0.940974773,1168.492441,1250.055286,2069.689224,1600.580913,4083,138.9248044,8166,-1967104,123392,-1843712,-1
1972,425,20,10,0.177304965,0.822695035,686.6214935,677.5441118,1153.639452,1409.472941,2397,134.8902645,4794,-1009664,217600,-792064,-1
9442,510,17,13,0.0512459807,0.948754019,2859.637648,3090.405204,4993.943232,4653.560784,9952,741.5797317,19904,-4834304,261120,-4573184,-1
699,74,22,8,0.0957309185,0.904269082,218.3263737,252.6742317,394.8283262,313.0540541,773,69.51438849,1546,-357888,37888,-320000,-1
5191,411,20,10,0.0733666548,0.926633345,1589.152947,1889.445725,2833.772491,2393.892944,5602,156.7431449,11204,-2657792,210432,-2447360,-1
9552,432,19,11,0.0432692308,0.956730769,2858.274766,3123.212928,5048.112228,3762.851852,9984,557.1428571,19968,-4890624,221184,-4669440,-1
2215,169,22,8,0.0708892617,0.929110738,673.7409198,838.0434829,1179.883521,1357.857988,2384,69.60583942,4768,-1134080,86528,-1047552,-1
114,31,20,10,0.213793103,0.786206897,40.81690928,42.21374184,77.07894737,58,145,26.95167286,290,-58368,15872,-42496,-1
273,79,19,11,0.224431818,0.775568182,96.67481807,117.0570974,177.1648352,174.2025316,352,34.14161009,704,-139776,40448,-99328,-1
6630,703,20,10,0.095867994,0.904132006,2094.731918,1995.829033,3785.287179,2551.432432,7333,325.7663261,14666,-3394560,359936,-3034624,-1
443,101,16,14,0.185661765,0.814338235,150.1685757,167.685519,288.1693002,203.7722772,544,80.47337278,1088,-226816,51712,-175104,-1
1113,124,21,9,0.100242522,0.899757478,349.5368658,386.0330367,636.1725067,464.8629032,1237,94.57186544,2474,-569856,63488,-506368,-1
392,65,20,10,0.142231947,0.857768053,129.0020764,137.6249117,237.497449,177.7538462,457,23.340143,914,-200704,33280,-167424,-1
206,62,26,4,0.231343284,0.768656716,76.48889427,74.26128044,142.4951456,107.9354839,268,7.712230216,536,-105472,31744,-73728,-1
4200,254,21,9,0.0570273911,0.942972609,1272.095026,1221.896669,2277.952381,1393.248031,4454,486.7759563,8908,-2150400,130048,-2020352,-1
2807,240,20,10,0.0787659993,0.921234001,869.2515015,986.5732216,1532.946918,1419.358333,3047,84.31101273,6094,-1437184,122880,-1314304,-1
7199,335,19,11,0.0444650916,0.955534908,2162.398424,2327.341719,3798.909432,3092.525373,7534,787.2518286,15068,-3685888,171520,-3514368,-1
9462,505,20,10,0.0506672018,0.949332798,2848.429917,3138.611499,5048.041746,3784.073267,9967,1577.056962,19934,-4844544,258560,-4585984,-1
1243,69,18,12,0.0525914634,0.947408537,370.4789097,456.412274,668.1705551,446.2608696,1312,38.08417997,2624,-636416,35328,-601088,-1
1184,103,22,8,0.08003108,0.91996892,359.5640669,463.1083267,656.9476351,495.1650485,1287,86.49193548,2574,-606208,52736,-553472,-1
9260,681,20,10,0.0685041746,0.931495825,2854.861292,2930.852368,5034.563175,4106.690162,9941,523.4860453,19882,-4741120,348672,-4392448,-1
8465,426,21,9,0.0479136205,0.952086379,2557.586495,2640.044431,4481.967513,3731.293427,8891,692.985191,17782,-4334080,218112,-4115968,-1
9593,379,21,9,0.038006418,0.961993582,2858.324277,3221.849163,5022.448035,4076.60686,9972,785.8156028,19944,-4911616,194048,-4717568,-1
9463,503,21,9,0.0504716035,0.949528397,2875.308564,2896.48084,4996.533552,4738.298211,9966,559.8876404,19932,-4845056,257536,-4587520,-1
509,90,21,9,0.150250417,0.849749583,168.2788975,168.5616439,316.6502947,205.8333333,599,71.99519231,1198,-260608,46080,-214528,-1
4131,290,21,9,0.065596019,0.934403981,1252.004654,1524.721641,2182.486807,2617.165517,4421,86.95908733,8842,-2115072,148480,-1966592,-1
2180,240,25,5,0.0991735537,0.900826446,691.7307173,710.3281943,1238.172936,959.1375,2420,69.98264893,4840,-1116160,122880,-993280,-1
3739,292,18,12,0.0724386008,0.927561399,1167.967352,1096.705784,2027.257288,1871.85274,4031,113.2939854,8062,-1914368,149504,-1764864,-1
9603,384,23,7,0.038449985,0.961550015,2874.534778,3011.351298,5020.654587,4327.427083,9987,1089.094875,19974,-4916736,196608,-4720128,-1
6880,416,22,8,0.0570175439,0.942982456,2081.961636,2350.669541,3693.500436,2904.262019,7296,474.3823147,14592,-3522560,212992,-3309568,-1
1982,203,21,9,0.0929061785,0.907093822,623.5162061,616.0971704,1124.897578,781.5665025,2185,229.0356394,4370,-1014784,103936,-910848,-1
9391,571,21,9,0.0573178077,0.942682192,2859.527117,3105.891108,5004.875945,4597.045534,9962,500.1004016,19924,-4808192,292352,-4515840,-1
9568,406,21,9,0.0407058352,0.959294165,2860.62112,3098.41633,5033.201505,3910.475369,9974,1242.092154,19948,-4898816,207872,-4690944,-1
9396,564,22,8,0.056626506,0.943373494,2863.280992,3067.021146,4980.046296,4988.058511,9960,197.7760127,19920,-4810752,288768,-4521984,-1
4958,319,19,11,0.0604510138,0.939548986,1508.890185,1703.635626,2619.366075,2944.15674,5277,199.7350492,10554,-2538496,163328,-2375168,-1
3239,184,17,13,0.0537540169,0.946245983,976.0355827,1180.279573,1709.724298,1752.059783,3423,194.5992041,6846,-1658368,94208,-1564160,-1
3703,175,21,9,0.0451263538,0.954873646,1104.675925,1376.456762,1950.372941,1709.428571,3878,323.9766082,7756,-1895936,89600,-1806336,-1
217,53,18,12,0.196296296,0.803703704,76.32993848,71.31776973,145.3087558,95.33962264,270,55.10204082,540,-111104,27136,-83968,-1
1234,122,25,5,0.0899705015,0.910029499,388.728731,332.7236592,702.3492707,437.2704918,1356,69.14839368,2712,-631808,62464,-569344,-1
2491,156,21,9,0.058934643,0.941065357,767.365927,708.2731573,1327.287836,1271.5,2647,139.5361096,5294,-1275392,79872,-1195520,-1
370,44,25,5,0.106280193,0.893719807,115.6132663,145.2572294,210.8540541,179.2954545,414,44.70842333,828,-189440,22528,-166912,-1
9367,582,20,10,0.0584983415,0.941501658,2835.226672,3057.723342,5066.020604,3510.068729,9949,1335.436242,19898,-4795904,297984,-4497920,-1
2106,145,21,9,0.0644158152,0.935584185,633.6224122,848.0140988,1130.626781,1058.8,2251,121.4786832,4502,-1078272,74240,-1004032,-1
9523,456,19,11,0.0456959615,0.954304038,2854.961334,3089.870836,5053.327418,3667.484649,9979,1103.871681,19958,-4875776,233472,-4642304,-1
2116,304,17,13,0.125619835,0.874380165,687.7568752,766.0447262,1220.715028,1139.398026,2420,70.4922808,4840,-1083392,155648,-927744,-1
9521,450,20,10,0.0451308796,0.95486912,2854.532915,3174.921219,5034.383468,3962.313333,9971,876.1862917,19942,-4874752,230400,-4644352,-1
6494,689,21,9,0.0959209244,0.904079076,2075.166003,2053.53115,3606.115953,3458.953556,7183,214.8026316,14366,-3324928,352768,-2972160,-1
3077,245,23,7,0.0737507526,0.926249247,945.9417859,1105.481801,1668.949301,1567.942857,3322,108.4203655,6644,-1575424,125440,-1449984,-1
8068,504,20,10,0.0587960803,0.94120392,2466.828681,2591.819794,4293.767848,4170.156746,8572,260.3888214,17144,-4130816,258048,-3872768,-1
1122,104,27,3,0.0848287113,0.915171289,347.656947,341.5763422,634.4750446,387.2115385,1226,79.50713359,2452,-574464,53248,-521216,-1
1180,111,27,3,0.0859798606,0.914020139,367.1176593,410.9212045,656.5550847,533.7927928,1291,133.6438923,2582,-604160,56832,-547328,-1
7129,352,20,10,0.0470525331,0.952947467,2140.112674,2342.944307,3785.945434,2830.727273,7481,472.8824273,14962,-3650048,180224,-3469824,-1
745,62,18,12,0.0768277571,0.923172243,228.8959807,266.5585629,410.0765101,330.983871,807,41.77018634,1614,-381440,31744,-349696,-1
9667,321,19,11,0.0321385663,0.967861434,2875.724923,3079.545214,5006.78018,4624.679128,9988,1059.172853,19976,-4949504,164352,-4785152,-1
5869,317,18,12,0.0512447462,0.948755254,1760.452688,2174.058715,3111.941898,2752.063091,6186,177.3509174,12372,-3004928,162304,-2842624,-1
784,125,27,3,0.137513751,0.862486249,249.4200535,316.0802142,439.7295918,550.776,909,34.1986456,1818,-401408,64000,-337408,-1
1023,166,18,12,0.13961312,0.86038688,340.9487405,355.5117288,590.1006843,625.1927711,1189,70.02355713,2378,-523776,84992,-438784,-1
2567,187,21,9,0.0679012346,0.932098765,789.4727624,854.8752431,1387.859758,1235.28877,2754,112.5919869,5508,-1314304,95744,-1218560,-1
2462,361,22,8,0.127878144,0.872121856,822.7080869,759.7132601,1410.81844,1420.058172,2823,75.28,5646,-1260544,184832,-1075712,-1
5030,465,21,9,0.084622384,0.915377616,1557.136113,1856.172323,2726.064612,2985.27957,5495,163.7853949,10990,-2575360,238080,-2337280,-1
580,63,16,14,0.0979782271,0.902021773,180.5112786,207.3594161,331.6051724,233.5714286,643,76.9138756,1286,-296960,32256,-264704,-1
3363,334,21,9,0.0903435218,0.909656478,1054.856802,1179.481385,1838.525721,1954.464072,3697,73.41143765,7394,-1721856,171008,-1550848,-1
9411,534,19,11,0.0536953243,0.946304676,2847.462455,3219.794037,4999.713952,4502.20412,9945,1001.510574,19890,-4818432,273408,-4545024,-1
7235,572,17,13,0.0732675804,0.92673242,2202.900293,2805.867699,3884.004561,4156.914336,7807,313.0312751,15614,-3704320,292864,-3411456,-1
7073,279,20,10,0.0379488575,0.962051143,2112.859597,2297.047673,3695.679485,3190.275986,7352,923.6180905,14704,-3621376,142848,-3478528,-1
2825,417,20,10,0.128624306,0.871375694,913.0915539,1071.867834,1606.101947,1725.815348,3242,164.7357724,6484,-1446400,213504,-1232896,-1
50,22,19,11,0.305555556,0.694444444,19.96933649,22.062271,38.16,32.72727273,72,10.54172767,144,-25600,11264,-14336,-1
6531,700,19,11,0.0968054211,0.903194579,2031.873087,2546.402141,3607.145307,3698.614286,7231,258.1578008,14462,-3343872,358400,-2985472,-1
9433,531,19,11,0.0532918507,0.946708149,2849.511976,2996.864234,5060.403689,3598.572505,9964,964.5692159,19928,-4829696,271872,-4557824,-1
8951,536,19,11,0.0564983662,0.943501634,2701.839669,3293.192946,4745.326891,4721.841418,9487,181.9175455,18974,-4582912,274432,-4308480,-1
1130,93,18,12,0.0760425184,0.923957482,341.7366651,385.715661,633.1345133,355.2043011,1223,71.10465116,2446,-578560,47616,-530944,-1
3403,195,27,3,0.054196776,0.945803224,1029.397973,1172.466661,1810.383485,1609.569231,3598,97.77173913,7196,-1742336,99840,-1642496,-1
3591,163,23,7,0.0434203516,0.956579648,1074.64562,1238.576217,1889.261766,1618.380368,3754,248.7740225,7508,-1838592,83456,-1755136,-1
2154,159,18,12,0.0687418936,0.931258106,653.6950634,816.8639655,1169.207521,991.6226415,2313,182.5572218,4626,-1102848,81408,-1021440,-1
1689,212,20,10,0.111520252,0.888479748,537.1355959,633.5994474,953.267614,932.9339623,1901,115.9146341,3802,-864768,108544,-756224,-1
7352,365,17,13,0.0472981729,0.952701827,2212.601694,2341.836893,3903.130985,2970.093151,7717,221.0541392,15434,-3764224,186880,-3577344,-1
7247,493,22,8,0.0636950904,0.93630491,2203.692538,2635.814735,3856.609632,4074.685598,7740,550.4978663,15480,-3710464,252416,-3458048,-1
9567,408,22,8,0.0409022556,0.959097744,2871.631633,3051.887343,4996.705655,4783.865196,9975,816.953317,19950,-4898304,208896,-4689408,-1
1718,193,21,9,0.100994244,0.899005756,541.5218059,580.8573362,983.2747381,713.2124352,1911,121.7973231,3822,-879616,98816,-780800,-1
9161,746,24,6,0.0753002927,0.924699707,2817.080054,3251.338608,5014.317651,4213.289544,9907,461.4345599,19814,-4690432,381952,-4308480,-1
5472,394,19,11,0.0671667235,0.932833277,1689.470852,1695.757212,2962.593019,2529.446701,5866,323.3737596,11732,-2801664,201728,-2599936,-1
61,23,18,12,0.273809524,0.726190476,24.43033303,19.72188482,46.75409836,31.2173913,84,2.352941176,168,-31232,11776,-19456,-1
844,128,24,6,0.131687243,0.868312757,276.444391,306.4090259,487.7618483,478.1796875,972,44.93758669,1944,-432128,65536,-366592,-1
68,26,19,11,0.276595745,0.723404255,27.37637753,24.49477664,50.77941176,38.92307692,94,12.16041397,188,-34816,13312,-21504,-1
7551,371,21,9,0.0468316082,0.953168392,2260.843961,2764.044433,3960.803072,3975.684636,7922,659.0682196,15844,-3866112,189952,-3676160,-1
9567,411,27,3,0.0411906194,0.958809381,2864.279245,3169.185412,5016.393331,4363.493917,9978,635.9464627,19956,-4898304,210432,-4687872,-1
9559,419,20,10,0.0419923832,0.958007617,2865.871616,3192.788601,4993.206193,4904.947494,9978,1132.576617,19956,-4894208,214528,-4679680,-1
4391,196,20,10,0.0427294528,0.957270547,1312.971322,1495.76618,2312.356183,1882.765306,4587,283.1481481,9174,-2248192,100352,-2147840,-1
6408,362,27,3,0.0534711965,0.946528804,1937.028602,2238.043518,3388.189451,3337.892265,6770,260.9868928,13540,-3280896,185344,-3095552,-1
9505,467,18,12,0.0468311272,0.953168873,2854.600702,3064.600799,5049.105629,3712.267666,9972,845.8015267,19944,-4866560,239104,-4627456,-1
8494,405,21,9,0.0455107315,0.954489268,2564.108318,2666.447533,4454.00883,4365.923457,8899,262.9728132,17798,-4348928,207360,-4141568,-1
1578,169,27,3,0.0967372639,0.903262736,496.9393398,549.9288798,888.7046895,736.6982249,1747,116.0797342,3494,-807936,86528,-721408,-1
9523,444,21,9,0.0445470051,0.955452995,2871.326051,2978.028169,5000.874304,4622.076577,9967,657.8877888,19934,-4875776,227328,-4648448,-1
3621,227,20,10,0.058991684,0.941008316,1097.630718,1216.54341,1952.935929,1470.903084,3848,316.1873459,7696,-1853952,116224,-1737728,-1
5179,473,27,3,0.0836871904,0.91631281,1577.585675,1766.622508,2931.367059,1678.283298,5652,543.9846006,11304,-2651648,242176,-2409472,-1
2122,111,21,9,0.0497089118,0.950291088,635.3212455,778.4119523,1126.797832,929.6936937,2233,141.7777778,4466,-1086464,56832,-1029632,-1
719,96,24,6,0.117791411,0.882208589,233.6840516,240.510199,414.9568846,355.8958333,815,33.10316816,1630,-368128,49152,-318976,-1
1726,132,22,8,0.0710441335,0.928955867,531.3508045,571.1366536,942.5602549,758.7272727,1858,65.03325166,3716,-883712,67584,-816128,-1
4418,369,21,9,0.0770837685,0.922916231,1369.822679,1459.831401,2427.662291,1990.96477,4787,150.1097523,9574,-2262016,188928,-2073088,-1
4640,676,16,14,0.127163281,0.872836719,1530.988028,1529.66086,2617.425647,2940.430473,5316,209.6214511,10632,-2375680,346112,-2029568,-1
5212,1180,21,9,0.184605757,0.815394243,1704.387354,1807.211168,2883.323484,4579.784746,6392,120.3086768,12784,-2668544,604160,-2064384,-1
264,49,21,9,0.156549521,0.843450479,86.70473973,103.8790505,161.9848485,130.1428571,313,16.39601886,626,-135168,25088,-110080,-1
8813,642,20,10,0.0679005817,0.932099418,2670.814464,3226.334133,4810.777147,3591.683801,9455,376.5432099,18910,-4512256,328704,-4183552,-1
3258,568,22,8,0.148457919,0.851542081,1097.619167,1103.443748,1865.555249,2188.507042,3826,84.42188879,7652,-1668096,290816,-1377280,-1
8504,370,25,5,0.0416948389,0.958305161,2550.575866,2655.875779,4475.976952,3553.154054,8874,674.3161094,17748,-4354048,189440,-4164608,-1
3336,283,18,12,0.0781983973,0.921801603,1030.479146,1184.884015,1825.395384,1628.519435,3619,78.13039724,7238,-1708032,144896,-1563136,-1
4445,1155,17,13,0.20625,0.79375,1609.340099,1375.736315,2592.075591,3602.618182,5600,104.6924659,11200,-2275840,591360,-1684480,-1
71,26,20,10,0.268041237,0.731958763,29.25559948,19.86749747,53.35211268,37.11538462,97,12.5974026,194,-36352,13312,-23040,-1
8766,421,21,9,0.0458256232,0.954174377,2636.449807,2857.822275,4629.882729,3846.855107,9187,298.7642276,18374,-4488192,215552,-4272640,-1
3382,198,24,6,0.0553072626,0.944692737,1018.585849,1180.817098,1815.624187,1361.358586,3580,214.3712575,7160,-1731584,101376,-1630208,-1
4278,308,22,8,0.0671609246,0.932839075,1301.335303,1564.264229,2318.296634,1949.084416,4586,304.717608,9172,-2190336,157696,-2032640,-1
5366,312,18,12,0.0549489257,0.945051074,1614.114981,1959.78579,2867.401975,2359.621795,5678,159.2260236,11356,-2747392,159744,-2587648,-1
6697,485,19,11,0.067529936,0.932470064,2045.059006,2424.135247,3602.769598,3435.886598,7182,135.2797137,14364,-3428864,248320,-3180544,-1
8288,574,20,10,0.0647709321,0.935229068,2506.775704,3088.401834,4372.725748,5280.142857,8862,275.3028891,17724,-4243456,293888,-3949568,-1
4670,449,21,9,0.0877124438,0.912287556,1433.453832,1872.571788,2547.773233,2687.169265,5119,188.7536873,10238,-2391040,229888,-2161152,-1
2758,142,25,5,0.0489655172,0.951034483,830.4828435,923.888981,1463.149021,1204.823944,2900,112.1423047,5800,-1412096,72704,-1339392,-1
9581,399,17,13,0.0399799599,0.96002004,2870.456215,3059.552037,5016.056362,4376.827068,9980,858.1255374,19960,-4905472,204288,-4701184,-1
4547,470,25,5,0.093681483,0.906318517,1444.749198,1451.084418,2538.650099,2222.151064,5017,118.0470588,10034,-2328064,240640,-2087424,-1
33,23,16,14,0.410714286,0.589285714,16.04939574,16.21453524,29.51515152,27.04347826,56,13.17647059,112,-16896,11776,-5120,-1
229,24,21,9,0.0948616601,0.90513834,70.10473631,87.0962012,131.1703057,87.20833333,253,20.33762058,506,-117248,12288,-104960,-1
9558,416,20,10,0.0417084419,0.958291558,2867.64579,3120.273052,4999.966939,4701.060096,9974,654.8916612,19948,-4893696,212992,-4680704,-1
3784,267,21,9,0.0659096519,0.934090348,1165.492753,1209.900702,2038.52722,1848.460674,4051,223.0726872,8102,-1937408,136704,-1800704,-1
4997,325,22,8,0.0610672679,0.938932732,1507.912789,1919.643948,2656.896338,2732.283077,5322,135.3165523,10644,-2558464,166400,-2392064,-1
7875,414,20,10,0.0499457112,0.950054289,2376.956539,2590.27086,4179.608127,3486.693237,8289,565.8020478,16578,-4032000,211968,-3820032,-1
69,31,21,9,0.31,0.69,28.27320429,29.70142788,52.42028986,46.22580645,100,1.901502187,200,-35328,15872,-19456,-1
380,50,22,8,0.11627907,0.88372093,120.4656879,116.2096055,227.0473684,127.74,430,32.06562267,860,-194560,25600,-168960,-1
41,21,21,9,0.338709677,0.661290323,18.38542345,16.85956399,31.97560976,30.57142857,62,17.03296703,124,-20992,10752,-10240,-1
995,72,21,9,0.0674789128,0.932521087,299.661757,401.8720967,538.1527638,476.6111111,1067,93.35083115,2134,-509440,36864,-472576,-1
1047,145,20,10,0.121644295,0.878355705,343.0878845,325.7996148,613.5644699,473.2827586,1192,41.23140782,2384,-536064,74240,-461824,-1
1193,86,27,3,0.0672400313,0.932759969,361.6098551,420.1107074,653.379715,454.3953488,1279,37.66195524,2558,-610816,44032,-566784,-1
7247,415,20,10,0.0541634038,0.945836596,2184.788426,2612.295488,3810.353526,4200.773494,7662,261.6803279,15324,-3710464,212480,-3497984,-1
2722,173,22,8,0.0597582038,0.940241796,824.8620359,864.1271688,1477.891256,977.6878613,2895,109.6175691,5790,-1393664,88576,-1305088,-1
9565,413,22,8,0.0413910603,0.95860894,2861.063158,3244.669269,5014.155358,4418.486683,9978,421.0126582,19956,-4897280,211456,-4685824,-1
6715,414,20,10,0.058072661,0.941927339,2046.847484,2215.594075,3580.43723,3314.611111,7129,154.1072201,14258,-3438080,211968,-3226112,-1
181,19,21,9,0.095,0.905,55.42109377,58.90585945,105.3480663,54.31578947,200,36.03603604,400,-92672,9728,-82944,-1
9484,482,23,7,0.0483644391,0.951635561,2860.191872,3026.149498,5033.310628,4003.408714,9966,1003.625378,19932,-4855808,246784,-4609024,-1
4151,128,27,3,0.0299135312,0.970086469,1234.056629,1271.885569,2141.652132,2086.421875,4279,860.9657948,8558,-2125312,65536,-2059776,-1
8769,587,22,8,0.0627404874,0.937259513,2688.061375,2553.333575,4765.546699,3378.13799,9356,177.2641152,18712,-4489728,300544,-4189184,-1
3268,291,21,9,0.0817645406,0.918235459,1024.289437,1061.351203,1782.130049,1756.079038,3559,88.1595244,7118,-1673216,148992,-1524224,-1
2407,356,18,12,0.128845458,0.871154542,787.2392279,853.9119255,1363.409223,1507.696629,2763,99.38848921,5526,-1232384,182272,-1050112,-1
3427,172,21,9,0.0477910531,0.952208947,1038.733126,1041.055733,1803.189087,1736.459302,3599,333.8589981,7198,-1754624,88064,-1666560,-1
192,28,18,12,0.127272727,0.872727273,60.75139227,40.70789424,119.8645833,46.28571429,220,36.42384106,440,-98304,14336,-83968,-1
690,100,21,9,0.126582278,0.873417722,220.2036293,275.8927647,393.7347826,407.68,790,15.82849128,1580,-353280,51200,-302080,-1
244,50,22,8,0.170068027,0.829931973,83.93845595,79.26609363,155.1680328,110.08,294,24.60251046,588,-124928,25600,-99328,-1
6379,679,19,11,0.0962028903,0.90379711,2012.830333,2255.666159,3526.659821,3556.182622,7058,289.8562628,14116,-3266048,347648,-2918400,-1
5371,462,21,9,0.079204526,0.920795474,1638.917133,2079.564794,2876.050084,3393.064935,5833,183.2547911,11666,-2749952,236544,-2513408,-1
5051,980,19,11,0.162493782,0.837506218,1753.717113,1668.706037,2992.555732,3136.833673,6031,116.744096,12062,-2586112,501760,-2084352,-1
737,67,21,9,0.0833333333,0.916666667,228.37396,268.4979755,400.3283582,426.3880597,804,59.1611479,1608,-377344,34304,-343040,-1
7932,538,22,8,0.0635182999,0.9364817,2409.847232,2767.637364,4295.671205,3348.366171,8470,220.5729167,16940,-4061184,275456,-3785728,-1
50,16,21,9,0.242424242,0.757575758,18.48173152,20.16097328,34.84,29.3125,66,4.526748971,132,-25600,8192,-17408,-1
9351,599,22,8,0.060201005,0.939798995,2873.883394,2721.390042,5027.596193,4162.225376,9950,886.8092692,19900,-4787712,306688,-4481024,-1
4450,623,20,10,0.122807018,0.877192982,1466.763455,1447.233982,2542.349888,2498.786517,5073,93.78813089,10146,-2278400,318976,-1959424,-1
2470,474,25,5,0.161005435,0.838994565,835.4376766,910.9745052,1448.245344,1598.890295,2944,105.3686471,5888,-1264640,242688,-1021952,-1
2043,185,20,10,0.0830341113,0.916965889,637.1205188,705.0120754,1118.499755,1070.32973,2228,75.39763113,4456,-1046016,94720,-951296,-1
4484,407,22,8,0.0832140667,0.916785933,1399.605208,1523.92171,2426.125558,2664.960688,4891,92.96711652,9782,-2295808,208384,-2087424,-1
2715,199,17,13,0.0682910089,0.931708991,822.9801937,1058.610337,1455.737385,1481.547739,2914,251.6407599,5828,-1390080,101888,-1288192,-1
2637,218,21,9,0.076357268,0.923642732,816.7307007,901.5595763,1437.418658,1314.068807,2855,201.056338,5710,-1350144,111616,-1238528,-1
7247,788,22,8,0.0980709396,0.90192906,2302.927761,2454.008959,3992.153581,4255.701777,8035,196.0712543,16070,-3710464,403456,-3307008,-1
2901,268,21,9,0.0845692648,0.915430735,892.2874525,1108.798258,1565.626336,1794.712687,3169,90.49114792,6338,-1485312,137216,-1348096,-1
444,101,16,14,0.185321101,0.814678899,149.4813611,166.3434941,290.9752252,193.980198,545,78.53025937,1090,-227328,51712,-175616,-1
2081,155,18,12,0.0693202147,0.930679785,634.775245,729.3333445,1137.329649,865.6967742,2236,397.1580817,4472,-1065472,79360,-986112,-1
1702,178,22,8,0.0946808511,0.905319149,532.7872254,628.6854458,944.1180964,905.9044944,1880,64.87232574,3760,-871424,91136,-780288,-1
3438,191,18,12,0.0526315789,0.947368421,1032.548487,1287.370113,1811.669575,1874.947644,3629,314.4714038,7258,-1760256,97792,-1662464,-1
4248,276,27,3,0.0610079576,0.938992042,1285.749167,1550.83788,2283.085452,1945.663043,4524,88.20432833,9048,-2174976,141312,-2033664,-1
9433,528,22,8,0.0530067262,0.946993274,2857.608942,2852.979463,5057.272448,3618.352273,9961,741.1458333,19922,-4829696,270336,-4559360,-1
4754,265,21,9,0.0527993624,0.947200638,1432.421601,1709.878269,2518.616113,2355.430189,5019,99.36646209,10038,-2434048,135680,-2298368,-1
3122,189,21,9,0.0570824524,0.942917548,942.6372971,1058.008549,1682.749199,1214.142857,3311,140.7738095,6622,-1598464,96768,-1501696,-1
9489,485,20,10,0.0486264287,0.951373571,2850.118596,3178.435882,5047.585625,3811.927835,9974,970.233463,19948,-4858368,248320,-4610048,-1
3257,519,27,3,0.137447034,0.862552966,1082.114608,1095.053523,1842.39914,2177.807322,3776,80.82191781,7552,-1667584,265728,-1401856,-1
58,7,24,6,0.107692308,0.892307692,17.98414713,18.34588315,34.81034483,18,65,7.158590308,130,-29696,3584,-26112,-1
9664,326,16,14,0.0326326326,0.967367367,2874.203954,3115.295283,5012.437707,4493.395706,9990,622.0423412,19980,-4947968,166912,-4781056,-1
3934,452,20,10,0.103055176,0.896944824,1235.673502,1501.665331,2205.036858,2093.088496,4386,169.017341,8772,-2014208,231424,-1782784,-1
8950,523,21,9,0.0552095429,0.944790457,2714.822929,2761.981897,4810.964916,3471.25239,9473,354.9269389,18946,-4582400,267776,-4314624,-1
7512,546,18,12,0.0677587491,0.932241251,2322.321235,2286.849164,4075.291667,3399.487179,8058,230.1628106,16116,-3846144,279552,-3566592,-1
252,12,27,3,0.0454545455,0.954545455,75.91978286,79.14999825,133.5079365,111.3333333,264,53.76782077,528,-129024,6144,-122880,-1
1719,117,21,9,0.0637254902,0.93627451,517.1247459,691.1422569,916.0110529,955.0683761,1836,162.3342175,3672,-880128,59904,-820224,-1
7519,619,22,8,0.0760629147,0.923937085,2322.000882,2622.663144,4035.367735,4484.105008,8138,188.1183541,16276,-3849728,316928,-3532800,-1
9112,826,19,11,0.083115315,0.916884685,2860.674039,2667.42076,5080.393547,3746.180387,9938,1098.121547,19876,-4665344,422912,-4242432,-1
9424,534,17,13,0.0536252259,0.946374774,2869.140345,2889.059431,5017.410123,4310.464419,9958,1600.96463,19916,-4825088,273408,-4551680,-1
8833,1078,20,10,0.108768036,0.891231964,2798.914961,3205.397087,4853.390581,5796.769017,9911,559.3115124,19822,-4522496,551936,-3970560,-1
1814,213,21,9,0.105081401,0.894918599,580.0194823,598.1590442,993.084344,1192.126761,2027,39.23732094,4054,-928768,109056,-819712,-1
35,21,20,10,0.375,0.625,16.11347516,16.22545242,28.11428571,29.14285714,56,6.511627907,112,-17920,10752,-7168,-1
2709,186,22,8,0.0642487047,0.935751295,836.2092803,800.0530111,1462.289037,1239.887097,2895,170.8972845,5790,-1387008,95232,-1291776,-1
4345,310,20,10,0.0665950591,0.933404941,1326.592919,1552.289794,2341.705409,2135.903226,4655,275.93361,9310,-2224640,158720,-2065920,-1
1101,245,22,8,0.182020802,0.817979198,387.6190381,392.6985341,674.6811989,668.1918367,1346,59.26904447,2692,-563712,125440,-438272,-1
249,34,16,14,0.120141343,0.879858657,78.15944261,63.50361677,152.5461847,64.76470588,283,54.84496124,566,-127488,17408,-110080,-1
5398,590,20,10,0.0985303941,0.901469606,1720.667931,1798.65108,2989.043905,3044.418644,5988,248.053024,11976,-2763776,302080,-2461696,-1
8294,1235,21,9,0.129604366,0.870395634,2694.33346,2278.161954,4472.241982,6731.101215,9529,481.505811,19058,-4246528,632320,-3614208,-1
7229,994,22,8,0.120880457,0.879119543,2366.604925,2413.887462,4081.718633,4332.225352,8223,194.6732955,16446,-3701248,508928,-3192320,-1
6147,697,22,8,0.101841029,0.898158971,1905.255103,2323.872527,3525.226127,2516.535151,6844,179.679706,13688,-3147264,356864,-2790400,-1
6313,800,22,8,0.112470125,0.887529875,2026.025825,2081.002163,3452.572153,4381.06625,7113,155.3395938,14226,-3232256,409600,-2822656,-1
4836,450,17,13,0.0851305335,0.914869467,1499.535667,1765.974707,2620.254342,2893.313333,5286,121.3220106,10572,-2476032,230400,-2245632,-1
1195,244,19,11,0.169562196,0.830437804,415.5152516,414.7757573,718.4887029,727.4016393,1439,103.599712,2878,-611840,124928,-486912,-1
7999,388,19,11,0.0462620723,0.953737928,2407.322438,2689.09892,4196.937992,4133.430412,8387,249.3162901,16774,-4095488,198656,-3896832,-1
3580,391,20,10,0.098463863,0.901536137,1127.787573,1196.455084,2039.748045,1493.882353,3971,97.44785276,7942,-1832960,200192,-1632768,-1
4515,220,23,7,0.0464625132,0.953537487,1350.766708,1663.380433,2367.742857,2373.277273,4735,202.8706084,9470,-2311680,112640,-2199040,-1
6074,645,20,10,0.095996428,0.904003572,1871.93873,1963.756833,3205.730655,4812.762791,6719,265.2585867,13438,-3109888,330240,-2779648,-1
6258,330,18,12,0.0500910747,0.949908925,1880.084133,2268.017723,3303.362895,3126.427273,6588,214.1742523,13176,-3204096,168960,-3035136,-1
145,23,24,6,0.136904762,0.863095238,48.86446883,33.78526653,89.12413793,55.34782609,168,16.96969697,336,-74240,11776,-62464,-1
1924,137,22,8,0.0664725861,0.933527414,583.074259,708.6102828,1046.147609,818.270073,2061,207.7620968,4122,-985088,70144,-914944,-1
3269,317,20,10,0.0883993307,0.911600669,1036.874453,977.8217376,1819.599878,1524.350158,3586,69.00134693,7172,-1673728,162304,-1511424,-1
3328,277,20,10,0.0768377254,0.923162275,1032.094104,1121.969277,1818.558293,1616.075812,3605,93.92912976,7210,-1703936,141824,-1562112,-1
9407,558,20,10,0.055995986,0.944004014,2861.997575,3084.136696,5007.486978,4570.188172,9965,690.5751906,19930,-4816384,285696,-4530688,-1
9460,508,17,13,0.0509630819,0.949036918,2850.557757,3128.270453,5045.717125,3844.511811,9968,722.8426396,19936,-4843520,260096,-4583424,-1
9337,622,21,9,0.0624560699,0.93754393,2876.761866,2724.982942,5033.198458,4181.424437,9959,956.6762728,19918,-4780544,318464,-4462080,-1
5924,396,22,8,0.0626582278,0.937341772,1803.554263,1969.7147,3209.855165,2422.166667,6320,504.7923323,12640,-3033088,202752,-2830336,-1
413,66,19,11,0.137787056,0.862212944,130.9545995,177.0621159,241.4987893,230.6212121,479,14.97811132,958,-211456,33792,-177664,-1
9326,618,22,8,0.062148029,0.937851971,2829.917379,3383.834583,5006.961291,4452.457929,9944,453.0296128,19888,-4774912,316416,-4458496,-1
193,58,19,11,0.231075697,0.768924303,69.91541931,75.58075781,133.1761658,102.1206897,251,7.711213518,502,-98816,29696,-69120,-1
1624,82,20,10,0.0480656506,0.951934349,484.9213527,539.6381017,868.8934729,548.6341463,1706,80.5476865,3412,-831488,41984,-789504,-1
6899,368,21,9,0.0506398789,0.949360121,2079.960892,2340.128866,3663.488911,3081.163043,7267,297.5839476,14534,-3532288,188416,-3343872,-1
5742,556,21,9,0.0882819943,0.911718006,1815.388423,1808.634927,3115.517938,3500.444245,6298,128.8461538,12596,-2939904,284672,-2655232,-1
410,64,23,7,0.135021097,0.864978903,132.2636489,141.4871764,249.2756098,162.0625,474,30.58064516,948,-209920,32768,-177152,-1
2100,290,18,12,0.121338912,0.878661088,671.9561958,807.8962298,1198.68,1172.472414,2390,147.1674877,4780,-1075200,148480,-926720,-1
800,46,22,8,0.0543735225,0.945626478,241.7757636,278.1960217,426.51125,371.1304348,846,26.99425654,1692,-409600,23552,-386048,-1
3974,194,21,9,0.0465451056,0.953454894,1194.368293,1320.749411,2102.140664,1723.139175,4168,272.4183007,8336,-2034688,99328,-1935360,-1
9484,483,20,10,0.0484599177,0.951540082,2868.409397,3039.109274,4993.531632,4796.84058,9967,1079.848321,19934,-4855808,247296,-4608512,-1
9003,871,20,10,0.0882114645,0.911788536,2797.202275,3210.881663,4848.936688,5852.925373,9874,232.0018797,19748,-4609536,445952,-4163584,-1
7962,641,20,10,0.0745088922,0.925491108,2480.395075,2485.96149,4334.61693,3896.858034,8603,211.3759214,17206,-4076544,328192,-3748352,-1
5425,321,21,9,0.0558649495,0.94413505,1640.408724,1928.412501,2886.85788,2647.747664,5746,243.4745763,11492,-2777600,164352,-2613248,-1
8467,1433,21,9,0.144747475,0.855252525,2793.070198,2876.333726,4725.948742,6277.279833,9900,486.2475442,19800,-4335104,733696,-3601408,-1
8175,788,20,10,0.0879169921,0.912083008,2627.602406,2116.80361,4500.052355,4294.718274,8963,327.1167883,17926,-4185600,403456,-3782144,-1
7090,361,21,9,0.0484498725,0.951550127,2132.152829,2490.519913,3728.383639,3679.185596,7451,418.5955056,14902,-3630080,184832,-3445248,-1
7737,605,23,7,0.0725245744,0.927475426,2383.645418,2616.505596,4222.199431,3523.133884,8342,268.4905053,16684,-3961344,309760,-3651584,-1
1852,164,20,10,0.0813492063,0.918650794,573.7098252,667.6118762,1010.855832,981.8963415,2016,61.1094271,4032,-948224,83968,-864256,-1
9374,590,22,8,0.0592131674,0.940786833,2853.599963,3056.355442,5043.672605,4010.581356,9964,1239.303483,19928,-4799488,302080,-4497408,-1
717,71,21,9,0.0901015228,0.909898477,218.5192282,283.8543888,404.6345886,292.1549296,788,96.80589681,1576,-367104,36352,-330752,-1
6366,367,26,4,0.0545076489,0.945492351,1941.926368,1817.319579,3410.104461,2619.307902,6733,123.3602052,13466,-3259392,187904,-3071488,-1
5608,1252,20,10,0.182507289,0.817492711,1886.519991,1747.035127,3111.722718,4858.377796,6860,158.6127168,13720,-2871296,641024,-2230272,-1
998,142,17,13,0.124561404,0.875438596,326.41083,346.4753456,573.748497,547.6690141,1140,96.12141653,2280,-510976,72704,-438272,-1
9512,459,25,5,0.0460334971,0.953966503,2860.296624,3146.444878,5020.488856,4271.276688,9971,247.4193548,19942,-4870144,235008,-4635136,-1
1008,69,22,8,0.0640668524,0.935933148,301.4368735,336.5560151,556.2777778,286.5942029,1077,138.9677419,2154,-516096,35328,-480768,-1
664,106,24,6,0.137662338,0.862337662,222.0905756,219.8759612,391.4096386,348.4811321,770,37.83783784,1540,-339968,54272,-285696,-1
9658,332,17,13,0.0332332332,0.966766767,2872.968362,3131.096208,5015.141127,4424.13253,9990,759.118541,19980,-4944896,169984,-4774912,-1
3256,338,18,12,0.0940456316,0.905954368,1010.792463,1255.848326,1781.508292,1951.550296,3594,121.132457,7188,-1667072,173056,-1494016,-1
1437,185,19,11,0.11405672,0.88594328,463.1921488,496.4916022,823.1176061,721.2594595,1622,131.6558442,3244,-735744,94720,-641024,-1
9394,559,21,9,0.0561639707,0.943836029,2866.487279,2857.837952,5026.523419,4144.758497,9953,550.802435,19906,-4809728,286208,-4523520,-1
4300,473,21,9,0.0990990991,0.900900901,1367.979699,1446.386023,2410.973023,2169.063425,4773,196.5815486,9546,-2201600,242176,-1959424,-1
9298,660,21,9,0.0662783692,0.933721631,2857.611664,2980.227467,4919.869864,5819.562121,9958,530.2449414,19916,-4760576,337920,-4422656,-1
8805,1089,22,8,0.110066707,0.889933293,2865.897059,2628.6,4843.325724,5789.790634,9894,452.6075023,19788,-4508160,557568,-3950592,-1
8734,905,20,10,0.0938894076,0.906110592,2759.252342,2934.902437,4759.652164,5402.40663,9639,198.1702303,19278,-4471808,463360,-4008448,-1
208,35,21,9,0.144032922,0.855967078,67.06531204,85.16749404,124.0913462,109.5714286,243,11.15190454,486,-106496,17920,-88576,-1
2262,126,21,9,0.0527638191,0.947236181,683.2701831,746.7936736,1208.583112,941.6746032,2388,177.2828508,4776,-1158144,64512,-1093632,-1
9407,538,20,10,0.0540975365,0.945902464,2842.943429,3227.783111,5016.578399,4211.026022,9945,991.5254237,19890,-4816384,275456,-4540928,-1
9303,628,22,8,0.0632363307,0.936763669,2857.730022,2987.048023,4983.062883,4713.235669,9931,303.7932089,19862,-4763136,321536,-4441600,-1
1190,120,21,9,0.0916030534,0.908396947,380.5937721,352.8764726,654.1193277,669.1916667,1310,131.1311311,2620,-609280,61440,-547840,-1
9210,728,20,10,0.0732541759,0.926745824,2867.060101,2867.616448,4941.310858,5326.123626,9938,810.6035889,19876,-4715520,372736,-4342784,-1
745,103,20,10,0.121462264,0.878537736,240.838602,271.5980414,423.4818792,431.8640777,848,33.45167653,1696,-381440,52736,-328704,-1
1267,157,21,9,0.110252809,0.889747191,399.0258438,495.1651317,718.406472,664.8343949,1424,101.8597997,2848,-648704,80384,-568320,-1
9366,581,21,9,0.0584095707,0.941590429,2871.261578,2874.502105,4974.459428,4966.593804,9947,856.7614126,19894,-4795392,297472,-4497920,-1
700,61,22,8,0.0801576873,0.919842313,215.2287173,261.2369795,384.9542857,335.6229508,761,21.81766055,1522,-358400,31232,-327168,-1
455,71,21,9,0.134980989,0.865019011,144.0601747,187.2861023,255.9054945,312.1690141,526,40.68058778,1052,-232960,36352,-196608,-1
4657,580,17,13,0.11075043,0.88924957,1508.240639,1508.78589,2582.765514,2909.937931,5237,122.8189493,10474,-2384384,296960,-2087424,-1
8599,789,20,10,0.0840434597,0.91595654,2642.719386,3178.930412,4599.564368,5729.166033,9388,277.7514793,18776,-4402688,403968,-3998720,-1
551,93,20,10,0.144409938,0.855590062,178.6702767,223.8194951,320.9655172,331.5913978,644,24.21052632,1288,-282112,47616,-234496,-1
3343,192,19,11,0.0543140028,0.945685997,1017.487938,990.8481601,1790.705354,1372.666667,3535,511.577424,7070,-1711616,98304,-1613312,-1
1255,117,21,9,0.0852769679,0.914723032,384.2518694,502.2420606,681.247012,742.8461538,1372,25.42624166,2744,-642560,59904,-582656,-1
9469,494,20,10,0.0495834588,0.950416541,2874.59034,2798.410478,5021.521491,4224.451417,9963,818.652424,19926,-4848128,252928,-4595200,-1
2773,168,18,12,0.0571234274,0.942876573,836.6978044,1030.015693,1473.613054,1427.869048,2941,206.9669247,5882,-1419776,86016,-1333760,-1
1655,66,21,9,0.0383497966,0.961650203,494.1632772,543.1228481,866.1885196,730.8939394,1721,324.1054614,3442,-847360,33792,-813568,-1
5362,1097,20,10,0.169840533,0.830159467,1872.672131,1778.240125,3154.029467,3601.334549,6459,134.0319568,12918,-2745344,561664,-2183680,-1
4992,300,18,12,0.0566893424,0.943310658,1493.703526,1761.975139,2702.994591,1706.43,5292,235.828877,10584,-2555904,153600,-2402304,-1
9303,650,20,10,0.0653069426,0.934693057,2855.025849,2800.535253,5070.131463,3644.073846,9953,644.2071197,19906,-4763136,332800,-4430336,-1
2447,228,17,13,0.0852336449,0.914766355,760.1567713,880.8635695,1350.134859,1207.763158,2675,88.89996677,5350,-1252864,116736,-1136128,-1
1042,113,22,8,0.0978354978,0.902164502,323.2143431,414.9975701,580.7994242,552.1858407,1155,79.93079585,2310,-533504,57856,-475648,-1
105,29,19,11,0.21641791,0.78358209,37.76026058,27.68778711,75.17142857,39.72413793,134,26.74650699,268,-53760,14848,-38912,-1
3388,208,21,9,0.0578420467,0.942157953,1024.998979,1225.304401,1791.041322,1919.990385,3596,66.07864756,7192,-1734656,106496,-1628160,-1
9524,448,20,10,0.0449257922,0.955074208,2879.446916,2802.180261,5013.27436,4417.305804,9972,796.485623,19944,-4876288,229376,-4646912,-1
2961,300,16,14,0.0919963201,0.90800368,939.8314742,956.0846337,1633.437352,1606.943333,3261,121.6791045,6522,-1516032,153600,-1362432,-1
2563,607,20,10,0.19148265,0.80851735,858.5735276,863.5862006,1432.682403,2230.757825,3170,108.7478559,6340,-1312256,310784,-1001472,-1
9326,639,21,9,0.0641244355,0.935875564,2855.043727,2954.085408,5060.178533,3856.604069,9965,758.3713851,19930,-4774912,327168,-4447744,-1
9511,457,27,3,0.0458467095,0.954153291,2875.562545,2808.910939,5021.567659,4213.054705,9968,346.7130435,19936,-4869632,233984,-4635648,-1
5238,169,21,9,0.0312557795,0.96874422,1557.508399,1652.31406,2709.565865,2531.491124,5407,259.2042186,10814,-2681856,86528,-2595328,-1
4583,314,21,9,0.0641208903,0.93587911,1402.107172,1564.811578,2438.773729,2598.257962,4897,367.918858,9794,-2346496,160768,-2185728,-1
6074,539,22,8,0.0815061243,0.918493876,1896.822871,1952.28855,3256.292065,3878.428571,6613,188.0295707,13226,-3109888,275968,-2833920,-1
92,23,23,7,0.2,0.8,33.28852928,31.49909231,60.06521739,49.73913043,115,2.334077532,230,-47104,11776,-35328,-1
393,38,21,9,0.0881670534,0.911832947,119.9744654,157.5337276,220.0203562,174.4210526,431,35.91666667,862,-201216,19456,-181760,-1
5633,613,20,10,0.0981428114,0.901857189,1774.3987,2039.691158,3142.295935,2950.779772,6246,123.414345,12492,-2884096,313856,-2570240,-1
1905,193,21,9,0.0919923737,0.908007626,593.3832117,691.7444725,1067.130709,875.4766839,2098,226.3214671,4196,-975360,98816,-876544,-1
5582,365,21,9,0.0613754834,0.938624517,1701.524816,1802.719897,3018.498925,2293.471233,5947,368.2352941,11894,-2857984,186880,-2671104,-1
1689,124,20,10,0.0683949255,0.931605074,509.8177045,634.1122747,924.7164002,665.6854839,1813,112.9595016,3626,-864768,63488,-801280,-1
925,94,20,10,0.0922473013,0.907752699,284.3086351,334.3493821,526.9967568,342.7446809,1019,65.40436457,2038,-473600,48128,-425472,-1
4557,219,21,9,0.0458542714,0.954145729,1363.158182,1526.317833,2420.290761,1726.990868,4776,374.5882353,9552,-2333184,112128,-2221056,-1
58,16,23,7,0.216216216,0.783783784,22.12202673,17.00723651,39.17241379,31.4375,74,2.09453722,148,-29696,8192,-21504,-1
4695,317,22,8,0.0632482043,0.936751796,1426.727586,1680.247542,2483.296273,2850.164038,5012,127.5967413,10024,-2403840,162304,-2241536,-1
8793,355,22,8,0.0388062965,0.961193704,2619.469509,3007.560907,4607.795974,3749.791549,9148,463.1898734,18296,-4502016,181760,-4320256,-1
8267,739,20,10,0.0820564068,0.917943593,2600.454048,2567.928118,4534.043063,4161.822733,9006,174.6364165,18012,-4232704,378368,-3854336,-1
9586,399,19,11,0.0399599399,0.96004006,2871.636574,2991.234087,5030.638953,4088.721805,9985,1007.568113,19970,-4908032,204288,-4703744,-1
4343,354,17,13,0.0753672557,0.924632744,1329.564483,1645.106604,2349.03569,2348.562147,4697,377.8761062,9394,-2223616,181248,-2042368,-1
5062,392,20,10,0.0718738541,0.928126146,1559.646529,1752.410595,2733.455946,2650.589286,5454,196.8953069,10908,-2591744,200704,-2391040,-1
4953,477,17,13,0.0878453039,0.912154696,1554.904488,1681.713906,2733.306279,2530.60587,5430,144.6457112,10860,-2535936,244224,-2291712,-1
9445,433,18,12,0.0438347844,0.956165216,2836.116599,3144.541283,4957.189942,4553.630485,9878,673.3469666,19756,-4835840,221696,-4614144,-1
614,89,21,9,0.126600284,0.873399716,197.8230585,227.698213,359.9918567,296.8651685,703,49.6819788,1406,-314368,45568,-268800,-1
5496,404,21,9,0.0684745763,0.931525424,1672.662282,2074.175087,2951.735626,2933.690594,5900,574.4888023,11800,-2813952,206848,-2607104,-1
5558,464,22,8,0.0770508137,0.922949186,1725.886445,1796.566794,3056.422634,2473.396552,6022,210.4858441,12044,-2845696,237568,-2608128,-1
9204,718,20,10,0.0723644427,0.927635557,2857.913712,2942.216252,4969.329096,4861.139276,9922,1112.331839,19844,-4712448,367616,-4344832,-1
841,102,25,5,0.108165429,0.891834571,273.6506881,252.8326156,479.0071344,414.2254902,943,143.5312024,1886,-430592,52224,-378368,-1
5471,936,18,12,0.146090214,0.853909786,1811.154623,1845.61361,3059.460062,4048.848291,6407,137.3124732,12814,-2801152,479232,-2321920,-1
595,59,21,9,0.0902140673,0.909785933,183.2847629,210.0524127,337.9428571,222.1864407,654,94.50867052,1308,-304640,30208,-274432,-1
3685,343,19,11,0.0851539225,0.914846077,1141.82274,1323.992583,1983.90692,2343.174927,4028,138.8486729,8056,-1886720,175616,-1711104,-1
4112,515,21,9,0.11130322,0.88869678,1319.763585,1456.476415,2317.027967,2289.823301,4627,214.4114921,9254,-2105344,263680,-1841664,-1
5655,542,22,8,0.087461675,0.912538325,1766.674764,1953.217939,3057.002299,3537.186347,6197,243.114947,12394,-2895360,277504,-2617856,-1
4076,380,18,12,0.0852782765,0.914721724,1240.323102,1701.674434,2235.409715,2154.384211,4456,125.9112744,8912,-2086912,194560,-1892352,-1
5240,1348,21,9,0.204614451,0.795385549,1924.663527,1543.8175,3077.664313,4137.392433,6588,135.9752322,13176,-2682880,690176,-1992704,-1
138,35,19,11,0.202312139,0.797687861,49.09827567,43.42148438,93.93478261,59.65714286,173,38.02197802,346,-70656,17920,-52736,-1
8949,433,25,5,0.0461522064,0.953847794,2687.8144,2909.688578,4742.376355,3640.016166,9382,402.3156089,18764,-4581888,221696,-4360192,-1
3242,351,23,7,0.0976899527,0.902310047,1001.199806,1265.423473,1756.839914,2167.937322,3593,89.55633101,7186,-1659904,179712,-1480192,-1
3316,289,21,9,0.0801664355,0.919833564,1026.569105,1174.306747,1819.414656,1614.657439,3605,205.1792829,7210,-1697792,147968,-1549824,-1
4544,515,21,9,0.101798774,0.898201226,1429.415838,1673.84076,2567.404489,2199.968932,5059,265.1467505,10118,-2326528,263680,-2062848,-1
858,90,20,10,0.0949367089,0.905063291,266.8718506,258.2013962,495.2470862,276.7111111,948,66.20111732,1896,-439296,46080,-393216,-1
1023,126,20,10,0.109660574,0.890339426,328.4432895,343.2414389,586.3812317,482.5952381,1149,92.73607748,2298,-523776,64512,-459264,-1
3331,219,20,10,0.0616901408,0.938309859,1001.520653,1136.710507,1819.41429,1107.561644,3550,95.532831,7100,-1705472,112128,-1593344,-1
9511,462,20,10,0.0463250777,0.953674922,2870.452783,2954.369816,5022.709284,4251.867965,9973,1015.580448,19946,-4869632,236544,-4633088,-1
1020,101,21,9,0.0900981267,0.909901873,315.6771845,389.1292827,554.6784314,624.8415842,1121,120.6673843,2242,-522240,51712,-470528,-1
839,101,17,13,0.107446809,0.892553191,264.6790792,283.9854502,487.6388558,328.1287129,940,103.0701754,1880,-429568,51712,-377856,-1
1167,86,21,9,0.0686352753,0.931364725,356.989377,420.1309442,628.3504713,608.6744186,1253,100.4811548,2506,-597504,44032,-553472,-1
7208,577,20,10,0.0741168915,0.925883109,2185.184364,2888.818455,3922.501942,3524.455806,7785,532.125769,15570,-3690496,295424,-3395072,-1
1392,148,21,9,0.0961038961,0.903896104,437.9069046,485.2782133,783.8168103,645.25,1540,126.8533773,3080,-712704,75776,-636928,-1
2034,196,22,8,0.0878923767,0.912107623,641.2584706,668.8718352,1116.746804,1102.561224,2230,76.7377839,4460,-1041408,100352,-941056,-1
2253,173,27,3,0.0713107997,0.9286892,688.0908715,842.9487684,1215.976476,1181.248555,2426,85.15268515,4852,-1153536,88576,-1064960,-1
6516,813,20,10,0.110929185,0.889070815,2128.321878,2009.584955,3654.201197,3751.549815,7329,141.8424618,14658,-3336192,416256,-2919936,-1
6977,389,22,8,0.0528102091,0.947189791,2118.485742,2094.838661,3729.996703,2849.547558,7366,239.6226415,14732,-3572224,199168,-3373056,-1
9453,508,20,10,0.0509988957,0.949001104,2842.756208,3249.797823,5038.12504,3918.001969,9961,933.552015,19922,-4839936,260096,-4579840,-1
44,11,23,7,0.2,0.8,15.89278385,13.89631023,29.68181818,21.27272727,55,12.55707763,110,-22528,5632,-16896,-1
7792,638,21,9,0.0756820878,0.924317912,2417.813366,2568.320564,4255.414784,3728.014107,8430,161.3705972,16860,-3989504,326656,-3662848,-1
3797,271,27,3,0.0666175025,0.933382498,1157.597561,1351.706559,2056.157493,1731.055351,4068,85.31879195,8136,-1944064,138752,-1805312,-1
1098,95,19,11,0.0796311819,0.920368818,341.8416937,365.9031923,602.8251366,529.6736842,1193,82.50345781,2386,-562176,48640,-513536,-1
2633,258,27,3,0.0892424767,0.910757523,835.1424197,815.7744076,1459.575009,1307.46124,2891,165.6733524,5782,-1348096,132096,-1216000,-1
7454,464,20,10,0.0586006567,0.941399343,2254.040614,2723.37102,3980.325195,3624.950431,7918,169.1157625,15836,-3816448,237568,-3578880,-1
359,47,14,16,0.115763547,0.884236453,112.0610743,127.3254919,213.4456825,127.5319149,406,40,812,-183808,24064,-159744,-1
3258,203,20,10,0.0586535683,0.941346432,980.0392042,1136.398835,1764.788828,1188.714286,3461,82.957814,6922,-1668096,103936,-1564160,-1
4220,1218,20,10,0.223979404,0.776020596,1596.303252,1442.930368,2642.502133,2986.27422,5438,101.9497563,10876,-2160640,623616,-1537024,-1
1400,83,21,9,0.0559676332,0.944032367,421.8885874,498.1144939,750.9764286,590.5903614,1483,199.0604027,2966,-716800,42496,-674304,-1
1354,121,22,8,0.0820338983,0.917966102,414.3473379,442.9152601,764.0768095,446.1983471,1475,27.06918701,2950,-693248,61952,-631296,-1
6750,431,20,10,0.0600194959,0.939980504,2054.137306,2346.808883,3596.317926,3507.714617,7181,468.4279191,14362,-3456000,220672,-3235328,-1
2860,268,20,10,0.0856777494,0.914322251,879.0419106,1084.722664,1591.955944,1271.5,3128,243.8035853,6256,-1464320,137216,-1327104,-1
4991,335,19,11,0.0628989861,0.937101014,1519.129505,1680.949312,2703.241435,2071.41194,5326,337.5158428,10652,-2555392,171520,-2383872,-1
8668,1196,22,8,0.121248986,0.878751014,2850.49369,2779.381335,4866.640171,5409.818562,9864,608.8888889,19728,-4438016,612352,-3825664,-1
40,18,20,10,0.310344828,0.689655172,16.94631228,15.9807948,30.65,26.94444444,58,2.538293217,116,-20480,9216,-11264,-1
4341,232,19,11,0.0507325607,0.949267439,1302.634545,1467.480692,2321.808109,1635.698276,4573,321.1376404,9146,-2222592,118784,-2103808,-1
3858,494,21,9,0.113511029,0.886488971,1243.991854,1333.497483,2152.171073,2366.502024,4352,131.9187633,8704,-1975296,252928,-1722368,-1
69,17,20,10,0.197674419,0.802325581,24.66714351,16.54667301,47.76811594,26.17647059,86,10.10575793,172,-35328,8704,-26624,-1
5832,271,18,12,0.0444043913,0.955595609,1747.794473,2026.865941,3062.389403,2828.416974,6103,512.8571429,12206,-2985984,138752,-2847232,-1
121,45,21,9,0.271084337,0.728915663,47.67939855,47.9534445,85.92561983,76.97777778,166,25.73643411,332,-61952,23040,-38912,-1
7504,404,21,9,0.0510875063,0.948912494,2255.506267,2391.93037,4024.752932,2649.60396,7908,499.2424242,15816,-3842048,206848,-3635200,-1
5945,204,21,9,0.0331761262,0.966823874,1769.802615,1909.29636,3082.461228,2857.563725,6149,732.0238095,12298,-3043840,104448,-2939392,-1
3811,383,27,3,0.0913209347,0.908679065,1188.204525,1335.84311,2052.731829,2542.960836,4194,102.6180573,8388,-1951232,196096,-1755136,-1
4265,302,20,10,0.0661265601,0.93387344,1288.775009,1681.018699,2287.29449,2237.47351,4567,163.282088,9134,-2183680,154624,-2029056,-1
1336,228,18,12,0.145780051,0.854219949,439.3540479,516.4827579,785.752994,763.4385965,1564,92,3128,-684032,116736,-567296,-1
7952,568,22,8,0.0666666667,0.933333333,2443.902863,2492.403573,4194.720196,5181.417254,8520,320.7831325,17040,-4071424,290816,-3780608,-1
2124,144,19,11,0.0634920635,0.936507937,648.6346174,715.716924,1146.471751,957.9166667,2268,208.839779,4536,-1087488,73728,-1013760,-1
9498,472,20,10,0.0473420261,0.952657974,2861.502672,2952.2384,5044.579701,3796.646186,9970,919.7416974,19940,-4862976,241664,-4621312,-1
9430,530,19,11,0.0532128514,0.946787149,2865.911328,2981.631582,5011.721845,4424.986792,9960,1087.336245,19920,-4828160,271360,-4556800,-1
9596,382,27,3,0.0382842253,0.961715775,2875.654676,2970.373604,5005.105982,4597.471204,9978,851.3651877,19956,-4913152,195584,-4717568,-1
9444,518,18,12,0.0519975908,0.948002409,2857.058662,3009.691684,5039.236023,3928.876448,9962,480.0963855,19924,-4835328,265216,-4570112,-1
9593,388,21,9,0.0388738603,0.96112614,2865.138684,3127.56593,5026.717711,4107.907216,9981,1110.233593,19962,-4911616,198656,-4712960,-1
4765,197,18,12,0.0397017332,0.960298267,1420.796846,1619.606234,2500.92319,2011.695431,4962,316.0509554,9924,-2439680,100864,-2338816,-1
1498,126,21,9,0.0775862069,0.922413793,464.7651257,506.8607532,819.611482,727.952381,1624,62.77541554,3248,-766976,64512,-702464,-1
6790,411,21,9,0.0570754062,0.942924594,2071.581241,2088.053486,3640.549043,2947.622871,7201,231.468981,14402,-3476480,210432,-3266048,-1
6704,1029,21,9,0.13306608,0.86693392,2190.836733,2368.55647,3759.217631,4569.208941,7733,154.9078526,15466,-3432448,526848,-2905600,-1
650,157,16,14,0.194547708,0.805452292,230.6162503,239.2602012,412.4646154,368.955414,807,73.96883593,1614,-332800,80384,-252416,-1
5686,349,21,9,0.0578293289,0.942170671,1715.372651,2131.575646,3017.322898,3029.031519,6035,200.4317502,12070,-2911232,178688,-2732544,-1
7336,905,22,8,0.10981677,0.89018323,2356.616234,2460.944941,4041.936341,4761.896133,8241,160.9256005,16482,-3756032,463360,-3292672,-1
421,71,20,10,0.144308943,0.855691057,138.5629344,158.3919002,251.0451306,219.5492958,492,44.93150685,984,-215552,36352,-179200,-1
3350,322,21,9,0.0876906318,0.912309368,1059.776371,1050.492157,1821.879104,1988.611801,3672,216.1271336,7344,-1715200,164864,-1550336,-1
9270,651,21,9,0.0656183852,0.934381615,2860.579046,2875.917915,4991.790939,4522.548387,9921,895.3971119,19842,-4746240,333312,-4412928,-1
4637,397,20,10,0.0788637267,0.921136273,1441.530431,1578.815114,2526.991805,2406.634761,5034,113.9429606,10068,-2374144,203264,-2170880,-1
9532,437,20,10,0.0438358913,0.956164109,2869.88838,3042.698247,4990.65642,4861.620137,9969,561.3175676,19938,-4880384,223744,-4656640,-1
138,29,22,8,0.173652695,0.826347305,47.22710163,35.62871692,91.39855072,48.79310345,167,30.14440433,334,-70656,14848,-55808,-1
5072,244,22,8,0.0458991723,0.954100828,1519.674828,1638.040245,2695.476341,1889.877049,5316,262.0009857,10632,-2596864,124928,-2471936,-1
297,66,16,14,0.181818182,0.818181818,101.5171413,93.73561475,196.5387205,116.5757576,363,51.19887165,726,-152064,33792,-118272,-1
4320,590,21,9,0.120162933,0.879837067,1406.898444,1488.748339,2468.115972,2363.125424,4910,228.58473,9820,-2211840,302080,-1909760,-1
6000,1043,20,10,0.148090302,0.851909698,2057.830856,1867.934176,3481.607,3754.366251,7043,131.7187208,14086,-3072000,534016,-2537984,-1
6103,1430,21,9,0.189831408,0.810168592,1919.375866,2047.952099,3295.695887,5778.446853,7533,166.0348248,15066,-3124736,732160,-2392576,-1
82,29,20,10,0.261261261,0.738738739,32.85115287,24.23630201,61.18292683,41.34482759,111,21.30518234,222,-41984,14848,-27136,-1
7542,301,22,8,0.0383781716,0.961621828,2252.88986,2469.403154,3943.238133,3389.847176,7843,398.1218274,15686,-3861504,154112,-3707392,-1
2630,312,17,13,0.106050306,0.893949694,825.7919308,1026.123357,1470.845627,1477.016026,2942,54.50166728,5884,-1346560,159744,-1186816,-1
370,86,17,13,0.188596491,0.811403509,130.0639474,134.310108,235.3108108,199.1976744,456,33.2361516,912,-189440,44032,-145408,-1
6964,1145,21,9,0.141201135,0.858798865,2315.220444,2259.937368,3895.296669,5026.331004,8109,155.0774527,16218,-3565568,586240,-2979328,-1
589,54,22,8,0.0839813375,0.916018663,179.0576006,239.7631519,317.1443124,374.962963,643,25.39494471,1286,-301568,27648,-273920,-1
5584,683,21,9,0.108983565,0.891016435,1818.549254,1679.294234,3182.08596,2740.863836,6267,368.4303351,12534,-2859008,349696,-2509312,-1
113,15,21,9,0.1171875,0.8828125,35.54426514,23.94660728,69.42477876,27.4,128,13.83783784,256,-57856,7680,-50176,-1
408,62,22,8,0.131914894,0.868085106,132.3341359,155.8974789,235.502451,235.483871,470,48.20512821,940,-208896,31744,-177152,-1
9621,363,22,8,0.0363581731,0.963641827,2874.563436,3013.943088,5015.262343,4389.203857,9984,1160.930233,19968,-4925952,185856,-4740096,-1
1333,157,27,3,0.105369128,0.894630872,425.645997,425.8024279,766.7104276,565.4140127,1490,131.9751993,2980,-682496,80384,-602112,-1
4198,322,19,11,0.0712389381,0.928761062,1296.022548,1377.423678,2236.747022,2570.173913,4520,224.6520875,9040,-2149376,164864,-1984512,-1
3237,335,20,10,0.0937849944,0.906215006,1021.963711,1099.069287,1805.579549,1602.140299,3572,127.2079772,7144,-1657344,171520,-1485824,-1
9382,570,21,9,0.0572749196,0.94272508,2874.937444,2679.917605,5031.784161,4066.542105,9952,327.3684211,19904,-4803584,291840,-4511744,-1
423,83,20,10,0.164031621,0.835968379,144.9375421,151.6198595,254.4184397,248.8192771,506,22.23198594,1012,-216576,42496,-174080,-1
9231,704,20,10,0.0708605939,0.929139406,2864.534398,2899.089149,4988.816813,4695.045455,9935,374.6229261,19870,-4726272,360448,-4365824,-1
9403,549,20,10,0.055164791,0.944835209,2868.452595,2860.560922,5016.931937,4284.001821,9952,640.4118404,19904,-4814336,281088,-4533248,-1
4031,404,20,10,0.0910935738,0.908906426,1261.326947,1418.189673,2186.551228,2531.787129,4435,97.70874642,8870,-2063872,206848,-1857024,-1
2840,470,24,6,0.141993958,0.858006042,958.5713449,930.0310354,1672.773239,1551.125532,3310,117.5426136,6620,-1454080,240640,-1213440,-1
4077,371,19,11,0.0834082734,0.916591727,1267.278919,1448.43423,2212.079225,2360.994609,4448,163.9513454,8896,-2087424,189952,-1897472,-1
3058,474,21,9,0.134201586,0.865798414,1002.086515,1036.532366,1703.036625,2175.932489,3532,79.83725136,7064,-1565696,242688,-1323008,-1
1558,106,26,4,0.0637019231,0.936298077,477.9700362,485.5569117,843.6283697,668.9339623,1664,39.14373089,3328,-797696,54272,-743424,-1
4941,318,26,4,0.0604677695,0.93953223,1494.61171,1737.017573,2668.91014,2025.424528,5259,447.5744681,10518,-2529792,162816,-2366976,-1
7071,574,21,9,0.0750817528,0.924918247,2187.78232,2430.266826,3824.650827,3802.663763,7645,159.2376588,15290,-3620352,293888,-3326464,-1
2578,170,21,9,0.0618631732,0.938136827,784.0900835,900.9047086,1386.86346,1187.011765,2748,90.27595269,5496,-1319936,87040,-1232896,-1
9489,478,17,13,0.0479582623,0.952041738,2849.909029,3292.825824,5020.163347,4266.104603,9967,620.9968847,19934,-4858368,244736,-4613632,-1
58,16,23,7,0.216216216,0.783783784,22.14281824,16.54055149,39.37931034,30.6875,74,2.189997041,148,-29696,8192,-21504,-1
5649,205,20,10,0.0350187906,0.964981209,1683.702872,1831.198477,2937.518853,2651.419512,5854,164.4382022,11708,-2892288,104960,-2787328,-1
9522,450,22,8,0.0451263538,0.954873646,2874.088072,2965.082182,4997.089162,4762.433333,9972,787.0560379,19944,-4875264,230400,-4644864,-1
1771,213,20,10,0.107358871,0.892641129,557.3171503,650.7663986,967.2557877,1202.394366,1984,108.2969432,3968,-906752,109056,-797696,-1
9348,592,20,10,0.0595573441,0.940442656,2860.527809,2901.345657,5018.910783,4206.067568,9940,1248.743719,19880,-4786176,303104,-4483072,-1
4273,277,21,9,0.0608791209,0.939120879,1297.704201,1524.872583,2287.268196,2093.963899,4550,356.0250391,9100,-2187776,141824,-2045952,-1
4725,284,21,9,0.0566979437,0.943302056,1449.122373,1392.305965,2506.504339,2479.971831,5009,128.2714469,10018,-2419200,145408,-2273792,-1
9463,497,20,10,0.0498995984,0.950100402,2856.123126,3042.800407,5033.957519,3962.655936,9960,545.1559934,19920,-4845056,254464,-4590592,-1
4906,724,21,9,0.128596803,0.871403197,1580.669588,1852.796243,2757.571545,3208.037293,5630,106.4674735,11260,-2511872,370688,-2141184,-1
9335,615,19,11,0.0618090452,0.938190955,2851.596366,2993.377837,5042.128656,3964.152846,9950,649.9020248,19900,-4779520,314880,-4464640,-1
5751,905,21,9,0.135967548,0.864032452,1871.655101,2117.108209,3234.920536,3923.169061,6656,169.019807,13312,-2944512,463360,-2481152,-1
316,71,19,11,0.183462532,0.816537468,107.6104234,118.4262171,204.0791139,149.1408451,387,38.01571709,774,-161792,36352,-125440,-1
3287,215,22,8,0.0613934894,0.938606511,1003.651233,1077.083645,1770.125951,1466.739535,3502,95.26659412,7004,-1682944,110080,-1572864,-1
579,48,26,4,0.0765550239,0.923444976,179.1454293,197.5920573,317.3523316,273.5625,627,27.59683099,1254,-296448,24576,-271872,-1
2500,258,20,10,0.0935460479,0.906453952,782.9389388,850.8939768,1412.4192,1060.515504,2758,147.7236208,5516,-1280000,132096,-1147904,-1
9365,572,20,10,0.0575626447,0.942437355,2860.585014,2988.425478,4981.783342,4759.706294,9937,636.9871795,19874,-4794880,292864,-4502016,-1
5781,285,17,13,0.046983185,0.953016815,1729.691471,2138.850069,3036.335928,2975.975439,6066,149.9629172,12132,-2959872,145920,-2813952,-1
2398,145,20,10,0.0570192686,0.942980731,725.920254,832.3638629,1284.260634,1069.234483,2543,227.256479,5086,-1227776,74240,-1153536,-1
8468,703,22,8,0.0766546723,0.923345328,2635.353594,2787.625825,4579.248701,4667.322902,9171,334.7080292,18342,-4335616,359936,-3975680,-1
4657,281,20,10,0.0569056298,0.94309437,1396.611335,1734.968286,2433.762079,3061.782918,4938,280.7276862,9876,-2384384,143872,-2240512,-1
5670,344,23,7,0.057199867,0.942800133,1715.518317,1819.544909,3062.565432,2099.880814,6014,568.4310019,12028,-2903040,176128,-2726912,-1
3366,235,20,10,0.0652596501,0.93474035,1026.991381,993.7531922,1846.972371,1142.519149,3601,66.89578302,7202,-1723392,120320,-1603072,-1
2821,304,18,12,0.09728,0.90272,879.6057714,1081.336326,1549.813896,1685.361842,3125,209.0301003,6250,-1444352,155648,-1288704,-1
2301,173,20,10,0.0699272433,0.930072757,714.0338578,713.5525078,1241.920904,1178.699422,2474,157.5796178,4948,-1178112,88576,-1089536,-1
5849,1433,20,10,0.196786597,0.803213403,2053.827119,2135.521562,3460.7126,4379.410328,7282,144.3123266,14564,-2994688,733696,-2260992,-1
4639,465,20,10,0.0911050157,0.908894984,1445.018922,1688.878383,2516.1302,2915.337634,5104,372.8268809,10208,-2375168,238080,-2137088,-1
4333,220,22,8,0.0483197892,0.951680211,1304.369657,1494.192611,2281.698592,2184.459091,4553,539.4549763,9106,-2218496,112640,-2105856,-1
7669,863,21,9,0.101148617,0.898851383,2328.830492,2716.458401,4042.726561,6255.049826,8532,268.5552408,17064,-3926528,441856,-3484672,-1
9567,405,19,11,0.0406137184,0.959386282,2878.602383,2857.365807,5001.517613,4631.750617,9972,1018.590398,19944,-4898304,207360,-4690944,-1
5886,489,20,10,0.0767058824,0.923294118,1820.878749,2017.225873,3221.25773,2787.683027,6375,202.4452207,12750,-3013632,250368,-2763264,-1
1501,128,17,13,0.0785758134,0.921424187,457.3927348,573.8975213,829.5649567,644.203125,1629,161.2871287,3258,-768512,65536,-702976,-1
7761,416,18,12,0.0508744038,0.949125596,2337.045271,2737.393021,4108.105656,3732.560096,8177,620.8807897,16354,-3973632,212992,-3760640,-1
9441,526,21,9,0.0527741547,0.947225845,2857.28154,3186.470713,5006.848321,4573.903042,9967,619.8383085,19934,-4833792,269312,-4564480,-1
2308,217,25,5,0.0859405941,0.914059406,732.9926911,683.7773294,1261.770364,1276.078341,2525,73.78725891,5050,-1181696,111104,-1070592,-1
3546,593,20,10,0.143271322,0.856728678,1177.812883,1291.883656,2069.14326,2075.123103,4139,211.4971896,8278,-1815552,303616,-1511936,-1
1111,216,20,10,0.162773173,0.837226827,371.5054179,436.4344166,670.0594059,632.8333333,1327,36.09902067,2654,-568832,110592,-458240,-1
673,57,18,12,0.0780821918,0.921917808,205.4105467,264.7277387,367.2763744,344.5263158,730,31.49266609,1460,-344576,29184,-315392,-1
2454,348,27,3,0.124197002,0.875802998,801.1064594,854.4885847,1386.823553,1504.994253,2802,202.3104693,5604,-1256448,178176,-1078272,-1
9108,812,20,10,0.0818548387,0.918145161,2867.545949,2805.589417,4984.543808,4690.80665,9920,542.3728814,19840,-4663296,415744,-4247552,-1
57,10,21,9,0.149253731,0.850746269,18.85190375,13.52368293,36.78947368,18.1,67,3.247697528,134,-29184,5120,-24064,-1
1544,213,27,3,0.121229368,0.878770632,502.9824904,496.2116504,852.5200777,1070.948357,1757,40.18755718,3514,-790528,109056,-681472,-1
47,19,21,9,0.287878788,0.712121212,18.65730596,19.95618469,33.89361702,32.52631579,66,2.669902913,132,-24064,9728,-14336,-1
244,22,27,3,0.0827067669,0.917293233,76.58687342,59.3400517,138,83.59090909,266,41.49765991,532,-124928,11264,-113664,-1
279,81,20,10,0.225,0.775,96.43381292,125.1303018,175.9964158,196.0123457,360,14.07349492,720,-142848,41472,-101376,-1
3747,349,17,13,0.0852050781,0.914794922,1164.580616,1312.60906,2079.934614,1711.005731,4096,281.1256005,8192,-1918464,178688,-1739776,-1
910,248,22,8,0.214162349,0.785837651,333.3050822,337.4590868,583.4725275,564.9233871,1158,46.93960276,2316,-465920,126976,-338944,-1
9626,358,27,3,0.0358573718,0.964142628,2872.83419,3075.311098,5012.097133,4465.567039,9984,442.3571112,19968,-4928512,183296,-4745216,-1
9329,602,21,9,0.060618266,0.939381734,2851.563337,3038.908128,5002.301318,4403.450166,9931,732.3746313,19862,-4776448,308224,-4468224,-1
4840,335,19,11,0.0647342995,0.9352657,1468.573952,1774.410177,2615.346281,2192.907463,5175,158.111824,10350,-2478080,171520,-2306560,-1
9497,467,20,10,0.0468687274,0.953131273,2860.922636,3044.118684,5025.648205,4105.029979,9964,1259.671302,19928,-4862464,239104,-4623360,-1
9301,641,20,10,0.0644739489,0.935526051,2861.383876,2686.450658,5059.356843,3696.684867,9942,306.8518519,19884,-4762112,328192,-4433920,-1
118,23,26,4,0.163120567,0.836879433,41.29615453,36.93764224,72.16101695,65.04347826,141,18.31168831,282,-60416,11776,-48640,-1
701,122,19,11,0.148238153,0.851761847,225.7266202,294.3784167,417.8773181,378.2295082,823,14.93376883,1646,-358912,62464,-296448,-1
4471,289,21,9,0.0607142857,0.939285714,1353.276279,1646.817674,2395.123686,2154.262976,4760,265.1810585,9520,-2289152,147968,-2141184,-1
8360,841,21,9,0.0914031084,0.908596892,2663.218552,2559.143187,4635.472608,4258.323424,9201,213.2329085,18402,-4280320,430592,-3849728,-1
1207,83,16,14,0.0643410853,0.935658915,366.5555007,400.9028456,658.912179,450.4578313,1290,24.11214953,2580,-617984,42496,-575488,-1
9400,555,20,10,0.055750879,0.944249121,2836.038432,3298.119423,5036.196915,3992.322523,9955,949.9045802,19910,-4812800,284160,-4528640,-1
3169,302,21,9,0.0870066263,0.912993374,988.2152913,1121.745687,1752.634585,1561.44702,3471,89.9688958,6942,-1622528,154624,-1467904,-1
8693,1188,27,3,0.120230746,0.879769254,2773.04457,3292.97533,4845.163695,5642.266835,9881,475.2765753,19762,-4450816,608256,-3842560,-1
99,25,21,9,0.201612903,0.798387097,35.21314984,30.76891938,67.53535354,42.56,124,14.01129944,248,-50688,12800,-37888,-1
489,25,21,9,0.0486381323,0.951361868,146.1590889,153.3272787,262.799591,153.84,514,108.4388186,1028,-250368,12800,-237568,-1
3005,250,20,10,0.0768049155,0.923195084,929.6362216,995.6913117,1655.252579,1300.424,3255,113.4937238,6510,-1538560,128000,-1410560,-1
283,54,19,11,0.160237389,0.839762611,94.90090883,107.5266149,172.0353357,153.0925926,337,31.40726934,674,-144896,27648,-117248,-1
4189,188,20,10,0.0429517935,0.957048207,1254.355759,1378.508552,2209.167104,1739.638298,4377,140.1536984,8754,-2144768,96256,-2048512,-1
9573,402,23,7,0.0403007519,0.959699248,2869.522155,3000.166738,5021.457537,4191.261194,9975,779.9061767,19950,-4901376,205824,-4695552,-1
4073,306,17,13,0.0698789678,0.930121032,1253.809235,1393.965963,2190.07341,2189.022876,4379,81.06256942,8758,-2085376,156672,-1928704,-1
2821,232,25,5,0.0759908287,0.924009171,870.5123422,989.943946,1540.007444,1368.836207,3053,186.7278287,6106,-1444352,118784,-1325568,-1
1173,238,19,11,0.168674699,0.831325301,408.3046882,402.151508,703.2071611,719.7647059,1411,108.8734568,2822,-600576,121856,-478720,-1
1699,239,20,10,0.123323013,0.876676987,551.9406375,588.0036337,948.0241318,1122.167364,1938,117.7399757,3876,-869888,122368,-747520,-1
5099,764,20,10,0.130308716,0.869691284,1699.945466,1639.013525,2945.743479,2840.274869,5863,125.3581356,11726,-2610688,391168,-2219520,-1
537,118,18,12,0.180152672,0.819847328,186.316212,196.972053,336.1527002,290.8983051,655,36.67413214,1310,-274944,60416,-214528,-1
2582,176,20,10,0.0638143582,0.936185642,794.1974743,803.2946851,1391.754841,1199.715909,2758,97.21536835,5516,-1321984,90112,-1231872,-1
708,75,25,5,0.0957854406,0.904214559,224.9770899,235.4152666,390.7118644,404.16,783,69.7239537,1566,-362496,38400,-324096,-1
1899,210,20,10,0.0995732575,0.900426743,601.2649741,673.2172577,1054.182728,1062.390476,2109,138.2044561,4218,-972288,107520,-864768,-1
6095,251,27,3,0.039552474,0.960447526,1818.139506,2060.588514,3196.77096,2608.414343,6346,533.72582,12692,-3120640,128512,-2992128,-1
2964,282,20,10,0.0868761553,0.913123845,916.4942873,1099.878715,1647.306343,1373.280142,3246,63.06586361,6492,-1517568,144384,-1373184,-1
4414,514,27,3,0.104301948,0.895698052,1415.508162,1467.238471,2441.487313,2662.122568,4928,95.11677282,9856,-2259968,263168,-1996800,-1
1116,126,25,5,0.101449275,0.898550725,356.6374544,374.915581,621.3826165,622.5396825,1242,71.62629758,2484,-571392,64512,-506880,-1
9385,434,26,4,0.0442000204,0.95579998,2815.143183,2987.877464,4964.851145,3723.875576,9819,755.8891455,19638,-4805120,222208,-4582912,-1
6966,1742,20,10,0.200045935,0.799954065,2468.931491,2493.524958,4131.382716,5246.712974,8708,162.8272251,17416,-3566592,891904,-2674688,-1
2812,430,18,12,0.132634176,0.867365824,893.3839195,991.1158979,1531.205548,2211.983721,3242,132.2725418,6484,-1439744,220160,-1219584,-1
9567,409,21,9,0.0409983962,0.959001604,2874.708418,2993.88957,4982.809658,5121.603912,9976,576.3142692,19952,-4898304,209408,-4688896,-1
5327,326,20,10,0.0576684946,0.942331505,1613.034348,1746.549214,2873.470058,2067.656442,5653,508.8208821,11306,-2727424,166912,-2560512,-1
101,24,27,3,0.192,0.808,36.10374012,35.47299442,61.69306931,68.5,125,25.2016129,250,-51712,12288,-39424,-1
447,100,17,13,0.182815356,0.817184644,151.9658803,162.9516787,290.4384787,200.52,547,42.4689441,1094,-228864,51200,-177664,-1
9254,706,25,5,0.0708835341,0.929116466,2883.924192,2706.004387,5019.833369,4464.932011,9960,234.5184836,19920,-4738048,361472,-4376576,-1
3982,422,19,11,0.09582198,0.90417802,1274.152643,1239.998833,2212.952788,2103.867299,4404,100.6628571,8808,-2038784,216064,-1822720,-1
3669,281,22,8,0.0711392405,0.928860759,1119.707093,1369.557637,1962.461706,2145.740214,3950,218.9578714,7900,-1878528,143872,-1734656,-1
484,78,15,15,0.138790036,0.861209964,155.848496,183.1297081,292.4793388,213.3717949,562,48.11643836,1124,-247808,39936,-207872,-1
979,124,25,5,0.112420671,0.887579329,313.3835549,353.4809959,556.6220633,515.5080645,1103,62.84900285,2206,-501248,63488,-437760,-1
103,34,20,10,0.248175182,0.751824818,38.43516305,42.17679875,70.98058252,63,137,9.53375087,274,-52736,17408,-35328,-1
8975,325,19,11,0.0349462366,0.965053763,2676.144408,2847.610272,4671.904624,4059.403077,9300,241.0575428,18600,-4595200,166400,-4428800,-1
8957,395,17,13,0.0422369547,0.957763045,2683.224695,2939.27271,4711.52953,3882.172152,9352,175.2952202,18704,-4585984,202240,-4383744,-1
6608,243,17,13,0.0354692746,0.964530725,1968.617181,2145.936822,3445.194007,2904.049383,6851,1017.979198,13702,-3383296,124416,-3258880,-1
7700,658,21,9,0.0787269682,0.921273032,2327.507107,3099.153889,4099.768831,5112.524316,8358,507.1601942,16716,-3942400,336896,-3605504,-1
9571,404,22,8,0.0405012531,0.959498747,2861.63725,3170.42451,5021.954028,4183.608911,9975,763.7825421,19950,-4900352,206848,-4693504,-1
9391,553,20,10,0.055611424,0.944388576,2867.594177,2852.77865,5008.393036,4362.96745,9944,863.1944444,19888,-4808192,283136,-4525056,-1
4259,468,17,13,0.0990057119,0.900994288,1330.844094,1638.508483,2356.968537,2427.989316,4727,108.6416916,9454,-2180608,239616,-1940992,-1
9593,393,19,11,0.0393550971,0.960644903,2867.204278,3106.434917,5030.220786,4097.157761,9986,849.8723404,19972,-4911616,201216,-4710400,-1
4669,374,21,9,0.074162205,0.925837795,1444.563892,1514.64766,2559.091454,2058.951872,5043,371.9026549,10086,-2390528,191488,-2199040,-1
277,55,19,11,0.165662651,0.834337349,90.91710283,117.1207331,164.7039711,175.5454545,332,7.057823129,664,-141824,28160,-113664,-1
3710,497,22,8,0.118136439,0.881863561,1185.096595,1247.918228,2020.222102,2729.384306,4207,92.56325633,8414,-1899520,254464,-1645056,-1
372,85,18,12,0.185995624,0.814004376,129.3307652,132.7819171,239.7876344,181.7882353,457,31.32282385,914,-190464,43520,-146944,-1
105,30,20,10,0.222222222,0.777777778,37.41669023,43.73050042,66.82857143,72.1,135,3.670473083,270,-53760,15360,-38400,-1
82,25,19,11,0.23364486,0.76635514,31.16038847,22.98465575,59.13414634,37.16,107,19.24460432,214,-41984,12800,-29184,-1
297,51,27,3,0.146551724,0.853448276,100.824335,95.17626861,178.4006734,151.7843137,348,18.69962386,696,-152064,26112,-125952,-1
9199,719,21,9,0.0724944545,0.927505545,2844.711033,3046.903117,4921.486466,5445.851182,9918,612.2222222,19836,-4709888,368128,-4341760,-1
2797,313,16,14,0.100643087,0.899356913,876.5962271,1048.13162,1533.413657,1752.865815,3110,119.7535618,6220,-1432064,160256,-1271808,-1
402,26,21,9,0.0607476636,0.939252336,120.628926,140.4626759,219.5820896,135.9230769,428,22.75385433,856,-205824,13312,-192512,-1
9210,713,21,9,0.0718532702,0.92814673,2841.769444,3120.666813,4990.313355,4596.269285,9923,976.6732283,19846,-4715520,365056,-4350464,-1
9531,443,20,10,0.0444154802,0.95558452,2846.215859,3167.791088,5056.763089,3497.327314,9974,360.592914,19948,-4879872,226816,-4653056,-1
3229,412,20,10,0.113155726,0.886844274,1047.75139,1076.657713,1822.026634,1812.953883,3641,78.01585601,7282,-1653248,210944,-1442304,-1
4134,412,22,8,0.0906291245,0.909370875,1321.675949,1213.602679,2269.253507,2316.109223,4546,101.247216,9092,-2116608,210944,-1905664,-1
8534,628,20,10,0.068543986,0.931456014,2597.865015,3215.266651,4586.017928,4520.105096,9162,193.6588459,18324,-4369408,321536,-4047872,-1
1321,180,22,8,0.119920053,0.880079947,421.0469229,512.3493794,745.1665405,793.8111111,1501,29.19097627,3002,-676352,92160,-584192,-1
4670,362,22,8,0.0719395866,0.928060413,1425.692021,1763.298962,2518.159315,2495.093923,5032,146.7055394,10064,-2391040,185344,-2205696,-1
9574,405,21,9,0.040585229,0.959414771,2867.046674,3095.73268,5021.240338,4251.493827,9979,777.1806854,19958,-4901888,207360,-4694528,-1
676,101,21,9,0.12998713,0.87001287,212.8927346,270.0464428,374.5399408,485.7821782,777,31.49574382,1554,-346112,51712,-294400,-1
452,118,24,6,0.207017544,0.792982456,159.1463743,183.4433903,288.0110619,275.8813559,570,43.84615385,1140,-231424,60416,-171008,-1
6590,532,22,8,0.0746981185,0.925301881,2054.044531,2075.371201,3571.462974,3438.086466,7122,133.8470212,14244,-3374080,272384,-3101696,-1
9553,416,22,8,0.041729361,0.958270639,2867.551865,3072.198135,5003.860777,4551.882212,9969,780.6577917,19938,-4891136,212992,-4678144,-1
3629,411,21,9,0.101732673,0.898267327,1158.403122,1203.306334,1991.458804,2276.924574,4040,146.8023256,8080,-1858048,210432,-1647616,-1
6922,359,21,9,0.049306414,0.950693586,2098.747776,2136.004609,3657.462005,3323.590529,7281,231.7313813,14562,-3544064,183808,-3360256,-1
36,22,17,13,0.379310345,0.620689655,16.806887,16.34822507,30.97222222,27.09090909,58,16.52421652,116,-18432,11264,-7168,-1
4780,489,19,11,0.0928069842,0.907193016,1483.828473,1812.774733,2601.237448,2965.030675,5269,100.9967414,10538,-2447360,250368,-2196992,-1
9416,540,17,13,0.0542386501,0.94576135,2855.891286,2977.774093,5039.78048,3909.95,9956,628.5353535,19912,-4820992,276480,-4544512,-1
2887,173,27,3,0.0565359477,0.943464052,872.6936314,1032.152801,1520.91479,1690.456647,3060,76.63410969,6120,-1478144,88576,-1389568,-1
2017,129,26,4,0.060111836,0.939888164,617.439785,632.4541936,1083.017353,924.6899225,2146,141.8374091,4292,-1032704,66048,-966656,-1
2777,298,21,9,0.0969105691,0.903089431,874.1471089,844.3474775,1593.590925,1019.959732,3075,58.71682261,6150,-1421824,152576,-1269248,-1
3357,235,21,9,0.0654231626,0.934576837,1030.087624,981.9898161,1834.341674,1255.92766,3592,459.9231754,7184,-1718784,120320,-1598464,-1
5595,435,20,10,0.0721393035,0.927860697,1717.304837,1943.473201,2974.890617,3537.82069,6030,112.35327,12060,-2864640,222720,-2641920,-1
329,39,27,3,0.105978261,0.894021739,107.2521392,96.5494903,183.2401216,195.1282051,368,73.89558233,736,-168448,19968,-148480,-1
3729,308,27,3,0.0762942779,0.923705722,1149.153303,1345.493598,2022.979887,1970.814935,4037,229.8974943,8074,-1909248,157696,-1751552,-1
4314,825,19,11,0.160537069,0.839462931,1458.26045,1487.469607,2462.489801,3132.180606,5139,101.1216057,10278,-2208768,422400,-1786368,-1
4009,599,21,9,0.129991319,0.870008681,1305.032223,1422.040896,2243.524819,2712.595993,4608,141.5233415,9216,-2052608,306688,-1745920,-1
2224,334,24,6,0.130570758,0.869429242,727.1402532,764.7632395,1316.707734,1031.745509,2558,127.5174477,5116,-1138688,171008,-967680,-1
9615,368,16,14,0.0368626665,0.963137333,2864.06273,3166.88985,5028.519085,4037.839674,9983,749.4744745,19966,-4922880,188416,-4734464,-1
663,92,21,9,0.121854305,0.878145695,205.1804835,283.9748701,368.0995475,449.3478261,755,31.30182421,1510,-339456,47104,-292352,-1
2753,171,20,10,0.0584815321,0.941518468,838.885047,921.4450634,1458.529241,1526.426901,2924,180.1601972,5848,-1409536,87552,-1321984,-1
3671,434,22,8,0.105724726,0.894275274,1158.45184,1365.458295,2024.224734,2296.396313,4105,90.1801406,8210,-1879552,222208,-1657344,-1
1709,89,20,10,0.0494994438,0.950500556,512.7346126,602.9560816,908.3996489,728.6067416,1798,56.64776307,3596,-875008,45568,-829440,-1
58,16,23,7,0.216216216,0.783783784,22.12507012,16.90599006,39.22413793,31.25,74,2.170724553,148,-29696,8192,-21504,-1
4113,430,21,9,0.0946511116,0.905348888,1286.530757,1516.185925,2291.983224,2080.85814,4543,158.6243017,9086,-2105856,220160,-1885696,-1
3511,274,26,4,0.0723910172,0.927608983,1075.688706,1173.644631,1933.285104,1376.791971,3785,277.0863836,7570,-1797632,140288,-1657344,-1
3418,309,22,8,0.0829085055,0.917091494,1064.954877,1187.895514,1870.393798,1793.275081,3727,94.69004065,7454,-1750016,158208,-1591808,-1
9383,548,25,5,0.0551807472,0.944819253,2854.230147,3030.223826,4995.552382,4459.99635,9931,688.2189882,19862,-4804096,280576,-4523520,-1
5922,242,21,9,0.0392602206,0.960739779,1766.660333,1953.622479,3109.504222,2421.677686,6164,599.0281827,12328,-3032064,123904,-2908160,-1
8577,589,20,10,0.0642592189,0.935740781,2609.108894,3103.812582,4554.510901,5005.63837,9166,253.3443892,18332,-4391424,301568,-4089856,-1
7987,1113,20,10,0.122307692,0.877692308,2442.343613,3137.79378,4297.000501,6369.637916,9100,196.1629662,18200,-4089344,569856,-3519488,-1
1836,203,18,12,0.0995586072,0.900441393,568.8364446,737.8637718,1010.04793,1110.009852,2039,72.84744552,4078,-940032,103936,-836096,-1
4912,267,21,9,0.0515543541,0.948445646,1487.490993,1617.737092,2580.416327,2766.310861,5179,282.3882225,10358,-2514944,136704,-2378240,-1
201,16,25,5,0.0737327189,0.926267281,62.53157139,61.74392683,110.2935323,92.75,217,21.96356275,434,-102912,8192,-94720,-1
430,62,22,8,0.12601626,0.87398374,133.6723941,186.2617992,241.3581395,282.1612903,492,14.47910536,984,-220160,31744,-188416,-1
8161,1795,20,10,0.18029329,0.81970671,2701.804904,2598.645953,4495.877834,7172.750418,9956,359.5521849,19912,-4178432,919040,-3259392,-1
9449,522,21,9,0.0523518203,0.94764818,2848.065072,3016.474516,5068.05916,3500.603448,9971,1036.486486,19942,-4837888,267264,-4570624,-1
2269,525,21,9,0.187902649,0.812097351,813.7009809,765.2009158,1371.974438,1507.819048,2794,105.9135709,5588,-1161728,268800,-892928,-1
446,103,20,10,0.187613843,0.812386157,152.6803205,163.3287135,291.4663677,203.6990291,549,88.83495146,1098,-228352,52736,-175616,-1
39,14,21,9,0.264150943,0.735849057,13.79177355,18.73295143,27.69230769,25.07142857,53,15.91591592,106,-19968,7168,-12800,-1
8577,1292,19,11,0.130914986,0.869085014,2900.281767,2417.463935,4856.488632,5456.201238,9869,541.6575192,19738,-4391424,661504,-3729920,-1
6342,487,21,9,0.0713135159,0.928686484,1927.631085,2419.985056,3452.030274,2932.770021,6829,632.3148148,13658,-3247104,249344,-2997760,-1
4213,369,21,9,0.0805325186,0.919467481,1301.272185,1465.989627,2332.872537,1819.135501,4582,193.660186,9164,-2157056,188928,-1968128,-1
9491,483,17,13,0.0484259074,0.951574093,2879.768901,2688.834613,5037.168265,4011.513458,9974,475.631855,19948,-4859392,247296,-4612096,-1
5233,265,21,9,0.0481993452,0.951800655,1572.949022,1828.423711,2761.718517,2508.218868,5498,101.8902891,10996,-2679296,135680,-2543616,-1
9318,628,20,10,0.0631409612,0.936859039,2848.303001,3087.133252,4920.779674,5755.742038,9946,969.3957115,19892,-4770816,321536,-4449280,-1
6770,700,22,8,0.093708166,0.906291834,2111.715882,2540.784426,3716.028508,3923.817143,7470,205.2197802,14940,-3466240,358400,-3107840,-1
194,45,20,10,0.188284519,0.811715481,68.89896291,51.87103666,129.6340206,78.46666667,239,24.84407484,478,-99328,23040,-76288,-1
9216,715,22,8,0.0719967778,0.928003222,2834.096217,3139.475575,5031.495551,4121.794406,9931,1030.186722,19862,-4718592,366080,-4352512,-1
1231,220,27,3,0.151619573,0.848380427,418.9909397,412.4393924,714.6368806,789.5818182,1451,49.30343187,2902,-630272,112640,-517632,-1
7778,551,20,10,0.0661544003,0.9338456,2393.799777,2321.426355,4237.068912,3147.664247,8329,542.2526042,16658,-3982336,282112,-3700224,-1
9536,433,20,10,0.0434346474,0.956565353,2862.178622,3083.607168,5023.412542,4139.036952,9969,886.1333333,19938,-4882432,221696,-4660736,-1
3574,247,20,10,0.0646427637,0.935357236,1095.092829,1177.210423,1930.281757,1632,3821,225.6940343,7642,-1829888,126464,-1703424,-1
4376,511,23,7,0.104563127,0.895436873,1364.457933,1747.775275,2423.090037,2623.064579,4887,114.2356241,9774,-2240512,261632,-1978880,-1
61,29,18,12,0.322222222,0.677777778,25.41277614,26.79680887,47.16393443,42,90,20.27027027,180,-31232,14848,-16384,-1
839,77,17,13,0.0840611354,0.915938865,254.8457928,334.7979279,468.1370679,353.4935065,916,52.82583622,1832,-429568,39424,-390144,-1
767,102,18,12,0.117376295,0.882623705,240.7450077,305.5327187,424.5723598,513.4117647,869,37.07337884,1738,-392704,52224,-340480,-1
9553,432,20,10,0.0432648973,0.956735103,2856.383577,3181.698706,5046.982309,3799.266204,9985,610.7033639,19970,-4891136,221184,-4669952,-1
58,16,23,7,0.216216216,0.783783784,22.12917433,16.85681891,39.24137931,31.1875,74,2.085094393,148,-29696,8192,-21504,-1
4848,1086,19,11,0.183013145,0.816986855,1731.576836,1621.022864,2938.181724,3098.379374,5934,116.19346,11868,-2482176,556032,-1926144,-1
4539,291,17,13,0.0602484472,0.939751553,1388.250255,1485.490648,2415.421238,2416.728522,4830,102.2005925,9660,-2323968,148992,-2174976,-1
8543,1303,22,8,0.132338005,0.867661995,2811.84094,3011.543258,4870.680323,5269.807368,9846,372.3903177,19692,-4374016,667136,-3706880,-1
2594,189,20,10,0.0679123248,0.932087675,791.9253288,926.0084067,1405.855821,1201.830688,2783,104.9396682,5566,-1328128,96768,-1231360,-1
4707,608,19,11,0.114393227,0.885606773,1518.456464,1581.607372,2600.051625,3106.623355,5315,120.0587305,10630,-2409984,311296,-2098688,-1
9513,455,20,10,0.0456460674,0.954353933,2865.013548,2983.099031,5028.382004,4067.028571,9968,992.8286853,19936,-4870656,232960,-4637696,-1
5010,333,20,10,0.0623245368,0.937675463,1509.208392,1956.862192,2689.405589,2410.132132,5343,333.5205993,10686,-2565120,170496,-2394624,-1
9408,543,19,11,0.0545673802,0.94543262,2860.487041,3072.411272,4983.092793,4853.110497,9951,1045.273109,19902,-4816896,278016,-4538880,-1
1399,151,27,3,0.0974193548,0.902580645,443.4895303,475.7410215,783.7927091,698.6688742,1550,98.22560203,3100,-716288,77312,-638976,-1
9596,382,23,7,0.0382842253,0.961715775,2872.040445,2981.241944,5020.163714,4219.21466,9978,900.5415162,19956,-4913152,195584,-4717568,-1
5827,645,19,11,0.0996600742,0.900339926,1862.93611,1906.055823,3215.889137,3422.700775,6472,188.5231576,12944,-2983424,330240,-2653184,-1
3232,257,21,9,0.0736600745,0.926339925,996.4189238,1092.533267,1768.230507,1452.856031,3489,83.11100524,6978,-1654784,131584,-1523200,-1
169,35,21,9,0.171568627,0.828431373,56.37982849,62.4942381,108.3372781,74.31428571,204,16.32,408,-86528,17920,-68608,-1
9245,689,21,9,0.0693577612,0.930642239,2872.165211,2759.022872,5004.684478,4468.558781,9934,669.8583951,19868,-4733440,352768,-4380672,-1
1348,124,22,8,0.0842391304,0.91576087,418.6866917,452.8636542,720.5734421,909.6370968,1472,157.7706324,2944,-690176,63488,-626688,-1
165,27,21,9,0.140625,0.859375,52.8640629,68.182942,98.14545455,86.44444444,192,12.48374512,384,-84480,13824,-70656,-1
9519,463,21,9,0.0463834903,0.95361651,2864.278811,3192.289091,5010.110726,4608.87473,9982,904.1666667,19964,-4873728,237056,-4636672,-1
667,39,22,8,0.0552407932,0.944759207,201.3245073,219.4140035,359.3448276,253.5384615,706,55.59055118,1412,-341504,19968,-321536,-1
9311,550,19,11,0.0557752763,0.944224724,2829.508246,3120.721072,4925.49361,5024.218182,9861,222.6461955,19722,-4767232,281600,-4485632,-1
3394,165,17,13,0.0463613375,0.953638663,1013.944069,1227.721392,1795.961108,1451.684848,3559,212.8588517,7118,-1737728,84480,-1653248,-1
5473,321,22,8,0.0554021401,0.94459786,1648.164256,1975.64726,2927.498264,2386.034268,5794,163.1193694,11588,-2802176,164352,-2637824,-1
9145,782,20,10,0.0787750579,0.921224942,2821.33199,3214.686541,4889.354073,5836.93734,9927,620.4375,19854,-4682240,400384,-4281856,-1
3487,163,24,6,0.0446575342,0.955342466,1042.370298,1241.83108,1837.969028,1558.754601,3650,162.8737171,7300,-1785344,83456,-1701888,-1
209,14,23,7,0.0627802691,0.937219731,62.76674768,75.86965191,114.4593301,75.28571429,223,6.882716049,446,-107008,7168,-99840,-1
9451,510,21,9,0.0511996787,0.948800321,2874.680565,2819.533371,5014.46175,4360.907843,9961,619.8506534,19922,-4838912,261120,-4577792,-1
2739,337,20,10,0.109557867,0.890442133,878.3031578,951.3722393,1555.747353,1398.320475,3076,162.7513228,6152,-1402368,172544,-1229824,-1
5446,613,27,3,0.101171811,0.898828189,1633.924003,1858.698284,2843.154609,4689.967374,6059,110.1636364,12118,-2788352,313856,-2474496,-1
9574,403,20,10,0.0403929037,0.959607096,2867.044526,3034.090322,5027.537393,4073.473945,9977,1454.373178,19954,-4901888,206336,-4695552,-1
9444,513,21,9,0.0515215426,0.948478457,2863.869953,2864.683116,5036.008365,3929.512671,9957,919.3905817,19914,-4835328,262656,-4572672,-1
2406,141,21,9,0.0553592462,0.944640754,725.250093,883.2422692,1279.64921,1177.602837,2547,86.33898305,5094,-1231872,72192,-1159680,-1
3074,269,17,13,0.0804666467,0.919533353,963.1663349,973.3791699,1685.305791,1519.947955,3343,162.676399,6686,-1573888,137728,-1436160,-1
8854,948,27,3,0.0967149561,0.903285044,2740.313288,3194.80588,4742.405128,6387.392405,9802,180.1507076,19604,-4533248,485376,-4047872,-1
162,45,19,11,0.217391304,0.782608696,58.74161937,61.23847737,107.9074074,89.93333333,207,17.79879622,414,-82944,23040,-59904,-1
9482,495,16,14,0.0496141125,0.950385888,2840.216398,3101.611285,5077.831154,3287.389899,9977,1144.151376,19954,-4854784,253440,-4601344,-1
260,67,18,12,0.204892966,0.795107034,90.28425943,107.1569615,168.45,146.7313433,327,9.108635097,654,-133120,34304,-98816,-1
3379,863,20,10,0.203441773,0.796558227,1202.733057,1132.894775,1973.153892,2702.336037,4242,83.45465276,8484,-1730048,441856,-1288192,-1
58,28,20,10,0.325581395,0.674418605,23.93868505,26.50536623,44.20689655,42.03571429,86,8.143939394,172,-29696,14336,-15360,-1
1305,151,21,9,0.103708791,0.896291209,410.175481,498.6820362,725.554023,753.9602649,1456,77.03703704,2912,-668160,77312,-590848,-1
4146,246,20,10,0.056010929,0.943989071,1272.500109,1122.852882,2218.682344,1822.646341,4392,163.0894913,8784,-2122752,125952,-1996800,-1
5437,1332,19,11,0.196779436,0.803220564,1934.855126,1991.527818,3298.09417,3739.734985,6769,125.794462,13538,-2783744,681984,-2101760,-1
6888,775,17,13,0.101135326,0.898864674,2152.881932,2658.329615,3794.316638,4166.92,7663,220.0114844,15326,-3526656,396800,-3129856,-1
2145,100,20,10,0.0445434298,0.95545657,642.8194258,718.0714017,1133.181352,904.61,2245,227.2267206,4490,-1098240,51200,-1047040,-1
1354,609,22,8,0.310239429,0.689760571,638.4749095,358.5086767,976.8766617,993.3908046,1963,74.78095238,3926,-693248,311808,-381440,-1
1048,118,22,8,0.101200686,0.898799314,336.0159047,333.9770603,591.2089695,515.0338983,1166,36.72440945,2332,-536576,60416,-476160,-1
4918,300,21,9,0.0574932924,0.942506708,1485.295771,1814.10542,2604.068117,2698.546667,5218,112.16681,10436,-2518016,153600,-2364416,-1
128,28,17,13,0.179487179,0.820512821,41.80480284,55.89406662,81.1953125,66.17857143,156,2.924086223,312,-65536,14336,-51200,-1
2160,216,17,13,0.0909090909,0.909090909,671.5669811,663.9283453,1233.636574,737.1342593,2376,157.4552684,4752,-1105920,110592,-995328,-1
9586,400,21,9,0.0400560785,0.959943921,2861.921404,3169.967488,5036.82996,3955.0975,9986,851.3213981,19972,-4908032,204800,-4703232,-1
9390,574,20,10,0.0576073866,0.942392613,2870.7666,2966.025964,4985.094782,4940.052265,9964,1071.397849,19928,-4807680,293888,-4513792,-1
9465,499,21,9,0.050080289,0.949919711,2842.566591,3044.784943,5066.436133,3390.40481,9964,742.4739195,19928,-4846080,255488,-4590592,-1
32,20,19,11,0.384615385,0.615384615,15.2744425,14.52721584,27.0625,25.6,52,15.07246377,104,-16384,10240,-6144,-1
9556,416,22,8,0.0417168071,0.958283193,2876.434935,2925.882464,4992.70699,4843.918269,9972,254.8428316,19944,-4892672,212992,-4679680,-1
9549,424,25,5,0.0425147899,0.95748521,2882.294349,2778.483062,5002.988585,4626.917453,9973,980.6293019,19946,-4889088,217088,-4672000,-1
285,34,21,9,0.106583072,0.893416928,87.11586127,123.1731733,163.1403509,133.6764706,319,16.10297829,638,-145920,17408,-128512,-1
5133,439,22,8,0.0787867911,0.921213209,1579.337261,1914.115302,2794.851159,2688.854214,5572,225.222312,11144,-2628096,224768,-2403328,-1
9530,438,20,10,0.04394061,0.95605939,2874.00512,2913.369734,5006.119098,4514.111872,9968,1417.923186,19936,-4879360,224256,-4655104,-1
1669,176,21,9,0.0953929539,0.904607046,520.3698318,632.7545431,915.583583,993.3295455,1845,113.3988937,3690,-854528,90112,-764416,-1
694,58,17,13,0.0771276596,0.92287234,210.0226931,211.7753813,392.2247839,188.3448276,752,138.2352941,1504,-355328,29696,-325632,-1
9168,766,21,9,0.0771089189,0.922891081,2852.576952,2925.979573,5034.541776,4165.099217,9934,427.2688172,19868,-4694016,392192,-4301824,-1
9581,401,20,10,0.0401723102,0.95982769,2861.126966,3133.705621,5038.002922,3880.416459,9982,858.2975064,19964,-4905472,205312,-4700160,-1
1318,257,21,9,0.163174603,0.836825397,445.9040575,493.285308,776.9430956,844.7042802,1575,153.2101167,3150,-674816,131584,-543232,-1
322,49,16,14,0.132075472,0.867924528,102.6060801,105.2114865,197.5093168,110.3673469,371,71.07279693,742,-164864,25088,-139776,-1
97,44,19,11,0.312056738,0.687943262,41.38354671,38.79568754,73,66.59090909,141,25.35971223,282,-49664,22528,-27136,-1
9582,394,21,9,0.0394947875,0.960505213,2862.313582,3101.881067,5031.088604,3952.753807,9976,772.7343145,19952,-4905984,201728,-4704256,-1
9485,484,27,3,0.0485505066,0.951449493,2865.189745,2943.400966,5035.70195,3991.38843,9969,1352.645862,19938,-4856320,247808,-4608512,-1
5085,309,27,3,0.0572858732,0.942714127,1538.902248,1811.80738,2713.088889,2440.964401,5394,228.0761099,10788,-2603520,158208,-2445312,-1
4550,495,25,5,0.0981169475,0.901883053,1440.426293,1590.654412,2510.241758,2640.272727,5045,130.7672369,10090,-2329600,253440,-2076160,-1
204,54,17,13,0.209302326,0.790697674,72.05784847,74.91524475,137.9019608,97.75925926,258,35.3909465,516,-104448,27648,-76800,-1
951,150,21,9,0.136239782,0.863760218,304.3861539,375.2296539,534.1209253,658.0133333,1101,65.77060932,2202,-486912,76800,-410112,-1
5624,791,20,10,0.123304754,0.876695246,1820.033067,1971.765833,3127.661807,3779.20354,6415,141.6427467,12830,-2879488,404992,-2474496,-1
8724,1166,21,9,0.117896866,0.882103134,2822.471537,3061.766421,4895.565681,5319.108062,9890,233.254717,19780,-4466688,596992,-3869696,-1
3811,230,21,9,0.0569166048,0.943083395,1150.659771,1349.838013,2043.571504,1647,4041,338.7259011,8082,-1951232,117760,-1833472,-1
69,29,16,14,0.295918367,0.704081633,27.87265879,25.66884137,54.44927536,37.72413793,98,1.798495137,196,-35328,14848,-20480,-1
574,54,27,3,0.0859872611,0.914012739,177.7243242,194.7578814,322.8083624,226.1851852,628,29.73484848,1256,-293888,27648,-266240,-1
3955,238,22,8,0.0567612688,0.943238731,1192.870258,1461.987708,2087.155752,2260.588235,4193,102.0194647,8386,-2024960,121856,-1903104,-1
1246,117,19,11,0.0858400587,0.914159941,386.0339477,443.2685638,694.6990369,546.7606838,1363,122.9035167,2726,-637952,59904,-578048,-1
5382,231,22,8,0.0411544629,0.958845537,1611.640246,1764.4347,2824.167967,2407.008658,5613,107.302619,11226,-2755584,118272,-2637312,-1
8929,532,21,9,0.0562308424,0.943769158,2703.482695,2826.835676,4812.700526,3359.75188,9461,536.0339943,18922,-4571648,272384,-4299264,-1
3699,248,27,3,0.062832531,0.937167469,1123.910096,1221.849001,2011.185996,1419.358871,3947,291.9378698,7894,-1893888,126976,-1766912,-1
9522,453,20,10,0.0454135338,0.954586466,2869.063916,3039.941985,5014.115522,4439.055188,9975,681.8181818,19950,-4875264,231936,-4643328,-1
9468,496,19,11,0.0497792051,0.950220795,2861.24787,2951.430797,5038.847486,3906.899194,9964,604.9787492,19928,-4847616,253952,-4593664,-1
8967,965,21,9,0.0971606927,0.902839307,2923.026095,2283.021592,4964.620609,4983.963731,9932,637.8933847,19864,-4591104,494080,-4097024,-1
4264,390,22,8,0.0837988827,0.916201117,1325.843147,1455.479202,2288.182223,2757.374359,4654,197.5382003,9308,-2183168,199680,-1983488,-1
9573,406,27,3,0.0406854394,0.959314561,2862.439661,3151.767452,5027.980779,4094.458128,9979,1006.962664,19958,-4901376,207872,-4693504,-1
6739,682,18,12,0.091901361,0.908098639,2165.838276,1823.846933,3760.086066,3225.969208,7421,213.6154289,14842,-3450368,349184,-3101184,-1
2290,209,18,12,0.0836334534,0.916366547,710.2169011,695.2915437,1290.263755,808.8325359,2499,292.6229508,4998,-1172480,107008,-1065472,-1
33,22,16,14,0.4,0.6,15.78843133,15.82085923,29.24242424,26.13636364,55,14.94565217,110,-16896,11264,-5632,-1
1927,203,17,13,0.0953051643,0.904694836,603.0718747,613.6577258,1102.721847,712.1674877,2130,121.7838765,4260,-986624,103936,-882688,-1
5715,264,21,9,0.0441545409,0.955845459,1711.498968,2010.953844,2995.214348,2877.121212,5979,331.6139767,11958,-2926080,135168,-2790912,-1
1695,232,21,9,0.120394395,0.879605605,547.5412263,616.298885,965.0654867,956.2155172,1927,134.3793584,3854,-867840,118784,-749056,-1
6204,425,22,8,0.0641122341,0.935887766,1892.196404,2118.260057,3274.930529,3899.92,6629,150.3174603,13258,-3176448,217600,-2958848,-1
9497,473,17,13,0.047442327,0.952557673,2852.044507,3098.428463,5048.501843,3720.534884,9970,983.234714,19940,-4862464,242176,-4620288,-1
546,59,22,8,0.0975206612,0.902479339,167.050715,233.4712264,302.5677656,307,605,24.9793559,1210,-279552,30208,-249344,-1
3463,270,17,13,0.0723278864,0.927672114,1067.21625,1056.890578,1910.176148,1313.225926,3733,195.7524908,7466,-1773056,138240,-1634816,-1
1638,100,19,11,0.0575373993,0.942462601,495.8893202,585.850158,873.1214896,810.18,1738,171.5695953,3476,-838656,51200,-787456,-1
2662,513,20,10,0.161574803,0.838425197,907.3948107,877.7549529,1518.26296,1949.871345,3175,126.1923688,6350,-1362944,262656,-1100288,-1
43,20,20,10,0.317460317,0.682539683,16.9908511,20.51487265,32.09302326,31.8,63,2.398172821,126,-22016,10240,-11776,-1
9465,512,18,12,0.0513180315,0.948681969,2854.25215,3037.404111,5059.894559,3678.419922,9977,395.1287129,19954,-4846080,262144,-4583936,-1
2255,181,25,5,0.0743021346,0.925697865,700.1912127,691.0152184,1238.907761,964.2486188,2436,64.17281349,4872,-1154560,92672,-1061888,-1
2074,124,21,9,0.0564149227,0.943585077,623.1762152,797.6412654,1095.501929,1166.370968,2198,41.00746269,4396,-1061888,63488,-998400,-1
614,100,18,12,0.140056022,0.859943978,199.3940059,233.4015019,367.8957655,293.67,714,48.04845222,1428,-314368,51200,-263168,-1
342,162,22,8,0.321428571,0.678571429,146.3150916,138.7087744,237.7923977,283.5493827,504,13.24224908,1008,-175104,82944,-92160,-1
9511,461,19,11,0.0462294424,0.953770558,2871.155947,2947.375284,5019.665545,4302.253796,9972,935.4596623,19944,-4869632,236032,-4633600,-1
2837,205,21,9,0.0673898751,0.932610125,866.1485616,1029.732364,1523.05816,1499.936585,3042,129.281768,6084,-1452544,104960,-1347584,-1
1736,223,27,3,0.113833589,0.886166411,551.7184945,663.1666094,980.2960829,977.6950673,1959,41.25947767,3918,-888832,114176,-774656,-1
4377,1563,22,8,0.263131313,0.736868687,1386.340975,1526.697377,2400.209047,4567.533589,5940,124.1638796,11880,-2241024,800256,-1440768,-1
3901,696,17,13,0.151403089,0.848596911,1294.928596,1376.115024,2203.272494,2835.541667,4597,98.98794143,9194,-1997312,356352,-1640960,-1
1596,129,23,7,0.0747826087,0.925217391,492.4702081,480.7444423,885.5570175,583.9224806,1725,172.3276723,3450,-817152,66048,-751104,-1
8956,952,21,9,0.0960839725,0.903916027,2794.979844,3386.802784,4911.657101,5357.547269,9908,716.9319826,19816,-4585472,487424,-4098048,-1
5477,221,20,10,0.0387855388,0.961214461,1633.939816,1810.716781,2871.708234,2299.117647,5698,621.3740458,11396,-2804224,113152,-2691072,-1
2032,411,21,9,0.168235776,0.831764224,682.8462152,803.2258819,1207.929134,1291.56691,2443,86.47787611,4886,-1040384,210432,-829952,-1
7810,478,20,10,0.0576737452,0.942326255,2355.170226,2864.036127,4183.020487,3515.117155,8288,254.3891958,16576,-3998720,244736,-3753984,-1
5821,292,16,14,0.0477670538,0.952232946,1744.443441,2123.813621,3063.65487,2924.335616,6113,141.931739,12226,-2980352,149504,-2830848,-1
8006,593,20,10,0.0689615072,0.931038493,2422.64156,2880.942541,4203.744317,5599.532884,8599,244.9159784,17198,-4099072,303616,-3795456,-1
69,9,27,3,0.115384615,0.884615385,22.31704303,21.02908039,40.91304348,28.66666667,78,2.79971285,156,-35328,4608,-30720,-1
9500,471,21,9,0.0472369873,0.952763013,2848.487793,3030.905716,5063.301474,3426.840764,9971,290.7844853,19942,-4864000,241152,-4622848,-1
3949,295,18,12,0.0695098963,0.930490104,1206.227084,1453.275417,2117.705748,2186.677966,4244,460.8034745,8488,-2021888,151040,-1870848,-1
9416,539,22,8,0.0541436464,0.945856354,2848.730387,3273.183316,4990.074342,4767.068646,9955,959.9807136,19910,-4820992,275968,-4545024,-1
9069,872,22,8,0.0877175334,0.912282467,2879.398726,2547.319156,5070.24071,3938.873853,9941,361.7540029,19882,-4643328,446464,-4196864,-1
3191,307,17,13,0.0877644368,0.912235563,1001.121856,1084.052051,1764.197744,1596.729642,3498,72.18324391,6996,-1633792,157184,-1476608,-1
67,23,19,11,0.255555556,0.744444444,25.27576577,27.00178528,47.6119403,39.34782609,90,15.07537688,180,-34304,11776,-22528,-1
8746,1108,19,11,0.112441648,0.887558352,2776.093087,3283.011483,4856.561628,5487.452166,9854,517.2703412,19708,-4477952,567296,-3910656,-1
35,17,19,11,0.326923077,0.673076923,15.05673624,14.71340984,27.45714286,24.52941176,52,1.999231065,104,-17920,8704,-9216,-1
159,39,22,8,0.196969697,0.803030303,56.55821507,59.53400014,99.59748428,99.1025641,198,5.217391304,396,-81408,19968,-61440,-1
1749,192,16,14,0.0989180835,0.901081917,551.5302979,632.9081968,976.0960549,924.578125,1941,99.79434447,3882,-895488,98304,-797184,-1
2836,195,20,10,0.0643352029,0.935664797,867.9294916,883.9037348,1542.841326,1125.630769,3031,161.1376927,6062,-1452032,99840,-1352192,-1
9176,748,21,9,0.0753728335,0.924627166,2811.318621,3422.985048,4926.1432,5408.502674,9924,517.4139729,19848,-4698112,382976,-4315136,-1
374,53,20,10,0.12412178,0.87587822,118.2430166,122.7665458,226.355615,126.8113208,427,64.30722892,854,-191488,27136,-164352,-1
3001,274,20,10,0.0836641221,0.916335878,939.0769006,1011.281736,1641.756415,1596.857664,3275,89.06717433,6550,-1536512,140288,-1396224,-1
1327,110,22,8,0.0765483646,0.923451635,402.5042247,503.2907742,734.985682,526.1545455,1437,28.59701493,2874,-679424,56320,-623104,-1
1652,146,22,8,0.0812013348,0.918798665,508.0437203,552.9642655,925.1107748,609.7123288,1798,33.72725567,3596,-845824,74752,-771072,-1
725,94,17,13,0.114774115,0.885225885,226.9576133,296.326155,415.3489655,368.7446809,819,21.93358329,1638,-371200,48128,-323072,-1
1780,190,18,12,0.0964467005,0.903553299,553.2663721,570.1518743,1026.142697,604.7421053,1970,304.0123457,3940,-911360,97280,-814080,-1
3979,349,23,7,0.0806377079,0.919362292,1217.978699,1537.74401,2140.739884,2435.39255,4328,251.1897853,8656,-2037248,178688,-1858560,-1
1046,134,21,9,0.113559322,0.886440678,322.4984211,413.4406636,566.6835564,776.4104478,1180,88.52213053,2360,-535552,68608,-466944,-1
58,22,24,6,0.275,0.725,21.99964868,25.50174196,39.34482759,43.54545455,80,1.622060016,160,-29696,11264,-18432,-1
1957,235,17,13,0.107208029,0.892791971,611.0817071,782.4711186,1083.632601,1203.655319,2192,46.50965415,4384,-1001984,120320,-881664,-1
3011,498,20,10,0.141920775,0.858079225,973.5622731,1153.376969,1692.011956,2135.837349,3509,85.8996328,7018,-1541632,254976,-1286656,-1
2801,142,20,10,0.0482500849,0.951749915,845.3534218,927.1753767,1474.761871,1417.521127,2943,296.0764588,5886,-1434112,72704,-1361408,-1
122,35,21,9,0.222929936,0.777070064,44.30498852,48.52035971,77.95081967,82.65714286,157,11.9391635,314,-62464,17920,-44544,-1
2076,171,21,9,0.0761014686,0.923898531,645.1568151,684.359068,1130.773121,1041.77193,2247,86.35664873,4494,-1062912,87552,-975360,-1
6912,506,22,8,0.0682124562,0.931787544,2125.980443,2341.779515,3709.209346,3713.470356,7418,160.9110629,14836,-3538944,259072,-3279872,-1
2784,204,27,3,0.0682730924,0.931726908,857.9456213,844.108838,1520.952227,1133.504902,2988,224.8306998,5976,-1425408,104448,-1320960,-1
4614,333,27,3,0.0673135233,0.932686477,1405.107186,1502.24392,2531.658864,1675.087087,4947,254.2137718,9894,-2362368,170496,-2191872,-1
3968,329,21,9,0.0765650454,0.923434955,1222.6486,1436.264227,2143.796371,2211.759878,4297,195.3181818,8594,-2031616,168448,-1863168,-1
4622,999,18,12,0.177726383,0.822273617,1609.167522,1650.532628,2745.936608,3112.024024,5621,277.4432379,11242,-2366464,511488,-1854976,-1
4649,428,22,8,0.084301753,0.915698247,1440.385275,1684.357636,2510.188428,2851.955607,5077,369.5050946,10154,-2380288,219136,-2161152,-1
5047,374,20,10,0.0689909611,0.931009039,1557.355184,1632.521736,2733.839509,2402.78877,5421,101.4788469,10842,-2584064,191488,-2392576,-1
9372,576,21,9,0.0579010856,0.942098914,2871.530034,2759.427866,5022.671788,4190.704861,9948,1315.873016,19896,-4798464,294912,-4503552,-1
263,65,18,12,0.198170732,0.801829268,91.44486961,97.22128727,174.2813688,124.9230769,328,23.16384181,656,-134656,33280,-101376,-1
5837,877,21,9,0.13062258,0.86937742,1789.838689,2336.986756,3160.607675,4667.945268,6714,129.9651568,13428,-2988544,449024,-2539520,-1
8922,984,20,10,0.0993337371,0.900666263,2861.543675,2767.6351,4885.86169,5566.781504,9906,618.7382886,19812,-4568064,503808,-4064256,-1
8383,554,21,9,0.0619894819,0.938010518,2544.426347,2999.727879,4509.847429,3850.906137,8937,187.0447886,17874,-4292096,283648,-4008448,-1
5961,351,27,3,0.055608365,0.944391635,1803.210272,1948.010847,3204.013421,2349.584046,6312,120.8500862,12624,-3052032,179712,-2872320,-1
1762,259,17,13,0.128154379,0.871845621,572.6745689,650.2653412,1017.103292,969.4787645,2021,126.4705882,4042,-902144,132608,-769536,-1
5848,408,20,10,0.0652173913,0.934782609,1773.928964,2202.988043,3143.798735,2909.218137,6256,150.5293551,12512,-2994176,208896,-2785280,-1
5434,1181,20,10,0.178533636,0.821466364,1900.423489,1898.066024,3218.924365,3717.853514,6615,140.7446809,13230,-2782208,604672,-2177536,-1
1546,109,22,8,0.0658610272,0.934138973,469.520108,508.7206333,847.2891332,554.412844,1655,135.9901397,3310,-791552,55808,-735744,-1
589,60,23,7,0.092449923,0.907550077,181.7968447,177.2371293,339.9745331,178,649,136.0587002,1298,-301568,30720,-270848,-1
3857,341,21,9,0.0812291567,0.918770843,1192.357568,1292.649548,2148.030334,1550.580645,4198,383.0291971,8396,-1974784,174592,-1800192,-1
695,95,12,18,0.120253165,0.879746835,218.0099012,277.1374518,406.9510791,311.7263158,790,67.40614334,1580,-355840,48640,-307200,-1
4786,179,20,10,0.0360523666,0.963947633,1424.749052,1580.182266,2499.770581,2034.597765,4965,127.0145817,9930,-2450432,91648,-2358784,-1
104,30,21,9,0.223880597,0.776119403,39.22471673,27.49119051,73.69230769,46.03333333,134,27.23577236,268,-53248,15360,-37888,-1
7720,582,21,9,0.0701035895,0.929896411,2371.143056,2687.253211,4177.813601,3802.460481,8302,389.9483326,16604,-3952640,297984,-3654656,-1
6859,1078,21,9,0.135819579,0.864180421,2185.361145,2590.346404,3786.820965,5128.152134,7937,148.9118199,15874,-3511808,551936,-2959872,-1
9350,605,22,8,0.0607734807,0.939226519,2832.887129,3339.265151,5030.936898,4159.884298,9955,959.0558767,19910,-4787200,309760,-4477440,-1
273,31,21,9,0.101973684,0.898026316,85.68177039,87.67626812,158.5714286,99.03225806,304,50.66666667,608,-139776,15872,-123904,-1
9585,394,19,11,0.0394829141,0.960517086,2868.535629,3114.742455,5011.939802,4456.261421,9979,812.6221498,19958,-4907520,201728,-4705792,-1
2722,182,17,13,0.0626721763,0.937327824,820.5555933,981.6313547,1479.942689,1042.065934,2904,257.4468085,5808,-1393664,93184,-1300480,-1
961,77,23,7,0.0741811175,0.925818882,295.3139117,342.6341064,514.301769,584.3766234,1038,84.048583,2076,-492032,39424,-452608,-1
2057,182,21,9,0.0812862885,0.918713711,642.2277116,652.9293512,1139.224113,902.7252747,2239,78.31409584,4478,-1053184,93184,-960000,-1
403,102,20,10,0.201980198,0.798019802,139.9114066,166.9103098,252.0421836,256.7843137,505,26.6350211,1010,-206336,52224,-154112,-1
2096,227,20,10,0.0977184675,0.902281533,661.3354211,746.5438906,1170.10687,1087.145374,2323,61.16377041,4646,-1073152,116224,-956928,-1
46,15,21,9,0.245901639,0.754098361,17.42400458,17.4121286,32.45652174,26.53333333,61,10.99099099,122,-23552,7680,-15872,-1
1487,120,21,9,0.0746733043,0.925326696,454.8207743,486.8992891,826.1620713,529.375,1607,31.01717815,3214,-761344,61440,-699904,-1
2478,445,20,10,0.152240848,0.847759152,821.9901419,883.9632843,1401.725182,1797.642697,2923,64.94112419,5846,-1268736,227840,-1040896,-1
4030,329,20,10,0.0754760266,0.924523973,1245.0685,1405.80335,2170.733995,2293.50152,4359,236.5165491,8718,-2063360,168448,-1894912,-1
9655,336,21,9,0.0336302672,0.966369733,2872.001124,3152.067231,5017.441533,4379.875,9991,1300.911458,19982,-4943360,172032,-4771328,-1
9502,461,20,10,0.0462712035,0.953728797,2871.058647,2913.18195,5011.162176,4380.91757,9963,672.7211344,19926,-4865024,236032,-4628992,-1
868,118,18,12,0.119675456,0.880324544,279.4543319,298.8080252,508.1658986,385.6186441,986,118.5096154,1972,-444416,60416,-384000,-1
4907,436,22,8,0.0816020962,0.918397904,1528.991393,1676.856626,2686.825963,2505.139908,5343,102.7697634,10686,-2512384,223232,-2289152,-1
9103,809,21,9,0.0816182405,0.918381759,2866.406471,2800.605217,4945.10513,5084.716934,9912,514.6417445,19824,-4660736,414208,-4246528,-1
4845,431,19,11,0.0816906748,0.918309325,1504.144343,1658.417498,2677.813829,2196.561485,5276,131.4072229,10552,-2480640,220672,-2259968,-1
2465,314,21,9,0.112990284,0.887009716,794.5564482,853.1072124,1376.888032,1492.933121,2779,92.26427623,5558,-1262080,160768,-1101312,-1
6007,209,19,11,0.0336229086,0.966377091,1787.568777,1944.498433,3121.414683,2737.311005,6216,150.0362056,12432,-3075584,107008,-2968576,-1
664,90,18,12,0.119363395,0.880636605,211.7504911,256.3118194,374.939759,396.3888889,754,62.52072968,1508,-339968,46080,-293888,-1
3551,150,27,3,0.0405295866,0.959470413,1062.773484,1186.784135,1856.264151,1726.38,3701,317.9553265,7402,-1818112,76800,-1741312,-1
3173,223,21,9,0.0656654888,0.934334511,968.7512164,1072.678366,1723.166719,1347.524664,3396,169.6303696,6792,-1624576,114176,-1510400,-1
3758,391,21,9,0.0942395758,0.905760424,1169.956845,1367.095829,2118.971794,1652.375959,4149,256.7450495,8298,-1924096,200192,-1723904,-1
9025,879,19,11,0.0887520194,0.911247981,2822.678015,3207.764006,4945.615069,5023.189989,9904,414.2199916,19808,-4620800,450048,-4170752,-1
236,44,17,13,0.157142857,0.842857143,78.51786281,83.05308904,147.3686441,103.6590909,280,6.034482759,560,-120832,22528,-98304,-1
5618,675,21,9,0.107262037,0.892737963,1784.769677,2062.819001,3146.849413,3148.253333,6293,119.1630373,12586,-2876416,345600,-2530816,-1
3874,298,22,8,0.0714285714,0.928571429,1195.009158,1303.36175,2071.101962,2286.674497,4172,86.80815647,8344,-1983488,152576,-1830912,-1
9615,370,20,10,0.0370555834,0.962944417,2870.119204,3137.147618,5013.877275,4450.472973,9985,773.4314485,19970,-4922880,189440,-4733440,-1
8734,508,22,8,0.0549664575,0.945033543,2632.685135,3163.429694,4653.638539,4068.944882,9242,414.8114901,18484,-4471808,260096,-4211712,-1
6612,698,22,8,0.0954856361,0.904514364,2091.663028,2257.715623,3624.690411,3947.352436,7310,186.4320326,14620,-3385344,357376,-3027968,-1
33,20,16,14,0.377358491,0.622641509,15.66786819,14.16333294,28.81818182,24,53,13.41772152,106,-16896,10240,-6656,-1
9557,419,17,13,0.0420008019,0.957999198,2870.561911,3045.047229,5009.336612,4513.236277,9976,898.7387387,19952,-4893184,214528,-4678656,-1
1790,213,21,9,0.106340489,0.893659511,569.5792401,604.5061303,1027.705028,785.9812207,2003,104.9790356,4006,-916480,109056,-807424,-1
1801,172,20,10,0.087176888,0.912823112,560.2749612,555.9886212,1019.26874,649.1162791,1973,36.88539914,3946,-922112,88064,-834048,-1
1648,280,20,10,0.145228216,0.854771784,548.5657589,600.8755142,960.2020631,989.7964286,1928,49.19622353,3856,-843776,143360,-700416,-1
350,25,19,11,0.0666666667,0.933333333,105.6548701,116.5088426,193.3114286,113.64,375,46.01226994,750,-179200,12800,-166400,-1
4021,314,18,12,0.0724336794,0.927566321,1248.9188,1213.443604,2199.302661,1767.146497,4335,93.24585932,8670,-2058752,160768,-1897984,-1
1245,98,25,5,0.0729709605,0.927029039,380.9363652,433.5288518,684.7518072,510,1343,78.3090379,2686,-637440,50176,-587264,-1
3589,313,20,10,0.0802152742,0.919784726,1113.863948,1260.033564,1956.382279,1895.517572,3902,233.5128665,7804,-1837568,160256,-1677312,-1
1709,102,25,5,0.0563224738,0.943677526,522.8423828,491.8309795,916.1263897,736.3333333,1811,135.960961,3622,-875008,52224,-822784,-1
9375,576,21,9,0.0578836298,0.94211637,2849.789804,3139.483338,5019.027947,4275.675347,9951,903.8147139,19902,-4800000,294912,-4505088,-1
5347,297,17,13,0.0526222537,0.947377746,1615.733337,1757.58842,2854.80288,2240.939394,5644,284.3324937,11288,-2737664,152064,-2585600,-1
2739,190,22,8,0.0648685558,0.935131444,823.8406517,1057.067383,1488.186564,1130.747368,2929,100.8261618,5858,-1402368,97280,-1305088,-1
412,49,25,5,0.106290672,0.893709328,130.0112297,154.2321795,233.9927184,205.8367347,461,43.16479401,922,-210944,25088,-185856,-1
5116,346,20,10,0.0633467594,0.936653241,1555.13502,1763.752045,2771.633112,2138.086705,5462,749.2455418,10924,-2619392,177152,-2442240,-1
9398,565,20,10,0.0567098264,0.943290174,2842.337018,3021.267059,5071.554692,3492.380531,9963,562.8813559,19926,-4811776,289280,-4522496,-1
680,59,21,9,0.0798376184,0.920162382,207.3888985,257.9810348,377.3352941,285.4576271,739,36.72962227,1478,-348160,30208,-317952,-1
8408,657,22,8,0.0724765582,0.927523442,2546.894964,3093.977208,4429.34039,5859.590563,9065,189.2879516,18130,-4304896,336384,-3968512,-1
9325,630,21,9,0.0632847815,0.936715218,2846.631328,3070.454234,5047.443432,3950.126984,9955,919.2059095,19910,-4774400,322560,-4451840,-1
9097,823,21,9,0.0829637097,0.91703629,2821.524746,3235.514902,4907.120589,5550.527339,9920,712.6436782,19840,-4657664,421376,-4236288,-1
9509,466,20,10,0.046716792,0.953283208,2846.676377,3230.882376,5050.24766,3717.800429,9975,1179.078014,19950,-4868608,238592,-4630016,-1
4633,431,21,9,0.0851105845,0.914889415,1439.082117,1617.429918,2575.260522,2072.849188,5064,115.3793575,10128,-2372096,220672,-2151424,-1
9034,489,19,11,0.0513493647,0.948650635,2739.480465,2911.574824,4773.869493,4542.717791,9523,429.1572781,19046,-4625408,250368,-4375040,-1
8973,932,22,8,0.094093892,0.905906108,2838.104153,2890.075898,4854.766856,5898.757511,9905,776.8627451,19810,-4594176,477184,-4116992,-1
7244,2633,20,10,0.266578921,0.733421079,2931.836047,2160.09789,4479.265047,6203.838587,9877,494.0970485,19754,-3708928,1348096,-2360832,-1
2099,411,19,11,0.16374502,0.83625498,704.3083204,757.329768,1199.060505,1543.739659,2510,103.2921811,5020,-1074688,210432,-864256,-1
376,99,18,12,0.208421053,0.791578947,131.8594327,155.0909328,240.6010638,228.1212121,475,49.12099276,950,-192512,50688,-141824,-1
9211,535,21,9,0.0548943156,0.945105684,2775.394797,3146.507163,4800.432092,6131.497196,9746,309.1024421,19492,-4716032,273920,-4442112,-1
3389,337,22,8,0.090445518,0.909554482,1056.263978,1226.212023,1838.779876,2112.094955,3726,129.2403746,7452,-1735168,172544,-1562624,-1
1939,157,21,9,0.0749045802,0.92509542,597.894524,678.3092827,1057.206808,940.9681529,2096,170.4065041,4192,-992768,80384,-912384,-1
8710,1155,22,8,0.117080588,0.882919412,2846.140404,2836.870593,4887.656716,5274.939394,9865,699.6453901,19730,-4459520,591360,-3868160,-1
6518,638,22,8,0.089155953,0.910844047,2017.307968,2425.542206,3519.035133,4186.010972,7156,204.3403769,14312,-3337216,326656,-3010560,-1
8770,410,23,7,0.0446623094,0.955337691,2619.990219,2962.427291,4648.908324,3341.131707,9180,422.4574321,18360,-4490240,209920,-4280320,-1
9571,408,20,10,0.0408858603,0.95911414,2863.949971,3109.61388,5029.261937,4068.980392,9979,304.0524071,19958,-4900352,208896,-4691456,-1
95,35,21,9,0.269230769,0.730769231,37.31166335,37.65510508,67.33684211,60.51428571,130,17.44966443,260,-48640,17920,-30720,-1
6380,315,18,12,0.0470500373,0.952949963,1906.861741,2385.023893,3359.271944,3119.698413,6695,135.9666937,13390,-3266560,161280,-3105280,-1
3437,272,21,9,0.0733351308,0.926664869,1047.975106,1323.910784,1858.343032,1812.757353,3709,129.0086957,7418,-1759744,139264,-1620480,-1
2801,210,25,5,0.069744271,0.930255729,863.7168828,929.5723795,1515.744377,1376.028571,3011,253.6647009,6022,-1434112,107520,-1326592,-1
2994,185,21,9,0.0581944008,0.941805599,901.9072865,962.4236993,1627.01002,991.0378378,3179,160.3126576,6358,-1532928,94720,-1438208,-1
3973,175,27,3,0.0421890068,0.957810993,1193.310929,1283.427539,2078.790335,1977.097143,4148,133.6770867,8296,-2034176,89600,-1944576,-1
9531,437,27,3,0.0438402889,0.956159711,2874.180627,2838.108957,5020.460812,4200.19222,9968,366.066838,19936,-4879872,223744,-4656128,-1
4296,448,22,8,0.0944350759,0.905564924,1351.869307,1469.860731,2331.057495,2769.904018,4744,91.16064566,9488,-2199552,229376,-1970176,-1
2804,168,18,12,0.0565275908,0.943472409,849.4949817,970.3336208,1497.42689,1304.125,2972,235.8730159,5944,-1435648,86016,-1349632,-1
9111,629,20,10,0.0645790554,0.935420945,2814.342577,2730.108099,4902.96817,4400.201908,9740,237.6769156,19480,-4664832,322048,-4342784,-1
4414,731,22,8,0.142079689,0.857920311,1449.209998,1669.651346,2536.543045,2793.138167,5145,98.79032258,10290,-2259968,374272,-1885696,-1
1022,107,17,13,0.0947741364,0.905225864,315.6494213,405.3325975,558.0802348,631.0934579,1129,109.9318403,2258,-523264,54784,-468480,-1
3728,222,20,10,0.0562025316,0.943797468,1121.120332,1423.680683,1976.695011,1955.432432,3950,316.7602245,7900,-1908736,113664,-1795072,-1
43,13,22,8,0.232142857,0.767857143,16.43302615,14.07419057,30.04651163,23.38461538,56,12.5,112,-22016,6656,-15360,-1
9609,379,21,9,0.0379455346,0.962054465,2864.195315,3173.143714,5033.697055,4000.71504,9988,1216.565164,19976,-4919808,194048,-4725760,-1
9471,488,19,11,0.0490009037,0.950999096,2872.099177,2789.648587,5024.862317,4109.321721,9959,664.3762508,19918,-4849152,249856,-4599296,-1
7418,384,21,9,0.0492181492,0.950781851,2223.276067,2731.249027,3884.212456,4235.455729,7802,553.7260468,15604,-3798016,196608,-3601408,-1
2932,274,18,12,0.0854647536,0.914535246,912.3299746,1055.622078,1606.398363,1572.485401,3206,128.496994,6412,-1501184,140288,-1360896,-1
7230,694,22,8,0.0875820293,0.912417971,2272.197508,2440.651319,3965.065975,3935.768012,7924,191.1239749,15848,-3701760,355328,-3346432,-1
9506,462,22,8,0.0463483146,0.953651685,2849.536143,3148.81678,5045.683989,3725.593074,9968,813.7142857,19936,-4867072,236544,-4630528,-1
9612,371,25,5,0.0371631774,0.962836823,2865.120678,3138.050657,5028.868914,4036.787062,9983,931.25,19966,-4921344,189952,-4731392,-1
9260,666,20,10,0.0670965142,0.932903486,2845.156828,2889.641039,5047.635205,3793.692192,9926,834.1176471,19852,-4741120,340992,-4400128,-1
1464,69,20,10,0.0450097847,0.954990215,437.7813486,501.8611662,775.3463115,589.9130435,1533,258.0808081,3066,-749568,35328,-714240,-1
291,89,20,10,0.234210526,0.765789474,100.0582309,133.1862396,182.4501718,216.8202247,380,6.860444123,760,-148992,45568,-103424,-1
3830,270,20,10,0.0658536585,0.934146341,1154.377633,1538.073629,2054.377285,1995.5,4100,309.4339623,8200,-1960960,138240,-1822720,-1
5934,583,25,5,0.0894583397,0.91054166,1853.470544,2075.552851,3309.407651,2745.931389,6517,164.6954764,13034,-3038208,298496,-2739712,-1
4363,356,20,10,0.0754397118,0.924560288,1331.459776,1619.859519,2320.885629,2839.370787,4719,259.2857143,9438,-2233856,182272,-2051584,-1
2958,656,20,10,0.181516325,0.818483675,956.7972706,1166.78917,1664.652806,2451.618902,3614,118.0659915,7228,-1514496,335872,-1178624,-1
677,81,23,7,0.106860158,0.893139842,212.2603245,267.1554494,380.7710487,368.8765432,758,32.42087254,1516,-346624,41472,-305152,-1
4438,369,22,8,0.0767630539,0.923236946,1373.260477,1548.807459,2398.35489,2471.894309,4807,106.7036626,9614,-2272256,188928,-2083328,-1
9539,431,24,6,0.0432296891,0.956770311,2859.535161,3064.253878,5034.914247,3891.851508,9970,1006.05449,19940,-4883968,220672,-4663296,-1
4585,232,23,7,0.0481627569,0.951837243,1373.456318,1684.779388,2417.374482,2243.49569,4817,382.90938,9634,-2347520,118784,-2228736,-1
1970,337,19,11,0.146077156,0.853922844,652.5143539,732.3950809,1137.530964,1250.272997,2307,110.966811,4614,-1008640,172544,-836096,-1
4441,367,25,5,0.0763311148,0.923668885,1379.204657,1410.991641,2442.452376,1945.245232,4808,260.3140227,9616,-2273792,187904,-2085888,-1
9568,411,20,10,0.0411864916,0.958813508,2877.611016,2907.389208,5011.368416,4492.547445,9979,966.0212972,19958,-4898816,210432,-4688384,-1
461,79,16,14,0.146296296,0.853703704,150.6684012,174.2404774,279.5553145,217.6582278,540,38.27072998,1080,-236032,40448,-195584,-1
9325,628,21,9,0.0630965538,0.936903446,2852.732471,3061.260043,5028.438713,4213.200637,9953,1025.025747,19906,-4774400,321536,-4452864,-1
2127,175,21,9,0.0760208514,0.923979149,658.0912874,734.8309195,1145.834979,1220.354286,2302,138.2582583,4604,-1089024,89600,-999424,-1
7545,525,21,9,0.0650557621,0.934944238,2297.501316,2746.821178,4044.299536,3909.038095,8070,291.1255411,16140,-3863040,268800,-3594240,-1
647,62,21,9,0.0874471086,0.912552891,200.0798162,202.9622843,367.9737249,219.6129032,709,68.90184645,1418,-331264,31744,-299520,-1
4148,444,22,8,0.0966898955,0.903310105,1332.304142,1242.033999,2274.213356,2504.709459,4592,94.07908216,9184,-2123776,227328,-1896448,-1
9490,475,20,10,0.0476668339,0.952333166,2857.715307,3138.09694,5020.723815,4229.317895,9965,1202.050663,19930,-4858880,243200,-4615680,-1
2120,168,24,6,0.0734265734,0.926573427,647.4182773,805.7892831,1148.441038,1094.767857,2288,58.3971414,4576,-1085440,86016,-999424,-1
354,49,22,8,0.121588089,0.878411911,113.7884519,127.0744239,207.2231638,164.2653061,403,34.89177489,806,-181248,25088,-156160,-1
106,15,21,9,0.123966942,0.876033058,33.97857182,18.91548454,65.82075472,26.93333333,121,21.64579606,242,-54272,7680,-46592,-1
32,22,16,14,0.407407407,0.592592593,15.26200219,15.95344467,28.40625,26.18181818,54,11.86813187,108,-16384,11264,-5120,-1
2088,512,20,10,0.196923077,0.803076923,743.3799158,697.0383348,1224.002874,1612.464844,2600,60.90419302,5200,-1069056,262144,-806912,-1
110,43,21,9,0.281045752,0.718954248,44.20862356,43.67630082,78.91818182,72.09302326,153,2.861417617,306,-56320,22016,-34304,-1
1485,121,22,8,0.0753424658,0.924657534,461.4738677,397.6372065,825.8127946,529.661157,1606,71.31438721,3212,-760320,61952,-698368,-1
58,16,23,7,0.216216216,0.783783784,22.12507012,16.90599006,39.22413793,31.25,74,2.182247125,148,-29696,8192,-21504,-1
452,101,19,11,0.182640145,0.817359855,153.010704,163.2897024,295.1725664,195.6732673,553,72.76315789,1106,-231424,51712,-179712,-1
9477,488,20,10,0.0489713999,0.9510286,2879.845678,2770.675905,5007.649573,4504.303279,9965,1122.184685,19930,-4852224,249856,-4602368,-1
1459,167,20,10,0.102706027,0.897293973,459.6097617,546.6887665,816.5620288,786.748503,1626,54.58207452,3252,-747008,85504,-661504,-1
6472,466,19,11,0.0671663304,0.93283367,1991.439659,1979.245871,3528.74042,2646.744635,6938,175.9127789,13876,-3313664,238592,-3075072,-1
1095,120,25,5,0.0987654321,0.901234568,343.5751679,409.699644,610.4611872,585.5416667,1215,183.5347432,2430,-560640,61440,-499200,-1
6401,327,22,8,0.0486028537,0.951397146,1913.101528,2439.85353,3358.248711,3486.868502,6728,143.8836612,13456,-3277312,167424,-3109888,-1
3392,289,20,10,0.0785112741,0.921488726,1042.043432,1278.589514,1836.929835,1888.771626,3681,134.8845731,7362,-1736704,147968,-1588736,-1
886,69,21,9,0.0722513089,0.927748691,271.7042959,318.8081663,474.3713318,524.5942029,955,72.95645531,1910,-453632,35328,-418304,-1
6454,885,20,10,0.120588636,0.879411364,2049.278666,2473.792277,3581.340409,4316.563842,7339,205,14678,-3304448,453120,-2851328,-1
9476,483,21,9,0.0484988453,0.951501155,2867.234771,2949.901213,5012.546961,4341.459627,9959,982.1499014,19918,-4851712,247296,-4604416,-1
4727,492,21,9,0.0942709331,0.905729067,1482.110796,1721.890752,2601.144489,2695.081301,5219,154.0436836,10438,-2420224,251904,-2168320,-1
688,49,22,8,0.0664857531,0.933514247,208.4079025,207.0992696,380.5290698,207.122449,737,106.1959654,1474,-352256,25088,-327168,-1
4161,557,20,10,0.118058499,0.881941501,1358.682747,1381.564605,2345.14708,2466.721724,4718,125.4453603,9436,-2130432,285184,-1845248,-1
7336,494,22,8,0.0630906769,0.936909323,2238.811906,2523.585927,3887.997955,4323.910931,7830,223.6503856,15660,-3756032,252928,-3503104,-1
9427,533,24,6,0.0535140562,0.946485944,2860.776133,2917.406992,5041.238358,3906.24015,9960,702.3977433,19920,-4826624,272896,-4553728,-1
523,67,20,10,0.113559322,0.886440678,164.8659179,207.5593225,297.1739962,282.4328358,590,55.87121212,1180,-267776,34304,-233472,-1
7645,670,20,10,0.08057727,0.91942273,2363.192586,2765.368505,4188.658862,3808.168657,8315,238.252149,16630,-3914240,343040,-3571200,-1
303,55,19,11,0.153631285,0.846368715,101.5430691,93.05096799,190.1353135,120.9090909,358,60.26936027,716,-155136,28160,-126976,-1
9402,556,25,5,0.0558345049,0.944165495,2834.432054,3435.086857,5013.207084,4409.510791,9958,458.4714549,19916,-4813824,284672,-4529152,-1
3006,213,21,9,0.0661696179,0.933830382,917.2540627,1041.28955,1630.734198,1317.384977,3219,254.6677215,6438,-1539072,109056,-1430016,-1
9536,437,17,13,0.0438183094,0.956181691,2869.064114,2955.041101,5027.005243,4114.025172,9973,1080.498375,19946,-4882432,223744,-4658688,-1
9559,416,20,10,0.0417042607,0.958295739,2865.357924,3072.995089,5024.144994,4157.447115,9975,1073.735199,19950,-4894208,212992,-4681216,-1
2739,168,20,10,0.0577915377,0.942208462,826.4455659,995.3326372,1439.500913,1690.386905,2907,215.0147929,5814,-1402368,86016,-1316352,-1
5105,403,22,8,0.0731663036,0.926833696,1576.239635,1669.61443,2795.664447,2233.049628,5508,349.7142857,11016,-2613760,206336,-2407424,-1
9329,630,21,9,0.0632593634,0.936740637,2830.915624,3456.632176,4967.865795,5159.68254,9959,451.4505893,19918,-4776448,322560,-4453888,-1
5082,399,20,10,0.0727969349,0.927203065,1562.867432,1806.376373,2731.430146,2862.889724,5481,164.7925436,10962,-2601984,204288,-2397696,-1
2566,158,20,10,0.0580029369,0.941997063,773.3832591,815.0203567,1394.268122,846.5696203,2724,394.211288,5448,-1313792,80896,-1232896,-1
1503,81,25,5,0.0511363636,0.948863636,453.8164979,516.5249773,793.7045908,770.1481481,1584,70.3374778,3168,-769536,41472,-728064,-1
849,114,27,3,0.118380062,0.881619938,270.5326046,328.0722302,480.5641932,492.6929825,963,18,1926,-434688,58368,-376320,-1
5151,622,21,9,0.107742941,0.892257059,1658.659317,1726.277133,2900.381285,2776.184887,5773,305.4497354,11546,-2637312,318464,-2318848,-1
9035,875,21,9,0.0882946519,0.911705348,2846.557887,2972.595161,4995.302601,4544.509714,9910,458.3718779,19820,-4625920,448000,-4177920,-1
8926,556,27,3,0.0586374183,0.941362582,2714.088474,2899.154869,4805.213758,3718.642086,9482,329.3504689,18964,-4570112,284672,-4285440,-1
9441,515,22,8,0.0517276014,0.948272399,2851.022437,3153.649523,5023.929351,4145.687379,9956,1085.714286,19912,-4833792,263680,-4570112,-1
50,15,21,9,0.230769231,0.769230769,18.69592469,16.80661246,35.32,25.26666667,65,3.038803179,130,-25600,7680,-17920,-1
3914,286,25,5,0.0680952381,0.931904762,1198.617405,1361.608558,2119.423097,1841.531469,4200,272.0207254,8400,-2003968,146432,-1857536,-1
2914,289,17,13,0.0902279113,0.909772089,902.1037742,1120.99932,1612.843171,1492.66782,3203,206.9121447,6406,-1491968,147968,-1344000,-1
9135,764,22,8,0.0771795131,0.922820487,2868.709858,2712.603773,4967.348112,4742.57199,9899,648.2645711,19798,-4677120,391168,-4285952,-1
3428,213,20,10,0.058500412,0.941499588,1049.584333,1068.182663,1828.088098,1706.924883,3641,91.66666667,7282,-1755136,109056,-1646080,-1
869,100,17,13,0.103199174,0.896800826,274.2021901,237.8558353,508.9401611,276.96,969,101.4659686,1938,-444928,51200,-393728,-1
6110,304,24,6,0.0473963205,0.952603679,1839.104175,2037.493839,3229.272177,2769.907895,6414,169.9523052,12828,-3128320,155648,-2972672,-1
6701,523,21,9,0.0723975637,0.927602436,2061.034403,2342.083089,3642.320549,3230.42065,7224,179.8804781,14448,-3430912,267776,-3163136,-1
4716,360,20,10,0.0709219858,0.929078014,1449.691515,1525.805964,2585.938295,1917.058333,5076,130.0204918,10152,-2414592,184320,-2230272,-1
1880,243,19,11,0.114460669,0.885539331,595.134823,729.7702317,1050.681383,1149.567901,2123,40.63157895,4246,-962560,124416,-838144,-1
4988,235,19,11,0.0449932989,0.955006701,1497.893463,1694.180536,2620.221532,2437.493617,5223,131.7276166,10446,-2553856,120320,-2433536,-1
4027,194,21,9,0.0459606728,0.954039327,1213.539783,1294.74234,2122.397815,1874.407216,4221,525.6537983,8442,-2061824,99328,-1962496,-1
4410,302,22,8,0.0640916808,0.935908319,1339.901746,1623.531365,2364.932653,2233.360927,4712,215.2581087,9424,-2257920,154624,-2103296,-1
9550,420,20,10,0.0421263791,0.957873621,2859.894893,3198.821957,5013.561047,4347.445238,9970,805.3311793,19940,-4889600,215040,-4674560,-1
131,27,19,11,0.170886076,0.829113924,44.89074332,31.38390106,86.54961832,45.2962963,158,37.26415094,316,-67072,13824,-53248,-1
1296,128,20,10,0.0898876404,0.91011236,412.6439499,394.1071563,714.7322531,689.8984375,1424,80.49745619,2848,-663552,65536,-598016,-1
3931,288,20,10,0.0682626215,0.931737379,1199.159216,1345.454788,2148.216993,1588.364583,4219,131.2286159,8438,-2012672,147456,-1865216,-1
282,66,18,12,0.189655172,0.810344828,97.98056516,106.8458217,180.3723404,149.4090909,348,24.35269419,696,-144384,33792,-110592,-1
8466,1322,22,8,0.135063343,0.864936657,2780.667435,2823.168726,4709.377156,6080.014372,9788,281.5070463,19576,-4334592,676864,-3657728,-1
3063,445,22,8,0.126852908,0.873147092,999.543679,999.8835394,1692.649363,2180.226966,3508,138.0015736,7016,-1568256,227840,-1340416,-1
9453,507,19,11,0.0509036145,0.949096386,2857.517147,3045.890698,5029.512007,4066.672584,9960,255.5156491,19920,-4839936,259584,-4580352,-1
4043,258,27,3,0.0599860498,0.94001395,1214.124756,1599.87611,2163.209251,1959.674419,4301,396.40553,8602,-2070016,132096,-1937920,-1
9576,402,22,8,0.040288635,0.959711365,2868.736754,3105.754038,5009.994465,4501.303483,9978,883.7909655,19956,-4902912,205824,-4697088,-1
9461,502,16,14,0.0503864298,0.94961357,2870.558548,2950.14002,5003.028961,4585.675299,9963,897.5675676,19926,-4844032,257024,-4587008,-1
9145,775,20,10,0.078125,0.921875,2821.686534,2825.716714,5102.172881,3288.76,9920,338.5665529,19840,-4682240,396800,-4285440,-1
9478,490,19,11,0.0491573034,0.950842697,2850.677273,3205.959812,5034.287402,4021.469388,9968,574.8558247,19936,-4852736,250880,-4601856,-1
4659,652,19,11,0.122764075,0.877235925,1537.924969,1489.051858,2678.157545,2497.668712,5311,129.5681874,10622,-2385408,333824,-2051584,-1
9377,582,21,9,0.0584396024,0.941560398,2861.812966,3076.700439,4986.056841,4882.414089,9959,541.25,19918,-4801024,297984,-4503040,-1
50,28,18,12,0.358974359,0.641025641,24.15003934,18.6398465,41.66,35.64285714,78,21.6066482,156,-25600,14336,-11264,-1
9464,498,21,9,0.0499899619,0.950010038,2868.998865,2825.664179,5033.457101,3994.106426,9962,765.7186779,19924,-4845568,254976,-4590592,-1
53,11,20,10,0.171875,0.828125,18.12285514,12.46681546,35.47169811,18.18181818,64,5.405405405,128,-27136,5632,-21504,-1
5164,354,22,8,0.0641536789,0.935846321,1568.539116,1890.802838,2740.037761,3043.40678,5518,138.0535402,11036,-2643968,181248,-2462720,-1
5552,350,22,8,0.0593019315,0.940698068,1673.358328,2039.243422,2914.159942,3543.82,5902,224.7524752,11804,-2842624,179200,-2663424,-1
560,47,17,13,0.0774299835,0.922570016,170.7929453,194.2776734,312.5446429,202.1914894,607,47.68263943,1214,-286720,24064,-262656,-1
72,19,20,10,0.208791209,0.791208791,24.08607251,32.15147666,48,38.42105263,91,8.593012276,182,-36864,9728,-27136,-1
6770,976,20,10,0.126000516,0.873999484,2219.428912,2303.90802,3812.241359,4298.419057,7746,164.2841994,15492,-3466240,499712,-2966528,-1
6773,462,17,13,0.0638562543,0.936143746,2069.703799,2343.811044,3626.957921,3486.675325,7235,254.4846993,14470,-3467776,236544,-3231232,-1
107,22,19,11,0.170542636,0.829457364,35.04281847,44.63812254,67.41121495,53.27272727,129,20.87378641,258,-54784,11264,-43520,-1
6105,394,19,11,0.0606247115,0.939375289,1860.367048,2102.026262,3256.879443,3143.403553,6499,302.4197301,12998,-3125760,201728,-2924032,-1
1143,182,22,8,0.137358491,0.862641509,379.1834818,361.9521862,689.0936133,499.1263736,1325,97.35488611,2650,-585216,93184,-492032,-1
5385,420,18,12,0.0723514212,0.927648579,1668.278382,1755.653461,2886.785701,3110.890476,5805,159.7853014,11610,-2757120,215040,-2542080,-1
9483,481,20,10,0.0482737856,0.951726214,2857.615805,2975.012055,5043.938522,3771.22869,9964,580.314502,19928,-4855296,246272,-4609024,-1
8804,711,22,8,0.0747241198,0.92527588,2725.602541,2916.642177,4811.277828,4098.284107,9515,177.320164,19030,-4507648,364032,-4143616,-1
105,25,21,9,0.192307692,0.807692308,37.1012172,32.95660177,70.06666667,46.32,130,25.3411306,260,-53760,12800,-40960,-1
3285,195,22,8,0.0560344828,0.943965517,994.1817325,985.5001485,1776.444749,1134.969231,3480,64.20664207,6960,-1681920,99840,-1582080,-1
1278,139,18,12,0.098094566,0.901905434,406.0225573,427.955978,717.5704225,630.2014388,1417,41.38434579,2834,-654336,71168,-583168,-1
3089,227,27,3,0.068455971,0.931544029,949.1680866,963.6703565,1689.999676,1229.854626,3316,171.5468184,6632,-1581568,116224,-1465344,-1
4191,499,16,14,0.106396588,0.893603412,1329.986719,1530.869413,2364.392746,2186.823647,4690,98.30224272,9380,-2145792,255488,-1890304,-1
101,38,22,8,0.273381295,0.726618705,39.49824504,41.71474327,70.5049505,68.65789474,139,26.57743786,278,-51712,19456,-32256,-1
4392,595,18,12,0.119310207,0.880689793,1402.84314,1478.755208,2390.910747,3254.954622,4987,94.29003592,9974,-2248704,304640,-1944064,-1
821,78,21,9,0.0867630701,0.91323693,259.3571616,260.7852594,451.3580999,435.7051282,899,49.04528096,1798,-420352,39936,-380416,-1
9090,826,20,10,0.0832997176,0.916700282,2835.00371,3147.930852,4966.586359,4869.510896,9916,271.6712329,19832,-4654080,422912,-4231168,-1
6496,1968,18,12,0.232514178,0.767485822,2109.577183,2371.552074,3617.939347,6261.049797,8464,177.5912715,16928,-3325952,1007616,-2318336,-1
529,78,19,11,0.128500824,0.871499176,170.1921836,202.6218228,309.2230624,268.5769231,607,11.23865951,1214,-270848,39936,-230912,-1
5490,576,21,9,0.0949554896,0.90504451,1726.91947,1947.534073,3006.134791,3294.324653,6066,216.4109882,12132,-2810880,294912,-2515968,-1
9212,726,20,10,0.0730529282,0.926947072,2811.644338,3469.086348,5012.374837,4425.473829,9938,484.0720896,19876,-4716544,371712,-4344832,-1
9403,527,27,3,0.0530715005,0.946928499,2842.137033,3257.160862,4982.222057,4667.136622,9930,1180.737218,19860,-4814336,269824,-4544512,-1
1931,148,21,9,0.0711880712,0.928811929,596.0448813,645.5574115,1046.438633,955.9932432,2079,54.91283677,4158,-988672,75776,-912896,-1
9572,401,19,11,0.0402085631,0.959791437,2853.505928,3201.655238,5037.607292,3778.987531,9973,1003.31992,19946,-4900864,205312,-4695552,-1
5629,443,20,10,0.0729578393,0.927042161,1731.911627,1982.954038,3016.914017,3285.370203,6072,127.8584965,12144,-2882048,226816,-2655232,-1
1154,148,20,10,0.113671275,0.886328725,363.4200337,449.1981292,638.7409012,750.9864865,1302,71.61716172,2604,-590848,75776,-515072,-1
9485,475,22,8,0.0476907631,0.952309237,2865.672476,2843.823273,5035.62098,3879.821053,9960,712.4463519,19920,-4856320,243200,-4613120,-1
1854,125,27,3,0.0631632137,0.936836786,565.8013392,632.8960588,981.1607335,1121.104,1979,58.08629293,3958,-949248,64000,-885248,-1
3485,202,18,12,0.0547870898,0.94521291,1060.78374,1083.403074,1860.87231,1552.910891,3687,376.993865,7374,-1784320,103424,-1680896,-1
4549,341,27,3,0.0697341513,0.930265849,1398.563024,1386.575044,2499.586503,1723.97654,4890,259.8299681,9780,-2329088,174592,-2154496,-1
9188,746,16,14,0.0750956312,0.924904369,2866.71708,2745.234984,5035.425446,4130.906166,9934,1111.185682,19868,-4704256,381952,-4322304,-1
1390,165,22,8,0.106109325,0.893890675,438.5894509,504.520815,795.3755396,631.6242424,1555,28.60033106,3110,-711680,84480,-627200,-1
2234,108,19,11,0.0461144321,0.953885568,667.9493374,804.4361692,1180.449418,986.3796296,2342,132.54103,4684,-1143808,55296,-1088512,-1
112,16,23,7,0.125,0.875,35.6302225,37.10963487,67.92857143,40.5,128,10.7472712,256,-57344,8192,-49152,-1
4493,293,17,13,0.0612202257,0.938779774,1366.242205,1595.330227,2400.075228,2292.672355,4786,254.5744681,9572,-2300416,150016,-2150400,-1
3921,499,25,5,0.112895928,0.887104072,1256.71918,1400.426801,2183.850293,2419.905812,4420,164.3122677,8840,-2007552,255488,-1752064,-1
117,9,26,4,0.0714285714,0.928571429,34.97902276,51.04488463,63.72649573,60.55555556,126,13.74045802,252,-59904,4608,-55296,-1
9532,431,19,11,0.0432600622,0.956739938,2861.191333,3154.670962,5002.159148,4536.160093,9963,811.3192182,19926,-4880384,220672,-4659712,-1
9469,497,22,8,0.0498695565,0.950130444,2848.996522,3118.116454,5048.258,3749.710262,9966,846.728972,19932,-4848128,254464,-4593664,-1
7594,437,22,8,0.0544141452,0.945585855,2298.696809,2364.556025,4081.268501,2881.791762,8031,451.1797753,16062,-3888128,223744,-3664384,-1
1837,125,21,9,0.0637104995,0.936289501,559.5960494,657.970939,982.2406097,970.616,1962,57.25124015,3924,-940544,64000,-876544,-1
32,20,18,12,0.384615385,0.615384615,15.30672723,14.28101887,27.78125,24.45,52,8.049535604,104,-16384,10240,-6144,-1
4891,702,22,8,0.125514035,0.874485965,1558.646402,1904.065708,2734.403803,3233.122507,5593,108.0981832,11186,-2504192,359424,-2144768,-1
7514,600,22,8,0.0739462657,0.926053734,2297.484286,2669.329716,3981.986425,5003.181667,8114,203.8181361,16228,-3847168,307200,-3539968,-1
528,89,16,14,0.144246353,0.855753647,170.5811091,208.3116129,318.75,251.1573034,617,57.77153558,1234,-270336,45568,-224768,-1
4522,358,20,10,0.0733606557,0.926639344,1394.367864,1552.775655,2462.336577,2164.675978,4880,91.76382099,9760,-2315264,183296,-2131968,-1
9346,594,24,6,0.0597585513,0.940241449,2836.684955,3140.862118,5040.997646,3861.289562,9940,713.0559541,19880,-4785152,304128,-4481024,-1
9389,559,21,9,0.0561921994,0.943807801,2852.495369,3141.186021,5002.247417,4508.452594,9948,600.3621002,19896,-4807168,286208,-4520960,-1
3432,287,16,14,0.0771712826,0.922828717,1067.544947,1125.069266,1843.656177,2055.442509,3719,225.5306246,7438,-1757184,146944,-1610240,-1
3498,164,21,9,0.0447842709,0.955215729,1042.973718,1222.722061,1854.707261,1336.506098,3662,245.2779638,7324,-1790976,83968,-1707008,-1
1975,158,21,9,0.0740740741,0.925925926,601.9974898,754.1953828,1056.229367,1201.632911,2133,82.03846154,4266,-1011200,80896,-930304,-1
4149,339,21,9,0.0755347594,0.924465241,1283.923298,1424.941387,2254.396481,2123.377581,4488,154.4390915,8976,-2124288,173568,-1950720,-1
4569,269,26,4,0.0556014882,0.944398512,1386.380961,1553.295233,2427.855767,2277.576208,4838,133.0217212,9676,-2339328,137728,-2201600,-1
8971,513,17,13,0.0540911008,0.945908899,2702.128275,3026.551275,4815.619329,3463.838207,9484,360.3343465,18968,-4593152,262656,-4330496,-1
197,18,23,7,0.0837209302,0.91627907,59.77670363,81.22520514,109.5279188,91.27777778,215,44.51345756,430,-100864,9216,-91648,-1
4735,365,20,10,0.0715686275,0.928431373,1437.375726,1853.988536,2534.516156,2757.852055,5100,440.4145078,10200,-2424320,186880,-2237440,-1
3280,351,21,9,0.0966675847,0.903332415,1024.131531,1250.659767,1817.512195,1801.868946,3631,131.7489115,7262,-1679360,179712,-1499648,-1
5065,445,21,9,0.0807622505,0.91923775,1585.868874,1640.220303,2764.228233,2656.155056,5510,219.4344883,11020,-2593280,227840,-2365440,-1
7934,364,20,10,0.0438659918,0.956134008,2375.41102,2729.289404,4176.802622,3554.392857,8298,277.1543086,16596,-4062208,186368,-3875840,-1
2071,130,27,3,0.0590640618,0.940935938,629.242097,666.3770942,1118.560599,821.2461538,2201,120.8676551,4402,-1060352,66560,-993792,-1
1604,144,18,12,0.0823798627,0.917620137,493.1108403,583.2192302,892.1683292,677.6944444,1748,133.1302361,3496,-821248,73728,-747520,-1
2262,354,27,3,0.135321101,0.864678899,761.4657681,712.5703029,1302.755084,1345.20904,2616,66.78580546,5232,-1158144,181248,-976896,-1
9379,587,21,9,0.0589002609,0.941099739,2832.858784,3183.158839,5072.846146,3555.940375,9966,235.0471698,19932,-4802048,300544,-4501504,-1
310,31,16,14,0.0909090909,0.909090909,93.78674134,93.07243775,180.5193548,75.80645161,341,84.40594059,682,-158720,15872,-142848,-1
6123,601,21,9,0.0893813206,0.910618679,1901.943161,2269.07908,3326.204965,3732.274542,6724,123.9218577,13448,-3134976,307712,-2827264,-1
5678,311,21,9,0.0519285356,0.948071464,1709.919135,2002.192818,3017.012504,2593.11254,5989,142.9696825,11978,-2907136,159232,-2747904,-1
1371,89,18,12,0.0609589041,0.939041096,415.4577189,454.3347029,744.3778264,516.7191011,1460,172.1698113,2920,-701952,45568,-656384,-1
358,60,21,9,0.14354067,0.85645933,115.4453737,137.0250372,218.1899441,157.65,418,54.49804433,836,-183296,30720,-152576,-1
9513,460,22,8,0.0461245362,0.953875464,2854.278313,3017.118501,5055.624093,3567.823913,9973,928.58473,19946,-4870656,235520,-4635136,-1
4099,270,22,8,0.0617990387,0.938200961,1246.643992,1459.276493,2193.122713,2061.685185,4369,229.584866,8738,-2098688,138240,-1960448,-1
282,44,20,10,0.134969325,0.865030675,91.5358769,104.9487749,167.858156,135.5681818,326,25.60879811,652,-144384,22528,-121856,-1
7812,486,22,8,0.0585683297,0.94143167,2382.262486,2347.196451,4216.708141,3069.191358,8298,212.0081758,16596,-3999744,248832,-3750912,-1
466,100,16,14,0.176678445,0.823321555,155.5169798,174.9937427,300.667382,203.5,566,70.31055901,1132,-238592,51200,-187392,-1
38,18,20,10,0.321428571,0.678571429,14.80519861,18.6993761,28.73684211,28,56,5.64516129,112,-19456,9216,-10240,-1
4648,362,17,13,0.072255489,0.927744511,1446.1207,1368.832248,2540.943632,2050.411602,5010,134.8223897,10020,-2379776,185344,-2194432,-1
2172,338,23,7,0.134661355,0.865338645,715.0708708,760.4297365,1228.543738,1428.721893,2510,47.00374532,5020,-1112064,173056,-939008,-1
69,26,19,11,0.273684211,0.726315789,28.39079018,23.06384245,50.8115942,40.53846154,95,23.28431373,190,-35328,13312,-22016,-1
379,63,17,13,0.142533937,0.857466063,126.7687237,130.1482923,225.2849604,198.7301587,442,38.50174216,884,-194048,32256,-161792,-1
3187,393,19,11,0.109776536,0.890223464,1027.602768,1058.773087,1815.148102,1590.618321,3580,89.97235486,7160,-1631744,201216,-1430528,-1
9528,435,21,9,0.0436615477,0.956338452,2847.965957,3411.367942,4999.745172,4593.31954,9963,785.7255521,19926,-4878336,222720,-4655616,-1
5942,373,20,10,0.0590657165,0.940934283,1793.292558,2203.731109,3183.638169,2749.576408,6315,416.2821358,12630,-3042304,190976,-2851328,-1
9089,826,21,9,0.083308119,0.916691881,2800.477813,3304.228589,4865.869403,5971.771186,9915,741.5856395,19830,-4653568,422912,-4230656,-1
66,36,18,12,0.352941176,0.647058824,29.46517843,29.20008667,53.01515152,48.72222222,102,1.869501466,204,-33792,18432,-15360,-1
4086,245,20,10,0.0565689217,0.943431078,1237.920787,1338.71104,2196.965247,1649.57551,4331,271.1959925,8662,-2092032,125440,-1966592,-1
4715,337,22,8,0.0667062549,0.933293745,1453.568556,1438.051251,2561.38176,2038.465875,5052,349.1361437,10104,-2414080,172544,-2241536,-1
1114,119,18,12,0.096512571,0.903487429,343.6152036,446.745199,625.9658887,533.0672269,1233,85.92334495,2466,-570368,60928,-509440,-1
9467,512,21,9,0.0513077463,0.948692254,2878.146811,2924.100645,4997.207246,4856.736328,9979,930.0093197,19958,-4847104,262144,-4584960,-1
1491,166,19,11,0.10018105,0.89981895,470.2669778,534.5283238,840.4828974,725.8614458,1657,217.1690695,3314,-763392,84992,-678400,-1
4700,1378,24,6,0.226719316,0.773280684,1581.514172,1842.83385,2708.165319,4169.596517,6078,338.6072423,12156,-2406400,705536,-1700864,-1
7738,899,21,9,0.104087067,0.895912933,2510.071049,2343.68177,4315.838976,4346.208009,8637,191.5502329,17274,-3961856,460288,-3501568,-1
9252,696,20,10,0.0699638118,0.930036188,2828.336308,3124.005955,5071.189148,3689.201149,9948,906.8368277,19896,-4737024,356352,-4380672,-1
9555,423,20,10,0.0423932652,0.957606735,2875.183753,2979.801914,5002.902983,4686.744681,9978,658.6138614,19956,-4892160,216576,-4675584,-1
2363,296,18,12,0.111320045,0.888679955,753.1350187,854.0389078,1352.173085,1152.989865,2659,160.8590442,5318,-1209856,151552,-1058304,-1
2752,152,20,10,0.0523415978,0.947658402,830.0708869,929.4612686,1468.433866,1164.013158,2904,488.0672269,5808,-1409024,77824,-1331200,-1
9520,464,20,10,0.046474359,0.953525641,2866.660124,3040.62977,5037.304097,4073.243534,9984,868.9295039,19968,-4874240,237568,-4636672,-1
431,40,22,8,0.08492569,0.91507431,132.7819378,153.8601232,241.638051,175.25,471,12.04603581,942,-220672,20480,-200192,-1
6772,399,21,9,0.0556407753,0.944359225,2061.169765,2177.894833,3609.430744,3188.323308,7171,151.478665,14342,-3467264,204288,-3262976,-1
9522,449,20,10,0.0450305887,0.954969411,2861.325059,3195.764443,5003.733459,4609.924276,9971,800.8835341,19942,-4875264,229888,-4645376,-1
5691,401,25,5,0.0658240315,0.934175968,1753.115309,1831.979418,3053.428044,2948.177057,6092,150.271337,12184,-2913792,205312,-2708480,-1
9399,559,22,8,0.0561357702,0.94386423,2842.981144,3233.494761,5032.780296,4083.647585,9958,958.4215592,19916,-4812288,286208,-4526080,-1
1477,192,19,11,0.115038945,0.884961055,464.4136957,579.0542903,816.3053487,978.8125,1669,61.20278695,3338,-756224,98304,-657920,-1
2810,152,20,10,0.0513166779,0.948683322,847.5635555,979.4839209,1486.079359,1396.842105,2962,157.637041,5924,-1438720,77824,-1360896,-1
3449,326,16,14,0.0863576159,0.913642384,1059.120717,1371.103329,1882.330821,1947.978528,3775,128.883578,7550,-1765888,166912,-1598976,-1
4382,213,21,9,0.0463547334,0.953645267,1308.577126,1544.334243,2325.844135,1725.169014,4595,441.8269231,9190,-2243584,109056,-2134528,-1
9438,523,22,8,0.0525047686,0.947495231,2863.179555,2895.843554,5039.038038,3933.652008,9961,985.2621167,19922,-4832256,267776,-4564480,-1
9523,444,20,10,0.0445470051,0.955452995,2865.236734,3035.880094,5017.440092,4266.77027,9967,1135.193622,19934,-4875776,227328,-4648448,-1
2080,149,17,13,0.0668461193,0.933153881,630.7188553,788.1441141,1124.647596,980.3221477,2229,227.2171254,4458,-1064960,76288,-988672,-1
1389,150,27,3,0.0974658869,0.902534113,439.4361151,484.9447375,774.3153348,730.04,1539,49.20076726,3078,-711168,76800,-634368,-1
3198,202,21,9,0.0594117647,0.940588235,966.9996783,1131.082611,1722.684803,1349.277228,3400,369.9673558,6800,-1637376,103424,-1533952,-1
1763,163,17,13,0.0846313603,0.91536864,541.3655392,694.5799087,962.137266,978.2392638,1926,287.4626866,3852,-902656,83456,-819200,-1
2007,217,27,3,0.0975719424,0.902428058,638.3771874,612.4383686,1141.580468,843.5391705,2224,71.88106012,4448,-1027584,111104,-916480,-1
1781,152,25,5,0.0786342473,0.921365753,557.2194669,562.2085602,973.1370017,895.0921053,1933,158.9638158,3866,-911872,77824,-834048,-1
5576,368,21,9,0.0619111709,0.938088829,1702.321569,1784.592335,3015.947095,2314.182065,5944,502.027027,11888,-2854912,188416,-2666496,-1
1067,93,21,9,0.0801724138,0.919827586,334.2671837,340.8467363,578.5735708,602.6021505,1160,69.00654372,2320,-546304,47616,-498688,-1
3587,186,20,10,0.0492976411,0.950702359,1082.253389,1175.70223,1902.477279,1588.521505,3773,320.2886248,7546,-1836544,95232,-1741312,-1
8550,1312,20,10,0.133035895,0.866964105,2818.30221,2999.084888,4873.15848,5311.698171,9862,325.9087905,19724,-4377600,671744,-3705856,-1
450,118,19,11,0.207746479,0.792253521,158.1973907,184.2704296,285.5022222,280.6779661,568,30.6364617,1136,-230400,60416,-169984,-1
3513,328,21,9,0.0853944285,0.914605571,1102.359506,1175.433471,1919.330771,1938.878049,3841,149.1071429,7682,-1798656,167936,-1630720,-1
4794,517,22,8,0.0973451327,0.902654867,1520.114468,1638.629594,2675.06383,2479.226306,5311,199.8118886,10622,-2454528,264704,-2189824,-1
3478,394,21,9,0.101756198,0.898243802,1111.380776,1120.366865,1973.610983,1608.906091,3872,90.89201878,7744,-1780736,201728,-1579008,-1
5336,295,21,9,0.0523885633,0.947611437,1613.885178,1760.98457,2841.447526,2355.701695,5631,203.4320809,11262,-2732032,151040,-2580992,-1
3400,153,20,10,0.043062201,0.956937799,1019.408416,1120.942094,1789.427941,1500.823529,3553,401.0158014,7106,-1740800,78336,-1662464,-1
1164,131,19,11,0.101158301,0.898841699,365.6544155,422.4167305,661.0953608,531.6412214,1295,95.85492228,2590,-595968,67072,-528896,-1
9543,437,19,11,0.0437875752,0.956212425,2872.1891,2956.657445,5026.944148,4194.649886,9980,348.8290807,19960,-4886016,223744,-4662272,-1
7342,416,23,7,0.0536220675,0.946377932,2211.269106,2519.871522,3931.40316,2963.459135,7758,143.0573483,15516,-3759104,212992,-3546112,-1
5167,527,19,11,0.0925535652,0.907446435,1611.773368,1883.639333,2807.056125,3244.034156,5694,216.9142857,11388,-2645504,269824,-2375680,-1
9248,688,22,8,0.0692431562,0.930756844,2835.522697,3198.999967,4917.516112,5653.818314,9936,712.76901,19872,-4734976,352256,-4382720,-1
7252,626,20,10,0.0794617923,0.920538208,2227.299733,2633.055796,3871.014755,4732.878594,7878,349.6671105,15756,-3713024,320512,-3392512,-1
6113,631,20,10,0.0935646501,0.90643535,1924.519896,2145.107533,3388.098642,3221.383518,6744,456.6012187,13488,-3129856,323072,-2806784,-1
1507,164,26,4,0.0981448235,0.901855177,475.5418629,532.9292254,845.711347,746.7621951,1671,58.3042568,3342,-771584,83968,-687616,-1
7854,898,21,9,0.102605119,0.897394881,2503.950131,2683.485114,4331.386682,4771.065702,8752,174.3426295,17504,-4021248,459776,-3561472,-1
591,86,21,9,0.127031019,0.872968981,190.3682664,184.1795174,357.0879865,214.6976744,677,43.64925854,1354,-302592,44032,-258560,-1
9043,445,20,10,0.0469013491,0.953098651,2712.730599,2938.568403,4808.439456,3445.164045,9488,348.4392214,18976,-4630016,227840,-4402176,-1
5173,498,21,9,0.0878152001,0.9121848,1615.930313,1831.39233,2817.479606,3028.381526,5671,122.088267,11342,-2648576,254976,-2393600,-1
2686,259,25,5,0.0879456706,0.912054329,841.0702361,938.7831537,1470.638868,1497.486486,2945,247.2712007,5890,-1375232,132608,-1242624,-1
9569,407,20,10,0.040797915,0.959202085,2863.886085,3141.607587,5020.110461,4245.304668,9976,825.8278146,19952,-4899328,208384,-4690944,-1
185,28,18,12,0.131455399,0.868544601,59.30094744,45.34419106,115.3081081,52.10714286,213,38.86861314,426,-94720,14336,-80384,-1
2578,185,17,13,0.066956207,0.933043793,785.8844854,886.7657193,1404.837859,1063.751351,2763,89.01417526,5526,-1319936,94720,-1225216,-1
2410,299,21,9,0.110372831,0.889627169,775.8141117,830.3314614,1355.753527,1348.926421,2709,86.21896881,5418,-1233920,153088,-1080832,-1
4648,808,21,9,0.148093842,0.851906158,1515.025335,1832.412997,2658.708692,3129.972772,5456,134.2850111,10912,-2379776,413696,-1966080,-1
1489,226,20,10,0.131778426,0.868221574,490.1227978,504.6482133,879.2585628,717.9380531,1715,74.9235474,3430,-762368,115712,-646656,-1
3927,384,21,9,0.0890744607,0.910925539,1244.913913,1157.171188,2197.590782,1730.669271,4311,254.787234,8622,-2010624,196608,-1814016,-1
38,18,20,10,0.321428571,0.678571429,14.75443029,18.76996879,28.86842105,27.72222222,56,5.951115834,112,-19456,9216,-10240,-1
3792,1820,21,9,0.324305061,0.675694939,1226.686236,1256.12903,2081.191983,4317.691209,5612,291.5324675,11224,-1941504,931840,-1009664,-1
4194,556,20,10,0.117052632,0.882947368,1369.06419,1385.037785,2385.2835,2301.701439,4750,231.5943442,9500,-2147328,284672,-1862656,-1
8319,457,21,9,0.0520738377,0.947926162,2519.991627,2722.677389,4414.693112,3911.693654,8776,397.4637681,17552,-4259328,233984,-4025344,-1
9495,469,21,9,0.04706945,0.95293055,2854.791672,3278.277468,4990.677409,4816.946695,9964,989.4736842,19928,-4861440,240128,-4621312,-1
2811,360,21,9,0.113528855,0.886471145,899.9820147,1025.944312,1578.599787,1643.783333,3171,136.5633075,6342,-1439232,184320,-1254912,-1
6941,489,20,10,0.0658142665,0.934185734,2152.9963,1971.877332,3747.111944,3266.791411,7430,145.6006271,14860,-3553792,250368,-3303424,-1
9260,686,19,11,0.0689724512,0.931027549,2874.104072,2757.200138,5019.455832,4353.163265,9946,333.6464274,19892,-4741120,351232,-4389888,-1
7478,1133,20,10,0.131575891,0.868424109,2476.049342,2501.886467,4237.062049,4761.002648,8611,164.6462715,17222,-3828736,580096,-3248640,-1
229,51,24,6,0.182142857,0.817857143,80.31279214,79.05111035,145.6637555,117.3137255,280,21.48887183,560,-117248,26112,-91136,-1
4682,469,20,10,0.0910502815,0.908949719,1471.708782,1612.191042,2552.117685,2814.415778,5151,184.0300107,10302,-2397184,240128,-2157056,-1
9515,454,18,12,0.0455411777,0.954458822,2858.892071,3052.542516,5036.852338,3898.270925,9969,941.3597734,19938,-4871680,232448,-4639232,-1
5005,499,18,12,0.0906613372,0.909338663,1572.824596,1714.73471,2781.485914,2461.769539,5504,100.9167583,11008,-2562560,255488,-2307072,-1
94,28,19,11,0.229508197,0.770491803,35.3548653,25.16585292,67.76595745,40.46428571,122,13.16073355,244,-48128,14336,-33792,-1
3230,132,16,14,0.0392623438,0.960737656,961.9645918,1083.404717,1698.160372,1273.825758,3362,63.20736981,6724,-1653760,67584,-1586176,-1
101,17,18,12,0.144067797,0.855932203,31.87255895,37.64733456,63.31683168,36.82352941,118,20.99644128,236,-51712,8704,-43008,-1
68,22,18,12,0.244444444,0.755555556,26.09233007,17.04084786,50.88235294,28.86363636,90,17.68172888,180,-34816,11264,-23552,-1
2200,249,17,13,0.101674153,0.898325847,694.7892235,806.585998,1224.519545,1229.24498,2449,110.5144404,4898,-1126400,127488,-998912,-1
214,37,19,11,0.147410359,0.852589641,69.32217287,55.10538413,137.0420561,62.13513514,251,33.42210386,502,-109568,18944,-90624,-1
691,88,16,14,0.11296534,0.88703466,216.7447382,252.4559367,404.7091172,274.5,779,75.26570048,1558,-353792,45056,-308736,-1
428,99,20,10,0.187855787,0.812144213,144.2515541,163.1984813,280.9439252,190.7474747,527,52.38568588,1054,-219136,50688,-168448,-1
9468,492,21,9,0.0493975904,0.95060241,2867.117009,2987.770209,5004.993452,4509.150407,9960,1110.367893,19920,-4847616,251904,-4595712,-1
45,21,21,9,0.318181818,0.681818182,18.67095189,19.77079548,34.13333333,32.14285714,66,11.39896373,132,-23040,10752,-12288,-1
74,23,20,10,0.237113402,0.762886598,28.71536406,18.08183456,53.90540541,33.2173913,97,14.87730061,194,-37888,11776,-26112,-1
3174,184,27,3,0.0547945205,0.945205479,965.6846242,972.0090156,1698.854757,1345.630435,3358,191.3390313,6716,-1625088,94208,-1530880,-1
4650,287,20,10,0.0581324691,0.941867531,1413.369141,1580.005697,2485.766882,2197.341463,4937,155.8888538,9874,-2380800,146944,-2233856,-1
7616,572,19,11,0.0698583293,0.930141671,2326.32747,2813.06656,4089.073529,4166.751748,8188,157.3102786,16376,-3899392,292864,-3606528,-1
928,131,20,10,0.123701605,0.876298395,298.5234938,338.5065408,542.9590517,438.1984733,1059,78.44444444,2118,-475136,67072,-408064,-1
3671,493,20,10,0.118395773,0.881604227,1199.23141,1159.417305,2033.511305,2447.281947,4164,185.5614973,8328,-1879552,252416,-1627136,-1
9504,464,18,12,0.0465489567,0.953451043,2860.265625,3035.720116,5034.306818,3964.318966,9968,634.5003183,19936,-4866048,237568,-4628480,-1
2964,149,18,12,0.047863797,0.952136203,888.6462217,959.672835,1581.135965,1076.872483,3113,452.4709302,6226,-1517568,76288,-1441280,-1
406,91,25,5,0.183098592,0.816901408,138.72673,162.8925871,248.0172414,253.3846154,497,41.41666667,994,-207872,46592,-161280,-1
9574,403,21,9,0.0403929037,0.959607096,2860.306404,3247.702991,5016.61197,4333.027295,9977,864.5580589,19954,-4901888,206336,-4695552,-1
2802,179,18,12,0.0600469641,0.939953036,842.8546275,1040.922716,1513.20985,1143.335196,2981,55.76131687,5962,-1434624,91648,-1342976,-1
9231,704,21,9,0.0708605939,0.929139406,2838.378185,2842.920205,5080.899686,3487.634943,9935,684.7002068,19870,-4726272,360448,-4365824,-1
7222,462,20,10,0.0601249349,0.939875065,2193.446658,2574.019751,3841.256716,3861.935065,7684,183.8277512,15368,-3697664,236544,-3461120,-1
1742,124,21,9,0.0664523044,0.933547696,526.0756918,642.9292336,951.0556831,686.8709677,1866,174.8828491,3732,-891904,63488,-828416,-1
3371,127,21,9,0.0363064608,0.963693539,1003.298192,1121.185347,1761.724711,1425.015748,3498,299.4863014,6996,-1725952,65024,-1660928,-1
2362,197,20,10,0.0769831966,0.923016803,735.7586479,720.2214589,1302.569433,1009.395939,2559,227.2646536,5118,-1209344,100864,-1108480,-1
9223,687,21,9,0.0693239152,0.930676085,2863.474047,2804.195369,4979.627995,4631.580786,9910,535.9653867,19820,-4722176,351744,-4370432,-1
8858,1031,18,12,0.104257256,0.895742744,2812.444836,3162.405064,4995.043238,4515.045587,9889,469.7862233,19778,-4535296,527872,-4007424,-1
65,31,19,11,0.322916667,0.677083333,29.44559119,21.45993048,52.41538462,40.29032258,96,15.31100478,192,-33280,15872,-17408,-1
9445,516,20,10,0.0518020279,0.948197972,2867.504055,2996.579622,5000.09063,4631.560078,9961,856.4918315,19922,-4835840,264192,-4571648,-1
9342,603,21,9,0.0606334842,0.939366516,2858.13842,2956.912624,5022.614858,4204.339967,9945,629.0322581,19890,-4783104,308736,-4474368,-1
9477,488,19,11,0.0489713999,0.9510286,2859.538358,2908.822122,5048.854173,3704.106557,9965,740.3417533,19930,-4852224,249856,-4602368,-1
4263,536,20,10,0.111689935,0.888310065,1363.604693,1431.425129,2330.325123,2954.149254,4799,116.3676043,9598,-2182656,274432,-1908224,-1
58,16,23,7,0.216216216,0.783783784,22.12202673,17.00723651,39.17241379,31.4375,74,2.188054406,148,-29696,8192,-21504,-1
4660,331,17,13,0.0663193749,0.933680625,1415.377958,1759.227036,2492.714163,2542.259819,4991,257.5335397,9982,-2385920,169472,-2216448,-1
6358,1161,23,7,0.154408831,0.845591169,2122.965745,2230.277081,3604.649575,4610.747631,7519,142.9467681,15038,-3255296,594432,-2660864,-1
156,27,19,11,0.147540984,0.852459016,50.44329256,39.65156887,100.2115385,44.55555556,183,27.72727273,366,-79872,13824,-66048,-1
253,74,20,10,0.226299694,0.773700306,93.32251254,83.80486221,177.0592885,119.3513514,327,55.05050505,654,-129536,37888,-91648,-1
8356,1460,16,14,0.148736756,0.851263244,2814.525356,2910.202588,4840.495572,5297.708904,9816,254.7625227,19632,-4278272,747520,-3530752,-1
8938,967,21,9,0.0976274609,0.902372539,2808.111953,2922.621154,4796.565115,6398.930714,9905,524.6292373,19810,-4576256,495104,-4081152,-1
7047,302,20,10,0.0410940264,0.958905974,2121.765974,2107.829419,3682.115652,3508.960265,7349,607.3553719,14698,-3608064,154624,-3453440,-1
9569,403,27,3,0.0404131568,0.959586843,2866.583769,3029.165277,5022.452607,4132.826303,9972,656.4845293,19944,-4899328,206336,-4692992,-1
463,60,15,15,0.114722753,0.885277247,144.0496293,157.8651006,276.2419006,152.1,523,75.03586801,1046,-237056,30720,-206336,-1
9405,541,25,5,0.0543937261,0.945606274,2845.906676,3003.532585,5047.126635,3693.539741,9946,535.3067815,19892,-4815360,276992,-4538368,-1
6761,544,27,3,0.0744695414,0.925530459,2067.077128,2476.854156,3706.406449,2989.248162,7305,398.7445415,14610,-3461632,278528,-3183104,-1
6001,1463,21,9,0.196007503,0.803992497,2061.38759,1913.449124,3380.391768,5176.793575,7464,146.9580626,14928,-3072512,749056,-2323456,-1
2423,301,16,14,0.110499266,0.889500734,775.0870173,839.3162643,1390.095749,1140.358804,2724,108.0952381,5448,-1240576,154112,-1086464,-1
9293,635,20,10,0.0639605157,0.936039484,2850.950929,3074.298899,4973.552136,4832.025197,9928,371.835206,19856,-4758016,325120,-4432896,-1
5897,497,16,14,0.0777291211,0.922270879,1832.655283,1853.636452,3257.207394,2489.060362,6394,119.5810735,12788,-3019264,254464,-2764800,-1
9319,636,23,7,0.0638874937,0.936112506,2857.238751,2883.337795,5054.216976,3861.22956,9955,668.1208054,19910,-4771328,325632,-4445696,-1
8809,633,20,10,0.0670408812,0.932959119,2686.940488,3010.871109,4642.936656,5814.808847,9442,269.0795098,18884,-4510208,324096,-4186112,-1
436,29,27,3,0.0623655914,0.937634409,134.6562578,122.3518347,235.3577982,197.5517241,465,124.3315508,930,-223232,14848,-208384,-1
740,68,20,10,0.0841584158,0.915841584,228.9400335,238.8699802,416.6283784,272.5147059,808,89.38053097,1616,-378880,34816,-344064,-1
9549,420,18,12,0.0421306049,0.957869395,2865.661339,3138.135524,4990.973086,4849.197619,9969,1151.154734,19938,-4889088,215040,-4674048,-1
689,43,20,10,0.0587431694,0.941256831,207.0268845,236.5293972,374.490566,238.4651163,732,50.44796692,1464,-352768,22016,-330752,-1
7440,324,21,9,0.0417310665,0.958268934,2227.487849,2536.106317,3885.836156,3805.891975,7764,275.8081705,15528,-3809280,165888,-3643392,-1
6267,505,17,13,0.0745717661,0.925428234,1955.164487,1951.467883,3388.941758,3356.19802,6772,215.0523976,13544,-3208704,258560,-2950144,-1
9413,541,19,11,0.05435001,0.94564999,2854.725202,2913.973414,5048.944332,3734.421442,9954,680.3827751,19908,-4819456,276992,-4542464,-1
2695,141,21,9,0.0497179126,0.950282087,807.0794844,903.899068,1442.080519,967.7943262,2836,249.2091388,5672,-1379840,72192,-1307648,-1
4363,389,19,11,0.0818602694,0.918139731,1355.784262,1500.730944,2347.02017,2707.143959,4752,101.6688062,9504,-2233856,199168,-2034688,-1
226,30,20,10,0.1171875,0.8828125,70.89611128,93.23747458,129.3362832,122.2,256,39.32411674,512,-115712,15360,-100352,-1
123,38,20,10,0.236024845,0.763975155,46.60862797,42.08956944,86.04065041,64.68421053,161,20.50955414,322,-62976,19456,-43520,-1
5374,671,18,12,0.111000827,0.888999173,1738.10264,1798.743565,3029.71083,2969.253353,6045,117.9742389,12090,-2751488,343552,-2407936,-1
7745,596,21,9,0.0714542621,0.928545738,2387.923013,2569.928367,4219.870755,3535.926174,8341,254.0664027,16682,-3965440,305152,-3660288,-1
5027,249,21,9,0.0471948446,0.952805155,1509.81612,1742.250736,2653.367018,2338.353414,5276,150.0568828,10552,-2573824,127488,-2446336,-1
1262,115,27,3,0.0835148874,0.916485113,390.6493959,438.6411259,702.7670365,537.9217391,1377,124.5027125,2754,-646144,58880,-587264,-1
9185,707,17,13,0.0714718965,0.928528104,2819.772199,3134.417682,4873.469134,5895.281471,9892,207.1623037,19784,-4702720,361984,-4340736,-1
4920,365,22,8,0.0690633869,0.930936613,1517.771179,1397.259991,2702.819309,1836.668493,5285,143.1861284,10570,-2519040,186880,-2332160,-1
39,12,18,12,0.235294118,0.764705882,14.7488285,7.127801593,29.43589744,14.83333333,51,3.406813627,102,-19968,6144,-13824,-1
8203,584,22,8,0.0664618186,0.933538181,2518.486339,2736.347831,4427.133122,3928.604452,8787,256.8547208,17574,-4199936,299008,-3900928,-1
1141,105,27,3,0.0842696629,0.915730337,355.2223708,384.1780868,634.8063103,500.6380952,1246,134.7027027,2492,-584192,53760,-530432,-1
9299,649,18,12,0.0652392441,0.934760756,2863.321429,2913.619391,5019.740725,4326.281972,9948,1335.302013,19896,-4761088,332288,-4428800,-1
7812,565,22,8,0.0674465799,0.93255342,2375.195149,2454.557851,4303.237583,2609.488496,8377,158.0864314,16754,-3999744,289280,-3710464,-1
3593,529,25,5,0.128335759,0.871664241,1174.913506,1144.515993,1980.526579,2611.476371,4122,178.2871972,8244,-1839616,270848,-1568768,-1
9456,500,21,9,0.0502209723,0.949779028,2847.19822,3126.066292,5039.324767,3828.182,9956,961.003861,19912,-4841472,256000,-4585472,-1
463,40,26,4,0.0795228628,0.920477137,141.9178871,176.8288721,254.2462203,226,503,10.34128289,1006,-237056,20480,-216576,-1
5417,503,20,10,0.0849662162,0.915033784,1664.011739,2098.891602,2926.351301,3328.260437,5920,109.2250923,11840,-2773504,257536,-2515968,-1
9379,571,21,9,0.0573869347,0.942613065,2863.733518,2991.227411,4995.240537,4651.250438,9950,1123.024831,19900,-4802048,292352,-4509696,-1
111,29,21,9,0.207142857,0.792857143,40.3218989,40.23645923,72.01801802,64.68965517,140,8.115942029,280,-56832,14848,-41984,-1
9301,650,21,9,0.0653200683,0.934679932,2877.584908,2631.808814,5040.657026,4050.807692,9951,547.6609796,19902,-4762112,332800,-4429312,-1
3137,228,20,10,0.067756315,0.932243685,946.4777882,1255.643551,1672.042716,1833.758772,3365,193.3908046,6730,-1606144,116736,-1489408,-1
6323,410,21,9,0.0608941037,0.939105896,1919.678827,2187.304926,3407.803416,2737.731707,6733,123.5412844,13466,-3237376,209920,-3027456,-1
69,23,17,13,0.25,0.75,26.32125061,24.30360892,50.05797101,35.82608696,92,29.29936306,184,-35328,11776,-23552,-1
9533,438,20,10,0.0439273894,0.956072611,2859.490963,3122.949723,5028.409944,4062.954338,9971,1133.068182,19942,-4880896,224256,-4656640,-1
37,17,20,10,0.314814815,0.685185185,15.24031983,16.27020968,27.94594595,26.52941176,54,1.215668618,108,-18944,8704,-10240,-1
3856,216,19,11,0.0530451866,0.946954813,1153.257819,1513.248629,2043.370332,1913.851852,4072,345.0847458,8144,-1974272,110592,-1863680,-1
1630,179,20,10,0.098949696,0.901050304,512.7757415,600.9749635,907.2883436,884.1620112,1809,122.1471978,3618,-834560,91648,-742912,-1
9483,485,21,9,0.0486556982,0.951344302,2858.28524,3168.274201,5015.994095,4368.709278,9968,593.3333333,19936,-4855296,248320,-4606976,-1
9477,480,21,9,0.0482072914,0.951792709,2854.695567,3023.298078,5036.270761,3848.260417,9957,615.009265,19914,-4852224,245760,-4606464,-1
2397,503,19,11,0.173448276,0.826551724,824.6722958,884.3712918,1425.191907,1571.10338,2900,142.1568627,5800,-1227264,257536,-969728,-1
5670,374,22,8,0.06187955,0.93812045,1710.982487,2187.645899,3011.887831,3183.385027,6044,192.3615532,12088,-2903040,191488,-2711552,-1
9557,409,17,13,0.0410395344,0.958960466,2858.069235,3121.924387,5026.621115,3975.899756,9966,797.28,19932,-4893184,209408,-4683776,-1
8839,457,21,9,0.0491609294,0.950839071,2665.232008,2993.382591,4666.907795,4292.468271,9296,299.5810506,18592,-4525568,233984,-4291584,-1
3504,249,22,8,0.0663469225,0.933653078,1068.805708,992.1972752,1931.553653,1109.305221,3753,200.5879209,7506,-1794048,127488,-1666560,-1
840,70,20,10,0.0769230769,0.923076923,257.0539958,293.069796,466.3297619,325.5428571,910,161.0619469,1820,-430080,35840,-394240,-1
4615,325,20,10,0.0657894737,0.934210526,1399.271828,1737.425196,2450.134128,2759.695385,4940,109.9243436,9880,-2362880,166400,-2196480,-1
9597,380,21,9,0.0380876015,0.961912399,2864.541531,3197.434365,5011.32333,4425.218421,9977,1200.601685,19954,-4913664,194560,-4719104,-1
2713,198,20,10,0.0680178633,0.931982137,834.738819,912.356115,1459.281607,1411.035354,2911,56.56820832,5822,-1389056,101376,-1287680,-1
1120,138,17,13,0.109697933,0.890302067,353.5843581,432.4907671,632.0839286,608.5289855,1258,105.5369128,2516,-573440,70656,-502784,-1
4773,287,21,9,0.0567193676,0.943280632,1442.406948,1732.951038,2537.29206,2417.543554,5060,318.43927,10120,-2443776,146944,-2296832,-1
33,24,18,12,0.421052632,0.578947368,16.41781156,16.48968533,29.3030303,28.58333333,57,19.12751678,114,-16896,12288,-4608,-1
9485,462,25,5,0.0464461647,0.953553835,2849.140025,3213.481425,5008.924934,4256.980519,9947,942.8436019,19894,-4856320,236544,-4619776,-1
9491,479,17,13,0.0480441324,0.951955868,2855.744105,3157.412086,5030.979243,4084.365344,9970,927.4418605,19940,-4859392,245248,-4614144,-1
31,20,19,11,0.392156863,0.607843137,15.08436214,14.09352688,26.5483871,25.15,51,14.65517241,102,-15872,10240,-5632,-1
280,46,17,13,0.141104294,0.858895706,91.41697576,86.62332904,173.5892857,102.0869565,326,57.59717314,652,-143360,23552,-119808,-1
74,23,17,13,0.237113402,0.762886598,25.26097892,33.55113469,52.06756757,39.13043478,97,7.66192733,194,-37888,11776,-26112,-1
863,138,21,9,0.137862138,0.862137862,271.7522208,377.7559065,506.0405562,469.4782609,1001,43.29584775,2002,-441856,70656,-371200,-1
491,98,21,9,0.166383701,0.833616299,170.7862739,163.9955899,299.9002037,270.4489796,589,19.88521269,1178,-251392,50176,-201216,-1
1562,144,23,7,0.0844079719,0.915592028,489.2464214,519.7282313,860.8008963,774.3055556,1706,79.64519141,3412,-799744,73728,-726016,-1
5282,327,22,8,0.0582991621,0.941700838,1604.933751,1822.357187,2817.402499,2604.663609,5609,190.717443,11218,-2704384,167424,-2536960,-1
1764,487,24,6,0.21634829,0.78365171,571.7397617,745.8591451,1013.640023,1532.98768,2251,42.91706387,4502,-903168,249344,-653824,-1
644,362,22,8,0.359840954,0.640159046,248.9380872,242.6715178,388.628882,707.8563536,1006,20.50550347,2012,-329728,185344,-144384,-1
753,99,22,8,0.116197183,0.883802817,238.3520585,277.0512644,439.8844622,324.6969697,852,56.64893617,1704,-385536,50688,-334848,-1
7707,743,22,8,0.0879289941,0.912071006,2399.667909,2572.268405,4119.592708,5324.056528,8450,189.802336,16900,-3945984,380416,-3565568,-1
9590,391,17,13,0.0391744314,0.960825569,2858.776794,3186.113187,5036.857143,3866.268542,9981,842.278481,19962,-4910080,200192,-4709888,-1
5022,253,22,8,0.0479620853,0.952037915,1505.0059,1655.325388,2677.502389,1853.885375,5275,485.2805888,10550,-2571264,129536,-2441728,-1
1958,157,20,10,0.0742316785,0.925768322,601.8631385,707.8363058,1053.737487,1111.159236,2115,70.73578595,4230,-1002496,80384,-922112,-1
45,26,21,9,0.366197183,0.633802817,18.27761229,22.85434326,32.86666667,41.42307692,71,4.92371706,142,-23040,13312,-9728,-1
48,21,19,11,0.304347826,0.695652174,20.93839136,16.3296539,37.14583333,30.0952381,69,21.10091743,138,-24576,10752,-13824,-1
50,11,19,11,0.180327869,0.819672131,17.52826289,8.026814565,34.2,16.45454545,61,6.9476082,122,-25600,5632,-19968,-1
1727,159,20,10,0.0843054083,0.915694592,532.2710092,661.2902469,940.1563405,979.8176101,1886,106.0742407,3772,-884224,81408,-802816,-1
84,34,21,9,0.288135593,0.711864407,35.10068729,30.81814053,61.46428571,54.64705882,118,20.55749129,236,-43008,17408,-25600,-1
8240,959,21,9,0.104250462,0.895749538,2594.145472,2757.892776,4436.089442,6008.366006,9199,182.122352,18398,-4218880,491008,-3727872,-1
9381,581,20,10,0.0583216222,0.941678378,2854.056439,3012.192688,5047.52148,3915.497418,9962,895.0584007,19924,-4803072,297472,-4505600,-1
7903,379,22,8,0.0457618933,0.954238107,2375.643676,2687.446574,4142.771353,4114.989446,8282,272.6135616,16564,-4046336,194048,-3852288,-1
6482,329,21,9,0.0483042138,0.951695786,1950.417094,2153.740658,3438.937674,2757.057751,6811,125.3635192,13622,-3318784,168448,-3150336,-1
4361,428,22,8,0.0893714763,0.910628524,1359.159821,1598.938371,2402.036001,2323.308411,4789,199.9582463,9578,-2232832,219136,-2013696,-1
1162,109,19,11,0.0857592447,0.914240755,360.955897,404.006214,647.8881239,509.266055,1271,125.5928854,2542,-594944,55808,-539136,-1
4074,290,22,8,0.0664527956,0.933547204,1239.438647,1493.635205,2200.72435,1926.47931,4364,251.8176572,8728,-2085888,148480,-1937408,-1
550,101,27,3,0.155145929,0.844854071,185.1564924,201.8836898,328.32,313.3663366,651,42.60471204,1302,-281600,51712,-229888,-1
595,44,18,12,0.06885759,0.93114241,178.8959348,193.6376174,331.0285714,170.8636364,639,139.2156863,1278,-304640,22528,-282112,-1
387,27,19,11,0.0652173913,0.934782609,117.2844804,101.9264373,214.7183463,104.037037,414,43.44176285,828,-198144,13824,-184320,-1
5402,769,16,14,0.124615135,0.875384865,1763.591254,1788.047387,3172.33358,2479.53186,6171,134.8263054,12342,-2765824,393728,-2372096,-1
2928,255,16,14,0.0801131008,0.919886899,901.380629,1071.838618,1612.567964,1355.831373,3183,197.33416,6366,-1499136,130560,-1368576,-1
957,106,16,14,0.0997177799,0.90028222,294.7156406,367.9661594,548.5276907,382.7830189,1063,96.19909502,2126,-489984,54272,-435712,-1
1572,169,19,11,0.0970706491,0.902929351,498.8103199,535.0190919,874.942112,834.3313609,1741,47.00323974,3482,-804864,86528,-718336,-1
1265,152,19,11,0.107268878,0.892731122,404.8223604,393.7069818,731.9802372,517.75,1417,50.23041475,2834,-647680,77824,-569856,-1
9247,704,20,10,0.0707466586,0.929253341,2822.504668,3367.195844,4916.300422,5760.150568,9951,409.3377211,19902,-4734464,360448,-4374016,-1
2990,169,20,10,0.0534979424,0.946502058,904.0562171,1038.255665,1584.41204,1501.940828,3159,438.75,6318,-1530880,86528,-1444352,-1
1603,103,21,9,0.0603751465,0.939624853,486.2821554,579.1613012,851.077355,891.2038835,1706,82.1376986,3412,-820736,52736,-768000,-1
193,33,27,3,0.146017699,0.853982301,64.94595171,65.20786851,115.8860104,99.54545455,226,15.15761234,452,-98816,16896,-81920,-1
1970,93,19,11,0.0450799806,0.954920019,586.5162096,727.9118016,1042.384772,812.0215054,2063,142.867036,4126,-1008640,47616,-961024,-1
177,43,19,11,0.195454545,0.804545455,61.92221482,56.25146353,119.4519774,73.65116279,220,34.97615262,440,-90624,22016,-68608,-1
8162,1358,20,10,0.142647059,0.857352941,2556.283526,3172.347126,4467.915217,6519.025037,9520,181.1263318,19040,-4178944,695296,-3483648,-1
9499,472,20,10,0.0473372781,0.952662722,2853.687733,3244.912533,5023.693231,4227.423729,9971,968.0582524,19942,-4863488,241664,-4621824,-1
9511,451,20,10,0.0452720337,0.954727966,2855.941607,3122.550343,5025.891704,4045.337029,9962,1098.346196,19924,-4869632,230912,-4638720,-1
5654,352,20,10,0.0586080586,0.941391941,1721.033879,1894.965703,2982.350902,3343.207386,6006,109.8792536,12012,-2894848,180224,-2714624,-1
1352,214,21,9,0.136653895,0.863346105,438.9557303,508.0984953,762.7034024,914.8878505,1566,28.88233124,3132,-692224,109568,-582656,-1
1336,122,25,5,0.0836762689,0.916323731,418.4855289,369.0477636,751.4468563,489.1639344,1458,140.0576369,2916,-684032,62464,-621568,-1
7516,782,21,9,0.0942395758,0.905760424,2355.322154,2696.664318,4095.513438,4668.378517,8298,339.8034398,16596,-3848192,400384,-3447808,-1
5511,446,19,11,0.074869901,0.925130099,1703.981035,1881.121447,2956.863001,3252.535874,5957,134.0459046,11914,-2821632,228352,-2593280,-1
1794,351,27,3,0.163636364,0.836363636,614.6896294,634.1913747,1055.362876,1163.145299,2145,40.2892562,4290,-918528,179712,-738816,-1
229,47,22,8,0.170289855,0.829710145,76.5119577,84.88747911,145.8558952,102.6595745,276,42.59259259,552,-117248,24064,-93184,-1
2927,426,20,10,0.127050403,0.872949597,966.1182541,979.4029901,1682.604373,1638.492958,3353,78.24970828,6706,-1498624,218112,-1280512,-1
7422,497,22,8,0.0627604496,0.93723955,2262.837835,2606.712935,3964.851388,3887.551308,7919,230.7400932,15838,-3800064,254464,-3545600,-1
6998,558,16,14,0.0738485971,0.926151403,2150.104928,2420.470272,3837.430694,3039.437276,7556,143.6775052,15112,-3582976,285696,-3297280,-1
2030,286,22,8,0.123488774,0.876511226,644.9057861,798.7364569,1135.79064,1319.688811,2316,52.48130523,4632,-1039360,146432,-892928,-1
1320,51,20,10,0.0371991247,0.962800875,392.5629009,464.8723984,688.9462121,609.745098,1371,139.7553517,2742,-675840,26112,-649728,-1
363,48,20,10,0.116788321,0.883211679,113.3641533,141.1385976,213.2699725,151.0208333,411,58.46372688,822,-185856,24576,-161280,-1
338,66,27,3,0.163366337,0.836633663,118.0739238,108.635624,203.852071,195.5757576,404,10.52083333,808,-173056,33792,-139264,-1
2598,290,20,10,0.100415512,0.899584488,821.9952795,907.9487158,1466.756736,1245.110345,2888,190.7529723,5776,-1330176,148480,-1181696,-1
7223,642,22,8,0.0816274634,0.918372537,2247.815587,2337.655089,4011.057178,3054.79595,7865,195.3551913,15730,-3698176,328704,-3369472,-1
3572,399,17,13,0.100478469,0.899521531,1121.215104,1350.498014,1985.386058,1991.496241,3971,155.4207436,7942,-1828864,204288,-1624576,-1
9484,486,26,4,0.0487462387,0.951253761,2862.61767,2887.17667,5050.301244,3720.942387,9970,588.5478158,19940,-4855808,248832,-4606976,-1
7364,909,22,8,0.109875499,0.890124501,2273.496359,2515.569167,3912.754074,5953.663366,8273,336.1641609,16546,-3770368,465408,-3304960,-1
7247,547,22,8,0.0701821914,0.929817809,2226.292885,2311.751979,3974.526425,2877.005484,7794,496.1171229,15588,-3710464,280064,-3430400,-1
8236,597,20,10,0.0675874561,0.932412544,2527.636484,2627.195287,4492.284968,3378.39531,8833,594.8148148,17666,-4216832,305664,-3911168,-1
9326,616,21,9,0.0619593643,0.938040636,2862.436178,2896.272134,5016.99303,4282.753247,9942,631.639136,19884,-4774912,315392,-4459520,-1
2137,306,17,13,0.125255833,0.874744167,697.6422649,723.2874018,1251.518016,1015.856209,2443,55.08455468,4886,-1094144,156672,-937472,-1
447,104,20,10,0.188747731,0.811252269,149.9756932,185.8786656,287.1185682,228.2115385,551,10.43956044,1102,-228864,53248,-175616,-1
98,37,16,14,0.274074074,0.725925926,37.19567337,40.85614092,72.63265306,55.72972973,135,19.48051948,270,-50176,18944,-31232,-1
72,29,18,12,0.287128713,0.712871287,30.38562597,23.88229161,54.36111111,42.65517241,101,25.56962025,202,-36864,14848,-22016,-1
6330,473,16,14,0.0695281493,0.930471851,1938.140364,2275.903262,3412.166509,3265.945032,6803,189.2877017,13606,-3240960,242176,-2998784,-1
4670,632,22,8,0.119200302,0.880799698,1466.701268,1806.967384,2562.440685,3309.580696,5302,143.6078007,10604,-2391040,323584,-2067456,-1
3438,261,22,8,0.0705596107,0.929440389,1054.404767,1076.435285,1893.682373,1274.597701,3699,281.2927757,7398,-1760256,133632,-1626624,-1
4779,309,20,10,0.0607311321,0.939268868,1455.820593,1609.743657,2568.944758,2166.436893,5088,346.122449,10176,-2446848,158208,-2288640,-1
4743,1076,20,10,0.184911497,0.815088503,1711.888359,1435.011642,2801.092768,3390.062268,5819,117.7696823,11638,-2428416,550912,-1877504,-1
6316,247,27,3,0.0376352278,0.962364772,1879.490292,2133.830495,3308.907853,2593.94332,6563,600.4574565,13126,-3233792,126464,-3107328,-1
4682,277,27,3,0.0558580359,0.944141964,1413.19567,1576.316061,2518.416702,1830.66065,4959,213.1070047,9918,-2397184,141824,-2255360,-1
1779,183,21,9,0.0932721713,0.906727829,565.5817534,568.137139,973.4243957,1060.005464,1962,59.09638554,3924,-910848,93696,-817152,-1
4173,255,20,10,0.0575880759,0.942411924,1254.171672,1518.677437,2248.347472,1660.596078,4428,178.4764208,8856,-2136576,130560,-2006016,-1
2834,266,21,9,0.0858064516,0.914193548,891.6167595,927.0385687,1556.024347,1491.642857,3100,108.1646895,6200,-1451008,136192,-1314816,-1
231,51,26,4,0.180851064,0.819148936,79.87104729,86.18732226,145.0735931,125.3137255,282,25,564,-118272,26112,-92160,-1
484,99,20,10,0.169811321,0.830188679,161.2407243,188.0290916,304.2747934,231.989899,583,50.47619048,1166,-247808,50688,-197120,-1
57,21,20,10,0.269230769,0.730769231,21.76102049,24.2026591,40.57894737,36.57142857,78,8.108108108,156,-29184,10752,-18432,-1
3237,276,20,10,0.0785653288,0.921434671,995.4192877,1211.652271,1759.55329,1727.054348,3513,85.74566756,7026,-1657344,141312,-1516032,-1
485,115,16,14,0.191666667,0.808333333,171.0918346,171.4591056,313.414433,246.0347826,600,16.6481687,1200,-248320,58880,-189440,-1
8832,550,20,10,0.0586228949,0.941377105,2675.387926,3158.814966,4718.971694,4250.354545,9382,534.8916762,18764,-4521984,281600,-4240384,-1
149,45,15,15,0.231958763,0.768041237,53.25750873,60.82360653,102.9865772,79.33333333,194,5.598845599,388,-76288,23040,-53248,-1
4441,311,21,9,0.0654461279,0.934553872,1343.524966,1721.032821,2384.944607,2255.913183,4752,111.3141251,9504,-2273792,159232,-2114560,-1
8993,578,21,9,0.0603907638,0.939609236,2778.240912,2473.689833,4813.353497,4360.411765,9571,355.1391466,19142,-4604416,295936,-4308480,-1
7671,420,21,9,0.0519095291,0.948090471,2326.978926,2476.763313,4059.185765,3805.171429,8091,302.1284541,16182,-3927552,215040,-3712512,-1
1930,165,17,13,0.0787589499,0.92124105,601.1134394,632.3449959,1058.864249,920.9212121,2095,88.24768324,4190,-988160,84480,-903680,-1
9330,611,17,13,0.0614626295,0.93853737,2846.043381,3155.050939,5008.393569,4399.998363,9941,715.1798561,19882,-4776960,312832,-4464128,-1
6962,494,19,11,0.0662553648,0.933744635,2127.52957,2256.540228,3798.372881,2743.773279,7456,329.4741494,14912,-3564544,252928,-3311616,-1
9157,794,20,10,0.0797909758,0.920209024,2847.344283,3141.265223,4994.741728,4759.856423,9951,244.4362564,19902,-4688384,406528,-4281856,-1
1890,145,23,7,0.0712530713,0.928746929,579.8721732,626.851394,1037.21164,767.5862069,2035,147.3569877,4070,-967680,74240,-893440,-1
126,39,20,10,0.236363636,0.763636364,46.04949029,52.18121965,84.33333333,78.69230769,165,3.191489362,330,-64512,19968,-44544,-1
416,30,18,12,0.067264574,0.932735426,125.1726293,128.3928693,231.34375,114.7333333,446,11.39208174,892,-212992,15360,-197632,-1
9449,510,22,8,0.0512099608,0.948790039,2851.45769,3186.884613,5020.644724,4226.956863,9959,522.7821522,19918,-4837888,261120,-4576768,-1
9561,417,21,9,0.0417919423,0.958208058,2863.518616,3039.472192,5037.832549,3881.328537,9978,525.1578947,19956,-4895232,213504,-4681728,-1
2455,294,21,9,0.106947981,0.893052019,799.7631746,735.0923201,1384.44277,1296.14966,2749,184.2493298,5498,-1256960,150528,-1106432,-1
6676,855,21,9,0.11353074,0.88646926,2177.39993,2138.40712,3789.644098,3581.382456,7531,173.966274,15062,-3418112,437760,-2980352,-1
8580,1258,21,9,0.127871519,0.872128481,2770.371179,3106.086821,4777.102564,5890.700318,9838,530.0646552,19676,-4392960,644096,-3748864,-1
9566,407,23,7,0.0408101875,0.959189812,2874.373494,2963.396674,5001.819883,4638.678133,9973,877.9049296,19946,-4897792,208384,-4689408,-1
6578,436,19,11,0.0621613915,0.937838608,2013.526085,2050.908155,3556.314837,2771.022936,7014,309.6688742,14028,-3367936,223232,-3144704,-1
8623,503,21,9,0.0551172474,0.944882753,2615.541844,2939.620812,4564.940508,4538.805169,9126,192.1263158,18252,-4414976,257536,-4157440,-1
8410,516,20,10,0.0578086489,0.942191351,2547.888883,3007.460617,4466.305589,4417.773256,8926,523.5190616,17852,-4305920,264192,-4041728,-1
671,175,21,9,0.206855792,0.793144208,233.380684,281.4919345,427.1937407,409.3371429,846,17.57374325,1692,-343552,89600,-253952,-1
4426,344,21,9,0.0721174004,0.9278826,1356.516684,1608.654656,2398.030276,2224.281977,4770,224.4705882,9540,-2266112,176128,-2089984,-1
3258,252,20,10,0.0717948718,0.928205128,998.1131237,1183.628879,1765.855126,1621.623016,3510,215.0735294,7020,-1668096,129024,-1539072,-1
4060,477,22,8,0.105135552,0.894864448,1255.745862,1409.530528,2163.14532,3169.985325,4537,112.1354424,9074,-2078720,244224,-1834496,-1
65,23,20,10,0.261363636,0.738636364,25.06939953,25.35457439,46.64615385,38.43478261,88,15.85585586,176,-33280,11776,-21504,-1
4152,435,18,12,0.0948332243,0.905166776,1309.301052,1427.893978,2264.462669,2575.928736,4587,244.64,9174,-2125824,222720,-1903104,-1
383,52,17,13,0.11954023,0.88045977,119.7516619,131.1708144,230.1409922,128.5769231,435,87,870,-196096,26624,-169472,-1
5087,357,21,9,0.0655767818,0.934423218,1558.408483,1747.701031,2720.059564,2757.27451,5444,136.2362362,10888,-2604544,182784,-2421760,-1
1839,93,13,17,0.048136646,0.951863354,552.270039,618.119297,977.3779228,751.3978495,1932,263.2152589,3864,-941568,47616,-893952,-1
1772,76,18,12,0.0411255411,0.958874459,529.9243379,570.0762055,933.6585779,710.9605263,1848,191.5025907,3696,-907264,38912,-868352,-1
9442,533,19,11,0.053433584,0.946566416,2835.222112,3463.051544,5036.659924,4125.998124,9975,693.1897151,19950,-4834304,272896,-4561408,-1
2106,153,22,8,0.0677290837,0.932270916,638.2146594,685.5061559,1161.547009,695.7647059,2259,63.68762334,4518,-1078272,78336,-999936,-1
3977,301,21,9,0.0703599813,0.929640019,1212.605292,1364.576551,2184.820719,1540.694352,4278,448.427673,8556,-2036224,154112,-1882112,-1
670,43,17,13,0.0603085554,0.939691445,200.1954295,212.107629,368.3,180.9302326,713,159.1517857,1426,-343040,22016,-321024,-1
2085,148,21,9,0.066278549,0.933721451,628.4981383,757.1338982,1141.851319,766.8986486,2233,191.509434,4466,-1067520,75776,-991744,-1
43,13,22,8,0.232142857,0.767857143,16.47628054,13.63167214,30.20930233,22.84615385,56,9.523809524,112,-22016,6656,-15360,-1
9547,417,21,9,0.0418506624,0.958149338,2852.849957,3179.495247,5030.26071,3889.043165,9964,960.8486017,19928,-4888064,213504,-4674560,-1
2700,291,21,9,0.0972918756,0.902708124,828.4540016,1132.98875,1485.334074,1594.962199,2991,174.9122807,5982,-1382400,148992,-1233408,-1
9566,412,20,10,0.0412908398,0.95870916,2866.028474,3068.207375,5027.227263,4113.531553,9978,531.0271421,19956,-4897792,210944,-4686848,-1
3433,199,20,10,0.0547907489,0.945209251,1037.276827,1199.76764,1830.591611,1573.40201,3632,277.8882938,7264,-1757696,101888,-1655808,-1
9478,482,20,10,0.0483935743,0.951606426,2867.634734,2992.760782,5000.650665,4584.259336,9960,617.1003717,19920,-4852736,246784,-4605952,-1
1452,168,19,11,0.103703704,0.896296296,455.5545101,560.9671884,807.915978,832.8333333,1620,31.10599078,3240,-743424,86016,-657408,-1
9327,615,21,9,0.0618587809,0.938141219,2836.337539,3310.406779,4943.510775,5395.980488,9942,565.2075043,19884,-4775424,314880,-4460544,-1
5307,586,20,10,0.0994400136,0.900559986,1685.374713,1832.906139,2932.703411,3076.474403,5893,244.8275862,11786,-2717184,300032,-2417152,-1
5660,389,20,10,0.0643081501,0.93569185,1725.767556,1964.017304,2993.547703,3482.634961,6049,144.6437111,12098,-2897920,199168,-2698752,-1
5704,407,20,10,0.0666012109,0.933398789,1736.185812,2113.124022,3064.657083,2934.673219,6111,374.9079755,12222,-2920448,208384,-2712064,-1
4937,457,21,9,0.0847237671,0.915276233,1549.934131,1576.149181,2659.78813,3104.90372,5394,134.648028,10788,-2527744,233984,-2293760,-1
9527,443,23,7,0.0444332999,0.9555667,2878.163783,2845.137318,5004.763409,4571.227991,9970,443.9002671,19940,-4877824,226816,-4651008,-1
1334,99,21,9,0.0690858339,0.930914166,401.9454213,513.31706,730.67991,532.6666667,1433,164.7126437,2866,-683008,50688,-632320,-1
1454,132,21,9,0.0832282472,0.916771753,441.9899019,597.2331871,802.2001376,697.6666667,1586,195.8024691,3172,-744448,67584,-676864,-1
2448,132,20,10,0.0511627907,0.948837209,736.9547979,822.7806201,1306.501634,993.7424242,2580,288.2681564,5160,-1253376,67584,-1185792,-1
259,24,21,9,0.0848056537,0.915194346,78.87719961,89.64943298,147.2586873,85.25,283,14.67081389,566,-132608,12288,-120320,-1
8615,435,20,10,0.0480662983,0.951933702,2608.810902,2670.992734,4538.85711,4260.967816,9050,266.7256116,18100,-4410880,222720,-4188160,-1
2214,264,21,9,0.10653753,0.89346247,691.288476,864.3522845,1264.267841,1031.787879,2478,152.0245399,4956,-1133568,135168,-998400,-1
3510,336,22,8,0.0873634945,0.912636505,1098.118038,1197.889978,1948.950997,1657.627976,3846,287.4439462,7692,-1797120,172032,-1625088,-1
5194,380,20,10,0.0681736634,0.931826337,1591.973373,1794.739752,2811.58375,2458.313158,5574,128.226363,11148,-2659328,194560,-2464768,-1
4113,617,20,10,0.130443975,0.869556025,1362.394568,1377.347851,2386.519572,2225.380875,4730,144.7368421,9460,-2105856,315904,-1789952,-1
8983,913,20,10,0.0922594988,0.907740501,2838.98168,3017.098701,4970.705332,4730.021906,9896,852.3686477,19792,-4599296,467456,-4131840,-1
5374,522,21,9,0.0885345997,0.9114654,1675.992507,1904.473833,2909.66952,3348.260536,5896,187.0558376,11792,-2751488,267264,-2484224,-1
5904,544,17,13,0.0843672457,0.915632754,1807.941176,2134.767049,3314.218665,2250.788603,6448,385.1851852,12896,-3022848,278528,-2744320,-1
6132,521,27,3,0.0783105366,0.921689463,1911.509969,2023.981413,3327.293379,3323.547025,6653,184.0896514,13306,-3139584,266752,-2872832,-1
885,73,14,16,0.0762004175,0.923799582,267.350169,331.0783334,492.6553672,320.0136986,958,190.4572565,1916,-453120,37376,-415744,-1
3983,332,21,9,0.0769409038,0.923059096,1217.444622,1504.539772,2185.847853,1823.909639,4315,218.3704453,8630,-2039296,169984,-1869312,-1
6160,846,22,8,0.12075364,0.87924636,2029.242215,1952.101557,3539.80763,3239.132388,7006,186.1317747,14012,-3153920,433152,-2720768,-1
3650,397,19,11,0.0980973561,0.901902644,1142.709198,1326.622587,1984.264932,2389.322418,4047,171.3378493,8094,-1868800,203264,-1665536,-1
2548,250,20,10,0.0893495354,0.910650465,799.3889633,873.1083882,1414.720565,1244.372,2798,284.3495935,5596,-1304576,128000,-1176576,-1
3306,313,21,9,0.0864879801,0.91351202,1014.97578,1093.117225,1876.711736,1105.370607,3619,397.6923077,7238,-1692672,160256,-1532416,-1
6280,744,20,10,0.105922551,0.894077449,2006.478683,2141.200539,3456.747771,3983.096774,7024,163.9971982,14048,-3215360,380928,-2834432,-1
149,30,19,11,0.167597765,0.832402235,49.31733966,53.76983872,95.69127517,61.73333333,179,5.650252525,358,-76288,15360,-60928,-1
361,107,20,10,0.228632479,0.771367521,127.6371749,157.6869756,234.1606648,235.6448598,468,36.8503937,936,-184832,54784,-130048,-1
9505,460,23,7,0.0461615655,0.953838435,2866.088865,3086.607286,4984.413677,4953.78913,9965,678.3526208,19930,-4866560,235520,-4631040,-1
6461,1084,20,10,0.143671306,0.856328694,2144.545998,2259.630442,3663.07553,4428.186347,7545,146.3343677,15090,-3308032,555008,-2753024,-1
1845,220,20,10,0.10653753,0.89346247,589.6332055,646.2961936,1027.83523,1076.313636,2065,230.2118172,4130,-944640,112640,-832000,-1
3716,234,22,8,0.0592405063,0.940759494,1122.50307,1271.480122,2010.1507,1425.235043,3950,344.6771379,7900,-1902592,119808,-1782784,-1
1821,106,21,9,0.0550077841,0.944992216,549.350922,653.4543985,970.693575,849.009434,1927,164,3854,-932352,54272,-878080,-1
150,41,15,15,0.214659686,0.785340314,52.65869307,55.1318791,103.5733333,68.29268293,191,4.851409703,382,-76800,20992,-55808,-1
2574,254,20,10,0.0898161245,0.910183876,783.2579721,1047.71066,1445.090132,1104.503937,2828,91.72883555,5656,-1317888,130048,-1187840,-1
1460,160,17,13,0.0987654321,0.901234568,461.8671155,510.1358305,819.5349315,728.05625,1620,152.1126761,3240,-747520,81920,-665600,-1
1410,215,22,8,0.132307692,0.867692308,463.0440499,485.745781,833.6347518,677.6744186,1625,86.20689655,3250,-721920,110080,-611840,-1
8932,649,19,11,0.0677382319,0.932261768,2739.934683,2997.699309,4846.377631,4028.853621,9581,237.1534653,19162,-4573184,332288,-4240896,-1
310,23,23,7,0.0690690691,0.930930931,93.1862758,129.2124904,167.516129,160.0434783,333,43.47258486,666,-158720,11776,-146944,-1
1291,125,20,10,0.0882768362,0.911723164,403.7350621,418.3978279,725.6049574,531.84,1416,60.95566078,2832,-660992,64000,-596992,-1
959,74,17,13,0.0716360116,0.928363988,292.1522392,331.3074064,528.8581856,363.3243243,1033,165.0159744,2066,-491008,37888,-453120,-1
2332,171,20,10,0.0683180184,0.931681982,716.4555209,693.259859,1280.41295,864.5204678,2503,255.6690501,5006,-1193984,87552,-1106432,-1
63,18,20,10,0.222222222,0.777777778,23.93045479,15.61783169,44.66666667,28.16666667,81,8.737864078,162,-32256,9216,-23040,-1
5091,303,21,9,0.0561735261,0.943826474,1540.588447,1777.069923,2718.083088,2351.663366,5394,297.5179261,10788,-2606592,155136,-2451456,-1
9282,656,21,9,0.0660092574,0.933990743,2862.826565,2937.845008,4989.780974,4682.536585,9938,453.1691746,19876,-4752384,335872,-4416512,-1
4485,341,21,9,0.0706589308,0.929341069,1347.177327,1851.282772,2383.241918,2811.469208,4826,89.76934524,9652,-2296320,174592,-2121728,-1
36,16,20,10,0.307692308,0.692307692,15.18474198,14.51817288,27.08333333,25.1875,52,11.9266055,104,-18432,8192,-10240,-1
9051,869,21,9,0.0876008065,0.912399194,2860.421153,2894.845884,4949.90896,5070.810127,9920,342.0689655,19840,-4634112,444928,-4189184,-1
467,65,19,11,0.122180451,0.877819549,147.1785207,183.4891313,274.4732334,209.2153846,532,41.79104478,1064,-239104,33280,-205824,-1
244,62,19,11,0.202614379,0.797385621,87.13018213,89.97072741,158.7704918,132.7580645,306,24.59807074,612,-124928,31744,-93184,-1
5208,398,20,10,0.0709953621,0.929004638,1606.756403,1761.365141,2798.712558,2866.145729,5606,207.6296296,11212,-2666496,203776,-2462720,-1
97,15,21,9,0.133928571,0.866071429,31.15112181,31.9141905,59.75257732,35.46666667,112,20.74074074,224,-49664,7680,-41984,-1
756,117,18,12,0.134020619,0.865979381,242.1825117,295.1092845,449.7301587,354.7435897,873,75.12908778,1746,-387072,59904,-327168,-1
9475,490,22,8,0.0491721024,0.950827898,2858.923569,3135.249606,5015.330554,4357.832653,9965,1114.653244,19930,-4851200,250880,-4600320,-1
231,43,23,7,0.156934307,0.843065693,76.45555472,81.58270132,144.7662338,98.46511628,274,22.38562092,548,-118272,22016,-96256,-1
1708,127,19,11,0.0692098093,0.930790191,521.1179254,593.1288963,934.0971897,701.511811,1835,232.5728771,3670,-874496,65024,-809472,-1
2447,168,17,13,0.0642447419,0.935755258,740.3263988,907.0700706,1324.821005,1062.994048,2615,214.3442623,5230,-1252864,86016,-1166848,-1
1225,118,20,10,0.0878629933,0.912137007,379.0695236,463.1275134,678.1306122,608.3559322,1343,64.50528338,2686,-627200,60416,-566784,-1
9399,556,22,8,0.055851331,0.944148669,2872.314056,2829.781942,5013.959464,4370.116906,9955,811.3284434,19910,-4812288,284672,-4527616,-1
182,27,17,13,0.129186603,0.870813397,56.92475097,70.06258225,110.2252747,69.77777778,209,23.27394209,418,-93184,13824,-79360,-1
2340,237,22,8,0.091967404,0.908032596,733.1880527,834.9054376,1299.917949,1181.202532,2577,47.74874931,5154,-1198080,121344,-1076736,-1
47,26,18,12,0.356164384,0.643835616,21.34573872,20.24071122,38.61702128,34.07692308,73,14.98973306,146,-24064,13312,-10752,-1
2691,280,22,8,0.0942443622,0.905755638,848.3799773,933.6478779,1473.502787,1606.107143,2971,230.8469308,5942,-1377792,143360,-1234432,-1
6023,435,22,8,0.0673583153,0.932641685,1856.431839,1800.851335,3285.119708,2459.390805,6458,118.3651026,12916,-3083776,222720,-2861056,-1
9653,334,20,10,0.0334434765,0.966556523,2872.888379,3110.967876,5013.104423,4441.859281,9987,834.3358396,19974,-4942336,171008,-4771328,-1
5763,310,21,9,0.0510456117,0.948954388,1734.125458,2069.273651,3044.983689,2888.580645,6073,345.2529847,12146,-2950656,158720,-2791936,-1
4745,1143,20,10,0.194123641,0.805876359,1739.468273,1456.644838,2847.860063,3345.686789,5888,118.2091949,11776,-2429440,585216,-1844224,-1
375,68,21,9,0.153498871,0.846501129,120.3425758,160.1423513,216.6453333,251.5294118,443,40.12681159,886,-192000,34816,-157184,-1
47,21,17,13,0.308823529,0.691176471,18.87453512,20.87224937,35.91489362,31.33333333,68,13.38582677,136,-24064,10752,-13312,-1
9486,476,21,9,0.04778157,0.95221843,2862.581224,3119.003172,4992.613009,4760.033613,9962,671.2938005,19924,-4856832,243712,-4613120,-1
434,59,22,8,0.119675456,0.880324544,134.2086787,189.2376547,243.0990783,275.6949153,493,13.92655367,986,-222208,30208,-192000,-1
749,70,21,9,0.0854700855,0.914529915,231.014168,287.7660618,408.9092123,421.6714286,819,144.9557522,1638,-383488,35840,-347648,-1
3137,322,18,12,0.0930904886,0.906909511,995.5578808,1006.356082,1709.969398,1925.142857,3459,98.04421769,6918,-1606144,164864,-1441280,-1
6925,695,21,9,0.0912073491,0.908792651,2164.437238,2521.541024,3821.863971,3697.269065,7620,178.7054409,15240,-3545600,355840,-3189760,-1
4467,209,22,8,0.0446963216,0.955303678,1346.191174,1422.761011,2342.683904,2249.076555,4676,485.0622407,9352,-2287104,107008,-2180096,-1
2858,348,21,9,0.108546475,0.891453525,925.4309777,910.4505478,1622.925472,1443.965517,3206,173.1101512,6412,-1463296,178176,-1285120,-1
9412,542,17,13,0.0544504722,0.945549528,2870.500927,2870.819804,5008.758606,4434.684502,9954,1035.796046,19908,-4818944,277504,-4541440,-1
101,12,22,8,0.10619469,0.89380531,32.01488172,17.97896147,60.67326733,26.08333333,113,8.218181818,226,-51712,6144,-45568,-1
9464,503,20,10,0.0504665396,0.94953346,2864.667665,3013.331578,5022.578931,4258.133201,9967,1205.199516,19934,-4845568,257536,-4588032,-1
9433,519,17,13,0.0521503215,0.947849678,2864.127117,2974.71641,5006.745786,4426.77264,9952,1157.209302,19904,-4829696,265728,-4563968,-1
8531,729,20,10,0.0787257019,0.921274298,2625.766158,3155.157436,4601.186614,4973.534979,9260,197.5255973,18520,-4367872,373248,-3994624,-1
7992,1903,21,9,0.192319353,0.807680647,2558.476482,3069.445901,4445.511512,7058.293221,9895,356.705119,19790,-4091904,974336,-3117568,-1
9533,442,23,7,0.0443107769,0.955689223,2865.177207,3063.138935,5025.590265,4177.257919,9975,873.4676007,19950,-4880896,226304,-4654592,-1
661,97,16,14,0.127968338,0.872031662,206.4314975,271.2888567,365.6807867,473.6701031,758,29.87780844,1516,-338432,49664,-288768,-1
519,47,27,3,0.0830388693,0.916961131,160.1361321,179.0287159,290.3660886,207.6808511,566,10.62112967,1132,-265728,24064,-241664,-1
9481,477,22,8,0.047901185,0.952098815,2869.08849,2968.559048,4993.679886,4697.656184,9958,1392.727273,19916,-4854272,244224,-4610048,-1
4585,305,17,13,0.0623721881,0.937627812,1401.66622,1552.392491,2441.544166,2504.967213,4890,95.56380692,9780,-2347520,156160,-2191360,-1
2355,236,21,9,0.0910845234,0.908915477,741.6225812,808.1596182,1298.087898,1275.165254,2591,225.1086012,5182,-1205760,120832,-1084928,-1
9634,357,20,10,0.0357321589,0.964267841,2873.864672,3066.393319,5022.094976,4291.80112,9991,761.5091463,19982,-4932608,182784,-4749824,-1
231,43,26,4,0.156934307,0.843065693,80.39033305,64.80663087,142.7619048,109.2325581,274,22.87145242,548,-118272,22016,-96256,-1
9491,473,20,10,0.0474708952,0.952529105,2859.14225,3120.311445,5017.52397,4279.725159,9964,965.503876,19928,-4859392,242176,-4617216,-1
3109,297,23,7,0.0871990605,0.91280094,969.2708124,1103.179716,1720.571888,1524.791246,3406,62.95748614,6812,-1591808,152064,-1439744,-1
9548,423,27,3,0.0424230268,0.957576973,2864.583597,3027.201313,5027.344994,4052.756501,9971,415.2852978,19942,-4888576,216576,-4672000,-1
1573,135,19,11,0.0790398126,0.920960187,489.4174534,531.5479893,858.3865226,809.2148148,1708,41.15662651,3416,-805376,69120,-736256,-1
3108,231,22,8,0.0691823899,0.93081761,943.9982014,1081.730394,1632.777349,2170.813853,3339,94.05633803,6678,-1591296,118272,-1473024,-1
1048,176,21,9,0.14379085,0.85620915,339.5833874,425.3098205,608.3520992,637.1988636,1224,30.60765191,2448,-536576,90112,-446464,-1
1089,112,19,11,0.0932556203,0.90674438,337.1341392,412.6384994,612.389348,490.2589286,1201,122.1770092,2402,-557568,57344,-500224,-1
2931,381,22,8,0.115036232,0.884963768,955.2344591,957.0959716,1669.142272,1559.244094,3312,102.159161,6624,-1500672,195072,-1305600,-1
7634,417,20,10,0.0517948081,0.948205192,2310.705535,2291.24236,4086.419177,2919.908873,8051,159.7103749,16102,-3908608,213504,-3695104,-1
248,48,16,14,0.162162162,0.837837838,82.44559388,96.56732503,152.766129,126.4583333,296,32.77962348,592,-126976,24576,-102400,-1
2295,151,20,10,0.0617334424,0.938266558,691.8545289,804.6030865,1248.498039,843.5629139,2446,152.6841448,4892,-1175040,77312,-1097728,-1
3079,215,22,8,0.0652701882,0.934729812,935.9902466,1093.807372,1625.05164,1968.981395,3294,62.85060103,6588,-1576448,110080,-1466368,-1
38,24,18,12,0.387096774,0.612903226,18.33090725,17.03055873,32.63157895,29.70833333,62,11.2522686,124,-19456,12288,-7168,-1
6466,791,21,9,0.108998209,0.891001791,2060.840477,2351.995962,3615.16811,3742.068268,7257,157.9669134,14514,-3310592,404992,-2905600,-1
6524,1466,20,10,0.183479349,0.816520651,2358.72879,1888.01859,3829.128296,4735.888131,7990,146.6862493,15980,-3340288,750592,-2589696,-1
8700,1014,22,8,0.104385423,0.895614577,2845.122171,2415.957438,4880.277701,4662.07002,9714,466.3466155,19428,-4454400,519168,-3935232,-1
236,58,20,10,0.197278912,0.802721088,84.48251316,80.50581215,154.4237288,119.3275862,294,22.07207207,588,-120832,29696,-91136,-1
4129,286,20,10,0.0647791619,0.935220838,1253.753923,1460.097149,2241.474933,1724.72028,4415,348.4609313,8830,-2114048,146432,-1967616,-1
5505,447,20,10,0.0751008065,0.924899194,1715.850762,1732.967706,2993.631971,2765.512304,5952,227.1755725,11904,-2818560,228864,-2589696,-1
7393,550,21,9,0.0692433589,0.930756641,2278.45229,2222.510735,4050.90748,2911.34,7943,397.9458918,15886,-3785216,281600,-3503616,-1
9519,459,17,13,0.0460012026,0.953998797,2848.823098,3111.411227,5061.970375,3486.568627,9978,1427.467811,19956,-4873728,235008,-4638720,-1
354,79,24,6,0.182448037,0.817551963,125.1222508,123.807522,214.4943503,228.2278481,433,12.02109939,866,-181248,40448,-140800,-1
9137,763,22,8,0.0770707071,0.922929293,2853.635968,2833.493773,5003.066652,4321.009174,9900,337.883959,19800,-4678144,390656,-4287488,-1
147,30,17,13,0.169491525,0.830508475,48.996233,49.21612202,95.48979592,57.2,177,31.49466192,354,-75264,15360,-59904,-1
9469,499,21,9,0.0500601926,0.949939807,2861.092379,3058.872018,5027.827331,4162.322645,9968,493.9544103,19936,-4848128,255488,-4592640,-1
5171,357,20,10,0.0645803184,0.935419682,1571.780256,1887.16897,2744.801392,3049.826331,5528,333.2127788,11056,-2647552,182784,-2464768,-1
625,41,15,15,0.0615615616,0.938438438,185.998007,266.6573598,336.3056,290.7317073,666,25.92448424,1332,-320000,20992,-299008,-1
3603,404,22,8,0.100823559,0.899176441,1138.385182,1308.813678,2002.092423,2021.012376,4007,232.9651163,8014,-1844736,206848,-1637888,-1
1114,110,27,3,0.089869281,0.910130719,347.5836697,388.4973724,623.9470377,496.5727273,1224,110.4693141,2448,-570368,56320,-514048,-1
7000,758,20,10,0.0977055942,0.902294406,2213.75786,2305.298632,3789.739571,4708.422164,7758,264.5975443,15516,-3584000,388096,-3195904,-1
6601,355,16,14,0.0510350776,0.948964922,2003.804474,2068.974962,3491.988184,3227.695775,6956,338.3268482,13912,-3379712,181760,-3197952,-1
6434,361,17,13,0.0531272995,0.946872701,1934.877811,2386.038993,3402.422443,3319.180055,6795,134.8749504,13590,-3294208,184832,-3109376,-1
9305,630,20,10,0.0634121792,0.936587821,2840.974,2821.909575,5072.426867,3425.631746,9935,947.092469,19870,-4764160,322560,-4441600,-1
3234,156,22,8,0.0460176991,0.953982301,969.1726314,1066.199472,1716.670686,1256.615385,3390,144.0101954,6780,-1655808,79872,-1575936,-1
609,62,21,9,0.0923994039,0.907600596,187.3470086,182.667724,352.2101806,176.7741935,671,52.83464567,1342,-311808,31744,-280064,-1
9423,528,20,10,0.053059994,0.946940006,2850.375403,3011.455427,5041.739043,3802.782197,9951,714.3575018,19902,-4824576,270336,-4554240,-1
4512,936,19,11,0.171806167,0.828193833,1415.976654,1612.145646,2448.824246,4053.398504,5448,108.8511489,10896,-2310144,479232,-1830912,-1
2026,210,19,11,0.0939177102,0.90608229,636.9917664,714.1063293,1107.834156,1221.4,2236,53.12425754,4472,-1037312,107520,-929792,-1
9386,578,21,9,0.0580088318,0.941991168,2848.40255,3080.705582,5052.752823,3841.681661,9964,459.1705069,19928,-4805632,295936,-4509696,-1
3340,266,22,8,0.0737659456,0.926234054,1043.957929,943.2449989,1829.545808,1476.458647,3606,313.0208333,7212,-1710080,136192,-1573888,-1
9597,381,22,8,0.0381840048,0.961815995,2868.780766,3072.996196,5018.008023,4271.412073,9978,803.3816425,19956,-4913664,195072,-4718592,-1
7440,439,20,10,0.0557177307,0.944282269,2255.626867,2553.788788,3922.036022,4244.446469,7879,544.8824343,15758,-3809280,224768,-3584512,-1
3610,375,21,9,0.0941028858,0.905897114,1140.915707,1229.625735,2006.95374,1858.672,3985,233.1772967,7970,-1848320,192000,-1656320,-1
9670,320,21,9,0.032032032,0.967967968,2879.816399,2984.031497,5006.651086,4658.528125,9990,404.2897612,19980,-4951040,163840,-4787200,-1
1443,128,20,10,0.0814767664,0.918523234,451.4405889,471.0979508,791.9106029,719.3671875,1571,67.97922977,3142,-738816,65536,-673280,-1
2203,327,25,5,0.129249012,0.870750988,730.3190652,725.961889,1254.185656,1341.724771,2530,126.5,5060,-1127936,167424,-960512,-1
414,77,17,13,0.156822811,0.843177189,135.4806344,139.1313109,263.1304348,153.8961039,491,66.80272109,982,-211968,39424,-172544,-1
285,27,21,9,0.0865384615,0.913461538,87.47542479,77.35303779,164.0666667,76.62962963,312,19.54887218,624,-145920,13824,-132096,-1
9543,427,19,11,0.0428284855,0.957171515,2858.973313,3256.33697,4969.661322,5339.477752,9970,563.9140271,19940,-4886016,218624,-4667392,-1
7647,469,21,9,0.0577870872,0.942212913,2314.541491,2729.304847,4032.37518,4484.462687,8116,304.7690575,16232,-3915264,240128,-3675136,-1
1856,165,24,6,0.0816427511,0.918357249,578.5359826,635.5393269,1012.189655,997.6181818,2021,166.8868704,4042,-950272,84480,-865792,-1
767,77,21,9,0.0912322275,0.908767773,238.6132866,282.8346926,416.821382,479.0649351,844,19.10366682,1688,-392704,39424,-353280,-1
5607,767,18,12,0.120332601,0.879667399,1713.389934,1924.148056,2966.296772,4804.56193,6374,146.2933211,12748,-2870784,392704,-2478080,-1
6829,268,18,12,0.0377624348,0.962237565,2034.590513,2287.501233,3574.405916,2901.623134,7097,252.1136767,14194,-3496448,137216,-3359232,-1
9584,397,21,9,0.0397755736,0.960224426,2879.427583,2914.938678,5000.989566,4749.84131,9981,548.1054366,19962,-4907008,203264,-4703744,-1
769,119,19,11,0.134009009,0.865990991,249.9034229,291.9844586,450.1235371,408.1596639,888,58.73015873,1776,-393728,60928,-332800,-1
6750,469,22,8,0.064967447,0.935032553,2049.730405,2495.217129,3583.779704,3987.371002,7219,273.5505873,14438,-3456000,240128,-3215872,-1
2615,371,21,9,0.124246484,0.875753516,842.1622533,988.284896,1484.692161,1555.58221,2986,121.1359026,5972,-1338880,189952,-1148928,-1
594,65,18,12,0.0986342944,0.901365706,181.6838641,253.6182399,326.8198653,359.0615385,659,80.36585366,1318,-304128,33280,-270848,-1
6426,297,24,6,0.0441767068,0.955823293,1926.923011,2119.058083,3391.778711,2717.69697,6723,583.0875976,13446,-3290112,152064,-3138048,-1
704,136,22,8,0.161904762,0.838095238,234.8188543,276.1547671,427.3139205,385.2279412,840,68.29268293,1680,-360448,69632,-290816,-1
9140,814,19,11,0.0817761704,0.91822383,2864.058967,2650.766784,5093.157549,3678.839066,9954,579.0575916,19908,-4679680,416768,-4262912,-1
6537,495,20,10,0.0703924915,0.929607509,1998.885723,2190.342806,3588.651675,2563.660606,7032,206.3985911,14064,-3346944,253440,-3093504,-1
2567,197,22,8,0.0712735166,0.928726483,788.1303541,860.5859939,1405.640436,1080.969543,2764,250.1357466,5528,-1314304,100864,-1213440,-1
9617,370,19,11,0.0370481626,0.962951837,2862.605885,3224.770834,5030.95196,4033.548649,9987,930.7548928,19974,-4923904,189440,-4734464,-1
1490,244,17,13,0.14071511,0.85928489,490.0680777,492.7862592,908.0080537,620.1352459,1734,57.97392177,3468,-762880,124928,-637952,-1
8275,414,27,3,0.0476464495,0.95235355,2503.524017,2531.890869,4374.267795,3759.997585,8689,750.3454231,17378,-4236800,211968,-4024832,-1
4931,315,21,9,0.0600457491,0.939954251,1501.43959,1606.615951,2658.728047,2072.04127,5246,252.2115385,10492,-2524672,161280,-2363392,-1
334,72,23,7,0.177339901,0.822660099,117.0080242,115.4482675,198.6377246,226.0555556,406,12.77935159,812,-171008,36864,-134144,-1
104,32,20,10,0.235294118,0.764705882,37.87707363,42.79379153,70.51923077,61.9375,136,5.897658283,272,-53248,16384,-36864,-1
6221,344,21,9,0.0523990861,0.947600914,1895.527588,1883.573553,3290.226169,3152.319767,6565,195.5615133,13130,-3185152,176128,-3009024,-1
1722,295,21,9,0.146256817,0.853743183,581.607979,581.4390194,997.4041812,1076.688136,2017,39.56453511,4034,-881664,151040,-730624,-1
1189,185,18,12,0.134643377,0.865356623,393.2012688,408.0364394,700.6728343,602.8378378,1374,31.65898618,2748,-608768,94720,-514048,-1
9469,506,21,9,0.050726817,0.949273183,2862.307032,2918.573657,5054.363924,3746.102767,9975,1030.475207,19950,-4848128,259072,-4589056,-1
47,24,19,11,0.338028169,0.661971831,18.97626642,23.17625701,35.82978723,36.33333333,71,6.623134328,142,-24064,12288,-11776,-1
3499,177,27,3,0.0481501632,0.951849837,1048.335843,1258.118947,1852.319806,1565.305085,3676,99.94562262,7352,-1791488,90624,-1700864,-1
4925,329,22,8,0.062618957,0.937381043,1515.578111,1526.91097,2636.601827,2491.24924,5254,296,10508,-2521600,168448,-2353152,-1
7674,643,18,12,0.0773115306,0.922688469,2357.632176,2860.651189,4143.119494,4348.528771,8317,169.8386767,16634,-3929088,329216,-3599872,-1
4007,296,17,13,0.0687892168,0.931210783,1216.787606,1515.50405,2173.517095,1860.719595,4303,117.5040961,8606,-2051584,151552,-1900032,-1
870,135,20,10,0.134328358,0.865671642,288.7363819,298.0333687,499.7712644,523.8074074,1005,27.23577236,2010,-445440,69120,-376320,-1
7567,634,21,9,0.0773076454,0.922692355,2345.208865,2611.945326,4115.400423,3929.126183,8201,173.1630068,16402,-3874304,324608,-3549696,-1
4692,355,20,10,0.0703388151,0.929661185,1427.532403,1778.676662,2544.66624,2250.856338,5047,128.1615033,10094,-2402304,181760,-2220544,-1
295,53,27,3,0.152298851,0.847701149,101.3619075,93.51786247,171.4881356,191.2641509,348,16.73076923,696,-151040,27136,-123904,-1
7875,551,21,9,0.0653928317,0.934607168,2394.87622,2912.996906,4204.390222,4343.69873,8426,170.4977742,16852,-4032000,282112,-3749888,-1
1807,190,21,9,0.0951427141,0.904857286,570.0756554,570.308734,1026.747648,735.1052632,1997,119.3664077,3994,-925184,97280,-827904,-1
9529,442,22,8,0.0443285528,0.955671447,2859.321342,3176.765983,5019.650645,4260.531674,9971,478.6845895,19942,-4878848,226304,-4652544,-1
4829,362,22,8,0.0697360817,0.930263918,1478.325615,1732.017215,2580.277076,2805.740331,5191,109.0775373,10382,-2472448,185344,-2287104,-1
73,23,18,12,0.239583333,0.760416667,27.14724278,20.24051973,54.36986301,29.86956522,96,18.8976378,192,-37376,11776,-25600,-1
2512,229,19,11,0.083546151,0.916453849,770.2372931,992.1104456,1367.22293,1412.432314,2741,79.01412511,5482,-1286144,117248,-1168896,-1
87,43,21,9,0.330769231,0.669230769,36.19181222,39.63396613,63.05747126,70.44186047,130,2.449594875,260,-44544,22016,-22528,-1
5649,241,22,8,0.0409168081,0.959083192,1693.491661,1848.860415,2950.452115,2829.423237,5890,128.1549173,11780,-2892288,123392,-2768896,-1
7246,539,27,3,0.0692357097,0.93076429,2237.447944,2310.054339,3932.977505,3355.565863,7785,194.625,15570,-3709952,275968,-3433984,-1
9446,518,17,13,0.0519871538,0.948012846,2860.298417,3030.96211,5029.255981,4129.880309,9964,1047.739222,19928,-4836352,265216,-4571136,-1
3600,434,20,10,0.107585523,0.892414477,1115.688478,1203.546727,2121.323333,1156.292627,4034,180.2502234,8068,-1843200,222208,-1620992,-1
749,68,17,13,0.0832313341,0.916768666,229.6984282,283.3576747,416.2016021,329.6764706,817,81.0515873,1634,-383488,34816,-348672,-1
3764,505,20,10,0.118294683,0.881705317,1211.697697,1374.117001,2124.619022,2212.374257,4269,116.4802183,8538,-1927168,258560,-1668608,-1
76,26,19,11,0.254901961,0.745098039,30.46938884,21.58158458,55.89473684,38.65384615,102,20.73170732,204,-38912,13312,-25600,-1
9470,490,19,11,0.0491967871,0.950803213,2855.270818,3223.288874,4995.196515,4696.467347,9960,875.2196837,19920,-4848640,250880,-4597760,-1
5754,766,20,10,0.117484663,0.882515337,1866.818369,1968.135496,3300.258603,2961.843342,6520,152.8363807,13040,-2946048,392192,-2553856,-1
5173,645,17,13,0.110862839,0.889137161,1643.305277,1871.989869,2847.142471,3409.617054,5818,183.6489899,11636,-2648576,330240,-2318336,-1
61,24,19,11,0.282352941,0.717647059,25.53630084,19.43936442,46.27868852,34.66666667,85,13.62179487,170,-31232,12288,-18944,-1
9626,359,20,10,0.0359539309,0.964046069,2870.254007,3098.3809,5021.011427,4241.91922,9985,1171.948357,19970,-4928512,183808,-4744704,-1
83,23,20,10,0.216981132,0.783018868,30.53450392,21.70614889,58.86746988,34.13043478,106,16.23277182,212,-42496,11776,-30720,-1
1116,157,22,8,0.123330715,0.876669285,357.9727261,423.8263914,628.2043011,699.522293,1273,101.9215372,2546,-571392,80384,-491008,-1
59,29,21,9,0.329545455,0.670454545,27.02043658,20.98887084,46.77966102,39.86206897,88,19.59910913,176,-30208,14848,-15360,-1
4851,413,21,9,0.0784574468,0.921542553,1501.965076,1704.153505,2646.743352,2465.200969,5264,137.6569038,10528,-2483712,211456,-2272256,-1
3709,522,21,9,0.123375089,0.876624911,1176.510976,1447.808255,2063.261526,2490.726054,4231,122.283237,8462,-1899008,267264,-1631744,-1
6323,505,20,10,0.073960164,0.926039836,1970.873409,1928.577281,3382.292266,3817.766337,6828,185.7959184,13656,-3237376,258560,-2978816,-1
4555,319,21,9,0.0654493229,0.934550677,1381.272426,1534.595751,2492.045005,1658.652038,4874,127.2584856,9748,-2332160,163328,-2168832,-1
4024,544,20,10,0.119089317,0.880910683,1246.416065,1509.156987,2168.747018,3140.731618,4568,163.3762518,9136,-2060288,278528,-1781760,-1
2615,256,21,9,0.0891675374,0.910832463,815.095694,927.3179247,1413.721224,1663.574219,2871,148.6024845,5742,-1338880,131072,-1207808,-1
5824,332,20,10,0.0539311241,0.946068876,1757.786311,2058.019865,3097.645261,2742.650602,6156,433.5211268,12312,-2981888,169984,-2811904,-1
2599,247,19,11,0.0867884751,0.913211525,804.8074563,879.3253432,1462.942285,1008.477733,2846,178.544542,5692,-1330688,126464,-1204224,-1
9513,451,17,13,0.0452629466,0.954737053,2874.061504,2866.338571,5009.360454,4415.929047,9964,800.9646302,19928,-4870656,230912,-4639744,-1
859,128,19,11,0.129685917,0.870314083,282.5758225,292.5078775,503.3830035,431.03125,987,73.71172517,1974,-439808,65536,-374272,-1
8254,1687,19,11,0.169701237,0.830298763,3031.825712,1642.1421,5143.500485,4127.005335,9941,531.3201497,19882,-4226048,863744,-3362304,-1
1742,174,21,9,0.0908141962,0.909185804,539.4019004,628.8415257,981.891504,724.316092,1916,82.23175966,3832,-891904,89088,-802816,-1
9558,419,21,9,0.0419965922,0.958003408,2871.208806,2995.578118,5019.022599,4304.140811,9977,409.7330595,19954,-4893696,214528,-4679168,-1
3098,229,21,9,0.0688307785,0.931169222,942.0609883,1179.061167,1659.060362,1730.825328,3327,119.2473118,6654,-1586176,117248,-1468928,-1
3493,472,24,6,0.119041614,0.880958386,1152.099359,1044.57265,1944.645004,2266.84322,3965,182.718894,7930,-1788416,241664,-1546752,-1
9328,406,19,11,0.041709472,0.958290528,2793.658439,3110.156994,4891.679567,4311.965517,9734,363.7518685,19468,-4775936,207872,-4568064,-1
9577,397,27,3,0.0398034891,0.960196511,2872.954769,2976.0005,5009.985904,4445.062972,9974,1598.397436,19948,-4903424,203264,-4700160,-1
3487,268,19,11,0.0713715047,0.928628495,1058.308474,1265.047365,1917.889877,1358.985075,3755,177.3736419,7510,-1785344,137216,-1648128,-1
9245,684,22,8,0.0688891127,0.931110887,2844.220482,2921.367055,5048.920173,3830.72807,9929,643.4867142,19858,-4733440,350208,-4383232,-1
43,12,22,8,0.218181818,0.781818182,16.00165621,13.97095201,29.60465116,22.25,55,8.84244373,110,-22016,6144,-15872,-1
2097,288,21,9,0.120754717,0.879245283,687.7363022,693.8837553,1194.274201,1183.722222,2385,156.3934426,4770,-1073664,147456,-926208,-1
9370,585,20,10,0.05876444,0.94123556,2840.46873,3322.653569,5009.213661,4478.047863,9955,447.0139201,19910,-4797440,299520,-4497920,-1
9544,428,19,11,0.0429201765,0.957079824,2851.865448,3190.999928,5040.753982,3776.686916,9972,1048.580442,19944,-4886528,219136,-4667392,-1
9600,380,20,10,0.0380761523,0.961923848,2876.258605,2942.612835,5012.715625,4429.263158,9980,1008.080808,19960,-4915200,194560,-4720640,-1
1261,77,18,12,0.05754858,0.94245142,378.0513787,428.712514,684.9555908,416.3896104,1338,186.6108787,2676,-645632,39424,-606208,-1
2787,288,22,8,0.0936585366,0.906341463,882.8211444,881.232789,1568.254754,1245.222222,3075,66.50086505,6150,-1426944,147456,-1279488,-1
337,37,24,6,0.0989304813,0.901069519,106.2266404,122.633818,187.2284866,189.972973,374,47.70408163,748,-172544,18944,-153600,-1
315,36,27,3,0.102564103,0.897435897,98.48315266,123.4191487,176.1555556,174.6388889,351,33.39676499,702,-161280,18432,-142848,-1
925,127,22,8,0.120722433,0.879277567,299.173512,331.9847162,532.0010811,486.4330709,1052,30.48391771,2104,-473600,65024,-408576,-1
3879,253,17,13,0.0612294288,0.938770571,1170.737605,1468.04945,2050.104151,2317.881423,4132,178.4110535,8264,-1986048,129536,-1856512,-1
9535,437,20,10,0.0438227036,0.956177296,2864.421693,3155.751388,5001.579654,4657.473684,9972,1270.318471,19944,-4881920,223744,-4658176,-1
2745,186,22,8,0.0634595701,0.93654043,840.4131087,836.9917409,1491.98725,1082.478495,2931,83.62339515,5862,-1405440,95232,-1310208,-1
122,27,19,11,0.181208054,0.818791946,41.54103294,32.05550741,82.45081967,41.33333333,149,33.18485523,298,-62464,13824,-48640,-1
407,78,17,13,0.160824742,0.839175258,133.3091742,146.1190039,258.5085995,162.0769231,485,36.65910809,970,-208384,39936,-168448,-1
60,24,18,12,0.285714286,0.714285714,23.68389045,24.68003579,44.8,36.75,84,1.527272727,168,-30720,12288,-18432,-1
9588,390,22,8,0.0390859892,0.960914011,2876.19499,2945.47243,5008.034522,4533.835897,9978,883.7909655,19956,-4909056,199680,-4709376,-1
1406,103,27,3,0.0682571239,0.931742876,428.7490064,448.2386669,773.6820768,499.9805825,1509,36.21310295,3018,-719872,52736,-667136,-1
1878,154,21,9,0.0757874016,0.924212598,570.4695723,753.2670656,1011.449947,1078.084416,2032,87.66177739,4064,-961536,78848,-882688,-1
455,117,19,11,0.204545455,0.795454545,158.3044261,189.3067104,286.9010989,284.9401709,572,29.43901184,1144,-232960,59904,-173056,-1
4931,335,21,9,0.0636156476,0.936384352,1500.903752,1770.259995,2621.46522,2810.644776,5266,145.670816,10532,-2524672,171520,-2353152,-1
1961,182,23,7,0.0849276715,0.915072329,619.2417027,610.8566521,1075.332993,1036.087912,2143,79.63582311,4286,-1004032,93184,-910848,-1
9359,601,22,8,0.0603413655,0.939658635,2832.456482,3453.411459,4957.187306,5343.53411,9960,772.0930233,19920,-4791808,307712,-4484096,-1
6154,917,22,8,0.129684627,0.870315373,2010.502451,2043.834657,3409.765518,4383.161396,7071,167.2817601,14142,-3150848,469504,-2681344,-1
1050,125,20,10,0.106382979,0.893617021,326.5955073,403.2838971,605.0180952,445.048,1175,49.78813559,2350,-537600,64000,-473600,-1
554,98,21,9,0.150306748,0.849693252,182.2620978,202.8897994,313.1227437,402.122449,652,52.62308313,1304,-283648,50176,-233472,-1
9311,635,20,10,0.0638447617,0.936155238,2832.268156,3382.653402,4988.829879,4748.71811,9946,334.0947262,19892,-4767232,325120,-4442112,-1
5890,689,17,13,0.104727162,0.895272838,1845.929491,2230.059141,3225.550424,3840.955007,6579,141.3926499,13158,-3015680,352768,-2662912,-1
4442,185,19,11,0.0399827102,0.96001729,1326.069518,1462.744761,2334.805718,1814.437838,4627,392.4512299,9254,-2274304,94720,-2179584,-1
2138,258,21,9,0.107679466,0.892320534,682.8511675,758.5363713,1191.830683,1253.767442,2396,196.8775678,4792,-1094656,132096,-962560,-1
4164,213,20,10,0.0486634681,0.951336532,1251.094022,1482.699262,2184.135447,2284.098592,4377,427.8592375,8754,-2131968,109056,-2022912,-1
3571,440,27,3,0.10969833,0.89030167,1145.864619,1128.748761,1943.264912,2515.152273,4011,75.56518463,8022,-1828352,225280,-1603072,-1
7583,375,20,10,0.0471223926,0.952877607,2270.979087,2772.106007,3986.689833,3834.112,7958,288.542422,15916,-3882496,192000,-3690496,-1
6506,843,21,9,0.114709484,0.885290516,2009.280011,2525.76376,3516.141869,4901.015421,7349,541.5622697,14698,-3331072,431616,-2899456,-1
4801,337,21,9,0.0655897236,0.934410276,1472.962302,1557.601759,2600.258488,2131.305638,5138,319.1304348,10276,-2458112,172544,-2285568,-1
58,17,23,7,0.226666667,0.773333333,22.40236446,18.01594834,39.43103448,33.11764706,75,2.244836875,150,-29696,8704,-20992,-1
2074,245,21,9,0.105648987,0.894351013,657.5966164,693.074747,1124.529412,1460.269388,2319,78.13342318,4638,-1061888,125440,-936448,-1
2284,131,20,10,0.0542443064,0.945755694,693.5029627,722.5799549,1220.76007,985.5267176,2415,74.88372093,4830,-1169408,67072,-1102336,-1
5308,242,25,5,0.0436036036,0.956396396,1591.990871,1739.774904,2797.864167,2284.966942,5550,401.0115607,11100,-2717696,123904,-2593792,-1
3271,255,27,3,0.0723199092,0.927680091,1004.709961,1139.352698,1784.647508,1492.231373,3526,103.9504717,7052,-1674752,130560,-1544192,-1
9609,371,20,10,0.0371743487,0.962825651,2870.129582,3044.650162,5020.950879,4201.814016,9980,381.0614738,19960,-4919808,189952,-4729856,-1
6243,370,20,10,0.0559504007,0.944049599,1883.45946,2278.432106,3324.078328,3018.837838,6613,141.1526147,13226,-3196416,189440,-3006976,-1
8983,941,22,8,0.0948206368,0.905179363,2898.316641,2319.1975,5061.421908,4018.168969,9924,358.5260116,19848,-4599296,481792,-4117504,-1
1740,308,25,5,0.150390625,0.849609375,597.0798616,551.6255883,1012.066667,1094.74026,2048,94.42139235,4096,-890880,157696,-733184,-1
5385,356,20,10,0.0620101028,0.937989897,1627.623671,2026.30667,2849.338904,3198.654494,5741,130.004529,11482,-2757120,182272,-2574848,-1
9584,394,19,11,0.0394868711,0.960513129,2880.5958,2857.987648,5002.319804,4677.659898,9978,1043.723849,19956,-4907008,201728,-4705280,-1
1576,239,20,10,0.131680441,0.868319559,519.8232168,542.4127454,921.1643401,821.1924686,1815,48.21997875,3630,-806912,122368,-684544,-1
5315,778,21,9,0.12768751,0.87231249,1738.499079,1657.64474,2922.199436,3899.589974,6093,158.424337,12186,-2721280,398336,-2322944,-1
4487,283,26,4,0.0593291405,0.94067086,1373.075533,1374.413214,2411.259193,1977.084806,4770,279.110591,9540,-2297344,144896,-2152448,-1
5193,369,20,10,0.0663430421,0.933656958,1598.673938,1681.796423,2798.647603,2540.178862,5562,527.2037915,11124,-2658816,188928,-2469888,-1
4151,542,20,10,0.115491157,0.884508843,1353.756943,1361.010842,2354.421344,2290.162362,4693,89.57816377,9386,-2125312,277504,-1847808,-1
39,22,21,9,0.360655738,0.639344262,16.58984267,19.24123714,30.46153846,31.95454545,61,10.68301226,122,-19968,11264,-8704,-1
821,95,18,12,0.10371179,0.89628821,258.6364812,309.986985,458.6224117,457.4421053,916,37.72652389,1832,-420352,48640,-371712,-1
3804,317,20,10,0.0769230769,0.923076923,1165.464269,1362.211093,2100.431651,1587.820189,4121,333.4142395,8242,-1947648,162304,-1785344,-1
9458,506,21,9,0.0507828181,0.949217182,2862.885083,2917.768624,5039.729224,3912.788538,9964,1026.158599,19928,-4842496,259072,-4583424,-1
2984,165,27,3,0.0523975865,0.947602413,910.005927,861.6102693,1587.290214,1352.733333,3149,122.7201871,6298,-1527808,84480,-1443328,-1
4496,326,20,10,0.0676068022,0.932393198,1370.942584,1653.607615,2406.410142,2481.696319,4822,119.1794365,9644,-2301952,166912,-2135040,-1
1523,152,19,11,0.0907462687,0.909253731,471.4885068,589.3919592,841.8680236,799.2434211,1675,88.11152025,3350,-779776,77824,-701952,-1
1239,176,20,10,0.124381625,0.875618375,404.2243511,420.2130596,724.0573043,594.9602273,1415,43.29865361,2830,-634368,90112,-544256,-1
3227,266,20,10,0.0761523046,0.923847695,991.0979555,1157.038475,1771.586303,1448.729323,3493,67.21185299,6986,-1652224,136192,-1516032,-1
9422,534,21,9,0.0536359984,0.946364002,2857.322025,3114.337336,5006.213224,4489.522472,9956,477.7351248,19912,-4824064,273408,-4550656,-1
7296,585,21,9,0.0742291587,0.925770841,2241.958475,2564.349251,3888.442982,4596.480342,7881,367.5839552,15762,-3735552,299520,-3436032,-1
1334,131,20,10,0.0894197952,0.910580205,411.1311417,526.3434574,737.0262369,692,1465,28.00611738,2930,-683008,67072,-615936,-1
8611,316,21,9,0.0353982301,0.96460177,2575.04677,2617.386525,4473.179073,4213.870253,8927,408.5583524,17854,-4408832,161792,-4247040,-1
1370,89,18,12,0.0610006854,0.938999315,412.4173622,478.657378,745.5065693,491.3033708,1459,150.2574665,2918,-701440,45568,-655872,-1
939,67,21,9,0.0666003976,0.933399602,285.1129148,331.7702204,512.4792332,377.6567164,1006,33.53333333,2012,-480768,34304,-446464,-1
3265,224,21,9,0.064201777,0.935798223,990.2570693,1187.105936,1724.210107,2048.03125,3489,232.1357285,6978,-1671680,114688,-1556992,-1
9495,468,20,10,0.0469738031,0.953026197,2855.273326,3268.925167,4985.114692,4918.807692,9963,276.2129193,19926,-4861440,239616,-4621824,-1
4594,1120,19,11,0.1960098,0.8039902,1493.002071,1745.824618,2573.317588,4023.155357,5714,181.3968254,11428,-2352128,573440,-1778688,-1
4006,189,26,4,0.0450536353,0.954946365,1199.691338,1405.033337,2110.181727,1839.798942,4195,187.2767857,8390,-2051072,96768,-1954304,-1
8924,972,21,9,0.0982215036,0.901778496,2864.54406,2771.973761,4975.185567,4703.497942,9896,382.9721362,19792,-4569088,497664,-4071424,-1
2506,213,21,9,0.0783376241,0.921662376,763.6917392,994.1503833,1350.245012,1474.769953,2719,215.6225218,5438,-1283072,109056,-1174016,-1
1543,294,20,10,0.160043549,0.839956451,532.0900651,499.5334997,893.2890473,1053.938776,1837,137.8094524,3674,-790016,150528,-639488,-1
9130,790,21,9,0.0796370968,0.920362903,2806.301074,3457.610505,4965.666703,4900.788608,9920,648.3660131,19840,-4674560,404480,-4270080,-1
1667,175,21,9,0.0950054289,0.904994571,518.4555637,644.0689808,918.6526695,948.6228571,1842,60.93284816,3684,-853504,89600,-763904,-1
9495,467,20,10,0.0468781369,0.953121863,2865.763883,2995.000803,5014.402528,4312.528908,9962,987.3141724,19924,-4861440,239104,-4622336,-1
9002,898,22,8,0.0907070707,0.909292929,2830.286867,3074.961273,4899.653633,5460.209354,9900,546.961326,19800,-4609024,459776,-4149248,-1
694,36,20,10,0.0493150685,0.950684932,207.7167276,229.9735945,371.8674352,242.75,730,116.9871795,1460,-355328,18432,-336896,-1
4822,607,22,8,0.111806963,0.888193037,1577.076928,1483.209787,2703.147034,2809.159802,5429,177.5924109,10858,-2468864,310784,-2158080,-1
5264,319,23,7,0.0571377396,0.94286226,1589.597154,1843.267388,2827.601444,2204.520376,5583,205.5596465,11166,-2695168,163328,-2531840,-1
116,27,20,10,0.188811189,0.811188811,40.25206972,27.62764366,79.56034483,39.51851852,143,27.82101167,286,-59392,13824,-45568,-1
300,58,16,14,0.162011173,0.837988827,97.04418444,124.4262851,186.86,141.4310345,358,47.04336399,716,-153600,29696,-123904,-1
2184,231,27,3,0.0956521739,0.904347826,667.1967166,926.3314845,1195.967949,1321.757576,2415,48.01192843,4830,-1118208,118272,-999936,-1
4108,336,19,11,0.0756075608,0.924392439,1264.576051,1451.635695,2196.613437,2538.994048,4444,108.5756169,8888,-2103296,172032,-1931264,-1
2166,181,21,9,0.0771197273,0.922880273,657.6331322,831.2463919,1197.51662,892.5801105,2347,134.1909663,4694,-1108992,92672,-1016320,-1
1792,143,25,5,0.0739018088,0.926098191,553.973629,597.2268866,978.7645089,833.1048951,1935,51.90450644,3870,-917504,73216,-844288,-1
5987,694,22,8,0.103876665,0.896123335,1863.968252,2260.934328,3247.649574,4146.315562,6681,144.7043535,13362,-3065344,355328,-2710016,-1
8040,749,25,5,0.0852201616,0.914779838,2461.638597,3204.844508,4353.31505,4842.459279,8789,403.3501606,17578,-4116480,383488,-3732992,-1
4139,270,27,3,0.061238376,0.938761624,1262.028983,1279.562125,2244.972699,1592.233333,4409,183.7083333,8818,-2119168,138240,-1980928,-1
428,112,18,12,0.207407407,0.792592593,149.3617084,178.4520063,272.3528037,263.4196429,540,52.52918288,1080,-219136,57344,-161792,-1
224,38,17,13,0.145038168,0.854961832,71.1967796,74.27506059,141.4732143,72.71052632,262,32.18673219,524,-114688,19456,-95232,-1
2654,206,21,9,0.072027972,0.927972028,816.2128185,888.9486597,1452.955539,1141.194175,2860,130,5720,-1358848,105472,-1253376,-1
97,22,20,10,0.18487395,0.81512605,33.82603837,16.13450694,66.72164948,30.36363636,119,26.44444444,238,-49664,11264,-38400,-1
249,39,25,5,0.135416667,0.864583333,82.67190647,80.62857105,148.8795181,116.5384615,288,14.81481481,576,-127488,19968,-107520,-1
4898,283,22,8,0.0546226597,0.94537734,1495.753906,1464.897312,2607.315231,2308.625442,5181,385.4910714,10362,-2507776,144896,-2362880,-1
1776,169,20,10,0.0868894602,0.91311054,553.0740069,642.0427855,969.5878378,1008.857988,1945,141.3517442,3890,-909312,86528,-822784,-1
2113,219,20,10,0.0939108062,0.906089194,658.6890507,794.0722682,1175.850923,1076.278539,2332,105.1871899,4664,-1081856,112128,-969728,-1
9538,434,20,10,0.0435218612,0.956478139,2866.615218,3082.053713,5011.259593,4442.359447,9972,1572.870662,19944,-4883456,222208,-4661248,-1
112,25,19,11,0.182481752,0.817518248,38.33029371,28.35534518,75.94642857,37.88,137,24.50805009,274,-57344,12800,-44544,-1
5629,872,22,8,0.13413321,0.86586679,1847.112086,1951.075875,3156.92663,3858.269495,6501,127.1464893,13002,-2882048,446464,-2435584,-1
779,129,20,10,0.142070485,0.857929515,248.9786763,292.7614599,430.9640565,596.627907,908,19.14400169,1816,-398848,66048,-332800,-1
3892,288,27,3,0.0688995215,0.931100478,1193.967688,1315.593647,2116.936023,1733.246528,4180,297.9330007,8360,-1992704,147456,-1845248,-1
7346,355,23,7,0.0460979094,0.953902091,2191.80406,2769.399577,3868.049142,3498.202817,7701,315.8736669,15402,-3761152,181760,-3579392,-1
153,25,20,10,0.140449438,0.859550562,49.28049097,50.72870588,95.09150327,55.28,178,23.57615894,356,-78336,12800,-65536,-1
890,63,21,9,0.0661070304,0.93389297,270.3636895,333.5676659,479.1303371,446.9047619,953,101.2752391,1906,-455680,32256,-423424,-1
2865,160,23,7,0.052892562,0.947107438,864.5467771,916.1972203,1536.920768,1084.66875,3025,227.2727273,6050,-1466880,81920,-1384960,-1
2986,240,20,10,0.0743955363,0.925604464,915.3135079,1101.439947,1602.405224,1751.5375,3226,98.86607416,6452,-1528832,122880,-1405952,-1
2088,287,21,9,0.120842105,0.879157895,669.3149036,778.936801,1168.087644,1332.867596,2375,77.91994751,4750,-1069056,146944,-922112,-1
9596,384,21,9,0.0384769539,0.961523046,2865.49479,3153.844207,5020.298458,4245.848958,9980,1069.667738,19960,-4913152,196608,-4716544,-1
9068,842,19,11,0.0849646821,0.915035318,2804.345035,3199.558153,4850.802713,6083.047506,9910,538.5869565,19820,-4642816,431104,-4211712,-1
6628,253,21,9,0.0367679116,0.963232088,1975.680694,2217.403507,3454.951418,3075.505929,6881,304.7387068,13762,-3393536,129536,-3264000,-1
4266,292,21,9,0.0640631856,0.935936814,1287.308951,1650.229864,2299.456634,1987.941781,4558,337.879911,9116,-2184192,149504,-2034688,-1
2868,127,21,9,0.0424040067,0.957595993,859.7740646,918.9695117,1511.01569,1204.070866,2995,462.191358,5990,-1468416,65024,-1403392,-1
76,23,19,11,0.232323232,0.767676768,28.52472563,20.31416763,55.39473684,32.17391304,99,23.13084112,198,-38912,11776,-27136,-1
4302,529,25,5,0.109501138,0.890498862,1379.65708,1509.029971,2408.12901,2480.009452,4831,126.2676424,9662,-2202624,270848,-1931776,-1
7087,419,20,10,0.0558220091,0.944177991,2149.723729,2435.792827,3758.742768,3664.823389,7506,593.8291139,15012,-3628544,214528,-3414016,-1
6016,436,21,9,0.0675759454,0.932424055,1847.037857,1989.318334,3265.130153,2693.474771,6452,563.986014,12904,-3080192,223232,-2856960,-1
8736,1143,23,7,0.11569997,0.88430003,2837.714054,2876.739752,4855.585165,5585.186352,9879,515.3364632,19758,-4472832,585216,-3887616,-1
9366,576,21,9,0.057936029,0.942063971,2831.159013,3394.447003,4937.938821,5517.21875,9942,865.2741514,19884,-4795392,294912,-4500480,-1
4084,394,17,13,0.0879857079,0.912014292,1268.719086,1464.460675,2202.331293,2624.771574,4478,247.2667035,8956,-2091008,201728,-1889280,-1
9023,716,21,9,0.0735188418,0.926481158,2766.99377,3299.760028,4841.646902,5227.304469,9739,239.7587395,19478,-4619776,366592,-4253184,-1
3290,238,18,12,0.0674603175,0.932539683,1007.206619,990.1104028,1807.086322,1175.806723,3528,417.0212766,7056,-1684480,121856,-1562624,-1
4554,265,22,8,0.054990662,0.945009338,1361.823998,1525.379159,2466.417216,1440.475472,4819,140.6186169,9638,-2331648,135680,-2195968,-1
999,112,25,5,0.100810081,0.899189919,310.9050337,393.0555177,562.4244244,498.6964286,1111,95.85849871,2222,-511488,57344,-454144,-1
1700,182,19,11,0.0967056323,0.903294368,531.9112705,629.5141371,953.1523529,832.6593407,1882,34.4751786,3764,-870400,93184,-777216,-1
1975,220,21,9,0.10022779,0.89977221,619.7328776,691.9838219,1127.729114,831.1136364,2195,291.1140584,4390,-1011200,112640,-898560,-1
68,24,17,13,0.260869565,0.739130435,26.50734376,19.32542942,52.08823529,30.66666667,92,16.84981685,184,-34816,12288,-22528,-1
1123,110,27,3,0.0892133009,0.910786699,349.500907,400.530289,627.4986643,509.8181818,1233,182.9376855,2466,-574976,56320,-518656,-1
2522,220,17,13,0.0802334063,0.919766594,776.2091697,947.0888988,1377.548374,1302.163636,2742,102.0848846,5484,-1291264,112640,-1178624,-1
6594,1001,22,8,0.131797235,0.868202765,2155.714023,2294.814057,3688.970428,4516.222777,7595,144.0629742,15190,-3376128,512512,-2863616,-1
924,46,19,11,0.0474226804,0.95257732,275.2657225,331.4300151,492.6298701,342.2826087,970,197.1544715,1940,-473088,23552,-449536,-1
5512,370,20,10,0.0629037742,0.937096226,1677.18038,1710.625216,3006.581459,1971.962162,5882,131.0314101,11764,-2822144,189440,-2632704,-1
91,37,17,13,0.2890625,0.7109375,35.22792418,38.92229715,68.78021978,53.97297297,128,15.00586166,256,-46592,18944,-27648,-1
40,22,18,12,0.35483871,0.64516129,18.63974249,15.75490216,33.6,27.68181818,62,12.01550388,124,-20480,11264,-9216,-1
5376,1382,16,14,0.204498372,0.795501628,1829.457742,2099.452293,3130.061012,4349.821274,6758,161.3658071,13516,-2752512,707584,-2044928,-1
176,38,19,11,0.177570093,0.822429907,61.81483295,51.93910242,113.9829545,77.47368421,214,42.12598425,428,-90112,19456,-70656,-1
9446,531,21,9,0.0532224115,0.946777588,2886.394062,2660.158718,5030.446432,4251.706215,9977,859.3453919,19954,-4836352,271872,-4564480,-1
6914,411,19,11,0.056109215,0.943890785,2082.502711,2564.296612,3640.041221,4049.221411,7325,250,14650,-3539968,210432,-3329536,-1
9595,385,22,8,0.0385771543,0.961422846,2868.210861,3122.116536,5014.806983,4384.719481,9980,984.2209073,19960,-4912640,197120,-4715520,-1
2708,228,21,9,0.0776566757,0.922343324,839.0643174,922.3649832,1484.173929,1282.337719,2936,282.0365034,5872,-1386496,116736,-1269760,-1
3939,333,19,11,0.0779494382,0.922050562,1232.506715,1175.452934,2168.965981,1752.465465,4272,169.7933227,8544,-2016768,170496,-1846272,-1
7302,2289,20,10,0.238661245,0.761338755,2462.68185,2770.321795,4178.447549,6766.016601,9591,185.3691535,19182,-3738624,1171968,-2566656,-1
2157,236,21,9,0.0986209779,0.901379022,668.6683856,866.8431054,1194.111266,1223.402542,2393,135.3506787,4786,-1104384,120832,-983552,-1
1398,94,18,12,0.063002681,0.936997319,423.137662,469.3209054,762.6165951,506.8085106,1492,200.2684564,2984,-715776,48128,-667648,-1
1557,176,19,11,0.101557992,0.898442008,480.2706594,650.7764232,865.2010276,882.9147727,1733,111.5186615,3466,-797184,90112,-707072,-1
116,15,21,9,0.114503817,0.885496183,36.76139744,32.58384058,69.80172414,36.6,131,18.98550725,262,-59392,7680,-51712,-1
844,133,19,11,0.136131013,0.863868987,281.8171255,265.9119404,503.3625592,397.8571429,977,87.3881932,1954,-432128,68096,-364032,-1
4024,171,22,8,0.0407628129,0.959237187,1207.13934,1280.001381,2107.055417,1884.906433,4195,532.3604061,8390,-2060288,87552,-1972736,-1
9461,497,26,4,0.0499096204,0.95009038,2845.660735,2978.278571,5061.226509,3423.736419,9958,692.0083391,19916,-4844032,254464,-4589568,-1
216,38,21,9,0.149606299,0.850393701,71.7137777,81.19465087,125.7962963,137.1842105,254,9.153153153,508,-110592,19456,-91136,-1
5896,388,20,10,0.061744112,0.938255888,1805.843052,1933.656591,3139.454037,3188.786082,6284,216.9889503,12568,-3018752,198656,-2820096,-1
4515,319,22,8,0.0659908978,0.934009102,1381.327768,1530.259482,2444.88505,2029.902821,4834,89.91815476,9668,-2311680,163328,-2148352,-1
9550,417,21,9,0.0418380656,0.958161934,2869.480068,3029.804624,4998.683455,4647.724221,9967,1100.110375,19934,-4889600,213504,-4676096,-1
9529,442,20,10,0.0443285528,0.955671447,2871.77668,2937.739554,5017.196453,4313.441176,9971,750.8283133,19942,-4878848,226304,-4652544,-1
931,117,20,10,0.111641221,0.888358779,295.9975833,307.8446968,544.2760473,367.1367521,1048,25.82552982,2096,-476672,59904,-416768,-1
4184,222,21,9,0.0503858375,0.949614163,1266.487487,1363.620491,2210.308317,2075.184685,4406,131.8372232,8812,-2142208,113664,-2028544,-1
8967,942,21,9,0.0950650923,0.904934908,2828.627531,3067.712152,4884.578231,5625.352442,9909,774.7458952,19818,-4591104,482304,-4108800,-1
2179,242,21,9,0.0999586948,0.900041305,674.6929445,856.5806766,1235.456631,990.7892562,2421,108.2253017,4842,-1115648,123904,-991744,-1
2269,307,20,10,0.119177019,0.880822981,741.3090566,759.3851015,1283.178933,1327.827362,2576,149.3333333,5152,-1161728,157184,-1004544,-1
9391,560,19,11,0.0562757512,0.943724249,2847.628723,3136.0895,5028.226813,4100.175,9951,766.6409861,19902,-4808192,286720,-4521472,-1
1419,124,22,8,0.0803629294,0.919637071,439.9284537,480.4432258,759.2156448,918.2983871,1543,42.23925541,3086,-726528,63488,-663040,-1
9556,411,25,5,0.0412360791,0.958763921,2859.408723,3087.625092,5028.595437,3947.128954,9967,763.7547893,19934,-4892672,210432,-4682240,-1
138,34,19,11,0.197674419,0.802325581,48.46455093,52.31284816,89.63043478,73.79411765,172,15.04811899,344,-70656,17408,-53248,-1
1374,67,17,13,0.0464954892,0.953504511,409.1425227,472.9235808,733.1484716,471.8656716,1441,222.0338983,2882,-703488,34304,-669184,-1
5515,330,21,9,0.0564585115,0.943541488,1660.51484,2080.958265,2930.251677,2801.809091,5845,490.352349,11690,-2823680,168960,-2654720,-1
3799,243,22,8,0.0601187531,0.939881247,1158.961839,1271.168494,2032.508818,1849.390947,4042,431.3767343,8084,-1945088,124416,-1820672,-1
463,83,21,9,0.152014652,0.847985348,148.3496024,189.1913728,261.9848812,337.7349398,546,43.43675418,1092,-237056,42496,-194560,-1
2371,230,22,8,0.0884275279,0.911572472,737.3801359,876.2802374,1296.40911,1348.326087,2601,109.5157895,5202,-1213952,117760,-1096192,-1
7537,427,20,10,0.0536162732,0.946383727,2281.322891,2573.235924,3999.376012,3684.620609,7964,387.5425791,15928,-3858944,218624,-3640320,-1
93,25,20,10,0.211864407,0.788135593,34.59940712,19.1567847,65.61290323,36.76,118,20.20547945,236,-47616,12800,-34816,-1
8274,316,20,10,0.0367869616,0.963213038,2471.246988,2617.101165,4319.149867,3676.262658,8590,870.3140831,17180,-4236288,161792,-4074496,-1
5048,691,19,11,0.120404252,0.879595748,1647.510091,1720.815599,2879.485737,2800.703329,5739,151.4647664,11478,-2584576,353792,-2230784,-1
7987,1372,22,8,0.146596859,0.853403141,2540.876077,2482.529949,4289.842244,6951.27551,9359,267.4,18718,-4089344,702464,-3386880,-1
4229,178,16,14,0.0403902882,0.959609712,1261.850407,1443.519132,2220.352566,1815.488764,4407,588.3845127,8814,-2165248,91136,-2074112,-1
3334,191,22,8,0.0541843972,0.945815603,1006.129475,1151.460406,1781.818836,1434.507853,3525,94.78354396,7050,-1707008,97792,-1609216,-1
1484,95,27,3,0.0601646612,0.939835339,457.9910179,420.1334103,790.9575472,775.0421053,1579,253.0448718,3158,-759808,48640,-711168,-1
146,33,20,10,0.184357542,0.815642458,49.9831516,48.04419071,96.83561644,59.75757576,179,21.54031288,358,-74752,16896,-57856,-1
239,58,20,10,0.195286195,0.804713805,84.70984029,85.53373033,154.9832636,124.3448276,297,21.98371577,594,-122368,29696,-92672,-1
283,29,20,10,0.0929487179,0.907051282,87.89949881,76.6796539,164.0565371,82.75862069,312,12.27380016,624,-144896,14848,-130048,-1
7193,373,20,10,0.0492994978,0.950700502,2161.053351,2262.79383,3847.107605,2556.879357,7566,457.9903148,15132,-3682816,190976,-3491840,-1
7041,392,22,8,0.0527377909,0.947262209,2135.165647,2297.903816,3736.944752,3358.757653,7433,685.0691244,14866,-3604992,200704,-3404288,-1
640,95,18,12,0.129251701,0.870748299,199.1879373,261.0793055,352.2984375,473.7789474,735,13.56839579,1470,-327680,48640,-279040,-1
660,66,16,14,0.0909090909,0.909090909,202.7538347,201.5192281,380.4090909,194.4090909,726,93.07692308,1452,-337920,33792,-304128,-1
3444,1869,27,3,0.351778656,0.648221344,1289.351945,1239.775526,2025.862369,3819.995185,5313,101.8596626,10626,-1763328,956928,-806400,-1
778,119,20,10,0.132664437,0.867335563,253.6587157,279.9756572,460.3676093,374.6806723,897,66.59242762,1794,-398336,60928,-337408,-1
4239,295,21,9,0.0650639612,0.934936039,1291.689157,1477.990805,2239.75348,2666.20339,4534,226.8134067,9068,-2170368,151040,-2019328,-1
1665,103,19,11,0.0582579186,0.941742081,501.6264639,532.6148924,905.2930931,548.3786408,1768,32.13961098,3536,-852480,52736,-799744,-1
40,20,20,10,0.333333333,0.666666667,17.9776076,15.89740545,30.825,29.85,60,27.77777778,120,-20480,10240,-10240,-1
7961,669,22,8,0.0775202781,0.922479722,2475.790318,2525.076524,4385.171838,3486.415546,8630,272.2397476,17260,-4076032,342528,-3733504,-1
2250,180,22,8,0.0740740741,0.925925926,686.4753686,847.2875225,1201.199556,1394.255556,2430,90.90909091,4860,-1152000,92160,-1059840,-1
7149,720,20,10,0.0914982844,0.908501716,2225.941725,2663.586814,3965.90726,3628.116667,7869,151.9111969,15738,-3660288,368640,-3291648,-1
134,15,20,10,0.100671141,0.899328859,41.08455942,42.65030936,79.08208955,38.53333333,149,7.394540943,298,-68608,7680,-60928,-1
295,65,16,14,0.180555556,0.819444444,99.42172934,115.024052,188.779661,142.9230769,360,39.13043478,720,-151040,33280,-117760,-1
3426,220,21,9,0.0603400987,0.939659901,1042.161647,1182.177578,1809.894046,2035.381818,3646,341.3857678,7292,-1754112,112640,-1641472,-1
1538,107,18,12,0.0650455927,0.934954407,469.1549937,504.0205848,837.8940182,608.9158879,1645,241.202346,3290,-787456,54784,-732672,-1
397,78,17,13,0.164210526,0.835789474,130.7167697,128.5284903,256.8488665,142.0641026,475,61.21134021,950,-203264,39936,-163328,-1
6981,456,19,11,0.0613150464,0.938684954,2107.886927,2611.704433,3682.767655,4273.688596,7437,412.4792013,14874,-3574272,233472,-3340800,-1
3173,232,20,10,0.0681350954,0.931864905,958.7678181,1180.773426,1735.638512,1256.612069,3405,120.5736544,6810,-1624576,118784,-1505792,-1
2705,382,18,12,0.123744736,0.876255264,873.7615098,984.0115513,1516.574492,1738.204188,3087,58.34435834,6174,-1384960,195584,-1189376,-1
412,65,27,3,0.136268344,0.863731656,135.6024604,143.4756149,245.565534,197.3846154,477,69.13043478,954,-210944,33280,-177664,-1
9387,575,21,9,0.0577193335,0.942280667,2845.036343,3256.320546,5025.110152,4269.554783,9962,884.7246892,19924,-4806144,294400,-4511744,-1
3148,279,22,8,0.081412314,0.918587686,961.9347438,951.0393346,1783.863723,925.7168459,3427,64.5386064,6854,-1611776,142848,-1468928,-1
1524,221,21,9,0.126647564,0.873352436,492.711954,552.5125136,894.1023622,727.479638,1745,109.1989987,3490,-780288,113152,-667136,-1
68,28,18,12,0.291666667,0.708333333,29.20635625,18.65927028,53.55882353,36.21428571,96,19.2,192,-34816,14336,-20480,-1
6618,413,25,5,0.0587398663,0.941260134,1992.080323,2557.799752,3516.368994,3510.087167,7031,161.0767468,14062,-3388416,211456,-3176960,-1
4223,298,20,10,0.0659146207,0.934085379,1287.808716,1426.575,2298.57471,1728.52349,4521,331.4516129,9042,-2162176,152576,-2009600,-1
1553,204,21,9,0.116107001,0.883892999,510.697037,474.8528315,887.454604,814.6372549,1757,132.2046652,3514,-795136,104448,-690688,-1
8473,444,20,10,0.0497925311,0.950207469,2537.098116,3184.051685,4475.038947,4152.923423,8917,313.3169361,17834,-4338176,227328,-4110848,-1
3121,185,20,10,0.0559588627,0.944041137,949.3136601,1017.368354,1642.298302,1842.475676,3306,77.17086835,6612,-1597952,94720,-1503232,-1
9325,622,20,10,0.0625314165,0.937468583,2850.437282,3062.200267,5026.895871,4180.987138,9947,582.7182191,19894,-4774400,318464,-4455936,-1
4709,355,21,9,0.0701026856,0.929897314,1434.158136,1752.195967,2558.774899,2183.969014,5064,129.4809512,10128,-2411008,181760,-2229248,-1
2730,136,27,3,0.047452896,0.952547104,818.4821045,901.6806163,1453.202198,1038.007353,2866,197.9281768,5732,-1397760,69632,-1328128,-1
9136,787,18,12,0.0793106923,0.920689308,2802.211137,3507.7611,4960.844899,4975.409149,9923,481.9329772,19846,-4677632,402944,-4274688,-1
1835,167,20,10,0.0834165834,0.916583417,573.6933872,612.7127998,1011.108992,895.9161677,2002,74.56238361,4004,-939520,85504,-854016,-1
3769,160,21,9,0.0407228302,0.95927717,1128.469061,1201.661323,1981.002653,1588.0375,3929,461.6921269,7858,-1929728,81920,-1847808,-1
3979,238,17,13,0.0564382262,0.943561774,1205.762537,1316.768638,2136.076652,1656.319328,4217,375.1779359,8434,-2037248,121856,-1915392,-1
121,40,18,12,0.248447205,0.751552795,43.38811964,52.87328602,85.09090909,68.625,161,3.06842005,322,-61952,20480,-41472,-1
3296,1012,19,11,0.234911792,0.765088208,1213.838554,1137.027153,1966.113167,2768.060277,4308,81.74573055,8616,-1687552,518144,-1169408,-1
6632,359,25,5,0.0513517379,0.948648262,2015.406879,2067.737623,3495.626206,3502.905292,6991,291.0491257,13982,-3395584,183808,-3211776,-1
3278,230,21,9,0.0655644242,0.934435576,995.9216569,1226.765902,1755.064979,1746.447826,3508,132.5273895,7016,-1678336,117760,-1560576,-1
46,12,22,8,0.206896552,0.793103448,16.62156626,14.53921899,31.63043478,21.33333333,58,8.734939759,116,-23552,6144,-17408,-1
2599,142,19,11,0.0518059103,0.94819409,779.36,983.215442,1368.994998,1407.697183,2741,54.83096619,5482,-1330688,72704,-1257984,-1
256,54,21,9,0.174193548,0.825806452,84.57686852,109.8239332,155.6054688,155,310,40.31209363,620,-131072,27648,-103424,-1
5221,209,21,9,0.0384898711,0.961510129,1557.495556,1782.014244,2725.34955,2469.449761,5430,141.2958626,10860,-2673152,107008,-2566144,-1
127,56,20,10,0.306010929,0.693989071,52.19565366,54.20232081,92.64566929,90.53571429,183,10.84765857,366,-65024,28672,-36352,-1
1330,137,21,9,0.0933878664,0.906612134,420.0087884,366.5899275,760.5774436,475.9854015,1467,111.8993135,2934,-680960,70144,-610816,-1
176,46,17,13,0.207207207,0.792792793,60.27961464,73.65590823,116.6647727,91.73913043,222,12.89947705,444,-90112,23552,-66560,-1
4578,249,20,10,0.0515848353,0.948415165,1380.060221,1606.91577,2424.788554,2215.646586,4827,395.0081833,9654,-2343936,127488,-2216448,-1
4478,281,21,9,0.0590460181,0.940953982,1360.40231,1568.841845,2386.104288,2282.72242,4759,355.9461481,9518,-2292736,143872,-2148864,-1
9556,418,21,9,0.0419089633,0.958091037,2872.395881,2990.272174,5008.865843,4499.050239,9974,1092.442497,19948,-4892672,214016,-4678656,-1
1383,132,19,11,0.0871287129,0.912871287,435.3305107,371.5849781,782.3998554,502.3560606,1515,192.2588832,3030,-708096,67584,-640512,-1
5520,434,21,9,0.0728921733,0.927107827,1682.816121,2123.034229,2981.28587,2929.347926,5954,310.4275287,11908,-2826240,222208,-2604032,-1
4689,321,16,14,0.0640718563,0.935928144,1423.971273,1731.888348,2494.650885,2663.978193,5010,338.0566802,10020,-2400768,164352,-2236416,-1
2311,113,25,5,0.0466171617,0.953382838,695.5555243,731.8007863,1225.466897,947.3097345,2424,94.13592233,4848,-1183232,57856,-1125376,-1
105,22,27,3,0.173228346,0.826771654,37.0890257,34.25502919,64.84761905,59.95454545,127,9.952978056,254,-53760,11264,-42496,-1
5729,455,21,9,0.0735769728,0.926423027,1770.199399,1897.688272,3053.849363,3579.158242,6184,129.4265383,12368,-2933248,232960,-2700288,-1
3171,563,17,13,0.150776647,0.849223353,1066.148878,1141.372454,1861.765689,1899.797513,3734,76.81547007,7468,-1623552,288256,-1335296,-1
217,36,16,14,0.14229249,0.85770751,68.13220195,82.65247787,134.9447005,79.11111111,253,41.88741722,506,-111104,18432,-92672,-1
9403,559,20,10,0.0561132303,0.94388677,2863.121157,2785.03907,5057.596086,3701.479428,9962,1298.826597,19924,-4814336,286208,-4528128,-1
2336,203,21,9,0.0799527373,0.920047263,720.4344047,862.7980558,1273.767551,1226.64532,2539,84.60513162,5078,-1196032,103936,-1092096,-1
2145,136,25,5,0.0596229724,0.940377028,649.6949735,700.803407,1162.60373,800.2647059,2281,41.67732505,4562,-1098240,69632,-1028608,-1
9427,548,17,13,0.0549373434,0.945062657,2873.224777,2979.654646,4998.986528,4799.00365,9975,325.4486134,19950,-4826624,280576,-4546048,-1
4113,240,20,10,0.0551343901,0.94486561,1245.032404,1415.12126,2192.275225,1915.220833,4353,143.7582563,8706,-2105856,122880,-1982976,-1
7163,394,20,10,0.0521370914,0.947862909,2168.965792,2222.189211,3827.306017,2900.786802,7557,208.2391843,15114,-3667456,201728,-3465728,-1
951,89,23,7,0.0855769231,0.914423077,295.1130308,349.8157298,519.0504732,535.988764,1040,90.04329004,2080,-486912,45568,-441344,-1
87,34,20,10,0.280991736,0.719008264,35.57532356,31.43936054,64.55172414,51.91176471,121,23.91304348,242,-44544,17408,-27136,-1
8926,496,17,13,0.052642751,0.947357249,2687.344359,3146.478381,4667.388752,5505.324597,9422,174.9025432,18844,-4570112,253952,-4316160,-1
55,27,19,11,0.329268293,0.670731707,24.95957724,19.8725017,43.96363636,36.48148148,82,18.18181818,164,-28160,13824,-14336,-1
9520,446,19,11,0.0447521573,0.955247843,2863.346577,3139.501349,4996.882878,4697.838565,9966,1444.347826,19932,-4874240,228352,-4645888,-1
2953,351,21,9,0.106234867,0.893765133,933.2269174,1084.06527,1624.783271,1885.683761,3304,134.7471452,6608,-1511936,179712,-1332224,-1
889,172,20,10,0.162111216,0.837888784,293.5438517,353.9075404,546.8976378,448.8313953,1061,26.72544081,2122,-455168,88064,-367104,-1
9517,454,19,11,0.0455320429,0.954467957,2860.830617,3094.780475,5028.169906,4102.011013,9971,927.5348837,19942,-4872704,232448,-4640256,-1
501,58,23,7,0.103756708,0.896243292,155.2322777,175.9489618,291.9381238,176.8793103,559,39.25561798,1118,-256512,29696,-226816,-1
1288,199,19,11,0.133826496,0.866173504,429.9126645,397.273656,765.7158385,603.4472362,1487,98.28155981,2974,-659456,101888,-557568,-1
278,66,20,10,0.191860465,0.808139535,95.36656076,109.4299613,179.6258993,142.4848485,344,29.65517241,688,-142336,33792,-108544,-1
3452,343,20,10,0.0903820817,0.909617918,1083.969481,1205.157322,1894.761587,1930.591837,3795,72.78481013,7590,-1767424,175616,-1591808,-1
6179,573,21,9,0.0848637441,0.915136256,1913.815669,2216.311954,3429.604305,2803.844677,6752,234.6073662,13504,-3163648,293376,-2870272,-1
64,26,19,11,0.288888889,0.711111111,27.29836859,20.00769083,48.953125,37,90,20.7852194,180,-32768,13312,-19456,-1
1695,188,21,9,0.0998406798,0.90015932,535.6263297,606.9646576,948.9887906,878.9893617,1883,112.6196172,3766,-867840,96256,-771584,-1
733,97,22,8,0.11686747,0.88313253,229.6084487,295.6407605,406.3342428,484.7628866,830,47.42857143,1660,-375296,49664,-325632,-1
7555,364,21,9,0.0459653997,0.9540346,2269.657448,2472.448298,3998.228326,3166.552198,7919,560.4387827,15838,-3868160,186368,-3681792,-1
670,115,20,10,0.146496815,0.853503185,222.0133239,251.0742328,390.1298507,409.7217391,785,84.77321814,1570,-343040,58880,-284160,-1
5633,252,20,10,0.0428207307,0.957179269,1684.168969,1919.933312,2967.38452,2397.928571,5885,289.4736842,11770,-2884096,129024,-2755072,-1
5019,445,20,10,0.0814421669,0.918557833,1566.025631,1698.49487,2737.530584,2675.761798,5464,166.3824604,10928,-2569728,227840,-2341888,-1
570,82,19,11,0.125766871,0.874233129,176.9056028,241.1207263,316.0877193,398.8780488,652,12.26947685,1304,-291840,41984,-249856,-1
9155,780,22,8,0.0785103171,0.921489683,2843.951968,3106.817119,5003.123211,4555.752564,9935,868.4440559,19870,-4687360,399360,-4288000,-1
1396,156,21,9,0.100515464,0.899484536,450.0023331,429.3093495,778.9126074,754.9102564,1552,80.33126294,3104,-714752,79872,-634880,-1
5941,607,18,12,0.0927000611,0.907299939,1876.052047,2017.590523,3258.948998,3426.705107,6548,234.5272206,13096,-3041792,310784,-2731008,-1
5512,1325,17,13,0.19379845,0.80620155,1993.175615,1806.177654,3298.58418,3919.929811,6837,256.4516129,13674,-2822144,678400,-2143744,-1
466,53,19,11,0.102119461,0.897880539,144.8404174,166.4487045,269.4248927,177.1320755,519,69.85195155,1038,-238592,27136,-211456,-1
3234,242,21,9,0.0696202532,0.930379747,1002.046781,988.3093597,1719.772109,1988.772727,3476,130.4315197,6952,-1655808,123904,-1531904,-1
5155,360,17,13,0.0652765186,0.934723481,1560.427887,1957.515344,2782.335209,2409.533333,5515,227.3289365,11030,-2639360,184320,-2455040,-1
7398,492,22,8,0.0623574144,0.937642586,2246.683657,2672.024466,3920.195999,4325.985772,7890,260.654113,15780,-3787776,251904,-3535872,-1
7077,506,23,7,0.0667282078,0.933271792,2175.967728,2344.227295,3813.117705,3496.644269,7583,209.3594699,15166,-3623424,259072,-3364352,-1
6885,404,20,10,0.0554259844,0.944574016,2090.492239,2074.156853,3704.863617,2624.799505,7289,212.9418639,14578,-3525120,206848,-3318272,-1
2801,148,20,10,0.0501865039,0.949813496,843.642444,963.3228251,1485.610853,1274.182432,2949,104.204947,5898,-1434112,75776,-1358336,-1
3367,252,19,11,0.0696324952,0.930367505,1027.263534,1253.660075,1806.11286,1861.936508,3619,375.0259067,7238,-1723904,129024,-1594880,-1
5596,222,21,9,0.0381574424,0.961842558,1670.46998,1856.794267,2923.880272,2547.013514,5818,576.6105055,11636,-2865152,113664,-2751488,-1
8797,323,20,10,0.0354166667,0.964583333,2622.173715,2816.709951,4586.159486,3861.656347,9120,667.6427526,18240,-4504064,165376,-4338688,-1
79,15,22,8,0.159574468,0.840425532,26.73708389,24.78942427,50.16455696,33.46666667,94,8.73605948,188,-40448,7680,-32768,-1
1796,162,19,11,0.0827374872,0.917262513,557.9711904,635.1277007,972.5729399,1056.296296,1958,50.83073728,3916,-919552,82944,-836608,-1
36,18,20,10,0.333333333,0.666666667,14.99102098,16.68850421,27.13888889,28.22222222,54,6.976744186,108,-18432,9216,-9216,-1
1520,107,20,10,0.065765212,0.934234788,459.7705591,579.4629362,822.4927632,693.3551402,1627,53.92774279,3254,-778240,54784,-723456,-1
997,139,18,12,0.122359155,0.877640845,326.0229671,326.1929084,581.6308927,474.3165468,1136,114.4008056,2272,-510464,71168,-439296,-1
6636,339,21,9,0.0486021505,0.951397849,1994.648554,2323.329206,3506.386829,3128.073746,6975,294.9260042,13950,-3397632,173568,-3224064,-1
6815,2435,20,10,0.263243243,0.736756757,2234.015793,2295.931184,3766.418635,7029.869405,9250,186.0418343,18500,-3489280,1246720,-2242560,-1
158,44,17,13,0.217821782,0.782178218,58.31550502,50.17656325,108.8101266,75.25,202,26.86170213,404,-80896,22528,-58368,-1
2814,520,21,9,0.155968806,0.844031194,966.9387938,884.9861088,1614.856787,1952.380769,3334,62.13194186,6668,-1440768,266240,-1174528,-1
237,48,19,11,0.168421053,0.831578947,80.88507447,78.11209616,150.8016878,104.4791667,285,65.2173913,570,-121344,24576,-96768,-1
1163,119,21,9,0.0928237129,0.907176287,359.9784126,407.3091712,661.7429063,443.6638655,1282,106.7443797,2564,-595456,60928,-534528,-1
6681,616,21,9,0.0844182541,0.915581746,2090.156169,2275.318915,3644.771292,3694.863636,7297,148.0421992,14594,-3420672,315392,-3105280,-1
4653,376,20,10,0.0747663551,0.925233645,1415.979414,1837.546957,2516.397808,2497.702128,5029,229.8446069,10058,-2382336,192512,-2189824,-1
2170,242,17,13,0.100331675,0.899668325,683.41212,802.2562016,1204.26129,1226.57438,2412,187.8504673,4824,-1111040,123904,-987136,-1
1371,211,27,3,0.133375474,0.866624526,455.2410335,464.60102,786.4223195,824.492891,1582,58.0763583,3164,-701952,108032,-593920,-1
423,85,20,10,0.167322835,0.832677165,141.7901917,167.8173764,257.7470449,238.3411765,508,39.28847641,1016,-216576,43520,-173056,-1
3956,261,22,8,0.0618923405,0.938107659,1202.905191,1383.166916,2129.046006,1805.16092,4217,356.1655405,8434,-2025472,133632,-1891840,-1
2502,291,21,9,0.104189044,0.895810956,786.5853924,953.7819578,1386.018785,1491.415808,2793,115.4609343,5586,-1281024,148992,-1132032,-1
4822,327,22,8,0.0635074772,0.936492523,1455.589713,1880.380345,2568.553297,2670.06422,5149,106.67081,10298,-2468864,167424,-2301440,-1
9321,626,21,9,0.0629335478,0.937066452,2841.895072,3263.326137,4995.593499,4652.477636,9947,570.0286533,19894,-4772352,320512,-4451840,-1
3616,155,20,10,0.0411031557,0.958896844,1083.579391,1154.558332,1899.675055,1566.974194,3771,283.3208114,7542,-1851392,79360,-1772032,-1
9495,474,27,3,0.0475473969,0.952452603,2858.327172,2969.30214,5048.574618,3711.495781,9969,592.3351159,19938,-4861440,242688,-4618752,-1
1138,71,27,3,0.05872622,0.94127378,343.2762609,429.8076866,603.4297012,630.1690141,1209,118.4133203,2418,-582656,36352,-546304,-1
8265,1345,21,9,0.139958377,0.860041623,2764.07058,2743.453414,4697.39516,5469.80223,9610,180.2325581,19220,-4231680,688640,-3543040,-1
2117,221,19,11,0.0945252352,0.905474765,649.9292906,877.9115665,1173.919225,1127.167421,2338,141.7828987,4676,-1083904,113152,-970752,-1
5684,443,22,8,0.0723029215,0.927697079,1749.318201,1984.855322,3083.010028,2820.088036,6127,299.7553816,12254,-2910208,226816,-2683392,-1
2306,402,21,9,0.14844904,0.85155096,728.5811072,942.9590691,1285.792715,1748.626866,2708,57.67838126,5416,-1180672,205824,-974848,-1
5176,354,23,7,0.0640144665,0.935985533,1563.659633,2014.706197,2767.4716,2736.672316,5530,291.0526316,11060,-2650112,181248,-2468864,-1
5986,569,20,10,0.0868039664,0.913196034,1854.741919,2006.055377,3185.56298,4250.456942,6555,203.8880249,13110,-3064832,291328,-2773504,-1
5069,800,21,9,0.136309422,0.863690578,1666.986281,1808.854925,2872.98185,3327.9625,5869,151.2239114,11738,-2595328,409600,-2185728,-1
952,171,18,12,0.152270703,0.847729297,312.8129515,341.5613692,590.0409664,405.8888889,1123,118.7103594,2246,-487424,87552,-399872,-1
5642,418,16,14,0.0689768977,0.931023102,1716.948643,2080.306095,2994.786423,3512.547847,6060,127.0440252,12120,-2888704,214016,-2674688,-1
8367,598,21,9,0.0667038483,0.933296152,2542.663026,3153.933313,4486.716505,4431,8965,169.6310312,17930,-4283904,306176,-3977728,-1
6535,498,17,13,0.0708090431,0.929190957,2023.21912,2116.567583,3507.659985,3639.564257,7033,142.1382377,14066,-3345920,254976,-3090944,-1
2646,175,21,9,0.0620347395,0.937965261,796.7224047,1031.696951,1421.762283,1248.274286,2821,321.6647662,5642,-1354752,89600,-1265152,-1
2729,251,20,10,0.0842281879,0.915771812,841.2872,948.7003396,1452.049102,1908.557769,2980,71.49712092,5960,-1397248,128512,-1268736,-1
9397,565,16,14,0.056715519,0.943284481,2848.341911,3109.33825,5045.853996,3911.173451,9962,710.5563481,19924,-4811264,289280,-4521984,-1
7511,570,22,8,0.0705358248,0.929464175,2309.989883,2565.097688,4003.934762,4529.415789,8081,273.0067568,16162,-3845632,291840,-3553792,-1
4220,447,22,8,0.0957788729,0.904221127,1299.006274,1534.072078,2251.746919,3110.527964,4667,106.6499086,9334,-2160640,228864,-1931776,-1
3520,306,21,9,0.0799790904,0.92002091,1105.575448,1080.010559,1926.777557,1760.764706,3826,232.3011536,7652,-1802240,156672,-1645568,-1
274,31,19,11,0.101639344,0.898360656,83.95693545,115.1491907,155.8540146,127.7741935,305,14.12691061,610,-140288,15872,-124416,-1
9416,545,19,11,0.0547133822,0.945286618,2852.859342,3170.955527,5018.898046,4326.233028,9961,1000.100402,19922,-4820992,279040,-4541952,-1
72,19,19,11,0.208791209,0.791208791,23.86429209,33.12153395,47.65277778,39.73684211,91,9.352517986,182,-36864,9728,-27136,-1
5938,238,22,8,0.0385362694,0.961463731,1776.71214,1846.989835,3110.487033,2539.932773,6176,233.7623013,12352,-3040256,121856,-2918400,-1
5804,389,20,10,0.0628128532,0.937187147,1788.26686,1700.580833,3131.170744,2587.161954,6193,543.245614,12386,-2971648,199168,-2772480,-1
9453,510,22,8,0.0511894008,0.948810599,2849.616809,3114.952312,5043.651857,3839.264706,9963,514.8837209,19926,-4839936,261120,-4578816,-1
9527,434,21,9,0.0435699227,0.956430077,2843.161095,3174.928532,5047.782828,3515.009217,9961,420.8280524,19922,-4877824,222208,-4655616,-1
872,98,27,3,0.101030928,0.898969072,276.6801961,294.3098005,495.212156,399.0816327,970,42.78782532,1940,-446464,50176,-396288,-1
1728,279,21,9,0.139013453,0.860986547,568.9657262,640.0398684,1003.261574,1008.573477,2007,114.0989198,4014,-884736,142848,-741888,-1
3658,262,19,11,0.0668367347,0.933163265,1118.575869,1292.873897,1969.882449,1829.503817,3920,138.028169,7840,-1872896,134144,-1738752,-1
83,28,18,12,0.252252252,0.747747748,33.08412236,25.08747452,60.08433735,43.89285714,111,18.37748344,222,-42496,14336,-28160,-1
4442,287,20,10,0.0606893635,0.939310636,1351.059063,1566.871266,2366.643404,2339.56446,4729,166.3969036,9458,-2274304,146944,-2127360,-1
1550,277,26,4,0.151614669,0.848385331,526.1121014,528.4801641,900.7116129,988.3574007,1827,47.45454545,3654,-793600,141824,-651776,-1
1159,144,20,10,0.110514198,0.889485802,368.3958895,430.8135282,646.3658326,697.3472222,1303,84.88599349,2606,-593408,73728,-519680,-1
4440,314,20,10,0.0660496424,0.933950358,1355.179895,1560.329168,2400.312162,2054.933121,4754,164.2141623,9508,-2273280,160768,-2112512,-1
4152,703,22,8,0.144799176,0.855200824,1340.982207,1480.927645,2292.251686,3229.745377,4855,171.7368235,9710,-2125824,359936,-1765888,-1
356,73,27,3,0.17016317,0.82983683,123.0691475,120.8742502,207.3988764,252.0684932,429,22.59083728,858,-182272,37376,-144896,-1
1376,153,23,7,0.100065402,0.899934598,440.1620195,354.4389257,794.6257267,498.5620915,1529,35.95109335,3058,-704512,78336,-626176,-1
8066,1116,19,11,0.121542148,0.878457852,2501.656179,2677.156857,4289.999132,6770.62724,9182,204.4533511,18364,-4129792,571392,-3558400,-1
6933,427,20,10,0.0580163043,0.941983696,2116.027951,2252.300296,3691.661907,3499.269321,7360,138.9465735,14720,-3549696,218624,-3331072,-1
1422,206,19,11,0.126535627,0.873464373,461.0302703,438.3730504,854.2278481,540.2621359,1628,47.75594016,3256,-728064,105472,-622592,-1
2279,273,21,9,0.106974922,0.893025078,723.5046218,829.9178643,1290.269855,1161.549451,2552,59.34883721,5104,-1166848,139776,-1027072,-1
3164,288,20,10,0.0834298957,0.916570104,982.3434475,1134.287671,1716.071745,1841.065972,3452,122.6723525,6904,-1619968,147456,-1472512,-1
5671,753,19,11,0.117216687,0.882783313,1827.609608,1981.971824,3149.496738,3686.990704,6424,138.5378477,12848,-2903552,385536,-2518016,-1
3936,258,22,8,0.0615164521,0.938483548,1190.335086,1445.918131,2075.391768,2434.77907,4194,217.8701299,8388,-2015232,132096,-1883136,-1
123,66,22,8,0.349206349,0.650793651,55.95091827,51.86119294,95.26829268,94.5,189,15.80267559,378,-62976,33792,-29184,-1
9310,645,22,8,0.064791562,0.935208438,2833.244844,3400.750398,4989.783888,4807.910078,9955,832.3578595,19910,-4766720,330240,-4436480,-1
4379,410,20,10,0.0856128628,0.914387137,1376.88542,1436.59629,2385.256451,2499.065854,4789,210.969163,9578,-2242048,209920,-2032128,-1
1507,150,20,10,0.0905250453,0.909474955,471.0212016,536.2229548,838.9661579,728.8733333,1657,58.88415068,3314,-771584,76800,-694784,-1
860,55,19,11,0.0601092896,0.93989071,258.9867807,284.0493986,468.9546512,286.7090909,915,38.23652319,1830,-440320,28160,-412160,-1
107,36,17,13,0.251748252,0.748251748,40.08408273,40.67580157,77.35514019,56.08333333,143,25.71942446,286,-54784,18432,-36352,-1
5497,494,20,10,0.0824570189,0.917542981,1698.622994,2002.868672,2962.048754,3373.793522,5991,223.0454207,11982,-2814464,252928,-2561536,-1
8108,625,20,10,0.0715676171,0.928432383,2508.51044,2617.721473,4408.876418,3823.7456,8733,469.2638366,17466,-4151296,320000,-3831296,-1
428,103,17,13,0.193973635,0.806026365,144.800221,163.7060432,284.3434579,189.776699,531,87.33552632,1062,-219136,52736,-166400,-1
8283,385,22,8,0.0444162437,0.955583756,2500.052848,2458.813443,4364.992756,3678.47013,8668,588.0597015,17336,-4240896,197120,-4043776,-1
1712,200,17,13,0.10460251,0.89539749,548.7173916,534.2472906,981.1320093,745.65,1912,70.998886,3824,-876544,102400,-774144,-1
6106,417,27,3,0.0639276407,0.936072359,1881.308254,1907.939445,3260.769407,3280.019185,6523,245.2255639,13046,-3126272,213504,-2912768,-1
6326,623,20,10,0.0896531875,0.910346812,1979.418889,2257.909281,3478.908947,3435.308186,6949,236.1196058,13898,-3238912,318976,-2919936,-1
220,49,26,4,0.182156134,0.817843866,77.53162191,74.5051983,139.7818182,113.5306122,269,26.29521017,538,-112640,25088,-87552,-1
3019,196,21,9,0.0609642302,0.93903577,924.0161359,923.0328831,1630.295793,1264.576531,3215,64.89705289,6430,-1545728,100352,-1445376,-1
2615,238,20,10,0.0834209604,0.91657904,821.43239,843.4905569,1433.649713,1353.936975,2853,144.5288754,5706,-1338880,121856,-1217024,-1
9302,403,17,13,0.0415249871,0.958475013,2781.468545,3058.169728,4897.278435,3830.970223,9705,607.3216521,19410,-4762624,206336,-4556288,-1
4154,628,22,8,0.131325805,0.868674195,1355.30733,1532.755834,2376.608811,2490,4782,153.1219981,9564,-2126848,321536,-1805312,-1
6878,397,23,7,0.0545704467,0.945429553,2072.578845,2423.963536,3597.324949,4342.692695,7275,237.5898106,14550,-3521536,203264,-3318272,-1
9540,430,18,12,0.0431293882,0.956870612,2867.59329,3099.241489,4979.869916,5110.409302,9970,1002.01005,19940,-4884480,220160,-4664320,-1
1694,92,20,10,0.0515117581,0.948488242,505.2551556,608.3769044,909.3364817,601.9021739,1786,208.6448598,3572,-867328,47104,-820224,-1
8932,960,21,9,0.0970481197,0.90295188,2888.931573,2466.833986,5001.134236,4438.173958,9892,552.6256983,19784,-4573184,491520,-4081664,-1
9189,461,22,8,0.0477720207,0.952227979,2764.944277,2944.036652,4883.23724,3674.637744,9650,975.7330637,19300,-4704768,236032,-4468736,-1
2602,308,22,8,0.105841924,0.894158076,834.4252518,885.3533184,1451.440046,1489.798701,2910,175.9371221,5820,-1332224,157696,-1174528,-1
7450,546,19,11,0.0682841421,0.931715858,2281.550503,2638.46959,3984.647651,4187.510989,7996,176.3564182,15992,-3814400,279552,-3534848,-1
3512,187,25,5,0.0505542038,0.949445796,1062.911963,1137.775224,1860.589408,1651.122995,3699,146.1477677,7398,-1798144,95744,-1702400,-1
8906,1051,21,9,0.105553882,0.894446118,2730.674157,3214.908396,4735.763979,7040.14177,9957,646.5584416,19914,-4559872,538112,-4021760,-1
8659,455,21,9,0.0499231951,0.950076805,2610.563416,2894.709685,4596.50052,3815.29011,9114,303.1936128,18228,-4433408,232960,-4200448,-1
9307,628,19,11,0.0632108707,0.936789129,2820.89047,3474.248303,4944.847642,5311.119427,9935,1022.119342,19870,-4765184,321536,-4443648,-1
9433,528,20,10,0.0530067262,0.946993274,2834.801414,2977.550745,5083.685784,3146.464015,9961,222.1949587,19922,-4829696,270336,-4559360,-1
2457,309,27,3,0.111713666,0.888286334,787.4442221,879.8367957,1389.493691,1335.841424,2766,120.8916084,5532,-1257984,158208,-1099776,-1
332,32,21,9,0.0879120879,0.912087912,104.1418894,97.49743086,187.996988,125.46875,364,14.73684211,728,-169984,16384,-153600,-1
1978,126,17,13,0.0598859316,0.940114068,602.841163,674.2389297,1053.719414,1033.357143,2104,49.72819664,4208,-1012736,64512,-948224,-1
676,93,17,13,0.120936281,0.879063719,214.9315863,267.7609295,385.2618343,383.0967742,769,72.47879359,1538,-346112,47616,-298496,-1
1272,109,16,14,0.0789283128,0.921071687,390.4432565,417.6526611,711.1721698,455.5963303,1381,74.16756176,2762,-651264,55808,-595456,-1
4467,239,26,4,0.0507862303,0.94921377,1354.180383,1436.105001,2356.058652,2305.677824,4706,146.3763608,9412,-2287104,122368,-2164736,-1
9360,585,21,9,0.0588235294,0.941176471,2847.992838,3144.148876,5013.671474,4322.25641,9945,1006.578947,19890,-4792320,299520,-4492800,-1
400,61,21,9,0.132321041,0.867678959,125.781039,164.7202428,238.735,180.2786885,461,10.26954778,922,-204800,31232,-173568,-1
7277,389,19,11,0.0507435429,0.949256457,2186.137318,2615.631035,3860.313866,3331.894602,7666,343.7668161,15332,-3725824,199168,-3526656,-1
182,30,19,11,0.141509434,0.858490566,58.84438285,42.35138723,115.7472527,50.4,212,36.74176776,424,-93184,15360,-77824,-1
1905,145,21,9,0.0707317073,0.929268293,584.2817977,632.3448811,1044.387927,777.3517241,2050,59.71453539,4100,-975360,74240,-901120,-1
4682,346,21,9,0.068814638,0.931185362,1440.749516,1577.857568,2528.070696,2330.864162,5028,294.8973607,10056,-2397184,177152,-2220032,-1
189,9,27,3,0.0454545455,0.954545455,56.15800684,74.99893003,99.7037037,95.22222222,198,14.7761194,396,-96768,4608,-92160,-1
9224,744,20,10,0.0746388443,0.925361156,2804.658769,3335.433744,5101.848222,3529.634409,9968,1492.215569,19936,-4722688,380928,-4341760,-1
3372,208,22,8,0.0581005587,0.941899441,1020.316389,1195.039136,1773.841934,2060.552885,3580,81.40063665,7160,-1726464,106496,-1619968,-1
3948,303,22,8,0.0712773465,0.928722653,1217.88377,1274.372116,2157.14767,1720.155116,4251,206.3592233,8502,-2021376,155136,-1866240,-1
605,35,21,9,0.0546875,0.9453125,181.3920937,206.2865928,326.8743802,210.3142857,640,91.69054441,1280,-309760,17920,-291840,-1
9463,490,27,3,0.0492313875,0.950768612,2864.654159,3000.346552,4999.481137,4542.838776,9953,995.3,19906,-4845056,250880,-4594176,-1
8054,656,23,7,0.075315729,0.924684271,2488.019888,2716.383208,4296.83561,5075.748476,8710,533.374158,17420,-4123648,335872,-3787776,-1
9476,496,21,9,0.04973927,0.95026073,2848.298624,3283.096327,5033.009392,4097.945565,9972,793.3174224,19944,-4851712,253952,-4597760,-1
2762,205,26,4,0.0690933603,0.93090664,857.7843201,828.5615195,1493.443881,1356.760976,2967,137.4884152,5934,-1414144,104960,-1309184,-1
9035,682,21,9,0.0701862715,0.929813729,2786.51193,2989.633683,4899.140011,4327.233138,9717,309.2616168,19434,-4625920,349184,-4276736,-1
4861,432,22,8,0.0816172303,0.91838277,1527.803933,1527.527173,2640.084345,2724.81713,5293,301.9395322,10586,-2488832,221184,-2267648,-1
3355,470,19,11,0.122875817,0.877124183,1093.315332,1174.708578,1900.049776,2005.442553,3825,167.3960613,7650,-1717760,240640,-1477120,-1
6971,512,20,10,0.068421756,0.931578244,2136.189704,2295.882043,3678.708076,4603.734375,7483,366.2750857,14966,-3569152,262144,-3307008,-1
7694,339,18,12,0.0422009212,0.957799079,2308.284739,2406.588526,4053.165844,3196.174041,8033,453.3295711,16066,-3939328,173568,-3765760,-1
4821,309,21,9,0.0602339181,0.939766082,1451.342062,1847.173888,2588.195395,2211.407767,5130,159.5149254,10260,-2468352,158208,-2310144,-1
5535,301,22,8,0.0515764222,0.948423578,1662.630178,2048.704008,2918.723035,2914.398671,5836,142.0988556,11672,-2833920,154112,-2679808,-1
9527,444,17,13,0.0445291345,0.955470866,2858.941971,3083.992263,5035.211714,3930.054054,9971,1223.435583,19942,-4877824,227328,-4650496,-1
1161,70,21,9,0.0568643379,0.943135662,348.1386724,387.1083973,630.4229113,376.7857143,1231,146.0260973,2462,-594432,35840,-558592,-1
411,89,20,10,0.178,0.822,137.9670064,168.6867236,255.6301703,226.8089888,500,53.82131324,1000,-210432,45568,-164864,-1
9413,547,22,8,0.0549196787,0.945080321,2859.924033,3118.978494,4992.724211,4770.140768,9960,266.2389735,19920,-4819456,280064,-4539392,-1
6035,1392,20,10,0.187424263,0.812575737,2191.513545,1893.773752,3642.868268,4022.390805,7427,146.8076695,14854,-3089920,712704,-2377216,-1
4837,265,21,9,0.0519404155,0.948059584,1459.685807,1694.404958,2549.616084,2585.886792,5102,93.47746427,10204,-2476544,135680,-2340864,-1
2813,267,21,9,0.0866883117,0.913311688,859.3172841,1156.187938,1545.248845,1490.468165,3080,261.9047619,6160,-1440256,136704,-1303552,-1
2608,243,18,12,0.0852332515,0.914766749,812.2850568,908.7580532,1443.776074,1235.218107,2851,54.70069071,5702,-1335296,124416,-1210880,-1
6007,367,22,8,0.0575776592,0.942422341,1817.927816,1988.950166,3238.938572,2345.561308,6374,210.3630363,12748,-3075584,187904,-2887680,-1
1804,161,26,4,0.0819338422,0.918066158,560.1842498,480.4632311,1019.293792,576.3291925,1965,91.05653383,3930,-923648,82432,-841216,-1
441,94,19,11,0.175700935,0.824299065,145.4819124,174.7125791,282.9070295,198.0638298,535,93.20557491,1070,-225792,48128,-177664,-1
9501,464,22,8,0.0465629704,0.95343703,2867.538121,2978.501328,5015.868961,4309.965517,9965,512.0760534,19930,-4864512,237568,-4626944,-1
4907,618,21,9,0.111855204,0.888144796,1601.282233,1510.689968,2725.389851,3061.62945,5525,424.0214889,11050,-2512384,316416,-2195968,-1
779,102,21,9,0.115777526,0.884222474,244.0546871,322.0456523,440.139923,447.5686275,881,56.69240669,1762,-398848,52224,-346624,-1
9364,588,20,10,0.0590836013,0.940916399,2848.412579,3190.223015,5010.230137,4439.341837,9952,857.9310345,19904,-4794368,301056,-4493312,-1
6799,700,21,9,0.0933457794,0.906654221,2189.301147,1805.325619,3811.207531,3155.5,7499,139.5422404,14998,-3481088,358400,-3122688,-1
9553,423,21,9,0.0424017642,0.957598236,2883.316957,2799.718981,4987.860253,5002.947991,9976,1049.001052,19952,-4891136,216576,-4674560,-1
9159,605,20,10,0.0619623105,0.938037689,2780.384694,3344.060384,4878.903046,4936.953719,9764,363.3792333,19528,-4689408,309760,-4379648,-1
4797,338,18,12,0.0658227848,0.934177215,1471.089771,1623.118414,2555.316031,2748.014793,5135,169.3043192,10270,-2456064,173056,-2283008,-1
9610,375,21,9,0.0375563345,0.962443665,2877.071357,2986.715099,5009.12872,4579.674667,9985,959.1738713,19970,-4920320,192000,-4728320,-1
991,138,16,14,0.122232064,0.877767936,320.7425089,351.5516191,575.6367306,488.615942,1129,98.43068875,2258,-507392,70656,-436736,-1
9184,754,19,11,0.0758703965,0.924129604,2842.393052,3173.069934,4965.422365,5019.167109,9938,476.8714012,19876,-4702208,386048,-4316160,-1
5001,505,21,9,0.0917181257,0.908281874,1572.827231,1607.861891,2818.879624,2106.047525,5506,109.4849871,11012,-2560512,258560,-2301952,-1
2003,134,25,5,0.0627047263,0.937295274,609.3149453,714.6424518,1075.094358,977.9029851,2137,247.0520231,4274,-1025536,68608,-956928,-1
5782,307,20,10,0.050418788,0.949581212,1743.600176,1919.703087,3075.037011,2479.286645,6089,630.984456,12178,-2960384,157184,-2803200,-1
8324,498,23,7,0.0564497846,0.943550215,2534.499728,2675.261457,4446.567516,3825.351406,8822,190.8284664,17644,-4261888,254976,-4006912,-1
2681,280,19,11,0.0945626478,0.905437352,842.2432112,966.5000332,1480.852294,1482.414286,2961,97.33727811,5922,-1372672,143360,-1229312,-1
9457,513,18,12,0.0514543631,0.948545637,2854.685457,2888.652707,5067.561595,3472.719298,9970,825.3311258,19940,-4841984,262656,-4579328,-1
7302,498,21,9,0.0638461538,0.936153846,2236.928459,2227.694141,3968.991235,2896.236948,7800,201.863354,15600,-3738624,254976,-3483648,-1
1929,263,19,11,0.119981752,0.880018248,627.3333148,623.3016145,1128.398652,862.5361217,2192,109.2177379,4384,-987648,134656,-852992,-1
70,17,25,5,0.195402299,0.804597701,24.02532677,29.1013026,44.42857143,42.23529412,87,6.304347826,174,-35840,8704,-27136,-1
2970,316,18,12,0.0961655508,0.903834449,926.2594526,1136.920841,1640.910774,1667.835443,3286,223.3854521,6572,-1520640,161792,-1358848,-1
132,17,21,9,0.11409396,0.88590604,41.39543954,32.72872668,80.1969697,34.64705882,149,19.37581274,298,-67584,8704,-58880,-1
5870,379,20,10,0.060649704,0.939350296,1778.665781,2094.894108,3157.364395,2623.736148,6249,195.7093642,12498,-3005440,194048,-2811392,-1
7103,663,19,11,0.0853721349,0.914627865,2239.218269,2227.818924,3922.320006,3467.604827,7766,167.0826162,15532,-3636736,339456,-3297280,-1
7431,400,21,9,0.0510790448,0.948920955,2238.048956,2592.059396,3943.624142,3402.8125,7831,364.5716946,15662,-3804672,204800,-3599872,-1
1157,128,27,3,0.0996108949,0.900389105,368.5000841,385.9477175,650.426102,575.875,1285,207.2580645,2570,-592384,65536,-526848,-1
8604,615,22,8,0.0667100553,0.933289945,2645.451279,2868.172239,4597.56218,4784.00813,9219,205.7353269,18438,-4405248,314880,-4090368,-1
3180,336,20,10,0.0955631399,0.90443686,1006.172288,1091.831536,1750.333019,1835.794643,3516,154.4815466,7032,-1628160,172032,-1456128,-1
2541,178,21,9,0.0654652446,0.934534755,772.5908998,855.1717286,1386.969697,975,2719,74.12758997,5438,-1300992,91136,-1209856,-1
9506,460,20,10,0.0461569336,0.953843066,2861.64433,2914.716356,5043.180518,3750.18913,9966,756.7198178,19932,-4867072,235520,-4631552,-1
9313,635,18,12,0.063831926,0.936168074,2835.336664,3354.851682,4987.506604,4783.743307,9948,536.5695793,19896,-4768256,325120,-4443136,-1
1730,145,22,8,0.0773333333,0.922666667,530.4130497,593.6236442,960.6780347,667.4275862,1875,154.8307184,3750,-885760,74240,-811520,-1
1634,259,24,6,0.136819863,0.863180137,533.1158563,623.5524423,943.0973072,971.6216216,1893,40.80620823,3786,-836608,132608,-704000,-1
2465,288,25,5,0.104613149,0.895386851,781.3536704,898.6098359,1384.355781,1314.041667,2753,224.0032547,5506,-1262080,147456,-1114624,-1
1801,175,16,14,0.088562753,0.911437247,556.3149691,697.1008837,983.4081066,1040.902857,1976,57.96421238,3952,-922112,89600,-832512,-1
4178,510,19,11,0.108788396,0.891211604,1365.457414,1244.597841,2331.958114,2447.245098,4688,204.0034813,9376,-2139136,261120,-1878016,-1
2974,263,27,3,0.0812480692,0.918751931,937.5780782,896.2944809,1614.030935,1675.190114,3237,160.2475248,6474,-1522688,134656,-1388032,-1
5919,321,27,3,0.0514423077,0.948557692,1789.408668,2008.287652,3118.759757,3152.588785,6240,198.2840801,12480,-3030528,164352,-2866176,-1
9463,458,27,3,0.0461647011,0.953835299,2854.799711,2998.330036,4986.582479,4432.425764,9921,1055.425532,19842,-4845056,234496,-4610560,-1
1908,99,25,5,0.0493273543,0.950672646,573.7467813,666.3636501,1010.522013,878.3030303,2007,171.9794344,4014,-976896,50688,-926208,-1
1979,205,20,10,0.0938644689,0.906135531,617.4667901,733.2614123,1105.136938,970.5073171,2184,52.09923664,4368,-1013248,104960,-908288,-1
3029,238,20,10,0.0728497092,0.927150291,916.2417993,1198.072374,1656.655002,1345.672269,3267,100.4612546,6534,-1550848,121856,-1428992,-1
4447,443,20,10,0.090593047,0.909406953,1382.817435,1672.799399,2450.167978,2398.641084,4890,284.6332945,9780,-2276864,226816,-2050048,-1
5810,1014,21,9,0.1485932,0.8514068,1842.381792,1950.558464,3140.073838,4973.442801,6824,128.5848879,13648,-2974720,519168,-2455552,-1
98,25,19,11,0.203252033,0.796747967,35.2087264,22.64423989,68.56122449,36.28,123,19.55484897,246,-50176,12800,-37376,-1
6762,259,21,9,0.036889332,0.963110668,2022.799927,2088.941168,3526.308193,3111.332046,7021,332.2763843,14042,-3462144,132608,-3329536,-1
9554,418,21,9,0.0419173686,0.958082631,2859.853903,3140.309551,5026.967344,4061.559809,9972,927.627907,19944,-4891648,214016,-4677632,-1
9079,499,20,10,0.0520985592,0.947901441,2745.343366,3066.774573,4813.636744,4350.346693,9578,836.5065502,19156,-4648448,255488,-4392960,-1
7188,589,22,8,0.075736145,0.924263855,2226.357929,2451.078428,3871.19936,4106.234295,7777,281.2658228,15554,-3680256,301568,-3378688,-1
892,102,17,13,0.102615694,0.897384306,277.2836357,352.5893377,505.6625561,426.1176471,994,78.32939322,1988,-456704,52224,-404480,-1
586,65,19,11,0.0998463902,0.90015361,181.0998083,197.5016944,340.5153584,195.1384615,651,28.13310285,1302,-300032,33280,-266752,-1
1082,81,22,8,0.0696474635,0.930352537,333.9458928,321.5812787,593.474122,428.7283951,1163,83.78962536,2326,-553984,41472,-512512,-1
3792,558,21,9,0.128275862,0.871724138,1244.343463,1325.242425,2159.140823,2286.672043,4350,81.81305247,8700,-1941504,285696,-1655808,-1
7355,701,19,11,0.0870158888,0.912984111,2250.187754,2878.021435,3949.939769,4852.766049,8056,190.2243211,16112,-3765760,358912,-3406848,-1
6809,360,21,9,0.0502162087,0.949783791,2050.52425,2373.974337,3603.345572,3238.013889,7169,346.6634429,14338,-3486208,184320,-3301888,-1
43,12,22,8,0.218181818,0.781818182,16.00165621,13.97095201,29.60465116,22.25,55,11.75213675,110,-22016,6144,-15872,-1
6266,850,17,13,0.119449129,0.880550871,2077.639812,1753.215756,3474.791574,4175.578824,7116,148.4045881,14232,-3208192,435200,-2772992,-1
9575,405,21,9,0.0405811623,0.959418838,2872.152852,3047.047898,5009.749138,4535.412346,9980,1036.344756,19960,-4902400,207360,-4695040,-1
6483,494,22,8,0.0708040705,0.929195929,2013.238474,2014.466238,3504.28166,3288.451417,6977,151.2464773,13954,-3319296,252928,-3066368,-1
40,15,21,9,0.272727273,0.727272727,15.81858085,15.45660592,29.35,24.4,55,8.124076809,110,-20480,7680,-12800,-1
7998,578,21,9,0.0673973881,0.932602612,2480.526736,2340.665721,4327.839085,3744.150519,8576,160.960961,17152,-4094976,295936,-3799040,-1
1861,142,18,12,0.0708936595,0.92910634,573.6540544,609.4662253,1015.106394,830.2323944,2003,62.03158873,4006,-952832,72704,-880128,-1
9517,451,21,9,0.0452447833,0.954755217,2879.421563,2769.051344,5013.069139,4381.634146,9968,898.018018,19936,-4872704,230912,-4641792,-1
68,16,20,10,0.19047619,0.80952381,23.21914461,25.03052824,45.25,30.8125,84,14.78873239,168,-34816,8192,-26624,-1
2401,218,21,9,0.0832378771,0.916762123,741.6887728,890.8109424,1320.571429,1193.568807,2619,100.9637625,5238,-1229312,111616,-1117696,-1
5114,655,22,8,0.113537875,0.886462125,1677.061226,1469.241463,2952.097575,2361.126718,5769,263.7860082,11538,-2618368,335360,-2283008,-1
92,22,19,11,0.192982456,0.807017544,31.92397596,30.07373858,62.0326087,38.54545455,114,8.526551982,228,-47104,11264,-35840,-1
6030,638,22,8,0.0956808638,0.904319136,1866.566621,2077.23853,3212.091708,4491.431034,6668,149.3393057,13336,-3087360,326656,-2760704,-1
9384,569,21,9,0.0571686929,0.942831307,2879.768301,2617.144638,5029.03133,4118.894552,9953,621.6739538,19906,-4804608,291328,-4513280,-1
4236,263,27,3,0.058457435,0.941542565,1284.986592,1286.706199,2296.815864,1495.961977,4499,325.7784214,8998,-2168832,134656,-2034176,-1
662,91,16,14,0.120849934,0.879150066,206.7589482,267.8445186,365.2885196,462.1978022,753,28.9726818,1506,-338944,46592,-292352,-1
4773,523,22,8,0.0987537764,0.901246224,1527.986694,1524.471711,2668.409386,2466.803059,5296,125.5571361,10592,-2443776,267776,-2176000,-1
4235,396,22,8,0.0855106888,0.914489311,1305.174489,1624.283097,2297.242267,2516.603535,4631,294.9681529,9262,-2168320,202752,-1965568,-1
9343,598,21,9,0.060154914,0.939845086,2848.812855,2918.178324,5049.178958,3749.551839,9941,1085.262009,19882,-4783616,306176,-4477440,-1
9419,537,20,10,0.0539373242,0.946062676,2832.413758,3460.472341,5015.810489,4324.072626,9956,1078.656555,19912,-4822528,274944,-4547584,-1
7971,410,19,11,0.0489201766,0.951079823,2399.100549,2737.903857,4216.46205,3695.980488,8381,159.8207475,16762,-4081152,209920,-3871232,-1
447,74,21,9,0.142034549,0.857965451,141.9297697,185.9130883,252.5838926,311.8378378,521,46.47636039,1042,-228864,37888,-190976,-1
8566,438,22,8,0.0486450466,0.951354953,2578.117508,2901.97578,4536.776675,3832.148402,9004,1010.549944,18008,-4385792,224256,-4161536,-1
8331,398,22,8,0.0455951426,0.954404857,2518.537146,2521.74364,4381.722842,4014.954774,8729,223.0769231,17458,-4265472,203776,-4061696,-1
6594,697,20,10,0.0955973118,0.904402688,2070.943002,2252.804791,3729.470428,2856.324247,7291,294.9433657,14582,-3376128,356864,-3019264,-1
6736,404,20,10,0.0565826331,0.943417367,2052.369422,2038.358221,3619.063688,2760.784653,7140,131.8559557,14280,-3448832,206848,-3241984,-1
246,61,19,11,0.198697068,0.801302932,87.7310315,87.18660697,160.6097561,127.3442623,307,26.21690863,614,-125952,31232,-94720,-1
628,86,23,7,0.120448179,0.879551821,201.2483608,231.537075,364.9299363,303.244186,714,61.23499142,1428,-321536,44032,-277504,-1
1417,236,25,5,0.14277072,0.85722928,478.6864444,447.9464599,847.9160198,701.4152542,1653,44.28073935,3306,-725504,120832,-604672,-1
458,94,24,6,0.170289855,0.829710145,154.7361057,172.6613105,266.8973799,323.287234,552,19.88472622,1104,-234496,48128,-186368,-1
7248,313,20,10,0.0413966407,0.958603359,2172.964898,2359.110833,3798.828228,3368.159744,7561,433.0469645,15122,-3710976,160256,-3550720,-1
173,30,20,10,0.147783251,0.852216749,56.95643438,35.98958183,111.1040462,49.5,203,34.7008547,406,-88576,15360,-73216,-1
1816,226,20,10,0.110675808,0.889324192,580.6749241,640.3227196,1004.817181,1155.553097,2042,50.83395569,4084,-929792,115712,-814080,-1
8494,381,22,8,0.0429295775,0.957070423,2556.764681,2648.383598,4454.788557,4063.716535,8875,447.328629,17750,-4348928,195072,-4153856,-1
911,89,19,11,0.089,0.911,281.9521664,349.1543433,502.9527991,475.3932584,1000,81.10300081,2000,-466432,45568,-420864,-1
5183,316,21,9,0.0574649936,0.942535006,1566.083202,1887.009822,2735.147984,2993.601266,5499,101.103144,10998,-2653696,161792,-2491904,-1
3870,295,22,8,0.0708283313,0.929171669,1195.244273,1290.902323,2079.632817,2127.172881,4165,331.0810811,8330,-1981440,151040,-1830400,-1
1322,123,17,13,0.0851211073,0.914878893,407.2501987,506.7990446,729.1301059,657.1138211,1445,112.9788898,2890,-676864,62976,-613888,-1
1967,162,20,10,0.076092062,0.923907938,609.4380968,673.9972208,1065.184037,1062.765432,2129,155.8565154,4258,-1007104,82944,-924160,-1
4204,393,20,10,0.0854905373,0.914509463,1330.091187,1267.968255,2322.062322,2052.29771,4597,177.8336557,9194,-2152448,201216,-1951232,-1
6823,464,21,9,0.0636750377,0.936324962,2103.358162,2094.827591,3658.741463,3427.230603,7287,186.2254025,14574,-3493376,237568,-3255808,-1
9615,369,21,9,0.0369591346,0.963040865,2870.501091,3075.211272,5021.508476,4236.628726,9984,1121.797753,19968,-4922880,188928,-4733952,-1
5892,558,20,10,0.0865116279,0.913488372,1834.509727,2011.115708,3161.913103,3896.922939,6450,280.5567638,12900,-3016704,285696,-2731008,-1
5875,641,18,12,0.0983732351,0.901626765,1858.226045,2029.566497,3212.192681,3682.923557,6516,135.4677755,13032,-3008000,328192,-2679808,-1
9051,868,21,9,0.0875088215,0.912491179,2836.702749,3122.191851,4977.318639,4779.41129,9919,732.5701625,19838,-4634112,444416,-4189696,-1
9464,505,18,12,0.0506570368,0.949342963,2850.894778,3011.239396,5060.395287,3572.047525,9969,490.6003937,19938,-4845568,258560,-4587008,-1
2195,132,18,12,0.0567253975,0.943274602,656.7430471,736.8240298,1192.600456,688.4090909,2327,220.1513718,4654,-1123840,67584,-1056256,-1
542,51,17,13,0.0860033727,0.913996627,165.5201887,170.0022276,309.9335793,159.5490196,593,91.23076923,1186,-277504,26112,-251392,-1
9342,609,21,9,0.0611998794,0.938800121,2865.635683,2977.466274,4976.744487,4964.579639,9951,954.0747843,19902,-4783104,311808,-4471296,-1
339,67,21,9,0.165024631,0.834975369,113.6554165,130.4660239,198.2123894,230.2537313,406,10.639413,812,-173568,34304,-139264,-1
4398,567,22,8,0.114199396,0.885800604,1424.425506,1475.814397,2450.36653,2736.12522,4965,203.6505332,9930,-2251776,290304,-1961472,-1
3843,222,17,13,0.0546125461,0.945387454,1152.678538,1440.878512,2053.856362,1671.959459,4065,314.628483,8130,-1967616,113664,-1853952,-1
9411,544,21,9,0.0546459066,0.945354093,2861.490102,3003.08522,5016.013707,4320.376838,9955,1042.408377,19910,-4818432,278528,-4539904,-1
3262,250,27,3,0.0711845103,0.92881549,1017.281508,882.1164783,1785.874923,1373.216,3512,142.2438234,7024,-1670144,128000,-1542144,-1
6306,419,21,9,0.0623048327,0.937695167,1917.888798,2187.846496,3400.750079,2794.856802,6725,159.7387173,13450,-3228672,214528,-3014144,-1
2647,335,27,3,0.112340711,0.887659289,866.5108028,712.6253785,1538.541745,1119.8,2982,178.9915966,5964,-1355264,171520,-1183744,-1
7665,832,20,10,0.0979169119,0.902083088,2443.781025,2421.198458,4326.45923,3535.388221,8497,244.307073,16994,-3924480,425984,-3498496,-1
866,78,20,10,0.0826271186,0.917372881,262.1303669,365.9017458,468.6570439,515.1666667,944,63.91333785,1888,-443392,39936,-403456,-1
9510,455,21,9,0.0456598093,0.954340191,2868.729032,3001.916201,5004.647529,4530.542857,9965,1210.814095,19930,-4869120,232960,-4636160,-1
437,85,20,10,0.162835249,0.837164751,146.6412893,157.3813019,272.9290618,202.7411765,522,35.12786003,1044,-223744,43520,-180224,-1
9429,520,20,10,0.0522665595,0.947733441,2850.403089,3186.588362,5006.220914,4408.880769,9949,882.7861579,19898,-4827648,266240,-4561408,-1
9522,449,25,5,0.0450305887,0.954969411,2866.891606,2893.67565,5038.769901,3866.902004,9971,861.0535406,19942,-4875264,229888,-4645376,-1
2897,328,18,12,0.101705426,0.898294574,933.6887591,902.8633463,1621.913704,1534.271341,3225,163.7055838,6450,-1483264,167936,-1315328,-1
7400,1037,21,9,0.122910987,0.877089013,2426.165867,2337.194271,4101.976622,5054.075217,8437,175.6610452,16874,-3788800,530944,-3257856,-1
3114,347,20,10,0.10026004,0.89973996,985.6330167,1020.342312,1684.079319,2152.069164,3461,113.5871349,6922,-1594368,177664,-1416704,-1
9352,354,21,9,0.0364722852,0.963527715,2791.992148,2982.150509,4877.541488,4218.370056,9706,251.2555009,19412,-4788224,181248,-4606976,-1
9442,522,25,5,0.052388599,0.947611401,2856.930008,3014.497087,5041.481466,3915.636015,9964,405.3702197,19928,-4834304,267264,-4567040,-1
226,27,19,11,0.106719368,0.893280632,69.76930649,94.20151764,129.1504425,109,253,13.64617044,506,-115712,13824,-101888,-1
2260,177,19,11,0.0726302831,0.927369717,698.3892189,690.6113618,1243.954425,900.3728814,2437,242.0059583,4874,-1157120,90624,-1066496,-1
1415,79,26,4,0.0528781794,0.947121821,425.5190983,502.7519385,755.4968198,604.2658228,1494,122.559475,2988,-724480,40448,-684032,-1
5036,557,24,6,0.0995887717,0.900411228,1619.411361,1568.901991,2803.209293,2740.859964,5593,128.2504013,11186,-2578432,285184,-2293248,-1
47,23,20,10,0.328571429,0.671428571,19.86254258,20.59676778,36.89361702,32.65217391,70,16.90821256,140,-24064,11776,-12288,-1
4341,452,23,7,0.0943041936,0.905695806,1371.518413,1457.939604,2364.280811,2711.234513,4793,115.3272377,9586,-2222592,231424,-1991168,-1
1336,167,21,9,0.111111111,0.888888889,428.4186773,453.0111677,768.9543413,616.3652695,1503,37.25830441,3006,-684032,85504,-598528,-1
366,28,20,10,0.0710659898,0.92893401,111.3936721,133.7764469,200.7459016,155.0714286,394,13.17725753,788,-187392,14336,-173056,-1
1858,102,21,9,0.0520408163,0.947959184,560.6948152,627.8947537,989.8659849,809.8921569,1960,45.09894156,3920,-951296,52224,-899072,-1
297,44,21,9,0.129032258,0.870967742,94.63550274,119.2259297,173.8686869,151.6363636,341,44.5751634,682,-152064,22528,-129536,-1
3919,524,21,9,0.11793833,0.88206167,1265.261008,1403.93654,2230.011993,2162.078244,4443,116.8595476,8886,-2006528,268288,-1738240,-1
5708,270,19,11,0.0451656072,0.954834393,1715.500987,1897.113788,3005.576034,2649.640741,5978,866.3768116,11956,-2922496,138240,-2784256,-1
5048,768,21,9,0.132049519,0.867950481,1641.93451,1879.935278,2865.439778,3191.53125,5816,146.2408851,11632,-2584576,393216,-2191360,-1
135,39,19,11,0.224137931,0.775862069,47.14392056,54.4819364,93.7037037,66.02564103,174,3.198529412,348,-69120,19968,-49152,-1
8995,912,20,10,0.0920561219,0.907943878,2858.508316,2769.618167,5028.0199,4223.946272,9907,442.8699151,19814,-4605440,466944,-4138496,-1
48,12,21,9,0.2,0.8,17.16372092,13.62264251,33.10416667,20.08333333,60,13.60544218,120,-24576,6144,-18432,-1
9260,675,18,12,0.0679416205,0.932058379,2834.711927,3172.567515,4906.512095,5811.522963,9935,688.9736477,19870,-4741120,345600,-4395520,-1
9441,520,21,9,0.052203594,0.947796406,2859.941093,3013.93078,5029.084313,4107.992308,9961,989.1757696,19922,-4833792,266240,-4567552,-1
6018,540,21,9,0.0823421775,0.917657823,1895.105803,1870.788654,3277.151545,3305.672222,6558,196.7006599,13116,-3081216,276480,-2804736,-1
9476,491,20,10,0.0492625665,0.950737434,2864.208789,3094.816334,5003.093183,4615.513238,9967,311.6635397,19934,-4851712,251392,-4600320,-1
3556,198,22,8,0.05274374,0.94725626,1078.203575,1119.653258,1897.310461,1521.712121,3754,127.9481936,7508,-1820672,101376,-1719296,-1
2232,295,25,5,0.116739216,0.883260784,729.9940955,718.2699658,1251.22491,1360.657627,2527,82.55472068,5054,-1142784,151040,-991744,-1
7292,297,27,3,0.039135591,0.960864409,2172.912078,2082.007184,3856.545666,2283.919192,7589,329.6698523,15178,-3733504,152064,-3581440,-1
4898,270,20,10,0.052244582,0.947755418,1480.328617,1681.200948,2592.405676,2441.085185,5168,265.025641,10336,-2507776,138240,-2369536,-1
6512,430,21,9,0.0619418035,0.938058196,1984.798518,2225.034901,3501.770424,3013.07907,6942,129.5874557,13884,-3334144,220160,-3113984,-1
6362,391,22,8,0.0579001925,0.942099807,1935.431168,2144.63395,3359.583622,3660.383632,6753,339.5173454,13506,-3257344,200192,-3057152,-1
1329,165,27,3,0.110441767,0.889558233,424.9813503,448.6897715,727.8623025,905.6727273,1494,35.07042254,2988,-680448,84480,-595968,-1
1486,249,19,11,0.14351585,0.85648415,509.0303433,437.3569158,883.7207268,774.1807229,1735,40.18063918,3470,-760832,127488,-633344,-1
191,58,18,12,0.232931727,0.767068273,69.43805384,72.37977239,133.6753927,96.43103448,249,7.725721378,498,-97792,29696,-68096,-1
4729,666,22,8,0.123447637,0.876552363,1546.824162,1614.35776,2728.215479,2483.451952,5395,137.1726417,10790,-2421248,340992,-2080256,-1
284,82,20,10,0.224043716,0.775956284,98.32996101,126.6741735,179.1584507,198.5365854,366,14.21359223,732,-145408,41984,-103424,-1
9494,474,18,12,0.0475521669,0.952447833,2868.458672,3035.776655,5000.384875,4666.333333,9968,806.4724919,19936,-4860928,242688,-4618240,-1
9403,557,20,10,0.0559236948,0.944076305,2857.596934,2920.534689,5049.598426,3814.014363,9960,719.6531792,19920,-4814336,285184,-4529152,-1
4760,465,16,14,0.0889952153,0.911004785,1502.572078,1561.747988,2623.787815,2502.569892,5225,124.9103514,10450,-2437120,238080,-2199040,-1
4859,983,19,11,0.168264293,0.831735707,1651.310299,1710.022178,2791.103519,3566.053917,5842,121.9369651,11684,-2487808,503296,-1984512,-1
2909,320,21,9,0.0991018891,0.900898111,923.8876923,946.2862196,1650.022344,1296.625,3229,75.99435161,6458,-1489408,163840,-1325568,-1
5488,386,19,11,0.0657133129,0.934286687,1662.857519,2064.51805,2966.364796,2527.111399,5874,120.9139564,11748,-2809856,197632,-2612224,-1
2836,215,19,11,0.0704686988,0.929531301,858.6566979,1114.747056,1511.397743,1718.613953,3051,203.4,6102,-1452032,110080,-1341952,-1
9260,676,19,11,0.0680354267,0.931964573,2835.945946,3250.737577,4998.887689,4552.242604,9936,708.7018545,19872,-4741120,346112,-4395008,-1
3119,187,20,10,0.0565638234,0.943436177,950.4170617,952.8911769,1674.340173,1305.903743,3306,104.0276904,6612,-1596928,95744,-1501184,-1
2105,307,27,3,0.127280265,0.872719735,690.3464022,718.1935962,1228.24228,1057.420195,2412,151.3174404,4824,-1077760,157184,-920576,-1
9176,734,21,9,0.0740665994,0.925933401,2829.286897,2996.727263,5047.968178,3799.521798,9910,663.3199465,19820,-4698112,375808,-4322304,-1
3113,141,21,9,0.0433312846,0.956668715,928.809862,1108.393436,1640.681015,1336.489362,3254,145.0735622,6508,-1593856,72192,-1521664,-1
7126,471,17,13,0.0619981572,0.938001843,2166.591631,2513.062771,3830.374684,3324.316348,7597,210.7935627,15194,-3648512,241152,-3407360,-1
5918,608,20,10,0.0931657983,0.906834202,1866.805784,2040.620456,3254.337276,3352.685855,6526,203.4923605,13052,-3030016,311296,-2718720,-1
4120,286,27,3,0.0649114843,0.935088516,1259.240896,1423.492612,2218.966019,1980.702797,4406,114.0859658,8812,-2109440,146432,-1963008,-1
9649,331,26,4,0.0331663327,0.966833667,2874.429053,3040.210954,5003.817287,4602.287009,9980,1431.850789,19960,-4940288,169472,-4770816,-1
309,72,19,11,0.188976378,0.811023622,107.3788843,103.6482647,203.9093851,135.5972222,381,35.77464789,762,-158208,36864,-121344,-1
9582,398,22,8,0.0398797595,0.96012024,2867.285047,3061.190591,5027.447297,4100.979899,9980,490.9001476,19960,-4905984,203776,-4702208,-1
9433,516,21,9,0.051864509,0.948135491,2862.219993,2968.45101,5011.325029,4310.94186,9949,1039.602926,19898,-4829696,264192,-4565504,-1
9214,723,20,10,0.0727583778,0.927241622,2874.541118,2754.120479,5003.300195,4531.874136,9937,603.339405,19874,-4717568,370176,-4347392,-1
2078,301,22,8,0.126523749,0.873476251,691.1612177,650.0505681,1201.475457,1110.777409,2379,180.6378132,4758,-1063936,154112,-909824,-1
4081,226,19,11,0.0524727188,0.947527281,1244.034889,1157.479909,2176.495957,1747.778761,4307,409.0218424,8614,-2089472,115712,-1973760,-1
7773,454,25,5,0.0551841498,0.94481585,2350.756115,2568.440276,4170.753634,3142.312775,8227,390.0900901,16454,-3979776,232448,-3747328,-1
3189,238,22,8,0.0694484972,0.930551503,981.0184787,1069.684425,1730.547821,1492.273109,3427,429.4486216,6854,-1632768,121856,-1510912,-1
46,33,16,14,0.417721519,0.582278481,22.78983664,22.70196571,41.2826087,38.21212121,79,13.52739726,158,-23552,16896,-6656,-1
43,20,18,12,0.317460317,0.682539683,17.40986212,19.44292931,33.3255814,29.15,63,7.61789601,126,-22016,10240,-11776,-1
8414,495,21,9,0.0555617914,0.944438209,2540.682489,2916.6401,4506.524126,3579.193939,8909,244.0821918,17818,-4307968,253440,-4054528,-1
5175,424,21,9,0.0757278085,0.924272191,1593.007127,1674.449973,2866.869758,1983.841981,5599,485.1819757,11198,-2649600,217088,-2432512,-1
3307,361,20,10,0.0984187568,0.901581243,1055.965017,1082.777773,1827.267009,1900.759003,3668,233.3333333,7336,-1693184,184832,-1508352,-1
7067,502,26,4,0.0663231603,0.93367684,2158.130806,2530.57001,3792.542522,3678.818725,7569,157.5234131,15138,-3618304,257024,-3361280,-1
5898,275,21,9,0.0445488417,0.955451158,1762.989734,1937.045626,3129.462699,2176.290909,6173,284.0773125,12346,-3019776,140800,-2878976,-1
8200,576,17,13,0.065633546,0.934366454,2521.237568,2409.198635,4471.383902,3208.555556,8776,276.4094488,17552,-4198400,294912,-3903488,-1
9522,452,22,8,0.0453178263,0.954682174,2868.659465,3035.998707,5015.120563,4405.634956,9974,188.2597206,19948,-4875264,231424,-4643840,-1
2647,416,19,11,0.135814561,0.864185439,876.2893757,925.9866125,1515.260672,1638.512019,3063,116.3311812,6126,-1355264,212992,-1142272,-1
8168,943,20,10,0.103501262,0.896498738,2590.246662,2772.544979,4444.874143,5518.540827,9111,224.2983752,18222,-4182016,482816,-3699200,-1
5669,299,20,10,0.0501005362,0.949899464,1715.142129,1787.472074,3011.361263,2475.214047,5968,132.9175947,11936,-2902528,153088,-2749440,-1
9191,737,22,8,0.0742344883,0.925765512,2844.470833,3107.674375,4987.24796,4680.814111,9928,891.2028725,19856,-4705792,377344,-4328448,-1
7757,315,21,9,0.0390237859,0.960976214,2329.208126,2352.000635,4040.484981,3938.368254,8072,474.8235294,16144,-3971584,161280,-3810304,-1
4246,144,22,8,0.0328018223,0.967198178,1263.278041,1372.801243,2200.254593,2055.305556,4390,446.5920651,8780,-2173952,73728,-2100224,-1
2626,114,25,5,0.0416058394,0.958394161,785.3024401,911.1920264,1371.936405,1337.412281,2740,232.9931973,5480,-1344512,58368,-1286144,-1
4875,391,21,9,0.0742499051,0.925750095,1518.327176,1449.822248,2674.222769,2125.767263,5266,215.3783231,10532,-2496000,200192,-2295808,-1
2244,271,21,9,0.107753479,0.892246521,712.0414784,832.0628478,1261.9541,1225.258303,2515,90.24040187,5030,-1148928,138752,-1010176,-1
9551,423,21,9,0.0424102667,0.957589733,2864.714398,3027.522648,5031.029421,4004.640662,9974,464.988345,19948,-4890112,216576,-4673536,-1
4022,220,22,8,0.0518623291,0.948137671,1217.593544,1245.397438,2148.635256,1625.418182,4242,151.8796992,8484,-2059264,112640,-1946624,-1
8166,402,21,9,0.0469187675,0.953081232,2460.571522,2680.916331,4306.67132,3834.124378,8568,477.858338,17136,-4180992,205824,-3975168,-1
8410,766,21,9,0.0834786399,0.91652136,2630.651368,2837.945398,4600.656956,4455.027415,9176,170.7480461,18352,-4305920,392192,-3913728,-1
4285,357,18,12,0.0769065058,0.923093494,1318.172388,1564.24132,2304.292182,2528.042017,4642,382.3723229,9284,-2193920,182784,-2011136,-1
7600,559,20,10,0.0685132982,0.931486702,2309.835988,2847.517615,4039.673816,4628.26297,8159,335.6232003,16318,-3891200,286208,-3604992,-1
1238,157,18,12,0.112544803,0.887455197,389.9017742,492.1045776,698.1058158,697.1656051,1395,106.1643836,2790,-633856,80384,-553472,-1
9549,429,20,10,0.0429945881,0.957005412,2866.668086,3038.685843,5029.292806,4103.762238,9978,1119.86532,19956,-4889088,219648,-4669440,-1
5762,727,21,9,0.112035753,0.887964247,1874.970979,1821.382539,3200.630857,3596.657497,6489,161.0573343,12978,-2950144,372224,-2577920,-1
2152,119,24,6,0.0523998239,0.947600176,649.385233,752.5762224,1130.716543,1231.546218,2271,78.82679625,4542,-1101824,60928,-1040896,-1
1260,84,21,9,0.0625,0.9375,382.0379194,441.6566236,682.5190476,522.2142857,1344,97.74545455,2688,-645120,43008,-602112,-1
6474,686,21,9,0.0958100559,0.904189944,1982.937015,2416.61678,3451.400525,4798.85277,7160,218.3592559,14320,-3314688,351232,-2963456,-1
3856,661,22,8,0.146336064,0.853663936,1275.127209,1385.973368,2185.915197,2685.346445,4517,112.78402,9034,-1974272,338432,-1635840,-1
3403,260,18,12,0.070980071,0.929019929,1041.969718,1241.884104,1833.297385,1815.019231,3663,235.8660657,7326,-1742336,133120,-1609216,-1
2434,175,20,10,0.0670755079,0.932924492,740.0368807,916.0233456,1306.623254,1282.422857,2609,110.1773649,5218,-1246208,89600,-1156608,-1
1541,112,22,8,0.0677555959,0.932244404,467.215012,545.1890163,844.1823491,590.5892857,1653,143.989547,3306,-788992,57344,-731648,-1
6300,410,16,14,0.0611028316,0.938897168,1916.319418,2201.992931,3378.089683,3008.390244,6710,238.4506041,13420,-3225600,209920,-3015680,-1
448,100,17,13,0.182481752,0.817518248,151.3316825,165.526197,291.5558036,198.09,548,62.34357224,1096,-229376,51200,-178176,-1
9548,428,17,13,0.0429029671,0.957097033,2866.525885,2990.861808,5033.495287,3984.726636,9976,445.5560518,19952,-4888576,219136,-4669440,-1
8880,1039,21,9,0.104748463,0.895251537,2749.198586,3280.005476,4770.919482,6576.010587,9919,420.6530958,19838,-4546560,531968,-4014592,-1
9443,524,21,9,0.0525734925,0.947426507,2845.10637,3223.889166,5043.096368,3919.024809,9967,1197.956731,19934,-4834816,268288,-4566528,-1
552,162,21,9,0.226890756,0.773109244,200.0597949,222.6436618,348.2264493,389.0987654,714,42.88288288,1428,-282624,82944,-199680,-1
6252,1000,17,13,0.137892995,0.862107005,2046.697287,2238.272486,3513.056302,4335.75,7252,141.557681,14504,-3201024,512000,-2689024,-1
9314,634,19,11,0.0637314033,0.936268597,2822.653831,3410.129901,5030.552931,4151.0347,9948,1146.082949,19896,-4768768,324608,-4444160,-1
8661,371,27,3,0.0410761736,0.958923826,2599.839834,2725.636857,4538.598083,4000.619946,9032,819.600726,18064,-4434432,189952,-4244480,-1
2229,200,21,9,0.0823384109,0.917661589,682.4958806,882.0525891,1218.812472,1172.51,2429,65.33082302,4858,-1141248,102400,-1038848,-1
4352,743,21,9,0.145829244,0.854170756,1450.085913,1241.014009,2391.996094,3461.76716,5095,116.8042182,10190,-2228224,380416,-1847808,-1
245,29,16,14,0.105839416,0.894160584,75.01838797,81.95847387,145.2938776,71.65517241,274,70.98445596,548,-125440,14848,-110592,-1
6543,448,21,9,0.0640823916,0.935917608,2009.989808,2104.423134,3519.231851,3156.700893,6991,182.1047148,13982,-3350016,229376,-3120640,-1
433,43,14,16,0.0903361345,0.909663866,132.6428923,132.9248701,249.7759815,124.9534884,476,20.34188034,952,-221696,22016,-199680,-1
4752,590,18,12,0.110445526,0.889554474,1510.810345,1772.512314,2680.356902,2600.164407,5342,167.8818353,10684,-2433024,302080,-2130944,-1
7404,493,18,12,0.0624287704,0.93757123,2266.641487,2261.953371,4012.493922,2995.432049,7897,275.4447157,15794,-3790848,252416,-3538432,-1
9611,374,21,9,0.0374561843,0.962543816,2864.53639,3164.109444,5029.977006,4042.770053,9985,1015.768057,19970,-4920832,191488,-4729344,-1
5561,618,22,8,0.100016184,0.899983816,1771.12279,1882.364251,3068.536055,3283.140777,6179,238.9404486,12358,-2847232,316416,-2530816,-1
673,100,21,9,0.129366106,0.870633894,221.3948161,234.1227456,389.0505201,373.2,773,68.28621908,1546,-344576,51200,-293376,-1
9530,434,21,9,0.0435568045,0.956443196,2869.178881,3005.435746,4999.556768,4607.958525,9964,585.0851439,19928,-4879360,222208,-4657152,-1
9582,398,20,10,0.0398797595,0.96012024,2872.510077,3038.917943,5010.352953,4512.532663,9980,864.8180243,19960,-4905984,203776,-4702208,-1
6951,776,20,10,0.100427074,0.899572926,2254.746372,1927.933633,3920.842181,3354.837629,7727,187.1850775,15454,-3558912,397312,-3161600,-1
83,27,19,11,0.245454545,0.754545455,31.9905179,28.16266682,59.1686747,44.22222222,110,10.3480715,220,-42496,13824,-28672,-1
9516,448,20,10,0.0449618627,0.955038137,2870.800811,2990.915343,4986.177911,4904.377232,9964,879.435128,19928,-4872192,229376,-4642816,-1
4537,372,21,9,0.0757791811,0.924220819,1405.908503,1545.588276,2460.509588,2387.803763,4909,178.5740269,9818,-2322944,190464,-2132480,-1
4181,392,22,8,0.0857205336,0.914279466,1308.606721,1426.793795,2271.598661,2451.267857,4573,87.79036283,9146,-2140672,200704,-1939968,-1
5915,248,18,12,0.0402401428,0.959759857,1767.624168,1954.621715,3105.084193,2531.423387,6163,209.6258503,12326,-3028480,126976,-2901504,-1
9494,466,19,11,0.0467871486,0.953212851,2859.551106,3038.864839,5024.965663,4074.583691,9960,615.1945645,19920,-4860928,238592,-4622336,-1
2776,220,21,9,0.0734312417,0.926568758,846.4563781,1040.1157,1517.768012,1255.372727,2996,224.4194757,5992,-1421312,112640,-1308672,-1
6641,483,25,5,0.0677989893,0.932201011,2027.730977,2293.281658,3616.296943,2822.819876,7124,313.4183898,14248,-3400192,247296,-3152896,-1
133,27,16,14,0.16875,0.83125,43.36658563,46.18160609,87.03007519,48.33333333,160,36.36363636,320,-68096,13824,-54272,-1
4569,426,22,8,0.0852852853,0.914714715,1447.539948,1375.998077,2507.773473,2393.176056,4995,160.7660122,9990,-2339328,218112,-2121216,-1
1162,112,22,8,0.0879120879,0.912087912,361.6770352,410.1987183,648.0438898,528.1071429,1274,73.55658199,2548,-594944,57344,-537600,-1
123,30,17,13,0.196078431,0.803921569,41.67418136,39.38737812,84.81300813,44.96666667,153,21.54929577,306,-62976,15360,-47616,-1
2985,408,18,12,0.120247569,0.879752431,967.8806644,1038.994884,1669.79129,1896.063725,3393,204.2745334,6786,-1528320,208896,-1319424,-1
219,13,24,6,0.0560344828,0.943965517,65.53212792,82.75343,118.1826484,88.15384615,232,65.7223796,464,-112128,6656,-105472,-1
7154,308,20,10,0.0412757974,0.958724203,2134.298668,2399.079976,3770.508387,2825.441558,7462,453.3414338,14924,-3662848,157696,-3505152,-1
54,20,19,11,0.27027027,0.72972973,21.16626972,21.70086404,38.37037037,35.15,74,13.55311355,148,-27648,10240,-17408,-1
2900,152,21,9,0.0498034076,0.950196592,870.5012773,1049.04349,1517.982414,1689.006579,3052,59.48158254,6104,-1484800,77824,-1406976,-1
4248,258,19,11,0.0572569907,0.942743009,1291.985241,1336.193348,2284.794021,1738.24031,4506,180.5288462,9012,-2174976,132096,-2042880,-1
9536,435,18,12,0.0436265169,0.956373483,2856.855704,3129.098035,5034.867659,3914.731034,9971,756.5250379,19942,-4882432,222720,-4659712,-1
3313,269,17,13,0.0750977108,0.924902289,1019.702304,1121.399327,1824.091458,1390.104089,3582,82.85912561,7164,-1696256,137728,-1558528,-1
1594,161,22,8,0.0917378917,0.908262108,501.0455814,544.1024654,890.282936,756.3913043,1755,60.22649279,3510,-816128,82432,-733696,-1
4596,1528,21,9,0.249510124,0.750489876,1523.113678,1707.071199,2595.086162,4468.412304,6124,115.3947616,12248,-2353152,782336,-1570816,-1
3253,270,27,3,0.0766392279,0.923360772,1016.385627,996.3783058,1780.980633,1533.318519,3523,181.8791946,7046,-1665536,138240,-1527296,-1
3256,196,21,9,0.056778679,0.943221321,978.3177696,1223.165686,1708.614251,2023.622449,3452,180.7329843,6904,-1667072,100352,-1566720,-1
7167,2098,21,9,0.226443605,0.773556395,2565.099035,2241.624221,4112.440352,6411.289323,9265,193.666388,18530,-3669504,1074176,-2595328,-1
6327,361,22,8,0.0539772727,0.946022727,1909.489239,2236.188585,3322.883199,3723.362881,6688,223.8286479,13376,-3239424,184832,-3054592,-1
1152,125,27,3,0.0978856695,0.90211433,368.220686,371.2655533,635.9253472,667.336,1277,72.22850679,2554,-589824,64000,-525824,-1
5226,1323,19,11,0.202015575,0.797984425,1864.149637,1719.548579,3047.88672,4172.123205,6549,141.4165407,13098,-2675712,677376,-1998336,-1
4745,563,19,11,0.106066315,0.893933685,1499.037933,1747.08628,2611.772813,3014.60746,5308,120.7736064,10616,-2429440,288256,-2141184,-1
331,30,22,8,0.0831024931,0.916897507,102.0818507,98.98976378,187.6706949,107.4,361,36.68699187,722,-169472,15360,-154112,-1
9562,415,18,12,0.04159567,0.95840433,2851.441389,3269.950744,5039.069964,3835.339759,9977,450.4288939,19954,-4895744,212480,-4683264,-1
9177,732,21,9,0.0738722374,0.926127763,2862.67113,2786.877049,4994.035088,4465.621585,9909,981.0891089,19818,-4698624,374784,-4323840,-1
9509,458,21,9,0.0459516404,0.95404836,2866.963864,2908.527192,5032.038069,3986.633188,9967,657.8877888,19934,-4868608,234496,-4634112,-1
3922,369,19,11,0.0859939408,0.914006059,1234.485793,1282.579373,2144.470678,2162.254743,4291,145.5563094,8582,-2008064,188928,-1819136,-1
5627,433,17,13,0.0714521452,0.928547855,1709.832568,1794.415421,3124.8134,1804.861432,6060,526.4986968,12120,-2881024,221696,-2659328,-1
9401,560,24,6,0.0562192551,0.943780745,2855.176939,3189.199881,4994.189022,4759.589286,9961,1249.811794,19922,-4813312,286720,-4526592,-1
2934,138,19,11,0.044921875,0.955078125,876.1720625,1064.216453,1547.043286,1312.34058,3072,270.1846966,6144,-1502208,70656,-1431552,-1
65,18,21,9,0.21686747,0.78313253,23.93395251,21.73039062,44.52307692,32.88888889,83,7.757009346,166,-33280,9216,-24064,-1
1631,215,22,8,0.116468039,0.883531961,527.5360311,551.6236575,904.7939914,1065.404651,1846,70.21681248,3692,-835072,110080,-724992,-1
6373,270,25,5,0.0406442872,0.959355713,1909.238796,2055.522244,3341.185784,2869.144444,6643,291.6154522,13286,-3262976,138240,-3124736,-1
609,61,25,5,0.0910447761,0.908955224,191.0572629,193.1036332,344.6387521,244.2622951,670,112.4161074,1340,-311808,31232,-280576,-1
9537,439,20,10,0.0440056135,0.955994387,2870.453879,3010.955858,5016.891685,4371.708428,9976,385.7695282,19952,-4882944,224768,-4658176,-1
2514,427,27,3,0.145188711,0.854811289,819.4106121,991.2741562,1444.371122,1627.779859,2941,72.7790151,5882,-1287168,218624,-1068544,-1
3933,397,20,10,0.0916859122,0.908314088,1224.183341,1395.785594,2117.777524,2638.277078,4330,305.7909605,8660,-2013696,203264,-1810432,-1
7292,453,21,9,0.058489348,0.941510652,2240.540061,2077.064359,3908.262068,3305.381898,7745,190.6226926,15490,-3733504,231936,-3501568,-1
1094,218,20,10,0.166158537,0.833841463,369.8944201,420.334336,656.797075,655.0091743,1312,24.05132906,2624,-560128,111616,-448512,-1
1310,81,27,3,0.0582314881,0.941768512,400.7545509,398.9521151,702.6709924,588.1111111,1391,59.75085911,2782,-670720,41472,-629248,-1
498,76,18,12,0.132404181,0.867595819,157.3869631,211.6999523,285.311245,301.8421053,574,18.80733945,1148,-254976,38912,-216064,-1
8983,922,19,11,0.0930843009,0.906915699,2876.63735,2677.172618,4972.819993,4759.894794,9905,780.535855,19810,-4599296,472064,-4127232,-1
6977,305,17,13,0.0418840978,0.958115902,2086.867602,2261.800606,3678.949262,2784.832787,7282,364.6469705,14564,-3572224,156160,-3416064,-1
1239,146,21,9,0.105415162,0.894584838,394.8199639,416.8701257,708.6650525,560.0616438,1385,39.12429379,2770,-634368,74752,-559616,-1
3792,343,21,9,0.0829504232,0.917049577,1211.081625,954.0076795,2087.727584,1849.90379,4135,122.8461081,8270,-1941504,175616,-1765888,-1
138,26,19,11,0.158536585,0.841463415,45.0581062,46.65084967,88.44927536,50.92307692,164,30.94339623,328,-70656,13312,-57344,-1
4911,321,20,10,0.061353211,0.938646789,1504.012456,1589.512272,2630.19833,2406.928349,5232,308.8547816,10464,-2514432,164352,-2350080,-1
9363,586,20,10,0.058900392,0.941099608,2846.506133,3059.216288,5042.110755,3902.716724,9949,1018.321392,19898,-4793856,300032,-4493824,-1
639,152,17,13,0.19216182,0.80783818,224.6584381,241.0764302,402.8841941,367.0592105,791,60.10638298,1582,-327168,77824,-249344,-1
7761,380,21,9,0.0466773124,0.953322688,2334.708142,2640.708755,4078.212988,3923.684211,8141,269.9270557,16282,-3973632,194560,-3779072,-1
7111,324,22,8,0.0435776732,0.956422327,2130.468003,2429.144528,3737.519055,3289.604938,7435,393.5944944,14870,-3640832,165888,-3474944,-1
9510,461,20,10,0.0462340788,0.953765921,2863.09129,3064.458751,5025.74837,4166.0282,9971,924.9536178,19942,-4869120,236032,-4633088,-1
5953,520,21,9,0.0803336938,0.919666306,1813.58456,1961.762645,3119.663867,4580.273077,6473,135.2203886,12946,-3047936,266240,-2781696,-1
9424,533,20,10,0.0535301798,0.94646982,2842.338784,3046.127458,5060.933468,3530.330206,9957,1022.279261,19914,-4825088,272896,-4552192,-1
9575,395,21,9,0.0396188566,0.960381143,2866.226564,3081.865353,5012.243238,4337.23038,9970,1306.684142,19940,-4902400,202240,-4700160,-1
2708,375,22,8,0.121634771,0.878365229,883.0154567,938.1715571,1537.604136,1573.744,3083,197.8818999,6166,-1386496,192000,-1194496,-1
8969,408,27,3,0.0435107177,0.956489282,2694.07286,2877.238311,4722.665069,3948.946078,9377,1129.759036,18754,-4592128,208896,-4383232,-1
2749,507,20,10,0.155712531,0.844287469,920.8207951,1032.294619,1611.064023,1723.039448,3256,67.02346645,6512,-1407488,259584,-1147904,-1
9185,351,27,3,0.0368078859,0.963192114,2751.941113,2735.775617,4786.013827,4310.196581,9536,466.993144,19072,-4702720,179712,-4523008,-1
9181,747,21,9,0.0752417405,0.924758259,2829.552844,3224.880399,4917.364884,5543.813922,9928,333.6021505,19856,-4700672,382464,-4318208,-1
568,57,20,10,0.0912,0.9088,173.1756025,240.7476287,314.068662,302.3508772,625,24.07550077,1250,-290816,29184,-261632,-1
1420,84,20,10,0.0558510638,0.944148936,427.8414382,471.6594036,766.3690141,518.047619,1504,211.533052,3008,-727040,43008,-684032,-1
5711,519,21,9,0.0833065811,0.916693419,1795.327699,1831.815621,3111.440553,3160.169557,6230,175.8396839,12460,-2924032,265728,-2658304,-1
2060,211,23,7,0.0929106121,0.907089388,652.2045678,687.6724486,1136.229612,1133.758294,2271,95.26006711,4542,-1054720,108032,-946688,-1
4753,544,16,14,0.102699641,0.897300359,1493.269452,1804.991238,2631.28866,2803.746324,5297,330.2369077,10594,-2433536,278528,-2155008,-1
9415,543,22,8,0.0545290219,0.945470978,2855.110639,3143.308089,5011.321614,4427.74954,9958,1878.867925,19916,-4820480,278016,-4542464,-1
4917,347,20,10,0.0659194529,0.934080547,1501.222426,1755.955937,2639.911125,2527.48415,5264,144.3773999,10528,-2517504,177664,-2339840,-1
6956,372,18,12,0.0507641921,0.949235808,2087.180793,2585.629096,3659.85207,3751.41129,7328,243.8602329,14656,-3561472,190464,-3371008,-1
8701,577,21,9,0.0621901272,0.937809873,2640.350188,3112.788638,4592.749684,5344.481802,9278,333.9812815,18556,-4454912,295424,-4159488,-1
5689,984,19,11,0.147459913,0.852540087,1901.502081,2037.11081,3390.055018,3030.262195,6673,175.144357,13346,-2912768,503808,-2408960,-1
2076,153,21,9,0.068640646,0.931359354,627.5166892,784.4131986,1134.299133,853.1372549,2229,176.0663507,4458,-1062912,78336,-984576,-1
5395,407,21,9,0.0701482248,0.929851775,1642.047498,1964.489428,2946.941427,2299.149877,5802,143.7205846,11604,-2762240,208384,-2553856,-1
241,31,27,3,0.113970588,0.886029412,78.5426091,70.24920706,140.6970954,103.8709677,272,27.84032753,544,-123392,15872,-107520,-1
1283,160,21,9,0.110880111,0.889119889,415.167175,413.7205548,734.6827747,620.3,1443,102.1954674,2886,-656896,81920,-574976,-1
2857,341,21,9,0.106629143,0.893370857,905.4587326,1039.589678,1622.913196,1403.337243,3198,85.73726542,6396,-1462784,174592,-1288192,-1
52,13,20,10,0.2,0.8,18.08674038,18.93933011,35.15384615,24.38461538,65,13.68421053,130,-26624,6656,-19968,-1
3760,651,18,12,0.147585582,0.852414418,1234.000547,1466.404854,2173.688564,2392.62212,4411,88.60988349,8822,-1925120,333312,-1591808,-1
5074,252,18,12,0.0473150582,0.952684942,1525.369978,1618.833267,2697.44324,1980.055556,5326,447.9394449,10652,-2597888,129024,-2468864,-1
9318,624,21,9,0.0627640314,0.937235969,2849.64026,2988.33343,5037.819489,3981.171474,9942,625.6765261,19884,-4770816,319488,-4451328,-1
1485,198,25,5,0.117647059,0.882352941,472.7994818,567.409907,853.0942761,758.7929293,1683,43.42105263,3366,-760320,101376,-658944,-1
5045,437,19,11,0.0797154323,0.920284568,1560.689997,1677.645038,2799.185134,2075.546911,5482,108.5974643,10964,-2583040,223744,-2359296,-1
2336,157,19,11,0.0629763337,0.937023666,710.6282804,834.13899,1254.831336,1130.477707,2493,199.7596154,4986,-1196032,80384,-1115648,-1
1820,180,25,5,0.09,0.91,574.7623131,601.7843261,997.0521978,1035.361111,2000,40.75810067,4000,-931840,92160,-839680,-1
381,143,21,9,0.272900763,0.727099237,161.7215067,118.838314,260.4908136,267.8531469,524,58.22222222,1048,-195072,73216,-121856,-1
138,28,20,10,0.168674699,0.831325301,46.6945417,37.96702382,90.48550725,49.07142857,166,41.60401003,332,-70656,14336,-56320,-1
7616,626,21,9,0.0759524387,0.924047561,2361.31331,2402.887373,4197.372505,3198.42492,8242,344.1336117,16484,-3899392,320512,-3578880,-1
434,53,25,5,0.108829569,0.891170431,133.8461777,169.8047169,235.016129,317.5660377,487,13.83129793,974,-222208,27136,-195072,-1
294,50,20,10,0.145348837,0.854651163,93.2819465,122.5600849,178.9047619,134.84,344,12.12548467,688,-150528,25600,-124928,-1
8713,1149,21,9,0.116507808,0.883492192,2794.110675,2978.014048,4779.938368,6080.809399,9862,668.1571816,19724,-4461056,588288,-3872768,-1
2735,403,22,8,0.128425749,0.871574251,886.9565232,1015.516778,1588.632907,1439.652605,3138,220.056101,6276,-1400320,206336,-1193984,-1
1149,147,20,10,0.113425926,0.886574074,362.7697523,373.9894369,679.3281114,407.537415,1296,85.20710059,2592,-588288,75264,-513024,-1
42,13,27,3,0.236363636,0.763636364,14.67740794,17.83421351,26.04761905,34.30769231,55,17.51592357,110,-21504,6656,-14848,-1
5480,370,21,9,0.0632478632,0.936752137,1668.702872,1960.113512,2930.841423,2846.389189,5850,398.7730061,11700,-2805760,189440,-2616320,-1
9328,622,20,10,0.0625125628,0.937487437,2842.117183,3188.339475,5028.45819,4181.297428,9950,677.331518,19900,-4775936,318464,-4457472,-1
9286,657,21,9,0.0660766368,0.933923363,2815.355632,3556.409234,4966.850958,5044.776256,9943,774.9805144,19886,-4754432,336384,-4418048,-1
5167,310,20,10,0.0566003286,0.943399671,1556.694826,1921.601493,2722.288175,3017.548387,5477,103.9278937,10954,-2645504,158720,-2486784,-1
226,59,24,6,0.207017544,0.792982456,75.5373825,96.43289117,133.8761062,177.9491525,285,8.753071253,570,-115712,30208,-85504,-1
1344,69,21,9,0.0488322718,0.951167728,401.1128461,463.211035,719.1346726,470.6376812,1413,155.104281,2826,-688128,35328,-652800,-1
5783,308,25,5,0.0505664095,0.949433591,1751.690731,1869.802353,3055.346706,2870.506494,6091,128.2045885,12182,-2960896,157696,-2803200,-1
216,52,18,12,0.194029851,0.805970149,74.06209336,85.67877258,140.3055556,110.3846154,268,5.036647247,536,-110592,26624,-83968,-1
8283,1309,21,9,0.13646789,0.86353211,2696.486426,2708.016071,4548.984184,6362.713522,9592,186.1801242,19184,-4240896,670208,-3570688,-1
115,55,20,10,0.323529412,0.676470588,36.38969297,53.13505014,68.57391304,120.8909091,170,12.60192735,340,-58880,28160,-30720,-1
3593,237,22,8,0.0618798956,0.938120104,1094.489531,1220.44821,1936.138603,1602.611814,3830,283.7037037,7660,-1839616,121344,-1718272,-1
683,109,20,10,0.137626263,0.862373737,215.5141482,282.8380943,382.6149341,483.5045872,792,27.66329025,1584,-349696,55808,-293888,-1
4340,388,17,13,0.0820642978,0.917935702,1364.456562,1368.445537,2368.681567,2317.726804,4728,99.97885388,9456,-2222080,198656,-2023424,-1
3275,431,22,8,0.116297895,0.883702105,1059.080808,1144.539086,1842.125191,1939.932715,3706,100.5153241,7412,-1676800,220672,-1456128,-1
423,59,20,10,0.122406639,0.877593361,131.5816645,184.1354903,242.9716312,230.9491525,482,9.132247063,964,-216576,30208,-186368,-1
9572,407,20,10,0.0407856499,0.95921435,2873.842915,2927.715036,5023.66214,4198.31941,9979,937.8759398,19958,-4900864,208384,-4692480,-1
5679,1211,21,9,0.175761974,0.824238026,2018.620046,1674.05342,3295.997007,4146.596201,6890,145.4507072,13780,-2907648,620032,-2287616,-1
3187,327,20,10,0.093056346,0.906943654,996.8389493,1171.811645,1756.152495,1770.633028,3514,316.2916292,7028,-1631744,167424,-1464320,-1
8430,1507,22,8,0.151655429,0.848344571,2962.067622,2216.004316,5054.287782,4491.909091,9937,685.7832988,19874,-4316160,771584,-3544576,-1
1447,135,17,13,0.085335019,0.914664981,444.5801189,560.9547471,800.7795439,692.037037,1582,29.59775491,3164,-740864,69120,-671744,-1
276,49,15,15,0.150769231,0.849230769,91.11814087,81.00569959,174.6304348,97.48979592,325,43.56568365,650,-141312,25088,-116224,-1
9535,437,17,13,0.0438227036,0.956177296,2848.2997,3468.687241,4996.496592,4768.382151,9972,973.828125,19944,-4881920,223744,-4658176,-1
114,30,20,10,0.208333333,0.791666667,39.90098163,46.54627327,74.56140351,64.66666667,144,22.18798151,288,-58368,15360,-43008,-1
9123,824,20,10,0.0828390469,0.917160953,2898.817352,2492.036784,5020.314809,4461.220874,9947,416.8901928,19894,-4670976,421888,-4249088,-1
4776,418,18,12,0.080477474,0.919522526,1468.118964,1789.957708,2570.424204,2906.863636,5194,206.1929337,10388,-2445312,214016,-2231296,-1
6751,535,20,10,0.073428493,0.926571507,2086.569393,2252.877203,3606.739298,4107.371963,7286,159.8157491,14572,-3456512,273920,-3182592,-1
72,19,19,11,0.208791209,0.791208791,24.02830362,32.06770884,48.20833333,37.63157895,91,8.512628625,182,-36864,9728,-27136,-1
9397,558,19,11,0.0560522351,0.943947765,2840.197488,3389.270065,4979.847717,4946.883513,9955,510.7747563,19910,-4811264,285696,-4525568,-1
9404,554,20,10,0.0556336614,0.944366339,2848.737551,2973.343968,5059.19598,3626.68231,9958,796.64,19916,-4814848,283648,-4531200,-1
552,61,21,9,0.0995106036,0.900489396,171.9209764,214.5061201,310.6358696,274.0983607,613,51.81741336,1226,-282624,31232,-251392,-1
2596,276,17,13,0.0961002786,0.903899721,811.072215,949.5898702,1411.0547,1675.833333,2872,172.9078868,5744,-1329152,141312,-1187840,-1
9506,465,21,9,0.0466352422,0.953364758,2864.034134,2895.984375,5046.081948,3757.744086,9971,427.0235546,19942,-4867072,238080,-4628992,-1
5890,561,21,9,0.0869632615,0.913036738,1824.292965,2216.100758,3211.402207,3379.263815,6451,251.5009747,12902,-3015680,287232,-2728448,-1
7922,565,21,9,0.0665724049,0.933427595,2415.8699,2845.689806,4210.806993,4709.40708,8487,427.3413897,16974,-4056064,289280,-3766784,-1
560,68,15,15,0.108280255,0.891719745,173.896793,211.2677313,325.8803571,220.7794118,628,43.16151203,1256,-286720,34816,-251904,-1
6993,424,20,10,0.0571659701,0.94283403,2121.458833,2160.468699,3776.068211,2602.849057,7417,137.6322138,14834,-3580416,217088,-3363328,-1
9480,481,25,5,0.0482883245,0.951711676,2865.10106,3009.654495,5011.760443,4374.744283,9961,815.1391162,19922,-4853760,246272,-4607488,-1
106,29,15,15,0.214814815,0.785185185,37.65822677,27.77187518,76.09433962,38.4137931,135,13.98963731,270,-54272,14848,-39424,-1
881,63,24,6,0.0667372881,0.933262712,266.5814968,274.7928632,486.8978434,271.1587302,944,86.36779506,1888,-451072,32256,-418816,-1
2418,276,20,10,0.102449889,0.897550111,757.1303707,910.3786416,1372.272126,1130.474638,2694,56.13669514,5388,-1238016,141312,-1096704,-1
64,30,20,10,0.319148936,0.680851064,27.71425326,25.14190835,49.828125,42.53333333,94,1.763602251,188,-32768,15360,-17408,-1
124,20,20,10,0.138888889,0.861111111,39.60620084,41.37136691,77.24193548,43.1,144,6.010016694,288,-63488,10240,-53248,-1
5032,1230,20,10,0.196422868,0.803577132,1811.128141,1652.205099,2978.596383,3757.037398,6262,122.6880878,12524,-2576384,629760,-1946624,-1
179,63,16,14,0.260330579,0.739669421,65.38574455,76.19970182,130.0223464,97.28571429,242,44.56721915,484,-91648,32256,-59392,-1
1914,95,25,5,0.0472872076,0.952712792,572.5354894,623.5208593,1021.760188,667.3263158,2009,72.63195951,4018,-979968,48640,-931328,-1
2389,124,19,11,0.0493434142,0.950656586,717.2458607,810.9791393,1272.708665,954.3548387,2513,335.0666667,5026,-1223168,63488,-1159680,-1
9379,572,19,11,0.0574816601,0.94251834,2864.427818,2999.9268,4967.28905,5118.832168,9951,461.3351878,19902,-4802048,292864,-4509184,-1
1233,84,21,9,0.0637813212,0.936218679,373.6791827,462.2903619,662.5004055,607.6190476,1317,142.8416486,2634,-631296,43008,-588288,-1
3251,428,21,9,0.116335961,0.883664039,1041.094572,1184.95932,1869.888342,1612.974299,3679,134.2210872,7358,-1664512,219136,-1445376,-1
5492,519,21,9,0.0863417069,0.913658293,1713.583037,1898.682894,2966.02185,3429.044316,6011,150.5007511,12022,-2811904,265728,-2546176,-1
105,33,20,10,0.239130435,0.760869565,38.08713485,42.95236219,73.13333333,57.93939394,138,27.99188641,276,-53760,16896,-36864,-1
3711,229,20,10,0.0581218274,0.941878173,1122.488064,1350.718208,1963.273242,2087.611354,3940,152.6540101,7880,-1900032,117248,-1782784,-1
3749,324,22,8,0.0795482445,0.920451755,1163.861153,1282.981652,2057.122699,1804.160494,4073,245.3614458,8146,-1919488,165888,-1753600,-1
6132,591,21,9,0.0879071843,0.912092816,1930.933138,1959.00416,3414.372309,2818.604061,6723,297.741364,13446,-3139584,302592,-2836992,-1
106,32,18,12,0.231884058,0.768115942,38.25752613,37.44588543,75.94339623,48.15625,138,24.16812609,276,-54272,16384,-37888,-1
86,19,21,9,0.180952381,0.819047619,30.30198647,19.62134628,57.62790698,32.05263158,105,12.41134752,210,-44032,9728,-34304,-1
434,113,18,12,0.206581353,0.793418647,150.9146623,181.8926549,271.2534562,284.5486726,547,54.59081836,1094,-222208,57856,-164352,-1
7670,691,18,12,0.0826456166,0.917354383,2414.066986,2398.684745,4199.805867,3972.257598,8361,269.883796,16722,-3927040,353792,-3573248,-1
3623,211,20,10,0.0550339071,0.944966093,1096.127117,1199.139016,1942.176925,1493.781991,3834,73.11212815,7668,-1854976,108032,-1746944,-1
9556,408,19,11,0.0409474107,0.959052589,2858.701122,3081.362674,5027.3491,3932.063725,9964,942.6679281,19928,-4892672,208896,-4683776,-1
4315,289,21,9,0.062771503,0.937228497,1324.927227,1378.654876,2313.634531,2136.252595,4604,113.988611,9208,-2209280,147968,-2061312,-1
38,17,21,9,0.309090909,0.690909091,15.95657195,15.61207943,28.57894737,26.70588235,55,1.698054955,110,-19456,8704,-10752,-1
2464,373,27,3,0.131476912,0.868523088,830.202902,699.3769294,1453.333198,1192.198391,2837,65.18841912,5674,-1261568,190976,-1070592,-1
8182,1773,20,10,0.178101457,0.821898543,2781.754918,2657.204396,4605.30726,6697.893965,9955,460.6663582,19910,-4189184,907776,-3281408,-1
5219,411,21,9,0.0730017762,0.926998224,1621.659246,1667.728638,2808.818739,2900.340633,5630,405.6195965,11260,-2672128,210432,-2461696,-1
7313,434,27,3,0.0560216858,0.943978314,2201.969449,2749.635086,3867.356899,3985.937788,7747,517.50167,15494,-3744256,222208,-3522048,-1
3000,171,21,9,0.0539262062,0.946073794,906.2618667,1058.229263,1591.481,1489.842105,3171,84.11140584,6342,-1536000,87552,-1448448,-1
4860,544,19,11,0.100666173,0.899333827,1564.902238,1513.37788,2711.020165,2626.382353,5404,106.1064206,10808,-2488320,278528,-2209792,-1
8286,493,20,10,0.0561567377,0.943843262,2530.028778,2600.621051,4381.602221,4531.144016,8779,188.5119175,17558,-4242432,252416,-3990016,-1
63,23,18,12,0.26744186,0.73255814,24.32832655,25.37082259,45.46031746,38.13043478,86,38.91402715,172,-32256,11776,-20480,-1
6045,753,22,8,0.110767873,0.889232127,1963.142863,1830.140196,3318.2311,4051.917663,6798,226.9025367,13596,-3095040,385536,-2709504,-1
8016,597,21,9,0.0693138279,0.930686172,2453.965844,2850.575372,4274.471058,4743.770519,8613,227.5561427,17226,-4104192,305664,-3798528,-1
9435,527,20,10,0.0529010239,0.947098976,2862.763361,3051.863899,5010.960466,4454.062619,9962,1166.510539,19924,-4830720,269824,-4560896,-1
685,110,20,10,0.13836478,0.86163522,228.9683597,232.2928511,400.1941606,384.3363636,795,58.62831858,1590,-350720,56320,-294400,-1
498,50,27,3,0.0912408759,0.908759124,155.0090067,183.0134421,278.1646586,238,548,21.90247802,1096,-254976,25600,-229376,-1
2529,209,22,8,0.0763330898,0.92366691,773.0429874,920.1424559,1343.606959,1682.818182,2738,181.9269103,5476,-1294848,107008,-1187840,-1
3600,388,22,8,0.0972918756,0.902708124,1147.628043,1184.078947,1992.825556,2010.036082,3988,231.1884058,7976,-1843200,198656,-1644544,-1
3157,206,21,9,0.061254832,0.938745168,958.3213595,1061.495677,1709.197022,1265.199029,3363,72.275951,6726,-1616384,105472,-1510912,-1
9574,408,27,3,0.0408735724,0.959126428,2862.707647,3126.424681,5034.658241,3978.762255,9982,939.0404516,19964,-4901888,208896,-4692992,-1
2280,177,21,9,0.072039072,0.927960928,695.8676,854.4233933,1238.371053,1108.288136,2457,48.70168484,4914,-1167360,90624,-1076736,-1
3822,767,17,13,0.16713881,0.83286119,1190.909032,1302.989914,2053.789116,3496.966102,4589,200.743657,9178,-1956864,392704,-1564160,-1
9574,405,22,8,0.040585229,0.959414771,2873.178321,3000.38918,5013.352726,4437.953086,9979,1222.916667,19958,-4901888,207360,-4694528,-1
6018,455,18,12,0.0702919821,0.929708018,1843.036585,2156.382128,3259.624626,2937.758242,6473,244.9110859,12946,-3081216,232960,-2848256,-1
5774,265,21,9,0.0438814373,0.956118563,1735.071203,1880.664988,3035.965882,2672.124528,6039,165.0450943,12078,-2956288,135680,-2820608,-1
9515,453,22,8,0.0454454254,0.954554575,2850.943605,3198.896175,5036.382974,3894.728477,9968,515.1421189,19936,-4871680,231936,-4639744,-1
9502,471,20,10,0.0472275143,0.952772486,2854.225735,3125.669453,5043.818775,3840.732484,9973,435.5021834,19946,-4865024,241152,-4623872,-1
5300,409,21,9,0.0716412682,0.928358732,1609.263086,2080.199451,2843.044717,3009.92176,5709,194.7135061,11418,-2713600,209408,-2504192,-1
8326,422,21,9,0.0482395976,0.951760402,2498.593113,2722.623049,4437.334975,3134.774882,8748,309.1166078,17496,-4262912,216064,-4046848,-1
807,92,18,12,0.102335929,0.897664071,253.5349189,292.9438764,459.936803,362.8369565,899,68.52134146,1798,-413184,47104,-366080,-1
374,80,19,11,0.176211454,0.823788546,125.0347729,152.4125564,234.1069519,196.6125,454,15.56927298,908,-191488,40960,-150528,-1
3480,294,21,9,0.0779014308,0.922098569,1067.532674,1302.887106,1869.496552,2100.602041,3774,111.8885265,7548,-1781760,150528,-1631232,-1
2981,288,19,11,0.0881003365,0.911899664,914.1542638,996.8099759,1697.888293,984.0625,3269,104.6414853,6538,-1526272,147456,-1378816,-1
44,10,27,3,0.185185185,0.814814815,14.58481889,18.50972717,26.31818182,32.7,54,4.679376083,108,-22528,5120,-17408,-1
5506,320,21,9,0.0549261929,0.945073807,1668.286881,1898.27611,2909.412822,2983.825,5826,324.3875278,11652,-2819072,163840,-2655232,-1
1779,246,21,9,0.121481481,0.878518519,569.7335881,676.385425,1024.62507,928.9308943,2025,159.7003155,4050,-910848,125952,-784896,-1
4108,695,22,8,0.144701228,0.855298772,1404.617199,1269.096337,2384.152386,2507.493525,4803,89.55808316,9606,-2103296,355840,-1747456,-1
2498,154,21,9,0.0580693816,0.941930618,771.1447841,649.2098246,1336.067254,1171.311688,2652,151.6295026,5304,-1278976,78848,-1200128,-1
9406,538,26,4,0.0541029767,0.945897023,2860.775972,2946.017209,5013.536891,4255.040892,9944,1172.641509,19888,-4815872,275456,-4540416,-1
1818,125,22,8,0.0643335049,0.935666495,550.3474478,599.200176,995.6122112,628.584,1943,171.6431095,3886,-930816,64000,-866816,-1
3151,475,21,9,0.130998345,0.869001655,1031.411299,1141.614575,1805.027293,1869.705263,3626,133.5051546,7252,-1613312,243200,-1370112,-1
61,12,24,6,0.164383562,0.835616438,20.39295503,20.8691359,39.21311475,25.75,73,4.749512036,146,-31232,6144,-25088,-1
1955,232,20,10,0.10608139,0.89391861,612.932498,766.2784781,1101.376982,1031.836207,2187,152.0862309,4374,-1000960,118784,-882176,-1
37,14,21,9,0.274509804,0.725490196,13.98339828,16.05093932,27.24324324,22.71428571,51,0.950251537,102,-18944,7168,-11776,-1
9451,462,27,3,0.0466054676,0.953394532,2845.755948,2924.655091,5015.253201,3765.331169,9913,381.4159292,19826,-4838912,236544,-4602368,-1
818,151,19,11,0.155830753,0.844169247,274.1171296,290.2188942,502.6650367,389.3046358,969,65.69491525,1938,-418816,77312,-341504,-1
2041,204,27,3,0.0908685969,0.909131403,641.4825673,710.6612778,1122.519843,1127.803922,2245,53.92745616,4490,-1044992,104448,-940544,-1
2703,136,17,13,0.0479041916,0.952095808,814.4906433,896.7030229,1428.761746,1245.860294,2839,228.0321285,5678,-1383936,69632,-1314304,-1
9453,516,21,9,0.0517604574,0.948239543,2865.693958,2934.731348,5036.621178,4039.312016,9969,420.9881757,19938,-4839936,264192,-4575744,-1
986,187,21,9,0.15942029,0.84057971,324.1598025,392.5731252,568.7089249,683.4438503,1173,46.71445639,2346,-504832,95744,-409088,-1
5160,446,18,12,0.0795576168,0.920442383,1559.577948,2175.155606,2821.499806,2595.251121,5606,174.0453275,11212,-2641920,228352,-2413568,-1
9428,527,16,14,0.052938222,0.947061778,2844.524424,3175.871856,5036.669601,3928.404175,9955,468.4705882,19910,-4827136,269824,-4557312,-1
871,115,24,6,0.11663286,0.88336714,283.6818031,289.5235844,497.9552239,459.7565217,986,25.62370062,1972,-445952,58880,-387072,-1
644,67,27,3,0.094233474,0.905766526,201.7425875,215.5553227,365.5869565,263.8507463,711,58.23095823,1422,-329728,34304,-295424,-1
6960,622,22,8,0.082036402,0.917963598,2129.149505,2759.452767,3811.562069,3567.011254,7582,417.0517052,15164,-3563520,318464,-3245056,-1
3667,285,18,12,0.0721153846,0.927884615,1123.602483,1335.510568,1987.163076,1839.301754,3952,348.5008818,7904,-1877504,145920,-1731584,-1
4972,297,20,10,0.0563674322,0.943632568,1494.54561,1907.831894,2629.003218,2735.390572,5269,104.3572985,10538,-2545664,152064,-2393600,-1
4437,354,20,10,0.073888541,0.926111459,1370.811712,1524.415902,2404.099617,2294.480226,4791,110.6722107,9582,-2271744,181248,-2090496,-1
1366,238,21,9,0.148379052,0.851620948,452.8933757,514.9741916,794.4348463,848.789916,1604,101.905972,3208,-699392,121856,-577536,-1
9417,541,22,8,0.0543281783,0.945671822,2857.989944,3085.712475,5014.921419,4362.931608,9958,407.1136549,19916,-4821504,276992,-4544512,-1
5119,594,20,10,0.103973394,0.896026606,1653.045048,1606.192723,2837.781207,3022.624579,5713,263.8799076,11426,-2620928,304128,-2316800,-1
7323,310,20,10,0.0406131272,0.959386873,2196.152964,2327.257802,3835.46115,3380.9,7633,257.9587699,15266,-3749376,158720,-3590656,-1
2043,267,17,13,0.115584416,0.884415584,655.8465445,745.4380025,1157.460108,1140.501873,2310,99.6978852,4620,-1046016,136704,-909312,-1
5286,283,22,8,0.0508170228,0.949182977,1605.209838,1564.609122,2812.689936,2267.795053,5569,163.6016451,11138,-2706432,144896,-2561536,-1
5115,468,21,9,0.0838259001,0.9161741,1604.54343,1678.169082,2807.632845,2621.141026,5583,272.4743777,11166,-2618880,239616,-2379264,-1
4955,565,21,9,0.102355072,0.897644928,1578.377473,1642.290577,2705.162664,3245.80354,5520,111.7861482,11040,-2536960,289280,-2247680,-1
544,39,24,6,0.0668953688,0.933104631,164.6853184,208.9736637,294.6194853,255.4615385,583,22.42307692,1166,-278528,19968,-258560,-1
3916,330,21,9,0.0777202073,0.922279793,1217.495118,1301.923328,2140.796221,1918.251515,4246,78.02278574,8492,-2004992,168960,-1836032,-1
1586,80,23,7,0.0480192077,0.951980792,476.5358272,560.4304248,832.221942,858.8375,1666,77.85046729,3332,-812032,40960,-771072,-1
5169,554,20,10,0.0968023764,0.903197624,1632.5393,1772.271292,2817.889147,3273.568592,5723,126.4192622,11446,-2646528,283648,-2362880,-1
51,21,20,10,0.291666667,0.708333333,20.25250066,21.79184145,37.58823529,33.85714286,72,10.31518625,144,-26112,10752,-15360,-1
3735,598,22,8,0.138010616,0.861989384,1220.275978,1365.285697,2105.327443,2552.195652,4333,85.73407202,8666,-1912320,306176,-1606144,-1
6311,700,19,11,0.0998431037,0.900156896,2003.937974,2189.521318,3523.330217,3349.755714,7011,139.3836978,14022,-3231232,358400,-2872832,-1
1017,74,20,10,0.067827681,0.932172319,305.9913913,415.8598158,549.6184857,496.2702703,1091,76.72292546,2182,-520704,37888,-482816,-1
9297,642,21,9,0.0645940235,0.935405976,2842.378548,3086.221096,5034.089169,4041.904984,9939,1022.530864,19878,-4760064,328704,-4431360,-1
48,25,17,13,0.342465753,0.657534247,21.77819851,19.22190417,38.70833333,33.72,73,6.867356538,146,-24576,12800,-11776,-1
2667,281,20,10,0.0953188602,0.90468114,851.1712899,833.1665832,1491.125234,1316.708185,2948,184.5961177,5896,-1365504,143872,-1221632,-1
9513,456,21,9,0.0457417996,0.9542582,2864.345485,3016.942868,5026.667403,4115.741228,9969,644.8253558,19938,-4870656,233472,-4637184,-1
2388,340,20,10,0.124633431,0.875366569,780.8232992,798.2578236,1396.180067,1141.994118,2728,61.53846154,5456,-1222656,174080,-1048576,-1
9498,475,21,9,0.0476285972,0.952371403,2876.733629,2830.649246,5022.588124,4275.387368,9973,395.2833928,19946,-4862976,243200,-4619776,-1
4992,569,18,12,0.102319727,0.897680273,1581.512339,1789.918839,2759.684896,2968.003515,5561,244.2248573,11122,-2555904,291328,-2264576,-1
8395,439,17,13,0.0496943627,0.950305637,2520.403283,2673.774935,4493.781775,2958.763098,8834,577.763244,17668,-4298240,224768,-4073472,-1
1388,197,21,9,0.124290221,0.875709779,454.0319223,471.9750688,780.2694524,882.6954315,1585,86.80175246,3170,-710656,100864,-609792,-1
955,91,21,9,0.086998088,0.913001912,295.0133369,358.3587879,530.6910995,448.032967,1046,26.13693153,2092,-488960,46592,-442368,-1
602,82,20,10,0.119883041,0.880116959,188.7724674,250.6092576,338.8903654,369,684,71.02803738,1368,-308224,41984,-266240,-1
2302,287,22,8,0.110853611,0.889146389,751.7811144,690.6378599,1275.093397,1454.66899,2589,106.630972,5178,-1178624,146944,-1031680,-1
6787,388,21,9,0.0540766551,0.945923345,2063.316379,2204.329936,3584.339325,3652.033505,7175,134.893777,14350,-3474944,198656,-3276288,-1
6922,633,22,8,0.0837855725,0.916214428,2150.614634,2433.798743,3732.553453,4274.968404,7555,242.1474359,15110,-3544064,324096,-3219968,-1
9001,885,20,10,0.0895205341,0.910479466,2830.076085,3075.632727,4966.250528,4712.112994,9886,540.809628,19772,-4608512,453120,-4155392,-1
727,101,21,9,0.121980676,0.878019324,233.0762042,278.0854655,414.8707015,411.8316832,828,86.43006263,1656,-372224,51712,-320512,-1
6478,353,26,4,0.0516761821,0.948323818,1957.343922,2177.10637,3439.804261,2979.161473,6831,340.0199104,13662,-3316736,180736,-3136000,-1
5689,317,20,10,0.0527805528,0.947219447,1708.25149,2080.681943,3030.825628,2513.104101,6006,210.8108108,12012,-2912768,162304,-2750464,-1
9495,466,22,8,0.0467824516,0.953217548,2861.422965,3007.019924,5025.718799,4069.830472,9961,941.4933837,19922,-4861440,238592,-4622848,-1
2413,201,20,10,0.0768936496,0.92310635,741.5300622,895.4739594,1303.718193,1352.900498,2614,191.2216533,5228,-1235456,102912,-1132544,-1
9138,773,20,10,0.0779941479,0.922005852,2830.880235,3135.709351,5006.310681,4361.253558,9911,966.9268293,19822,-4678656,395776,-4282880,-1
9424,550,19,11,0.0551433728,0.944856627,2848.224631,3082.467193,5064.30104,3671.549091,9974,1147.756041,19948,-4825088,281600,-4543488,-1
2523,293,21,9,0.104048295,0.895951705,798.6753953,897.1934604,1433.899326,1189.788396,2816,160.8223872,5632,-1291776,150016,-1141760,-1
1066,81,20,10,0.0706190061,0.929380994,328.3011341,332.3661441,585.2401501,426.0740741,1147,58.94141829,2294,-545792,41472,-504320,-1
781,122,17,13,0.135105205,0.864894795,258.3326208,250.3811957,468.5877081,345.8114754,903,71.32701422,1806,-399872,62464,-337408,-1
4407,264,21,9,0.0565189467,0.943481053,1337.26545,1517.745594,2329.142047,2450.481061,4671,299.231262,9342,-2256384,135168,-2121216,-1
7412,1046,21,9,0.123669898,0.876330102,2304.8258,2473.102226,3950.945089,6203.351816,8458,278.0407627,16916,-3794944,535552,-3259392,-1
792,106,25,5,0.118040089,0.881959911,257.7559984,269.9106535,450.3207071,443.3679245,898,67.21556886,1796,-405504,54272,-351232,-1
273,73,18,12,0.210982659,0.789017341,96.95276389,100.7213931,184.0879121,133.9041096,346,26.84251358,692,-139776,37376,-102400,-1
2569,160,20,10,0.0586295346,0.941370465,782.1561829,810.9405616,1384.592059,1050.425,2729,50.97123646,5458,-1315328,81920,-1233408,-1
2513,237,24,6,0.0861818182,0.913818182,783.1641682,891.1614735,1386.4807,1259.067511,2750,113.8716356,5500,-1286656,121344,-1165312,-1
4501,174,20,10,0.0372192513,0.962780749,1342.171472,1519.048723,2344.345701,2173.850575,4675,206.0379022,9350,-2304512,89088,-2215424,-1
77,29,17,13,0.273584906,0.726415094,30.7911205,24.94417072,58.8961039,39.17241379,106,11.2886049,212,-39424,14848,-24576,-1
156,35,17,13,0.183246073,0.816753927,52.49834653,60.97136163,100.9166667,74.08571429,191,49.48186528,382,-79872,17920,-61952,-1
1936,343,22,8,0.150504607,0.849495393,646.9565909,714.1154258,1149.504132,1086.355685,2279,146.6537967,4558,-991232,175616,-815616,-1
706,119,18,12,0.144242424,0.855757576,235.2380217,241.87625,425.4858357,338.9243697,825,62.12349398,1650,-361472,60928,-300544,-1
5842,241,20,10,0.0396186092,0.960381391,1742.22247,1954.980141,3068.536974,2398.726141,6083,662.6361656,12166,-2991104,123392,-2867712,-1
2432,140,20,10,0.0544323484,0.945567652,730.6482156,903.1509876,1297.435855,1096.528571,2572,47.91356185,5144,-1245184,71680,-1173504,-1
2523,235,21,9,0.0852066715,0.914793328,777.4496744,962.1091569,1365.575505,1528.995745,2758,75.83172945,5516,-1291776,120320,-1171456,-1
6703,370,17,13,0.0523116075,0.947688392,2015.209881,2425.356546,3563.371326,3059.251351,7073,271.2039877,14146,-3431936,189440,-3242496,-1
132,53,21,9,0.286486486,0.713513514,53.02730024,54.30402398,93.58333333,91.54716981,185,10.10376843,370,-67584,27136,-40448,-1
5459,204,22,8,0.0360233092,0.963976691,1631.926147,1691.076693,2841.067961,2589.343137,5663,296.1820084,11326,-2795008,104448,-2690560,-1
8904,985,20,10,0.0996056224,0.900394378,2838.462431,2979.359146,4979.633985,4631.922843,9889,742.4174174,19778,-4558848,504320,-4054528,-1
4796,486,18,12,0.092010602,0.907989398,1504.696664,1654.478928,2599.618224,3054.802469,5282,111.505172,10564,-2455552,248832,-2206720,-1
209,68,21,9,0.245487365,0.754512635,80.17629581,73.21974055,147.6076555,112.5441176,277,6.43437863,554,-107008,34816,-72192,-1
9539,433,18,12,0.0434215804,0.95657842,2876.643778,2845.752433,5016.120243,4333.965358,9972,635.9693878,19944,-4883968,221696,-4662272,-1
1567,174,25,5,0.0999425617,0.900057438,493.9411175,574.17059,868.6987875,891.7241379,1741,139.9517685,3482,-802304,89088,-713216,-1
7303,525,21,9,0.0670669392,0.932933061,2222.861276,2703.010582,3892.505409,4220.455238,7828,154.9178706,15656,-3739136,268800,-3470336,-1
464,88,18,12,0.15942029,0.84057971,152.7576243,189.7887527,279.0689655,262.9545455,552,45.69536424,1104,-237568,45056,-192512,-1
9532,436,22,8,0.0437399679,0.956260032,2869.760024,3004.221946,5005.903798,4516.561927,9968,743.880597,19936,-4880384,223232,-4657152,-1
9301,636,22,8,0.0640032203,0.93599678,2864.213083,2927.746919,4978.767337,4826.160377,9937,802.0177563,19874,-4762112,325632,-4436480,-1
5700,253,21,9,0.04249958,0.95750042,1702.788897,1897.63392,3009.556316,2243.517787,5953,350.1764706,11906,-2918400,129536,-2788864,-1
440,72,21,9,0.140625,0.859375,139.7132096,181.6911421,248.1295455,307.6527778,512,55.53145336,1024,-225280,36864,-188416,-1
8734,384,20,10,0.0421144988,0.957885501,2610.282602,3019.573334,4587.27204,3927.830729,9118,338.3302412,18236,-4471808,196608,-4275200,-1
7722,422,20,10,0.0518172888,0.948182711,2325.519224,2761.84682,4057.715488,4343.035545,8144,193.5361217,16288,-3953664,216064,-3737600,-1
55,26,19,11,0.320987654,0.679012346,24.94529552,17.30888885,44.63636364,33.30769231,81,38.57142857,162,-28160,13312,-14848,-1
2623,164,22,8,0.0588446358,0.941155364,799.250348,884.7734608,1394.534502,1385.45122,2787,197.9403409,5574,-1342976,83968,-1259008,-1
9553,419,17,13,0.0420176494,0.957982351,2870.436411,3028.581906,5005.381556,4556.009547,9972,578.4222738,19944,-4891136,214528,-4676608,-1
2441,233,19,11,0.0871353777,0.912864622,758.0526737,894.1200622,1349.949611,1207.072961,2674,226.8023749,5348,-1249792,119296,-1130496,-1
1412,149,27,3,0.0954516336,0.904548366,446.2667349,487.1530805,786.26983,731.0604027,1561,137.654321,3122,-722944,76288,-646656,-1
9283,362,21,9,0.0375324002,0.9624676,2771.218134,2970.107209,4857.009695,3950.867403,9645,619.460501,19290,-4752896,185344,-4567552,-1
2811,242,19,11,0.0792662954,0.920733705,875.6163089,905.8084618,1549.281395,1268.18595,3053,94.374034,6106,-1439232,123904,-1315328,-1
9527,447,18,12,0.044816523,0.955183477,2861.133221,3002.345294,5043.511284,3793.720358,9974,706.3739377,19948,-4877824,228864,-4648960,-1
9421,535,22,8,0.0537364403,0.94626356,2870.282021,2878.229046,4945.490606,5559.773832,9956,524,19912,-4823552,273920,-4549632,-1
3403,426,27,3,0.111256203,0.888743797,1092.638758,1157.123065,1876.614752,2221.631455,3829,174.7603834,7658,-1742336,218112,-1524224,-1
5493,330,18,12,0.0566718187,0.943328181,1651.745866,2099.615857,2923.313854,2723.675758,5823,123.9727486,11646,-2812416,168960,-2643456,-1
54,31,16,14,0.364705882,0.635294118,24.46275969,24.62818196,43.59259259,41.96774194,85,11.34846462,170,-27648,15872,-11776,-1
1934,218,17,13,0.101301115,0.898698885,598.702712,792.1095744,1081.603413,1031.224771,2152,149.6522949,4304,-990208,111616,-878592,-1
245,21,23,7,0.0789473684,0.921052632,75.60636569,85.9421838,135.5306122,109.8095238,266,29.23076923,532,-125440,10752,-114688,-1
195,18,19,11,0.0845070423,0.915492958,59.18682486,53.64103943,112.5230769,47.16666667,213,52.72277228,426,-99840,9216,-90624,-1
681,184,20,10,0.212716763,0.787283237,249.4502275,249.6084589,427.5535977,453.1576087,865,79.7235023,1730,-348672,94208,-254464,-1
7315,403,25,5,0.0522155999,0.9477844,2202.942334,2624.642996,3875.6,3567.263027,7718,227.200471,15436,-3745280,206336,-3538944,-1
9563,418,21,9,0.0418795712,0.958120429,2866.410999,3127.325553,5020.486354,4316.411483,9981,1070.922747,19962,-4896256,214016,-4682240,-1
9412,537,21,9,0.0539752739,0.946024726,2855.546325,3139.347786,4987.118147,4762.605214,9949,705.6028369,19898,-4818944,274944,-4544000,-1
2899,271,19,11,0.085488959,0.914511041,884.3117898,1192.980057,1592.900655,1506.332103,3170,156.853043,6340,-1484288,138752,-1345536,-1
102,24,18,12,0.19047619,0.80952381,35.27204648,28.35339363,69.68627451,37.20833333,126,28,252,-52224,12288,-39936,-1
9399,468,19,11,0.04743083,0.95256917,2837.816398,2972.16263,4967.77987,4255.587607,9867,1095.116537,19734,-4812288,239616,-4572672,-1
9304,401,21,9,0.0413189078,0.958681092,2785.80038,2997.987498,4893.216681,3919.892768,9705,599.8145859,19410,-4763648,205312,-4558336,-1
9397,558,18,12,0.0560522351,0.943947765,2851.638729,3061.760783,5036.184101,3998.150538,9955,910.7959744,19910,-4811264,285696,-4525568,-1
791,81,21,9,0.0928899083,0.907110092,240.8652282,305.3777011,421.920354,578.8765432,872,63.64963504,1744,-404992,41472,-363520,-1
8067,429,25,5,0.0504943503,0.94950565,2434.948678,2763.322205,4248.622164,4246.202797,8496,155.9471366,16992,-4130304,219648,-3910656,-1
4670,610,18,12,0.115530303,0.884469697,1504.415873,1662.721005,2656.698929,2516.485246,5280,131.4413742,10560,-2391040,312320,-2078720,-1
2610,127,27,3,0.0464011692,0.953598831,781.3855425,879.0145375,1351.660536,1725.346457,2737,232.7380952,5474,-1336320,65024,-1271296,-1
534,75,15,15,0.123152709,0.876847291,166.7292663,194.5732178,321.2022472,189.64,609,110.5263158,1218,-273408,38400,-235008,-1
9537,434,19,11,0.0435262261,0.956473774,2868.830124,2948.284585,5025.775611,4111.9447,9971,764.0613027,19942,-4882944,222208,-4660736,-1
363,73,18,12,0.167431193,0.832568807,118.4457561,148.2100623,228.3553719,169.4931507,436,8.224863233,872,-185856,37376,-148480,-1
74,13,25,5,0.149425287,0.850574713,25.04573246,24.4874077,45.14864865,37.46153846,87,4.918032787,174,-37888,6656,-31232,-1
7469,540,21,9,0.0674241478,0.932575852,2273.367932,2756.337306,3973.930245,4434.740741,8009,165.0659522,16018,-3824128,276480,-3547648,-1
9392,570,21,9,0.0572174262,0.942782574,2841.938882,3383.852186,4986.790886,4894.321053,9962,669.0396239,19924,-4808704,291840,-4516864,-1
9470,502,22,8,0.0503409547,0.949659045,2860.291261,2897.053682,5057.393453,3649.12749,9972,645.4368932,19944,-4848640,257024,-4591616,-1
792,108,20,10,0.12,0.88,249.8203722,323.179706,452.9911616,432.2314815,900,31.85840708,1800,-405504,55296,-350208,-1
970,147,27,3,0.131602507,0.868397493,320.5844659,314.6911922,575.014433,453.3265306,1117,168.4766214,2234,-496640,75264,-421376,-1
1920,141,20,10,0.0684133916,0.931586608,593.3978125,612.5861245,1035.473958,970.0780142,2061,77.36486486,4122,-983040,72192,-910848,-1
1395,138,24,6,0.0900195695,0.909980431,437.2162513,492.9101544,765.6150538,781,1533,70.77562327,3066,-714240,70656,-643584,-1
2709,166,17,13,0.0577391304,0.94226087,827.751959,824.9018815,1453.460317,1185.698795,2875,186.8096166,5750,-1387008,84992,-1302016,-1
6529,1529,22,8,0.189749317,0.810250683,2215.733302,2211.274771,3685.530556,5498.28777,8058,165.4280435,16116,-3342848,782848,-2560000,-1
7919,441,19,11,0.0527511962,0.947248804,2400.284821,2612.146363,4161.115671,4528.582766,8360,220.1738214,16720,-4054528,225792,-3828736,-1
6609,355,18,12,0.0509764503,0.94902355,1998.6821,2200.29256,3496.321834,3225.180282,6964,129.346211,13928,-3383808,181760,-3202048,-1
9479,481,20,10,0.0482931727,0.951706827,2865.17139,3015.258492,5008.061821,4437.343035,9960,1398.876404,19920,-4853248,246272,-4606976,-1
2605,272,19,11,0.0945429267,0.905457073,823.1773023,890.6482843,1427.771593,1546.536765,2877,177.8121137,5754,-1333760,139264,-1194496,-1
9481,491,21,9,0.049237866,0.950762134,2855.658151,3183.269197,5028.790739,4169.88391,9972,930.2238806,19944,-4854272,251392,-4602880,-1
8218,873,22,8,0.0960290397,0.90397096,2630.18552,2522.681976,4497.100146,5006.319588,9091,174.6254322,18182,-4207616,446976,-3760640,-1
2990,174,22,8,0.0549936789,0.945006321,896.1648181,1125.477501,1600.609365,1271.310345,3164,124.5179063,6328,-1530880,89088,-1441792,-1
2166,177,27,3,0.0755441741,0.924455826,673.2232262,695.167205,1159.303324,1327.372881,2343,210.1345291,4686,-1108992,90624,-1018368,-1
9607,378,18,12,0.0378567852,0.962143215,2860.532457,3338.516864,5016.076715,4406.497354,9985,620.9577114,19970,-4918784,193536,-4725248,-1
514,52,17,13,0.0918727915,0.908127208,158.0849037,199.7332244,289.3326848,225.8461538,566,14.61022199,1132,-263168,26624,-236544,-1
5306,239,24,6,0.0431018936,0.956898106,1590.151516,1719.522605,2799.178854,2191.807531,5545,360.2988954,11090,-2716672,122368,-2594304,-1
8263,688,20,10,0.0768629203,0.92313708,2584.94774,2461.342977,4416.381823,5192.024709,8951,228.984395,17902,-4230656,352256,-3878400,-1
4213,584,18,12,0.121742756,0.878257244,1361.664319,1540.732808,2404.236886,2361.22089,4797,107.5801749,9594,-2157056,299008,-1858048,-1
1819,241,20,10,0.116990291,0.883009709,593.5598236,600.0811091,1037.864211,974.9170124,2060,146.0992908,4120,-931328,123392,-807936,-1
297,31,20,10,0.0945121951,0.905487805,91.56871406,103.3218706,170.6632997,105.4516129,328,24.69879518,656,-152064,15872,-136192,-1
9444,508,21,9,0.0510450161,0.948954984,2847.631956,3143.88546,5030.35144,3975.372047,9952,625.9119497,19904,-4835328,260096,-4575232,-1
3371,374,24,6,0.0998664887,0.900133511,1058.073188,1268.320386,1866.450311,1932.034759,3745,74.46808511,7490,-1725952,191488,-1534464,-1
4921,271,22,8,0.0521956857,0.947804314,1476.801318,1853.285347,2597.652306,2575.575646,5192,186.5612648,10384,-2519552,138752,-2380800,-1
3787,239,19,11,0.0593641331,0.940635867,1155.709636,1082.923367,2053.006866,1387.506276,4026,235.9906213,8052,-1938944,122368,-1816576,-1
619,41,21,9,0.0621212121,0.937878788,186.3368681,203.7700615,339.2504039,198.3902439,660,62.08842897,1320,-316928,20992,-295936,-1
9471,502,21,9,0.0503359069,0.949664093,2869.040074,3012.460597,5014.764228,4463.185259,9973,697.9006298,19946,-4849152,257024,-4592128,-1
1314,111,18,12,0.0778947368,0.922105263,401.7716836,510.3882209,710.3888889,743.9099099,1425,149.6848739,2850,-672768,56832,-615936,-1
114,30,22,8,0.208333333,0.791666667,42.87949806,29.60347202,77.35964912,54.03333333,144,4.426683062,288,-58368,15360,-43008,-1
6910,398,20,10,0.0544608648,0.945539135,2085.359159,2260.92894,3713.429088,2631.384422,7308,157.8401728,14616,-3537920,203776,-3334144,-1
2032,194,19,11,0.0871518419,0.912848158,632.5209207,727.230289,1125.92372,983.371134,2226,134.9909036,4452,-1040384,99328,-941056,-1
2208,120,27,3,0.0515463918,0.948453608,660.473033,773.8861442,1184.035326,805.05,2328,187.4396135,4656,-1130496,61440,-1069056,-1
9451,438,20,10,0.0442916372,0.955708363,2834.417333,3220.113581,4968.590414,4435.974886,9889,681.0606061,19778,-4838912,224256,-4614656,-1
6701,775,27,3,0.103665062,0.896334938,2153.504707,2139.379368,3683.399194,4214.926452,7476,228.9038579,14952,-3430912,396800,-3034112,-1
2208,201,23,7,0.0834371108,0.916562889,676.900451,872.1566921,1209.000453,1161.054726,2409,68.26296401,4818,-1130496,102912,-1027584,-1
145,39,11,19,0.211956522,0.788043478,49.57041905,58.42066722,99.08965517,68,184,6.277720914,368,-74240,19968,-54272,-1
9647,345,20,10,0.0345276221,0.965472378,2868.978645,3198.076796,5023.262154,4248.168116,9992,1116.424581,19984,-4939264,176640,-4762624,-1
175,16,21,9,0.0837696335,0.916230366,53.25141171,51.25487782,100.5028571,46.75,191,10.93302805,382,-89600,8192,-81408,-1
3428,250,22,8,0.0679717238,0.932028276,1047.455476,1207.546447,1859.71937,1562.252,3678,100.8223684,7356,-1755136,128000,-1627136,-1
2129,245,21,9,0.103201348,0.896798652,666.9041837,763.9298955,1222.372945,884.4612245,2374,108.4513476,4748,-1090048,125440,-964608,-1
5188,280,17,13,0.0512070227,0.948792977,1564.683487,1813.208971,2738.92579,2652.496429,5468,344.3324937,10936,-2656256,143360,-2512896,-1
5813,423,21,9,0.0678319436,0.932168056,1774.503283,2093.61127,3094.2952,3451.130024,6236,115.0341265,12472,-2976256,216576,-2759680,-1
3288,127,17,13,0.0371888726,0.962811127,978.5892505,1102.014811,1721.423358,1360.472441,3415,513.5338346,6830,-1683456,65024,-1618432,-1
324,85,21,9,0.207823961,0.792176039,118.740179,108.6476009,214.1296296,170.2,409,30.31875463,818,-165888,43520,-122368,-1
3583,294,21,9,0.0758318287,0.924168171,1087.979047,1096.597582,2013.40441,1032.227891,3877,588.3156297,7754,-1834496,150528,-1683968,-1
1882,183,21,9,0.0886198547,0.911380145,587.3082767,651.7183456,1051.044633,847.4262295,2065,135.0555919,4130,-963584,93696,-869888,-1
1013,233,23,7,0.186998395,0.813001605,327.1544981,429.0968646,580.792695,809.1759657,1246,31.43289606,2492,-518656,119296,-399360,-1
2042,208,20,10,0.0924444444,0.907555556,639.087236,719.878439,1107.186092,1305.293269,2250,70.91080996,4500,-1045504,106496,-939008,-1
927,91,21,9,0.0893909627,0.910609037,287.2246035,354.2800848,508.2081985,522.6593407,1018,78.85360186,2036,-474624,46592,-428032,-1
3250,365,18,12,0.100968188,0.899031812,1020.888181,1207.42251,1784.690462,2015.550685,3615,114.0018921,7230,-1664000,186880,-1477120,-1
2703,208,21,9,0.0714531089,0.928546891,830.312464,853.6120945,1488.749538,1030.413462,2911,152.0898642,5822,-1383936,106496,-1277440,-1
6785,409,25,5,0.056852933,0.943147067,2067.199648,2077.526715,3644.761828,2813.462103,7194,256.3791875,14388,-3473920,209408,-3264512,-1
5826,393,18,12,0.0631934395,0.936806561,1771.6976,2105.504685,3122.447648,2925.470738,6219,358.8574726,12438,-2982912,201216,-2781696,-1
8983,920,18,12,0.0929011411,0.907098859,2870.998279,2724.560346,4976.670823,4711.11087,9903,552.6227679,19806,-4599296,471040,-4128256,-1
5372,298,16,14,0.0525573192,0.947442681,1616.248232,1785.267841,2880.55901,2023.228188,5670,289.2857143,11340,-2750464,152576,-2597888,-1
3496,197,20,10,0.0533441646,0.946655835,1056.976499,1141.150334,1870.077803,1437.456853,3693,160.4257168,7386,-1789952,100864,-1689088,-1
6458,277,22,8,0.0411284336,0.958871566,1935.078663,2120.400646,3382.013472,3041.288809,6735,124.7684328,13470,-3306496,141824,-3164672,-1
8874,542,21,9,0.0575615973,0.942438403,2713.966268,2648.436252,4759.768763,3869.092251,9416,317.2506739,18832,-4543488,277504,-4265984,-1
9524,453,20,10,0.0454044302,0.95459557,2865.331078,3011.992361,5035.665687,4007.887417,9977,985.8695652,19954,-4876288,231936,-4644352,-1
444,96,18,12,0.177777778,0.822222222,146.9712001,172.3140677,287.0112613,194.1354167,540,49.18032787,1080,-227328,49152,-178176,-1
8994,899,21,9,0.090872334,0.909127666,2853.985578,2809.119643,5005.132755,4365.413793,9893,413.7599331,19786,-4604928,460288,-4144640,-1
6503,820,20,10,0.111975966,0.888024034,2105.401533,2137.61023,3610.734892,4068.557317,7323,156.9102207,14646,-3329536,419840,-2909696,-1
9009,430,22,8,0.0455556733,0.954444327,2711.281986,2775.068015,4772.418581,3621.769767,9439,624.6856386,18878,-4612608,220160,-4392448,-1
3011,181,21,9,0.0567042607,0.943295739,906.1357054,1125.988403,1583.8635,1806.712707,3192,142.9467085,6384,-1541632,92672,-1448960,-1
58,17,24,6,0.226666667,0.773333333,21.93599488,20.16077249,39.13793103,34.11764706,75,1.914730661,150,-29696,8704,-20992,-1
410,82,21,9,0.166666667,0.833333333,137.9229485,152.1703334,256.095122,198.5243902,492,44.16517056,984,-209920,41984,-167936,-1
3745,339,22,8,0.083006856,0.916993144,1175.748802,1213.738219,2042.806676,2039.112094,4084,145.8050696,8168,-1917440,173568,-1743872,-1
921,86,17,13,0.0854021847,0.914597815,282.7558916,336.1649795,516.7100977,367.8837209,1007,18.98925137,2014,-471552,44032,-427520,-1
32,22,16,14,0.407407407,0.592592593,15.41885894,15.73252671,28.40625,26.18181818,54,14.4,108,-16384,11264,-5120,-1
9649,339,21,9,0.0339407289,0.966059271,2871.492822,3138.075419,5016.27806,4374.628319,9988,819.3601313,19976,-4940288,173568,-4766720,-1
2054,238,22,8,0.103839442,0.896160558,643.8952,791.1197212,1158.451801,1043.352941,2292,88.87165568,4584,-1051648,121856,-929792,-1
522,77,21,9,0.128547579,0.871452421,169.1714291,172.048665,313.0517241,211.5194805,599,43.72262774,1198,-267264,39424,-227840,-1
9475,490,17,13,0.0491721024,0.950827898,2845.587306,3012.661173,5064.869657,3399.908163,9965,570.0800915,19930,-4851200,250880,-4600320,-1
4366,347,22,8,0.0736261405,0.92637386,1328.804404,1709.996941,2355.638342,2374.132565,4713,166.4782762,9426,-2235392,177664,-2057728,-1
933,129,20,10,0.121468927,0.878531073,299.7078446,349.4216883,537.2872454,489.6434109,1062,50.21276596,2124,-477696,66048,-411648,-1
1146,92,22,8,0.0743134087,0.925686591,352.3682844,351.7988005,636.4685864,408.1304348,1238,85.79348579,2476,-586752,47104,-539648,-1
2568,117,20,10,0.043575419,0.956424581,772.6297048,792.296124,1353.610202,1110.119658,2685,171.7850288,5370,-1314816,59904,-1254912,-1
2116,285,21,9,0.118700541,0.881299459,694.4996057,669.1353259,1183.880907,1328.101754,2401,89.8241676,4802,-1083392,145920,-937472,-1
1406,125,18,12,0.081645983,0.918354017,440.3295478,459.4101286,767.8435277,745.264,1531,60.46603476,3062,-719872,64000,-655872,-1
272,26,19,11,0.0872483221,0.912751678,82.41283143,93.38997735,155.9852941,81.65384615,298,15.1653944,596,-139264,13312,-125952,-1
9210,710,21,9,0.0715725806,0.928427419,2847.773961,2886.318497,5036.486102,3974.821127,9920,964.9805447,19840,-4715520,363520,-4352000,-1
57,29,19,11,0.337209302,0.662790698,23.76894524,26.59132738,42.19298246,46.06896552,86,1.641221374,172,-29184,14848,-14336,-1
3554,347,19,11,0.0889515509,0.911048449,1088.196342,1289.548187,1887.42825,2602.106628,3901,121.6022444,7802,-1819648,177664,-1641984,-1
441,59,23,7,0.118,0.882,136.5618592,189.3163543,245.9387755,284.5932203,500,14.2612664,1000,-225792,30208,-195584,-1
2203,141,21,9,0.0601535836,0.939846416,667.4956206,743.1536832,1191.917385,869.1205674,2344,233.6989033,4688,-1127936,72192,-1055744,-1
4838,345,19,11,0.0665637662,0.933436234,1467.976429,1710.790969,2639.986978,1919.069565,5183,350.4394861,10366,-2477056,176640,-2300416,-1
5825,1128,19,11,0.16223213,0.83776787,1813.651491,2065.210428,3141.560515,5209.211879,6953,140.5214228,13906,-2982400,577536,-2404864,-1
557,50,18,12,0.0823723229,0.917627677,168.9964004,232.8099517,305.6983842,285.08,607,24.20255183,1214,-285184,25600,-259584,-1
9518,450,20,10,0.0451444623,0.954855538,2867.532389,2933.617108,5028.007144,4064.275556,9968,689.3499308,19936,-4873216,230400,-4642816,-1
423,60,20,10,0.124223602,0.875776398,136.2030139,159.9071293,243.5744681,230.9,483,22.76154571,966,-216576,30720,-185856,-1
2913,271,22,8,0.0851130653,0.914886935,908.644944,1021.574015,1600.173018,1510.02214,3184,165.66077,6368,-1491456,138752,-1352704,-1
2988,211,21,9,0.0659581119,0.934041888,906.6618118,1135.07281,1600.562918,1592.028436,3199,227.8490028,6398,-1529856,108032,-1421824,-1
4481,222,20,10,0.0472039124,0.952796088,1349.562945,1379.391895,2381.880161,1748.878378,4703,396.5430017,9406,-2294272,113664,-2180608,-1
1647,246,20,10,0.129952456,0.870047544,548.7890609,529.1617302,941.5251973,983.6544715,1893,84.92597577,3786,-843264,125952,-717312,-1
2030,204,27,3,0.0913160251,0.908683975,632.8660192,754.240292,1116.953202,1122.941176,2234,112.6575895,4468,-1039360,104448,-934912,-1
3353,289,20,10,0.0793520044,0.920647996,1031.381543,1256.535156,1813.6102,1913.038062,3642,149.4460402,7284,-1716736,147968,-1568768,-1
9553,422,21,9,0.0423057644,0.957694236,2860.530199,3116.431172,5032.276458,3985.694313,9975,649.8371336,19950,-4891136,216064,-4675072,-1
332,29,21,9,0.08033241,0.91966759,100.3187355,116.9483661,187.6475904,104.8965517,361,32.84804368,722,-169984,14848,-155136,-1
9562,416,22,8,0.0416917218,0.958308278,2861.185474,3158.908855,5028.854528,4084.913462,9978,729.9195318,19956,-4895744,212992,-4682752,-1
1923,190,20,10,0.0899195457,0.910080454,611.4607847,594.5581409,1058.120645,1045.657895,2113,56.39178009,4226,-984576,97280,-887296,-1
508,88,17,13,0.147651007,0.852348993,164.092249,189.5818797,313.757874,210.4204545,596,39.9463807,1192,-260096,45056,-215040,-1
1850,232,19,11,0.111431316,0.888568684,591.2847096,644.9189528,1018.492432,1224.965517,2082,153.7666174,4164,-947200,118784,-828416,-1
266,62,26,4,0.18902439,0.81097561,91.51676161,101.8964809,157.4962406,194.5483871,328,11.71428571,656,-136192,31744,-104448,-1
972,86,25,5,0.0812854442,0.918714556,304.2713552,315.4730172,532.9547325,490.4534884,1058,48.04722979,2116,-497664,44032,-453632,-1
1115,91,21,9,0.0754560531,0.924543947,342.0231791,395.5078707,613.5865471,479.9120879,1206,88.54625551,2412,-570880,46592,-524288,-1
5000,281,22,8,0.0532096194,0.946790381,1502.566591,1807.822747,2667.6152,2167.419929,5281,389.1672808,10562,-2560000,143872,-2416128,-1
1647,95,17,13,0.0545350172,0.945464983,493.8749042,547.9902153,889.9368549,551.8631579,1742,326.2172285,3484,-843264,48640,-794624,-1
4002,296,20,10,0.0688692415,0.931130758,1219.853417,1400.863674,2112.321839,2652.158784,4298,81.91347437,8596,-2049024,151552,-1897472,-1
4393,554,20,10,0.111987063,0.888012937,1406.870896,1555.098305,2436.843615,2768.635379,4947,106.7544238,9894,-2249216,283648,-1965568,-1
348,96,20,10,0.216216216,0.783783784,128.0346673,122.3999906,232.1867816,187.3854167,444,35.09881423,888,-178176,49152,-129024,-1
855,122,19,11,0.124872057,0.875127943,277.4816894,311.5163046,491.5251462,471.3032787,977,46.72405548,1954,-437760,62464,-375296,-1
4870,520,22,8,0.0964749536,0.903525046,1537.698966,1716.886647,2690.568994,2741.680769,5390,99.87029831,10780,-2493440,266240,-2227200,-1
72,26,20,10,0.265306122,0.734693878,29.35644279,23.24133738,52.43055556,41.38461538,98,11.99510404,196,-36864,13312,-23552,-1
35,21,19,11,0.375,0.625,16.38306742,15.71515149,29.22857143,27.28571429,56,9.271523179,112,-17920,10752,-7168,-1
2964,456,20,10,0.133333333,0.866666667,984.5396882,1004.632648,1713.339406,1692.04386,3420,152.1352313,6840,-1517568,233472,-1284096,-1
9378,575,22,8,0.0577715262,0.942228474,2855.247294,3145.00018,4988.890595,4783.069565,9953,893.4470377,19906,-4801536,294400,-4507136,-1
8010,666,22,8,0.0767634855,0.923236515,2464.967569,2893.964712,4379.488514,3845.53003,8676,525.8181818,17352,-4101120,340992,-3760128,-1
6665,529,27,3,0.0735335001,0.9264665,2079.796102,1971.355953,3636.896324,3101.136106,7194,275.315729,14388,-3412480,270848,-3141632,-1
9450,515,21,9,0.0516808831,0.948319117,2866.252565,2823.611545,5045.743386,3831.68932,9965,783.4119497,19930,-4838400,263680,-4574720,-1
5774,323,23,7,0.0529768739,0.947023126,1747.504348,1970.855418,3049.924489,3032.473684,6097,307.7738516,12194,-2956288,165376,-2790912,-1
3421,189,20,10,0.0523545706,0.947645429,1033.973979,1098.252998,1828.685764,1385.825397,3610,298.1007432,7220,-1751552,96768,-1654784,-1
827,81,24,6,0.0892070485,0.910792952,257.2677502,297.6890876,447.3808948,527.1851852,908,74.73251029,1816,-423424,41472,-381952,-1
4144,271,27,3,0.0613816535,0.938618347,1260.204921,1464.920656,2219.414093,2033.461255,4415,93.69694397,8830,-2121728,138752,-1982976,-1
5373,389,21,9,0.0675112808,0.932488719,1638.476779,1974.621132,2884.449097,2840.766067,5762,288.1,11524,-2750976,199168,-2551808,-1
1840,120,20,10,0.0612244898,0.93877551,562.6150508,605.9836012,986.1798913,893.4083333,1960,213.9737991,3920,-942080,61440,-880640,-1
9484,489,19,11,0.0490323874,0.950967613,2835.396072,3489.658812,5035.708878,4042.306748,9973,475.8110687,19946,-4855808,250368,-4605440,-1
9214,719,22,8,0.0723849794,0.927615021,2840.067432,2994.905861,5051.109833,3889.130737,9933,463.7254902,19866,-4717568,368128,-4349440,-1
46,15,20,10,0.245901639,0.754098361,16.96873863,18.60776421,32.58695652,26.13333333,61,4.221453287,122,-23552,7680,-15872,-1
9572,403,21,9,0.0404010025,0.959598997,2866.213672,3058.641383,5023.820623,4137.193548,9975,265.3631285,19950,-4900864,206336,-4694528,-1
360,94,21,9,0.207048458,0.792951542,132.1671206,120.7301257,236.4527778,193.212766,454,28.12887237,908,-184320,48128,-136192,-1
220,39,23,7,0.150579151,0.849420849,73.89122715,78.0527393,132.4863636,115.974359,259,16.87296417,518,-112640,19968,-92672,-1
9478,496,22,8,0.0497292962,0.950270704,2860.185367,3149.540973,5022.132412,4325.71371,9974,1499.849624,19948,-4852736,253952,-4598784,-1
6424,303,22,8,0.0450423666,0.954957633,1931.696388,2119.989282,3379.706258,3031.006601,6727,286.3771818,13454,-3289088,155136,-3133952,-1
1937,102,27,3,0.0500245218,0.949975478,584.8119731,655.893757,1018.491482,1048.647059,2039,127.5969962,4078,-991744,52224,-939520,-1
880,172,21,9,0.163498099,0.836501901,301.7814527,311.5846968,532.2659091,497,1052,88.70151771,2104,-450560,88064,-362496,-1
1551,123,27,3,0.0734767025,0.926523297,475.7385364,553.2962951,847.7762734,707.9186992,1674,31.68654174,3348,-794112,62976,-731136,-1
1625,244,27,3,0.130551097,0.869448903,535.8659116,554.1119825,920.7729231,1029.75,1869,38.63965268,3738,-832000,124928,-707072,-1
8889,999,18,12,0.101031553,0.898968447,2770.657663,3147.828671,4778.348858,6422.895896,9888,420.4081633,19776,-4551168,511488,-4039680,-1
2880,202,27,3,0.0655418559,0.934458144,878.6974784,1033.467482,1543.448958,1513.712871,3082,88.28415927,6164,-1474560,103424,-1371136,-1
1041,198,27,3,0.159806295,0.840193705,348.3497563,397.3142459,608.1008646,682.5606061,1239,26.36170213,2478,-532992,101376,-431616,-1
4542,483,21,9,0.096119403,0.903880597,1374.002296,1899.241519,2439.295465,3206.097308,5025,97.83878505,10050,-2325504,247296,-2078208,-1
1140,380,20,10,0.25,0.75,438.5227123,439.0359857,754.2157895,779.3526316,1520,27.90014684,3040,-583680,194560,-389120,-1
244,10,26,4,0.0393700787,0.960629921,72.59960908,80.49776394,129.0409836,89.9,254,66.66666667,508,-124928,5120,-119808,-1
1933,177,18,12,0.0838862559,0.916113744,605.8766757,635.2549782,1064.38955,958.4180791,2110,49.32211314,4220,-989696,90624,-899072,-1
1093,193,21,9,0.15007776,0.84992224,373.2388235,354.1636221,653.7191217,585.626943,1286,85.33510285,2572,-559616,98816,-460800,-1
2537,275,19,11,0.0977951636,0.902204836,794.6656087,948.1225735,1394.642097,1515.894545,2812,80.94415659,5624,-1298944,140800,-1158144,-1
67,20,19,11,0.229885057,0.770114943,25.79111387,18.95646328,47.26865672,33.05,87,22.36503856,174,-34304,10240,-24064,-1
8688,1157,21,9,0.117521585,0.882478415,2812.038232,2985.127323,4840.169659,5544.979257,9845,347.8798587,19690,-4448256,592384,-3855872,-1
73,32,17,13,0.304761905,0.695238095,31.46285195,23.72348438,58.08219178,41.40625,105,24.36194896,210,-37376,16384,-20992,-1
562,89,25,5,0.13671275,0.86328725,185.9619791,190.5082512,334.905694,269.7640449,651,118.579235,1302,-287744,45568,-242176,-1
5212,405,22,8,0.0721025458,0.927897454,1595.638988,1906.79798,2827.868764,2566.175309,5617,208.9657738,11234,-2668544,207360,-2461184,-1
5273,1122,22,8,0.17544957,0.82455043,1725.242309,1848.548156,2923.458752,4488.245989,6395,159.1191839,12790,-2699776,574464,-2125312,-1
9218,441,27,3,0.0456569003,0.9543431,2782.451334,2789.848975,4868.369169,4027.988662,9659,285.6847087,19318,-4719616,225792,-4493824,-1
8636,1241,21,9,0.125645439,0.874354561,2925.806035,2240.048957,4984.417902,4622.941176,9877,718.8500728,19754,-4421632,635392,-3786240,-1
1448,119,17,13,0.0759412891,0.924058711,441.8302054,520.4514737,801.3542818,572.8319328,1567,124.3650794,3134,-741376,60928,-680448,-1
1953,148,27,3,0.0704426464,0.929557354,601.7101405,658.7675248,1058.431132,952.9391892,2101,179.880137,4202,-999936,75776,-924160,-1
3069,281,18,12,0.083880597,0.916119403,958.0196495,1054.80052,1685.381558,1567.576512,3350,107.7170418,6700,-1571328,143872,-1427456,-1
2829,385,20,10,0.119788426,0.880211574,920.774235,971.7823505,1593.56345,1709.906494,3214,193.6144578,6428,-1448448,197120,-1251328,-1
5403,359,21,9,0.0623047553,0.937695245,1636.756899,1984.304269,2856.592078,3256.367688,5762,144.519689,11524,-2766336,183808,-2582528,-1
168,47,20,10,0.218604651,0.781395349,60.17600761,63.46211839,114.3035714,85.46808511,215,7.093368525,430,-86016,24064,-61952,-1
4046,582,20,10,0.125756266,0.874243734,1296.121466,1433.187377,2223.246663,2948.883162,4628,89.10281094,9256,-2071552,297984,-1773568,-1
9337,633,19,11,0.0634904714,0.936509529,2854.202344,3060.295486,5049.036843,4048.306477,9970,890.974084,19940,-4780544,324096,-4456448,-1
9591,389,21,9,0.0389779559,0.961022044,2870.912304,2979.391294,5027.172766,4086.313625,9980,390.9126518,19960,-4910592,199168,-4711424,-1
7762,276,27,3,0.0343368997,0.9656631,2311.516034,2505.06525,4037.392553,3516.304348,8038,483.3433554,16076,-3974144,141312,-3832832,-1
3531,380,22,8,0.0971618512,0.902838149,1118.981884,1218.176755,1957.232229,1944.55,3911,125.152,7822,-1807872,194560,-1613312,-1
9553,416,19,11,0.041729361,0.958270639,2863.387024,3120.803511,5013.368157,4333.555288,9969,922.2016651,19938,-4891136,212992,-4678144,-1
3948,534,17,13,0.11914324,0.88085676,1279.676554,1393.74936,2245.533688,2211.677903,4482,161.3971912,8964,-2021376,273408,-1747968,-1
2148,359,27,3,0.143199043,0.856800957,678.5148773,758.8988303,1165.534916,1783.311978,2507,154.0872772,5014,-1099776,183808,-915968,-1
451,102,18,12,0.184448463,0.815551537,151.4623406,174.7300164,293.0798226,205.9019608,553,58.82978723,1106,-230912,52224,-178688,-1
7989,633,19,11,0.0734168406,0.926583159,2445.117951,2962.421291,4282.067092,4682.968404,8622,426.4094955,17244,-4090368,324096,-3766272,-1
1304,161,25,5,0.109897611,0.890102389,422.576316,422.3033886,739.1526074,683.1677019,1465,105.9291396,2930,-667648,82432,-585216,-1
1257,105,25,5,0.077092511,0.922907489,390.0879036,408.3825633,691.8894193,557.1238095,1362,86.31178707,2724,-643584,53760,-589824,-1
3706,325,27,3,0.080625155,0.919374845,1143.603473,1357.395901,1999.40259,2205.261538,4031,147.4396489,8062,-1897472,166400,-1731072,-1
7028,485,21,9,0.0645547717,0.935445228,2166.071051,2159.4274,3787.809903,3310.542268,7513,155.9684451,15026,-3598336,248320,-3350016,-1
7693,670,21,9,0.0801147913,0.919885209,2425.38543,2279.225575,4190.894969,4079.867164,8363,168.3034816,16726,-3938816,343040,-3595776,-1
5215,521,19,11,0.0908298466,0.909170153,1631.041253,1861.050428,2839.26232,3161.15739,5736,248.0968858,11472,-2670080,266752,-2403328,-1
126,55,21,9,0.303867403,0.696132597,51.05077282,53.73283774,86.9047619,100.3818182,181,22.51243781,362,-64512,28160,-36352,-1
9362,589,17,13,0.0591900312,0.940809969,2833.220054,3161.165174,5058.572314,3663.534805,9951,943.2227488,19902,-4793344,301568,-4491776,-1
9575,408,20,10,0.0408694781,0.959130522,2866.682379,3084.338534,5030.185065,4095.867647,9983,305.103912,19966,-4902400,208896,-4693504,-1
9187,753,20,10,0.0757545272,0.924245473,2859.266781,2963.491498,5002.190922,4583.853918,9940,768.1607419,19880,-4703744,385536,-4318208,-1
362,48,21,9,0.117073171,0.882926829,116.5346979,131.1502647,206.2375691,199.9375,410,46.1192351,820,-185344,24576,-160768,-1
1961,237,18,12,0.107825296,0.892174704,624.4128149,712.287848,1101.791433,1080.540084,2198,60.53428807,4396,-1004032,121344,-882688,-1
5069,722,22,8,0.124676222,0.875323778,1598.237319,1672.459637,2723.046755,4110.265928,5791,179.5102294,11582,-2595328,369664,-2225664,-1
7759,624,21,9,0.0744363593,0.925563641,2407.843581,2562.7588,4201.806032,4070.06891,8383,192.2706422,16766,-3972608,319488,-3653120,-1
5179,890,20,10,0.146646894,0.853353106,1756.763029,1640.337214,2950.876231,3524.524719,6069,123.8571429,12138,-2651648,455680,-2195968,-1
6811,447,20,10,0.0615872141,0.938412786,2073.49283,2387.278383,3612.69608,3885.543624,7258,484.1894596,14516,-3487232,228864,-3258368,-1
531,40,22,8,0.0700525394,0.929947461,160.2984977,178.4181535,294.8700565,168.25,571,62.60964912,1142,-271872,20480,-251392,-1
2079,155,18,12,0.0693822739,0.930617726,630.6632416,717.9339175,1144.797018,751.3677419,2234,91.10929853,4468,-1064448,79360,-985088,-1
2090,125,21,9,0.0564334086,0.943566591,635.4954986,689.4457505,1115.591388,981.072,2215,216.3085938,4430,-1070080,64000,-1006080,-1
7930,416,19,11,0.0498442368,0.950155763,2394.804207,2404.936143,4232.843632,3042.262019,8346,240.3109703,16692,-4060160,212992,-3847168,-1
363,71,17,13,0.16359447,0.83640553,123.5309402,133.8740033,217.8980716,215.4647887,434,25.15942029,868,-185856,36352,-149504,-1
3128,263,25,5,0.0775582424,0.922441758,948.9020316,1191.488837,1734.418159,1239.072243,3391,387.98627,6782,-1601536,134656,-1466880,-1
1362,109,17,13,0.0740992522,0.925900748,416.5443648,442.5382344,756.3135095,482.1743119,1471,82.64044944,2942,-697344,55808,-641536,-1
693,55,19,11,0.0735294118,0.926470588,209.6075523,224.1177849,387.7950938,206.9818182,748,112.481203,1496,-354816,28160,-326656,-1
75,19,18,12,0.20212766,0.79787234,26.64156819,23.49031745,51.34666667,32.31578947,94,34.18181818,188,-38400,9728,-28672,-1
565,119,25,5,0.173976608,0.826023392,193.5306366,188.7984549,362.2318584,248.8151261,684,65.95949855,1368,-289280,60928,-228352,-1
49,28,20,10,0.363636364,0.636363636,23.19362391,20.42120247,38.87755102,39.21428571,77,8.661417323,154,-25088,14336,-10752,-1
409,51,22,8,0.110869565,0.889130435,130.1180883,149.4906719,234.0660147,201.9019608,460,9.24437299,920,-209408,26112,-183296,-1
5787,489,22,8,0.07791587,0.92208413,1792.486132,2025.366196,3136.133921,3166.501022,6276,119.0891841,12552,-2962944,250368,-2712576,-1
3977,529,20,10,0.117399024,0.882600976,1303.95994,1275.78095,2258.978627,2212.311909,4506,84.17709695,9012,-2036224,270848,-1765376,-1
1716,221,20,10,0.11409396,0.88590604,549.4575413,624.0360447,959.0081585,1046.58371,1937,37.3866049,3874,-878592,113152,-765440,-1
6373,375,20,10,0.0555720213,0.944427979,1927.272846,2158.693755,3414.870077,2688.424,6748,125.9660258,13496,-3262976,192000,-3070976,-1
2854,131,21,9,0.0438860972,0.956113903,854.1768642,982.0994373,1503.906797,1255.381679,2985,95.3978907,5970,-1461248,67072,-1394176,-1
9476,486,20,10,0.0487853845,0.951214616,2863.802886,2902.738983,5035.946285,3919.909465,9962,833.6401674,19924,-4851712,248832,-4602880,-1
168,17,26,4,0.0918918919,0.908108108,52.78089705,45.94889594,96.60119048,57.41176471,185,16.03119584,370,-86016,8704,-77312,-1
2974,313,21,9,0.0952236082,0.904776392,931.7847861,1094.141321,1634.710491,1732.265176,3287,143.977223,6574,-1522688,160256,-1362432,-1
2530,274,17,13,0.0977175464,0.902282454,802.9518075,866.0021413,1397.999605,1444.054745,2804,174.2697328,5608,-1295360,140288,-1155072,-1
4778,621,19,11,0.1150213,0.8849787,1529.714298,1761.790078,2712.55023,2603.438003,5399,112.5729775,10798,-2446336,317952,-2128384,-1
3757,406,20,10,0.0975258227,0.902474177,1170.062428,1457.041476,2068.68379,2205.224138,4163,81.6594743,8326,-1923584,207872,-1715712,-1
2566,266,21,9,0.0939265537,0.906073446,796.360348,996.3728903,1423.575604,1348.244361,2832,91.03182257,5664,-1313792,136192,-1177600,-1
6399,975,22,8,0.132221318,0.867778682,2027.653979,2248.108212,3475.378497,5079.669744,7374,148.1020285,14748,-3276288,499200,-2777088,-1
5262,420,22,8,0.0739176346,0.926082365,1631.36098,1719.191212,2817.302357,3144.661905,5682,165.5594406,11364,-2694144,215040,-2479104,-1
504,87,15,15,0.147208122,0.852791878,162.4092438,193.0014249,309.9623016,215.1149425,591,53.09973046,1182,-258048,44544,-213504,-1
9089,830,20,10,0.0836777901,0.91632221,2841.926542,3062.829635,4994.700627,4580.007229,9919,985.0049652,19838,-4653568,424960,-4228608,-1
9339,617,20,10,0.0619726798,0.93802732,2847.117171,3126.75868,5036.294036,4103.721232,9956,1203.869407,19912,-4781568,315904,-4465664,-1
3155,381,25,5,0.107748869,0.892251131,1003.562253,1140.794809,1749.16355,1928.622047,3536,87.15799852,7072,-1615360,195072,-1420288,-1
1515,94,18,12,0.0584213797,0.94157862,457.0695596,531.7868042,817.4818482,603.8297872,1609,211.7105263,3218,-775680,48128,-727552,-1
446,41,22,8,0.0841889117,0.915811088,136.8517554,125.9482203,254.8340807,126.1463415,487,8.955498345,974,-228352,20992,-207360,-1
478,65,18,12,0.119705341,0.880294659,146.1209055,219.6063256,272.5460251,267.9846154,543,53.33988212,1086,-244736,33280,-211456,-1
4912,266,20,10,0.0513711858,0.948628814,1477.603343,1608.670417,2629.950529,1842.533835,5178,434.3959732,10356,-2514944,136192,-2378752,-1
1178,85,20,10,0.0673000792,0.932699921,359.0071907,377.1045662,647.0713073,423.1294118,1263,86.86382393,2526,-603136,43520,-559616,-1
3863,210,21,9,0.0515590474,0.948440953,1173.002761,1225.355027,2038.375356,2011.7,4073,168.5844371,8146,-1977856,107520,-1870336,-1
690,59,20,10,0.0787716956,0.921228304,211.1151402,202.9388446,389.4652174,205.8305085,749,75.0501002,1498,-353280,30208,-323072,-1
6147,505,22,8,0.0759170174,0.924082983,1924.921218,1817.999453,3358.527086,2936.657426,6652,133.0666133,13304,-3147264,258560,-2888704,-1
9419,532,22,8,0.0534619636,0.946538036,2860.005284,3011.833085,5013.256078,4316.385338,9951,990.1492537,19902,-4822528,272384,-4550144,-1
56,20,21,9,0.263157895,0.736842105,23.67632908,14.79349519,40.44642857,33.05,76,6.834532374,152,-28672,10240,-18432,-1
8571,933,21,9,0.0981691919,0.901830808,2738.797436,2761.481826,4713.59048,5109.942122,9504,235.2475248,19008,-4388352,477696,-3910656,-1
2326,215,21,9,0.0846123573,0.915387643,723.6347492,829.4252348,1264.149613,1345.111628,2541,92.29930984,5082,-1190912,110080,-1080832,-1
2360,250,25,5,0.0957854406,0.904214559,752.7400741,758.1470447,1300.104661,1356.432,2610,48.83982036,5220,-1208320,128000,-1080320,-1
864,64,19,11,0.0689655172,0.931034483,259.1950212,280.594721,481.2476852,238.40625,928,241.6666667,1856,-442368,32768,-409600,-1
70,23,18,12,0.247311828,0.752688172,27.45744016,16.37659356,52.34285714,30.73913043,93,18.12865497,186,-35840,11776,-24064,-1
4031,311,19,11,0.0716259788,0.928374021,1224.387186,1576.350367,2161.292483,2303.803859,4342,111.9649304,8684,-2063872,159232,-1904640,-1
5762,523,21,9,0.0832140016,0.916785998,1795.895594,2001.810053,3131.511454,3269.571702,6285,223.745105,12570,-2950144,267776,-2682368,-1
3849,183,20,10,0.0453869048,0.954613095,1157.226992,1289.505413,2022.998181,1879.825137,4032,116.1290323,8064,-1970688,93696,-1876992,-1
6079,675,17,13,0.0999407758,0.900059224,1939.160791,2042.27567,3377.902451,3373.875556,6754,185.8558063,13508,-3112448,345600,-2766848,-1
1713,251,20,10,0.127800407,0.872199593,543.3852191,707.1552734,982.6158786,981.7091633,1964,111.401021,3928,-877056,128512,-748544,-1
1384,106,19,11,0.0711409396,0.92885906,418.7521309,546.9675333,737.449422,850.6132075,1490,122.6337449,2980,-708608,54272,-654336,-1
3454,454,18,12,0.116171955,0.883828045,1121.721522,1175.806046,1953.326867,1963.42511,3908,173.7661183,7816,-1768448,232448,-1536000,-1
2253,143,17,13,0.0596828047,0.940317195,684.2445798,678.0970867,1224.573014,787.7132867,2396,66.50013877,4792,-1153536,73216,-1080320,-1
2382,360,18,12,0.131291028,0.868708972,769.4134036,861.0551935,1323.994123,1685.830556,2742,74.63255308,5484,-1219584,184320,-1035264,-1
2904,280,21,9,0.0879396985,0.912060302,916.3291085,886.0220108,1623.498278,1271.003571,3184,105.0825083,6368,-1486848,143360,-1343488,-1
80,10,27,3,0.111111111,0.888888889,24.2102477,35.08788965,44.0375,57.2,90,15.2027027,180,-40960,5120,-35840,-1
77,22,23,7,0.222222222,0.777777778,28.11125285,29.98777299,50.79220779,47.22727273,99,15.68938193,198,-39424,11264,-28160,-1
9263,674,21,9,0.0678273121,0.932172688,2838.970089,2962.601058,5062.545072,3683.379822,9937,724.271137,19874,-4742656,345088,-4397568,-1
271,46,25,5,0.14511041,0.85488959,88.72389058,104.8264837,156.0922509,176.1304348,317,16.69299631,634,-138752,23552,-115200,-1
209,34,22,8,0.139917695,0.860082305,68.06762602,63.98118235,129.6842105,74.76470588,243,41.0472973,486,-107008,17408,-89600,-1
225,42,21,9,0.157303371,0.842696629,76.68362891,79.13956572,133.8711111,134.6904762,267,38.47262248,534,-115200,21504,-93696,-1
9168,772,21,9,0.077665996,0.922334004,2879.129738,2626.586582,5036.82079,4182.897668,9940,775.351014,19880,-4694016,395264,-4298752,-1
9080,383,21,9,0.0404734228,0.959526577,2721.770862,2874.065099,4760.92522,4046.253264,9463,523.3960177,18926,-4648960,196096,-4452864,-1
8965,581,18,12,0.0608631888,0.939136811,2753.671115,2733.930311,4807.398996,4250.428571,9546,321.3059576,19092,-4590080,297472,-4292608,-1
4162,377,24,6,0.0830579423,0.916942058,1291.655043,1481.827823,2290.623979,2042.31565,4539,87.72709702,9078,-2130944,193024,-1937920,-1
446,97,20,10,0.178637201,0.821362799,148.9921601,174.2528462,286.0941704,207.1958763,543,73.47767253,1086,-228352,49664,-178688,-1
2101,166,20,10,0.0732245258,0.926775474,638.6965836,786.0927198,1153.801999,883.373494,2267,41.63452709,4534,-1075712,84992,-990720,-1
5278,835,20,10,0.136594144,0.863405856,1786.451242,1618.612854,3067.669572,2989.558084,6113,135.1835471,12226,-2702336,427520,-2274816,-1
6449,251,19,11,0.0374626866,0.962537313,1920.173597,2173.180186,3374.636843,2730.346614,6700,496.2962963,13400,-3301888,128512,-3173376,-1
4688,402,20,10,0.078978389,0.921021611,1457.702846,1527.111758,2584.512159,2090.552239,5090,147.4507532,10180,-2400256,205824,-2194432,-1
9281,322,20,10,0.0335311882,0.966468812,2762.446501,3012.824233,4815.436806,4414.71118,9603,739.26097,19206,-4751872,164864,-4587008,-1
4536,313,21,9,0.0645493916,0.935450608,1388.466933,1552.877816,2429.873457,2354.373802,4849,268.9406545,9698,-2322432,160256,-2162176,-1
2274,196,18,12,0.0793522267,0.920647773,705.6900694,792.7949479,1237.623131,1210.867347,2470,100.7751938,4940,-1164288,100352,-1063936,-1
2040,184,18,12,0.0827338129,0.917266187,630.1944114,751.8930773,1122.553431,1001.038043,2224,47.098687,4448,-1044480,94208,-950272,-1
3084,163,20,10,0.0502001848,0.949799815,921.9605439,1080.470058,1649.845979,1134.98773,3247,225.9568546,6494,-1579008,83456,-1495552,-1
1327,120,18,12,0.0829302004,0.9170698,404.9987112,529.6571467,732.492841,630.0833333,1447,104.8550725,2894,-679424,61440,-617984,-1
2613,211,20,10,0.0747167139,0.925283286,811.3322498,859.8190678,1417.143513,1354.995261,2824,119.1058625,5648,-1337856,108032,-1229824,-1
9356,596,23,7,0.0598874598,0.94011254,2844.385347,3081.845613,5047.314664,3864.852349,9952,787.9651623,19904,-4790272,305152,-4485120,-1
9244,703,21,9,0.0706745752,0.929325425,2808.782888,3483.050057,4908.656642,5833.223329,9947,1099.116022,19894,-4732928,359936,-4372992,-1
108,27,19,11,0.2,0.8,37.63511552,31.11842947,74.92592593,40.2962963,135,13.4194831,270,-55296,13824,-41472,-1
2737,523,25,5,0.160429448,0.839570552,919.6437365,1018.306692,1588.540007,1850.087954,3260,119.5891416,6520,-1401344,267776,-1133568,-1
9272,367,26,4,0.0380744891,0.961925511,2774.73907,2931.378701,4839.205349,4334.790191,9639,1100.342466,19278,-4747264,187904,-4559360,-1
136,25,20,10,0.155279503,0.844720497,44.98834672,36.30105233,87.72058824,44.44,161,30.09345794,322,-69632,12800,-56832,-1
4128,540,19,11,0.115681234,0.884318766,1293.239407,1430.071983,2219.968023,3210.033333,4668,347.8390462,9336,-2113536,276480,-1837056,-1
5540,333,22,8,0.0567001532,0.943299847,1671.413441,1947.300174,2975.071841,2303.612613,5873,163.5022272,11746,-2836480,170496,-2665984,-1
9118,826,19,11,0.0830651649,0.916934835,2777.404348,3554.592643,4869.324304,6111.429782,9944,961.7021277,19888,-4668416,422912,-4245504,-1
9426,545,20,10,0.0546585097,0.94534149,2848.028019,2902.366796,5081.193401,3339.590826,9971,971.8323587,19942,-4826112,279040,-4547072,-1
9506,472,18,12,0.047304069,0.952695931,2862.279454,3151.359433,5022.422049,4326.455508,9978,1295.844156,19956,-4867072,241664,-4625408,-1
4596,196,20,10,0.0409015025,0.959098497,1370.875425,1564.051728,2418.273064,1885.943878,4792,254.7581074,9584,-2353152,100352,-2252800,-1
5271,249,21,9,0.0451086957,0.954891304,1577.588348,1893.221343,2753.632897,2905.86747,5520,529.7504798,11040,-2698752,127488,-2571264,-1
289,47,20,10,0.139880952,0.860119048,96.63214593,97.92723715,170.8823529,153.8510638,336,8.96,672,-147968,24064,-123904,-1
8781,434,27,3,0.0470971243,0.952902876,2628.319175,2866.711172,4680.583874,3139.430876,9215,177.6899344,18430,-4495872,222208,-4273664,-1
288,38,21,9,0.116564417,0.883435583,93.74425497,78.82201012,170.4722222,110.6578947,326,29.93572084,652,-147456,19456,-128000,-1
5694,929,22,8,0.14026876,0.85973124,1935.49842,1626.317693,3210.086231,3936.646932,6623,128.7269193,13246,-2915328,475648,-2439680,-1
4658,266,22,8,0.054021121,0.945978879,1413.7785,1547.235749,2467.060112,2382.646617,4924,235.4854137,9848,-2384896,136192,-2248704,-1
6215,288,20,10,0.044287252,0.955712748,1869.43768,1976.756894,3274.583749,2764.645833,6503,358.6872587,13006,-3182080,147456,-3034624,-1
128,18,22,8,0.123287671,0.876712329,39.9813891,51.36125383,76.140625,54.72222222,146,18.09169765,292,-65536,9216,-56320,-1
2729,354,22,8,0.114823224,0.885176776,909.7408703,717.7248482,1548.520337,1491.734463,3083,127.3440727,6166,-1397248,181248,-1216000,-1
9295,644,22,8,0.064795251,0.935204749,2870.598006,2808.440445,5001.713502,4512.271739,9939,952.0114943,19878,-4759040,329728,-4429312,-1
9181,730,21,9,0.0736555343,0.926344466,2834.189904,2747.262107,5078.511273,3415.210959,9911,893.6880072,19822,-4700672,373760,-4326912,-1
4480,381,21,9,0.0783789344,0.921621066,1383.644591,1598.731937,2450.25558,2204.582677,4861,133.6173722,9722,-2293760,195072,-2098688,-1
4576,326,22,8,0.066503468,0.933496532,1401.452251,1432.056373,2499.715253,1774.711656,4902,298.902439,9804,-2342912,166912,-2176000,-1
479,85,21,9,0.15070922,0.84929078,153.2873048,196.089126,270.908142,347.8235294,564,37.5249501,1128,-245248,43520,-201728,-1
9058,519,21,9,0.0541923358,0.945807664,2754.122249,2928.998729,4804.505299,4518.38921,9577,345.3660296,19154,-4637696,265728,-4371968,-1
8409,530,22,8,0.0592907484,0.940709252,2549.020552,3033.44211,4462.195862,4593.820755,8939,291.3624511,17878,-4305408,271360,-4034048,-1
4142,304,18,12,0.0683760684,0.931623932,1262.427381,1521.202934,2241.195316,1982.401316,4446,81.93881312,8892,-2120704,155648,-1965056,-1
9275,667,21,9,0.0670891169,0.932910883,2854.719226,3074.390642,4974.722911,4926.683658,9942,743.605086,19884,-4748800,341504,-4407296,-1
5034,836,21,9,0.14241908,0.85758092,1590.487101,1849.783513,2746.667461,4072.561005,5870,135.9740561,11740,-2577408,428032,-2149376,-1
1311,167,23,7,0.112990528,0.887009472,419.0632369,447.2645658,761.109077,569.8622754,1478,96.47519582,2956,-671232,85504,-585728,-1
1720,144,18,12,0.0772532189,0.922746781,534.27078,567.6843678,942.7360465,810.2361111,1864,62.57133266,3728,-880640,73728,-806912,-1
2533,169,13,17,0.062546262,0.937453738,763.4326374,995.457331,1353.239637,1325.426036,2702,199.4095941,5404,-1296896,86528,-1210368,-1
5455,317,21,9,0.0549203049,0.945079695,1635.275592,2089.141127,2909.833731,2484.968454,5772,136.0999764,11544,-2792960,162304,-2630656,-1
5363,858,18,12,0.137919949,0.862080051,1775.80337,1825.242614,3024.250979,3653.231935,6221,123.7763629,12442,-2745856,439296,-2306560,-1
9533,432,21,9,0.0433517311,0.956648269,2875.18973,2871.68511,5003.483898,4530.979167,9965,1776.292335,19930,-4880896,221184,-4659712,-1
1627,226,25,5,0.121964382,0.878035618,526.6261619,555.6952713,953.2526122,738.0044248,1853,33.86330409,3706,-833024,115712,-717312,-1
1090,68,27,3,0.0587219344,0.941278066,328.8380953,336.2698766,593.8963303,348.7352941,1158,49.93531695,2316,-558080,34816,-523264,-1
5700,1049,20,10,0.155430434,0.844569566,1891.962516,1805.782996,3153.846316,4576.693041,6749,148.8859475,13498,-2918400,537088,-2381312,-1
2887,216,21,9,0.0696100548,0.930389945,887.4004519,968.114158,1533.693453,1796.680556,3103,109.1068917,6206,-1478144,110592,-1367552,-1
265,26,20,10,0.089347079,0.910652921,80.29896381,91.5254354,152.5433962,79.30769231,291,13.5097493,582,-135680,13312,-122368,-1
5024,1068,19,11,0.175311884,0.824688116,1832.095297,1355.798697,3068.720541,2941.97191,6092,135.4680898,12184,-2572288,546816,-2025472,-1
93,31,23,7,0.25,0.75,34.49766699,39.24482243,61.39784946,65.80645161,124,2.24028907,248,-47616,15872,-31744,-1
9200,736,21,9,0.0740740741,0.925925926,2832.117405,3286.385589,4964.169783,5022.627717,9936,512.1649485,19872,-4710400,376832,-4333568,-1
6923,308,20,10,0.0425943853,0.957405615,2064.81887,2385.918116,3654.275892,2755.662338,7231,187.3316062,14462,-3544576,157696,-3386880,-1
9366,581,21,9,0.0584095707,0.941590429,2856.384037,2883.67954,5043.180974,3858.769363,9947,777.109375,19894,-4795392,297472,-4497920,-1
9502,462,20,10,0.0463669209,0.953633079,2873.076546,2943.045994,4982.903704,4974.19697,9964,1236.228288,19928,-4865024,236544,-4628480,-1
9562,420,20,10,0.0420757363,0.957924264,2854.643262,3190.981812,5046.478875,3739.814286,9982,881.8021201,19964,-4895744,215040,-4680704,-1
2133,211,27,3,0.0900170648,0.909982935,670.4850018,735.4781599,1175.408814,1143.094787,2344,437.3134328,4688,-1092096,108032,-984064,-1
7703,1621,21,9,0.173852424,0.826147576,2505.906819,2738.224378,4264.331559,6554.598396,9324,172.8907844,18648,-3943936,829952,-3113984,-1
3597,265,22,8,0.0686172967,0.931382703,1093.128771,1373.276634,1938.025855,1842.920755,3862,147.9693487,7724,-1841664,135680,-1705984,-1
788,99,18,12,0.111612176,0.888387824,247.9571697,306.9895653,451.3058376,385.8484848,887,66.34255797,1774,-403456,50688,-352768,-1
2090,184,20,10,0.0809146878,0.919085312,647.2107831,659.6367463,1168.2311,788.4347826,2274,211.9291705,4548,-1070080,94208,-975872,-1
4269,267,21,9,0.0588624339,0.941137566,1305.208717,1375.06226,2269.546732,2251.764045,4536,291.1424904,9072,-2185728,136704,-2049024,-1
1016,121,14,16,0.106420405,0.893579595,315.3490384,365.8998974,592.4586614,372.0247934,1137,35.64263323,2274,-520192,61952,-458240,-1
9063,873,20,10,0.0878623188,0.912137681,2881.288896,2728.644204,4974.868476,4902.386025,9936,586.1946903,19872,-4640256,446976,-4193280,-1
628,120,17,13,0.160427807,0.839572193,209.9433177,211.7686369,396.0286624,261.8333333,748,39.93593166,1496,-321536,61440,-260096,-1
3139,377,22,8,0.107224118,0.892775882,1009.168726,1043.212958,1735.842306,1947.153846,3516,144.0393281,7032,-1607168,193024,-1414144,-1
1549,103,22,8,0.0623486683,0.937651332,471.8462407,542.160742,831.261459,754.8932039,1652,118.1688126,3304,-793088,52736,-740352,-1
873,57,23,7,0.0612903226,0.938709677,266.6427641,294.8623198,466.0927835,456.4210526,930,18.50746269,1860,-446976,29184,-417792,-1
5529,767,21,9,0.12182338,0.87817662,1769.169587,2025.070458,3061.107072,3778.481095,6296,129.2017238,12592,-2830848,392704,-2438144,-1
9501,473,19,11,0.0474233006,0.952576699,2865.684903,2999.40369,5032.520998,4083.17759,9974,799.8396151,19948,-4864512,242176,-4622336,-1
9578,399,18,12,0.0399919816,0.960008018,2858.348936,3166.082526,5034.976822,3885.325815,9977,1209.333333,19954,-4903936,204288,-4699648,-1
5831,306,27,3,0.0498614958,0.950138504,1765.177423,1842.129045,3090.577088,2657.836601,6137,300.0977995,12274,-2985472,156672,-2828800,-1
4504,305,17,13,0.063422749,0.936577251,1363.65869,1677.508428,2426.937167,2081.04918,4809,330.2884615,9618,-2306048,156160,-2149888,-1
1986,213,21,9,0.0968622101,0.90313779,624.1552261,715.7575973,1112.718026,981.4178404,2199,68.12267658,4398,-1016832,109056,-907776,-1
2547,400,21,9,0.135731252,0.864268748,819.7608016,1009.182074,1446.821751,1647.0575,2947,54.14293588,5894,-1304064,204800,-1099264,-1
8050,491,18,12,0.0574874137,0.942512586,2447.317818,2603.213054,4323.05677,3417.523422,8541,391.0714286,17082,-4121600,251392,-3870208,-1
1803,126,15,15,0.065318818,0.934681182,543.3604206,585.6147532,993.6311703,555.3015873,1929,316.7487685,3858,-923136,64512,-858624,-1
3141,331,20,10,0.0953341014,0.904665899,982.578076,1080.975389,1782.118752,1303.60423,3472,167.4867342,6944,-1608192,169472,-1438720,-1
988,74,17,13,0.0696798493,0.930320151,297.270537,341.8700997,547.9908907,311.3243243,1062,156.8685377,2124,-505856,37888,-467968,-1
1414,76,27,3,0.0510067114,0.948993289,429.0081369,450.2588368,746.1223479,733.9210526,1490,372.5,2980,-723968,38912,-685056,-1
6214,378,19,11,0.057342233,0.942657767,1888.620139,2103.392872,3314.208883,3005.380952,6592,300.3189066,13184,-3181568,193536,-2988032,-1
3558,270,18,12,0.0705329154,0.929467085,1097.25849,1200.235423,1920.462057,1835.933333,3828,84.37293366,7656,-1821696,138240,-1683456,-1
4928,323,18,12,0.0615120929,0.938487907,1500.492797,1715.370273,2641.710024,2386.312693,5251,173.014827,10502,-2523136,165376,-2357760,-1
5729,479,22,8,0.0771585052,0.922841495,1787.338654,1847.779326,3102.023215,3134.123173,6208,119.1326041,12416,-2933248,245248,-2688000,-1
976,107,16,14,0.0987996307,0.901200369,299.2381921,415.3187012,542.482582,537.5981308,1083,21.00872939,2166,-499712,54784,-444928,-1
128,36,18,12,0.219512195,0.780487805,47.2575374,42.89834201,87.6484375,64.19444444,164,36.85393258,328,-65536,18432,-47104,-1
273,56,21,9,0.170212766,0.829787234,90.71126422,109.3395934,170.6776557,137.3214286,329,50.22900763,658,-139776,28672,-111104,-1
9028,411,22,8,0.0435427482,0.956457252,2704.328168,2943.270076,4768.846588,3647.038929,9439,649.1746905,18878,-4622336,210432,-4411904,-1
1048,137,19,11,0.115611814,0.884388186,332.5555878,351.8848119,618.2986641,399.4744526,1185,42.29122056,2370,-536576,70144,-466432,-1
131,18,17,13,0.120805369,0.879194631,40.61607466,36.22443756,80.75572519,33.11111111,149,7.218992248,298,-67072,9216,-57856,-1
1009,211,22,8,0.17295082,0.82704918,346.7388778,376.9251568,608.1090188,621.9336493,1220,27.12919724,2440,-516608,108032,-408576,-1
3110,270,17,13,0.0798816568,0.920118343,960.9884364,1121.834987,1678.093569,1833.403704,3380,117.0360111,6760,-1592320,138240,-1454080,-1
1672,88,19,11,0.05,0.95,502.5801082,580.1061459,888.9282297,720.3636364,1760,71.89542484,3520,-856064,45056,-811008,-1
546,60,16,14,0.099009901,0.900990099,171.522191,170.3045728,315.0989011,197.95,606,91.67927383,1212,-279552,30720,-248832,-1
5780,394,20,10,0.0638160026,0.936183997,1773.538956,1791.141347,3130.462976,2457.230964,6174,399.0950226,12348,-2959360,201728,-2757632,-1
8562,769,21,9,0.0824134605,0.917586539,2634.275337,3119.345671,4578.00327,5645.750325,9331,182.996666,18662,-4383744,393728,-3990016,-1
3015,311,27,3,0.0935057126,0.906494287,931.5547908,1201.522326,1658.784411,1709.215434,3326,93.0870417,6652,-1543680,159232,-1384448,-1
6904,479,22,8,0.0648787756,0.935121224,2119.337578,2198.290149,3736.609357,3049.029228,7383,162.9082083,14766,-3534848,245248,-3289600,-1
1606,176,22,8,0.0987654321,0.901234568,508.9318862,547.605113,904.6575342,771.4375,1782,33.25867861,3564,-822272,90112,-732160,-1
2245,174,20,10,0.0719305498,0.92806945,688.1916017,815.508602,1214.414699,1153.04023,2419,125.4017626,4838,-1149440,89088,-1060352,-1
1507,99,17,13,0.0616438356,0.938356164,454.4631692,506.3561415,822.2050431,518.7676768,1606,262.8477905,3212,-771584,50688,-720896,-1
1749,77,22,8,0.0421686747,0.957831325,522.1205751,602.7331774,921.4139508,733.7402597,1826,221.8712029,3652,-895488,39424,-856064,-1
4011,250,21,9,0.0586716733,0.941328327,1220.297561,1319.319915,2154.853902,1748.288,4261,171.8145161,8522,-2053632,128000,-1925632,-1
4093,256,19,11,0.0588641067,0.941135893,1257.076673,1215.113266,2186.225996,1995.515625,4349,83.41004987,8698,-2095616,131072,-1964544,-1
7045,989,20,10,0.123101817,0.876898183,2299.063599,2432.521094,3971.102058,4348.0091,8034,165.2406417,16068,-3607040,506368,-3100672,-1
6678,538,20,10,0.074556541,0.925443459,2073.493408,2197.968928,3612.565738,3558.033457,7216,457.287706,14432,-3419136,275456,-3143680,-1
6389,393,22,8,0.0579475081,0.942052492,1938.591698,2222.602542,3411.246048,3070.48855,6782,267.007874,13564,-3271168,201216,-3069952,-1
1370,147,19,11,0.0969017798,0.90309822,429.3352592,502.9889389,768.2131387,673.1360544,1517,129.991431,3034,-701440,75264,-626176,-1
9232,729,20,10,0.0731854232,0.926814577,2873.882637,2711.084158,5058.366334,4001.238683,9961,208.3891213,19922,-4726784,373248,-4353536,-1
2874,232,25,5,0.0746941404,0.92530586,877.8695048,871.2825921,1605.99826,903.1551724,3106,218.2712579,6212,-1471488,118784,-1352704,-1
9427,531,22,8,0.0533239606,0.946676039,2873.085882,2901.832837,4978.949295,4989.276836,9958,721.0716872,19916,-4826624,271872,-4554752,-1
4679,379,27,3,0.0749308027,0.925069197,1439.119664,1679.047241,2549.265655,2285.480211,5058,110.2921936,10116,-2395648,194048,-2201600,-1
587,113,21,9,0.161428571,0.838571429,196.3864209,213.012689,365.4872232,272.6460177,700,23.52941176,1400,-300544,57856,-242688,-1
9556,421,22,8,0.0421970532,0.957802947,2874.510168,2912.827499,5020.747593,4268.382423,9977,1089.19214,19954,-4892672,215552,-4677120,-1
4171,319,20,10,0.0710467706,0.928953229,1287.449916,1263.624318,2290.772716,1653.548589,4490,94.84579637,8980,-2135552,163328,-1972224,-1
1876,376,20,10,0.1669627,0.8330373,644.4797983,677.1816706,1129.813433,1109.968085,2252,95.22198732,4504,-960512,192512,-768000,-1
51,11,23,7,0.177419355,0.822580645,18.12053283,14.58177284,33.1372549,23.90909091,62,13.80846325,124,-26112,5632,-20480,-1
9390,565,20,10,0.0567553993,0.943244601,2853.493192,3143.031769,5010.485304,4438.111504,9955,457.0707071,19910,-4807680,289280,-4518400,-1
5283,476,20,10,0.0826532384,0.917346762,1650.162549,1694.418399,2829.264244,3443.102941,5759,160.6415621,11518,-2704896,243712,-2461184,-1
2741,185,22,8,0.0632262474,0.936773753,836.3307561,959.5708218,1464.45239,1449.389189,2926,100.7228916,5852,-1403392,94720,-1308672,-1
3668,247,22,8,0.0630906769,0.936909323,1117.164769,1308.062386,1958.406216,1951.967611,3915,335.4755784,7830,-1878016,126464,-1751552,-1
9523,449,20,10,0.045026073,0.954973927,2856.933387,3210.112681,5022.953166,4213.351893,9972,637.5959079,19944,-4875776,229888,-4645888,-1
3309,192,22,8,0.0548414739,0.945158526,997.6623915,1078.310636,1782.318827,1211.239583,3501,141.0556003,7002,-1694208,98304,-1595904,-1
9444,515,20,10,0.0517120193,0.948287981,2851.270093,3104.348703,5035.975116,3953.535922,9959,732.2794118,19918,-4835328,263680,-4571648,-1
3184,400,27,3,0.111607143,0.888392857,1019.90902,1135.783284,1775.396357,1928.645,3584,93.5770235,7168,-1630208,204800,-1425408,-1
1542,70,23,7,0.0434243176,0.956575682,459.5881997,559.7962428,812.849546,666.6285714,1612,151.0777882,3224,-789504,35840,-753664,-1
9256,683,17,13,0.068719187,0.931280813,2824.800098,3411.047327,4960.353717,5100.726208,9939,623.1347962,19878,-4739072,349696,-4389376,-1
3339,394,20,10,0.105545138,0.894454862,1067.704752,1146.54513,1885.355496,1711.444162,3733,199.0933333,7466,-1709568,201728,-1507840,-1
3278,257,22,8,0.0727015559,0.927298444,1000.712804,1201.483445,1792.700427,1452.949416,3535,149.7881356,7070,-1678336,131584,-1546752,-1
4171,257,20,10,0.0580397471,0.941960253,1266.88673,1344.240441,2247.061136,1686.046693,4428,116.4343939,8856,-2135552,131584,-2003968,-1
2532,323,18,12,0.113134851,0.886865149,817.2307039,875.7769538,1432.686019,1391.266254,2855,122.008547,5710,-1296384,165376,-1131008,-1
601,43,18,12,0.0667701863,0.933229814,181.0320277,179.5459721,333.9251248,162.8139535,644,66.87435099,1288,-307712,22016,-285696,-1
115,38,19,11,0.248366013,0.751633987,44.02434968,42.93428109,80.45217391,66.55263158,153,37.13592233,306,-58880,19456,-39424,-1
5279,852,20,10,0.138965911,0.861034089,1683.783009,1688.183779,2847.710172,4418.525822,6131,133.0512153,12262,-2702848,436224,-2266624,-1
9518,455,18,12,0.0456231826,0.954376817,2853.183819,3255.150374,5028.320025,4122.63956,9973,1295.194805,19946,-4873216,232960,-4640256,-1
5601,381,18,12,0.0636910732,0.936308927,1718.201758,1849.256539,2990.024817,3013.186352,5982,316.3405605,11964,-2867712,195072,-2672640,-1
1919,226,26,4,0.105361305,0.894638695,610.9774732,659.7660356,1093.57061,898.3318584,2145,132,4290,-982528,115712,-866816,-1
3682,256,21,9,0.0650076181,0.934992382,1130.563154,1220.757971,1974.507061,1897.484375,3938,327.3482959,7876,-1885184,131072,-1754112,-1
3384,435,20,10,0.113904163,0.886095837,1055.364886,1318.469184,1847.424941,2396.790805,3819,72.729004,7638,-1732608,222720,-1509888,-1
2850,183,19,11,0.0603363007,0.939663699,863.3224499,1003.41825,1535.76807,1224.710383,3033,192.9389313,6066,-1459200,93696,-1365504,-1
7730,906,20,10,0.10490968,0.89509032,2489.373351,2498.679923,4279.179301,4653.984547,8636,198.5743849,17272,-3957760,463872,-3493888,-1
5457,452,20,10,0.0764934845,0.923506515,1657.482875,2194.455333,2973.701668,2729.214602,5909,478.8492707,11818,-2793984,231424,-2562560,-1
129,20,22,8,0.134228188,0.865771812,42.48359351,32.76797217,79.71317829,44.6,149,16.26637555,298,-66048,10240,-55808,-1
2159,110,21,9,0.0484795064,0.951520494,647.8218806,757.3675364,1144.823993,942.1818182,2269,158.7823653,4538,-1105408,56320,-1049088,-1
2617,151,17,13,0.0545520231,0.945447977,789.4265956,918.582038,1398.208254,1146.92053,2768,148.0213904,5536,-1339904,77312,-1262592,-1
6517,246,20,10,0.0363743901,0.96362561,1947.999663,2035.461188,3394.498696,3050.886179,6763,778.2508631,13526,-3336704,125952,-3210752,-1
1585,129,21,9,0.0752625438,0.924737456,490.670196,541.1801045,860.8321767,816.5581395,1714,55.0594282,3428,-811520,66048,-745472,-1
9479,489,20,10,0.0490569823,0.950943018,2857.128847,3102.915496,5032.700918,4050.151329,9968,398.8795518,19936,-4853248,250368,-4602880,-1
88,28,20,10,0.24137931,0.75862069,32.77156094,34.51641136,60.95454545,50.78571429,116,11.49653122,232,-45056,14336,-30720,-1
2236,208,21,9,0.085106383,0.914893617,694.5478832,811.7673213,1228.101521,1162.283654,2444,207.646559,4888,-1144832,106496,-1038336,-1
46,9,24,6,0.163636364,0.836363636,15.36735117,16.45044935,29.41304348,20.77777778,55,7.779349364,110,-23552,4608,-18944,-1
3324,448,21,9,0.118769883,0.881230117,1064.770145,1123.364335,1956.83213,1364.660714,3772,72.27438207,7544,-1701888,229376,-1472512,-1
4490,286,21,9,0.0598827471,0.940117253,1363.251644,1599.712329,2393.779287,2305.618881,4776,404.7457627,9552,-2298880,146432,-2152448,-1
9102,822,23,7,0.0828295042,0.917170496,2797.597012,3477.610755,4912.986377,5510.76399,9924,856.9948187,19848,-4660224,420864,-4239360,-1
4067,264,24,6,0.0609558993,0.939044101,1233.551244,1389.53045,2198.768134,1661.19697,4331,418.8588008,8662,-2082304,135168,-1947136,-1
2059,177,22,8,0.0791592129,0.920840787,631.5307802,684.9749423,1150.93832,741.1525424,2236,179.4542536,4472,-1054208,90624,-963584,-1
3023,358,22,8,0.105885833,0.894114167,971.7756334,1007.567473,1681.592127,1770.441341,3381,80.00473261,6762,-1547776,183296,-1364480,-1
4984,290,22,8,0.0549867273,0.945013273,1499.373128,1859.644287,2623.726124,2874.22069,5274,359.0197413,10548,-2551808,148480,-2403328,-1
404,52,21,9,0.114035088,0.885964912,126.5987826,157.4171932,234.740099,180.0192308,456,22.09302326,912,-206848,26624,-180224,-1
9538,435,25,5,0.043617768,0.956382232,2866.881686,3002.094042,5026.821661,4113.852874,9973,691.1295911,19946,-4883456,222720,-4660736,-1
3975,404,17,13,0.0922585065,0.907741493,1263.036885,1272.72008,2196.706164,2124.017327,4379,86.40489345,8758,-2035200,206848,-1828352,-1
8009,1784,21,9,0.182170938,0.817829062,2937.312675,2266.229283,4889.671744,4929.899103,9793,320.8715596,19586,-4100608,913408,-3187200,-1
5183,492,22,8,0.0866960352,0.913303965,1621.425919,1754.745206,2799.324715,3245.426829,5675,144.918284,11350,-2653696,251904,-2401792,-1
4875,451,18,12,0.0846789335,0.915321066,1512.138639,1769.757731,2640.539077,2911.691796,5326,108.0324544,10652,-2496000,230912,-2265088,-1
9509,463,22,8,0.046430004,0.953569996,2860.923219,3071.877149,5032.64949,4038.691145,9972,637.5959079,19944,-4868608,237056,-4631552,-1
144,41,20,10,0.221621622,0.778378378,52.88449326,49.82014052,98.96527778,72.04878049,185,24.47089947,370,-73728,20992,-52736,-1
4023,404,21,9,0.0912581884,0.908741812,1236.428644,1634.125529,2219.079294,2163.420792,4427,182.7073875,8854,-2059776,206848,-1852928,-1
2992,237,19,11,0.0733973366,0.926602663,916.4712329,1107.600371,1621.636698,1531.21519,3229,210.9079033,6458,-1531904,121344,-1410560,-1
1623,145,18,12,0.0820135747,0.917986425,493.672245,606.0693365,908.8478127,611.9724138,1768,127.8380333,3536,-830976,74240,-756736,-1
3243,347,20,10,0.0966573816,0.903342618,1038.862492,950.2478617,1831.048412,1463.270893,3590,111.9775421,7180,-1660416,177664,-1482752,-1
31,21,18,12,0.403846154,0.596153846,15.30277158,14.55336571,26.77419355,26.0952381,52,20.71713147,104,-15872,10752,-5120,-1
1862,56,27,3,0.0291970803,0.97080292,553.165377,568.6380813,958.1396348,1004.732143,1918,67.15686275,3836,-953344,28672,-924672,-1
220,49,22,8,0.182156134,0.817843866,76.84484462,80.11700627,137.6409091,123.1428571,269,6.378942376,538,-112640,25088,-87552,-1
3244,1417,21,9,0.304012015,0.695987985,1091.133117,1052.088604,1800.093403,3546.427664,4661,102.5296964,9322,-1660928,725504,-935424,-1
571,46,22,8,0.074554295,0.925445705,171.6070362,244.6798775,309.7583187,299.5869565,617,12.29328552,1234,-292352,23552,-268800,-1
612,89,17,13,0.126961484,0.873038516,193.8708751,231.3794447,364.9542484,255.0449438,701,119.6245734,1402,-313344,45568,-267776,-1
9482,487,22,8,0.0488514395,0.951148561,2865.111912,3090.007714,5004.567074,4604.024641,9969,815.1267375,19938,-4854784,249344,-4605440,-1
4737,296,21,9,0.0588118418,0.941188158,1440.296353,1640.378688,2520.703188,2457.736486,5033,308.2057563,10066,-2425344,151552,-2273792,-1
58,16,23,7,0.216216216,0.783783784,22.12202673,17.00723651,39.17241379,31.4375,74,2.167545401,148,-29696,8192,-21504,-1
7178,599,20,10,0.0770219879,0.922978012,2188.945439,2803.698941,3920.988994,3505.66611,7777,396.3812436,15554,-3675136,306688,-3368448,-1
8174,691,21,9,0.0779469825,0.922053017,2529.672469,2864.745305,4405.593834,4757.193922,8865,187.6190476,17730,-4185088,353792,-3831296,-1
3914,241,21,9,0.0580024067,0.941997593,1180.876871,1275.068116,2121.535003,1370.962656,4155,155.9099437,8310,-2003968,123392,-1880576,-1
58,16,23,7,0.216216216,0.783783784,22.12738093,16.7742362,39.29310345,31,74,2.242424242,148,-29696,8192,-21504,-1
479,51,18,12,0.0962264151,0.903773585,149.1143894,176.6390329,271.2484342,211.5098039,530,38.43364757,1060,-245248,26112,-219136,-1
6891,688,21,9,0.0907771474,0.909222853,2198.679364,2029.818394,3831.675809,3372.575581,7579,239.0851735,15158,-3528192,352256,-3175936,-1
7624,1163,22,8,0.132354615,0.867645385,2513.673096,2603.219418,4302.333814,4994.914015,8787,174.7961011,17574,-3903488,595456,-3308032,-1
9338,623,18,12,0.0625439213,0.937456079,2829.199584,3216.499155,5069.593275,3653.096308,9961,636.0791826,19922,-4781056,318976,-4462080,-1
2518,296,21,9,0.105188344,0.894811656,819.5712122,747.8947411,1406.822875,1413.260135,2814,131.25,5628,-1289216,151552,-1137664,-1
5883,573,20,10,0.0887546468,0.911245353,1841.299084,2063.939606,3204.780044,3472.033159,6456,138.8088583,12912,-3012096,293376,-2718720,-1
1386,126,19,11,0.0833333333,0.916666667,427.2507164,525.3224347,760.5865801,711.547619,1512,139.2265193,3024,-709632,64512,-645120,-1
6435,693,22,8,0.0972222222,0.902777778,2023.957544,2185.982307,3476.866356,4378.240981,7128,140.7305035,14256,-3294720,354816,-2939904,-1
9363,579,21,9,0.0582377791,0.941762221,2859.002394,3022.234739,4992.517783,4631.621762,9942,849.7435897,19884,-4793856,296448,-4497408,-1
428,100,17,13,0.189393939,0.810606061,143.9179181,168.3091798,280.364486,196.6,528,77.64705882,1056,-219136,51200,-167936,-1
1825,206,20,10,0.101427868,0.898572132,579.8014749,630.1590871,1028.556712,904.7572816,2031,42.73989899,4062,-934400,105472,-828928,-1
1612,123,23,7,0.0708933718,0.929106628,491.6594923,587.7831445,879.6116625,715.8211382,1735,68.84920635,3470,-825344,62976,-762368,-1
5693,884,21,9,0.134407785,0.865592215,1758.751914,1953.394156,3035.325839,4922.673077,6577,135.5523495,13154,-2914816,452608,-2462208,-1
263,55,22,8,0.172955975,0.827044025,91.40690816,84.22620075,167.2851711,122.2727273,318,26.43391521,636,-134656,28160,-106496,-1
4658,235,21,9,0.0480277948,0.951972205,1397.995506,1501.308048,2483.45599,1724.395745,4893,205.7611438,9786,-2384896,120320,-2264576,-1
4342,309,19,11,0.0664373253,0.933562675,1340.766345,1258.553564,2362.957854,1806.676375,4651,385.3355427,9302,-2223104,158208,-2064896,-1
6221,415,17,13,0.0625376733,0.937462327,1904.166073,1934.448285,3367.905481,2577.893976,6636,154.3973941,13272,-3185152,212480,-2972672,-1
4623,299,21,9,0.0607476636,0.939252336,1388.737401,1540.835949,2525.424183,1473.133779,4922,364.8628614,9844,-2366976,153088,-2213888,-1
456,32,22,8,0.0655737705,0.93442623,140.3922316,135.6532229,248.4385965,188.375,488,38.94652833,976,-233472,16384,-217088,-1
9404,554,20,10,0.0556336614,0.944366339,2844.124584,3123.083652,5048.930136,3800.942238,9958,1157.906977,19916,-4814848,283648,-4531200,-1
3339,283,26,4,0.0781336278,0.921866372,1032.041051,1139.440008,1840.480982,1469.565371,3622,154.6541418,7244,-1709568,144896,-1564672,-1
136,43,20,10,0.240223464,0.759776536,51.49921,51.26811569,92.72794118,81.37209302,179,7.966177125,358,-69632,22016,-47616,-1
8875,1014,27,3,0.102538174,0.897461826,2804.747127,3128.798053,4846.107831,5810.550296,9889,325.5102041,19778,-4544000,519168,-4024832,-1
7093,465,19,11,0.0615242128,0.938475787,2153.277111,2575.412662,3771.963062,3894.466667,7558,324.3776824,15116,-3631616,238080,-3393536,-1
8428,404,20,10,0.0457427536,0.954257246,2536.16936,2812.550283,4411.244898,4526.128713,8832,611.634349,17664,-4315136,206848,-4108288,-1
1321,131,23,7,0.0902203857,0.909779614,417.9289606,352.5311983,750.009084,489.4351145,1452,118.8216039,2904,-676352,67072,-609280,-1
42,17,22,8,0.288135593,0.711864407,16.86380014,17.35124618,30.57142857,28.58823529,59,8.939393939,118,-21504,8704,-12800,-1
543,116,22,8,0.176024279,0.823975721,187.4402368,202.3559366,327.3554328,342.3793103,659,58.01056338,1318,-278016,59392,-218624,-1
9470,504,20,10,0.0505313816,0.949468618,2852.167022,3123.458036,5049.950686,3814.071429,9974,378.5199241,19948,-4848640,258048,-4590592,-1
7392,360,18,12,0.0464396285,0.953560372,2223.070901,2373.891479,3916.922078,3046.5,7752,145.5228083,15504,-3784704,184320,-3600384,-1
494,53,18,12,0.0968921389,0.903107861,154.9319353,162.446784,282.659919,193.2830189,547,10.16539677,1094,-252928,27136,-225792,-1
982,104,21,9,0.0957642726,0.904235727,307.9661161,358.1385347,548.5346232,495.9615385,1086,80.92399404,2172,-502784,53248,-449536,-1
2817,721,20,10,0.203787451,0.796212549,1069.731247,804.5396188,1764.807952,1787.832178,3538,77.2489083,7076,-1442304,369152,-1073152,-1
2847,330,18,12,0.103871577,0.896128423,916.935941,918.4584649,1591.3804,1568.463636,3177,97.7237773,6354,-1457664,168960,-1288704,-1
59,22,22,8,0.271604938,0.728395062,22.32167998,25.90366769,40.25423729,43,81,10.99050204,162,-30208,11264,-18944,-1
9413,546,17,13,0.0548247816,0.945175218,2831.008332,3311.335397,5051.761394,3742.838828,9959,1101.659292,19918,-4819456,279552,-4539904,-1
2334,213,19,11,0.0836277974,0.916372203,728.5737077,792.4293658,1286.303342,1139.183099,2547,195.7724827,5094,-1195008,109056,-1085952,-1
2401,200,22,8,0.0768935025,0.923106498,733.4027992,861.0522844,1271.798834,1651.56,2601,90.97586569,5202,-1229312,102400,-1126912,-1
3346,327,18,12,0.0890280425,0.910971958,1021.170383,1399.15898,1836.165272,1845.541284,3673,125.9602195,7346,-1713152,167424,-1545728,-1
4021,644,21,9,0.138049303,0.861950697,1318.06432,1508.062234,2314.667496,2447.464286,4665,85.65919941,9330,-2058752,329728,-1729024,-1
9658,332,21,9,0.0332332332,0.966766767,2873.563674,3117.833645,5014.651066,4438.388554,9990,944.2344045,19980,-4944896,169984,-4774912,-1
9467,485,21,9,0.0487339228,0.951266077,2851.361304,3208.496124,5006.69325,4387.140206,9952,889.3655049,19904,-4847104,248320,-4598784,-1
6869,363,15,15,0.0501935841,0.949806416,2083.469601,2068.467475,3649.627166,2989.639118,7232,142.5305479,14464,-3516928,185856,-3331072,-1
8100,692,19,11,0.0787079163,0.921292084,2514.547297,2778.943557,4423.446296,4081.08815,8792,162.2439564,17584,-4147200,354304,-3792896,-1
5625,314,27,3,0.0528708537,0.947129146,1706.633672,1689.532352,3010.773867,2239.576433,5939,250.6964964,11878,-2880000,160768,-2719232,-1
7619,550,17,13,0.0673277023,0.932672298,2333.349982,2562.103261,4139.487728,3330.196364,8169,522.6487524,16338,-3900928,281600,-3619328,-1
9457,508,20,10,0.0509784245,0.949021576,2866.858831,2962.110971,5021.7256,4262.07874,9965,537.7765785,19930,-4841984,260096,-4581888,-1
9391,550,16,14,0.0553264259,0.944673574,2849.11363,3161.237748,4999.686082,4481.198182,9941,954.0307102,19882,-4808192,281600,-4526592,-1
8640,1233,19,11,0.124886053,0.875113947,2882.784511,2578.005575,4883.022569,5315.23601,9873,244.6233895,19746,-4423680,631296,-3792384,-1
9192,742,20,10,0.0746929736,0.925307026,2819.571737,3033.697879,4846.927328,6461.171159,9934,633.1421287,19868,-4706304,379904,-4326400,-1
3493,146,20,10,0.0401209123,0.959879088,1040.021631,1186.799668,1839.144002,1361.986301,3639,348.5632184,7278,-1788416,74752,-1713664,-1
1403,144,27,3,0.0930833872,0.906916613,432.8564325,558.7663429,767.2238061,840.0208333,1547,55.44802867,3094,-718336,73728,-644608,-1
1825,103,17,13,0.0534232365,0.946576763,549.2695878,641.973926,975.5627397,768.4854369,1928,117.7764203,3856,-934400,52736,-881664,-1
9461,497,21,9,0.0499096204,0.95009038,2837.022426,3382.638061,5028.342987,4049.714286,9958,1047.108307,19916,-4844032,254464,-4589568,-1
7777,437,20,10,0.0532018505,0.94679815,2349.517629,2707.321245,4125.844413,3781.036613,8214,196.1786482,16428,-3981824,223744,-3758080,-1
6315,509,19,11,0.0745896835,0.925410317,1935.988797,2173.333302,3481.914173,2551.300589,6824,288.6632826,13648,-3233280,260608,-2972672,-1
9069,454,26,4,0.0476740523,0.952325948,2740.894765,2866.400902,4785.720146,4288.171806,9523,377.7469258,19046,-4643328,232448,-4410880,-1
4403,323,21,9,0.0683453237,0.931654676,1344.550915,1600.988653,2351.962298,2520.77709,4726,300.0634921,9452,-2254336,165376,-2088960,-1
3995,472,22,8,0.105663756,0.894336244,1284.761387,1328.763436,2230.974718,2259.605932,4467,126.4722537,8934,-2045440,241664,-1803776,-1
3149,433,20,10,0.120882189,0.879117811,994.8655326,1229.032371,1743.841219,2138.099307,3582,88.4226117,7164,-1612288,221696,-1390592,-1
9346,607,19,11,0.0609866372,0.939013363,2853.128599,2825.902049,5066.83929,3593.741351,9953,591.7360285,19906,-4785152,310784,-4474368,-1
2006,303,19,11,0.131225639,0.868774361,652.224723,754.0250034,1150.978066,1181.627063,2309,150.8164598,4618,-1027072,155136,-871936,-1
40,12,21,9,0.230769231,0.769230769,15.23966863,12.93144316,28.05,21.33333333,52,10.81081081,104,-20480,6144,-14336,-1
4495,446,18,12,0.0902651285,0.909734871,1400.31666,1581.314112,2421.337931,2971.517937,4941,300.3647416,9882,-2301440,228352,-2073088,-1
2773,110,17,13,0.0381547,0.9618453,825.578051,942.0820636,1453.273711,1157.8,2883,519.4594595,5766,-1419776,56320,-1363456,-1
437,55,20,10,0.111788618,0.888211382,141.6847904,117.2378863,256.5652174,166.5272727,492,9.740645417,984,-223744,28160,-195584,-1
3351,303,18,12,0.0829228243,0.917077176,1031.683599,1098.174061,1884.971352,1191.90099,3654,366.1322645,7308,-1715712,155136,-1560576,-1
318,28,20,10,0.0809248555,0.919075145,97.18533287,99.76735054,180.0691824,98.89285714,346,21.76100629,692,-162816,14336,-148480,-1
8590,524,21,9,0.0574939653,0.942506035,2606.199721,3005.164548,4549.338068,4691.299618,9114,272.7925771,18228,-4398080,268288,-4129792,-1
389,49,20,10,0.111872146,0.888127854,118.9613434,174.4499704,218.18509,229.9387755,438,57.03125,876,-199168,25088,-174080,-1
136,28,21,9,0.170731707,0.829268293,47.40081613,34.34941998,88.52941176,53.21428571,164,37.27272727,328,-69632,14336,-55296,-1
4781,534,21,9,0.100470367,0.899529633,1512.783692,1676.349998,2619.633968,3001.498127,5315,113.1332482,10630,-2447872,273408,-2174464,-1
1265,120,22,8,0.0866425993,0.913357401,398.0828938,335.7379508,715.5193676,455.6083333,1385,104.1353383,2770,-647680,61440,-586240,-1
5066,539,22,8,0.0961641392,0.903835861,1611.124254,1614.283822,2755.394394,3250.439703,5605,153.2677058,11210,-2593792,275968,-2317824,-1
53,18,20,10,0.253521127,0.746478873,20.16455974,19.99722203,38.26415094,29.33333333,71,1.688466112,142,-27136,9216,-17920,-1
1176,121,20,10,0.0932922128,0.906707787,360.7294392,487.778522,649.3469388,645.6280992,1297,23.35253871,2594,-602112,61952,-540160,-1
1942,265,17,13,0.120072497,0.879927503,634.6150242,652.904027,1097.184861,1153.943396,2207,106.3102119,4414,-994304,135680,-858624,-1
1030,128,19,11,0.110535406,0.889464594,325.7904536,393.1388797,585.1349515,534.15625,1158,70.48082775,2316,-527360,65536,-461824,-1
9534,440,17,13,0.0441146982,0.955885302,2869.104192,3029.580649,5015.127124,4388.870455,9974,859.086994,19948,-4881408,225280,-4656128,-1
848,138,18,12,0.139959432,0.860040568,278.8913921,316.8122598,496.9752358,472.1449275,986,76.02158828,1972,-434176,70656,-363520,-1
5254,536,21,9,0.0925734024,0.907426598,1664.374169,1732.796167,2881.160069,3036.063433,5790,109.2658992,11580,-2690048,274432,-2415616,-1
3380,323,17,13,0.087226573,0.912773427,1044.539356,1242.184939,1817.857396,2209.281734,3703,249.696561,7406,-1730560,165376,-1565184,-1
9544,432,21,9,0.0433039294,0.956696071,2865.804138,3014.407327,5032.467519,4017.143519,9976,575.6491633,19952,-4886528,221184,-4665344,-1
1389,118,18,12,0.0783012608,0.921698739,433.3837912,452.5945291,756.9114471,719.7288136,1507,63.39924274,3014,-711168,60416,-650752,-1
4446,535,21,9,0.107408151,0.892591849,1407.209036,1670.803286,2486.786775,2526.013084,4981,125.27666,9962,-2276352,273920,-2002432,-1
9449,509,20,10,0.0511146817,0.948885318,2864.837006,2994.03137,5010.202244,4409.548134,9958,1373.517241,19916,-4837888,260608,-4577280,-1
3707,469,22,8,0.112308429,0.887691571,1177.790261,1296.5165,2023.820879,2599.727079,4176,110.2719831,8352,-1897984,240128,-1657856,-1
9342,600,20,10,0.0603500302,0.93964997,2828.377875,3124.575657,5063.160351,3544.348333,9942,562.6485569,19884,-4783104,307200,-4475904,-1
32,19,19,11,0.37254902,0.62745098,14.88415553,14.37063796,26.65625,24.89473684,51,11.86046512,102,-16384,9728,-6656,-1
2111,92,16,14,0.0417612347,0.958238765,628.9077243,717.5526136,1115.078162,801.9130435,2203,527.0334928,4406,-1080832,47104,-1033728,-1
8411,725,21,9,0.0793563923,0.920643608,2563.986252,3002.450097,4441.258114,6044.681379,9136,209.8300413,18272,-4306432,371200,-3935232,-1
1128,240,18,12,0.175438596,0.824561404,402.0622883,353.7689609,672.2819149,741.925,1368,92.18328841,2736,-577536,122880,-454656,-1
2858,214,27,3,0.0696614583,0.930338542,881.2425357,905.7089626,1559.061232,1235.191589,3072,264.144454,6144,-1463296,109568,-1353728,-1
486,32,21,9,0.0617760618,0.938223938,146.0799286,183.2258655,263.6790123,196.03125,518,14.94518177,1036,-248832,16384,-232448,-1
6668,504,20,10,0.070273285,0.929726715,2055.72719,2251.504867,3577.006749,3712.097222,7172,220.1350522,14344,-3414016,258048,-3155968,-1
7125,440,21,9,0.0581625909,0.941837409,2142.815382,2742.393321,3803.913263,3444.347727,7565,410.0271003,15130,-3648000,225280,-3422720,-1
3699,386,21,9,0.0944920441,0.905507956,1152.021733,1391.621321,2018.273047,2279.955959,4085,188.3356385,8170,-1893888,197632,-1696256,-1
203,57,20,10,0.219230769,0.780769231,69.74626258,91.39176609,131.5665025,126.7017544,260,28.23018458,520,-103936,29184,-74752,-1
978,85,20,10,0.0799623706,0.920037629,299.8488491,361.145607,541.3916155,423.9411765,1063,108.138352,2126,-500736,43520,-457216,-1
1700,139,25,5,0.0755845568,0.924415443,524.9874537,592.2579918,913.3917647,1000.820144,1839,116.9847328,3678,-870400,71168,-799232,-1
9458,510,27,3,0.0511637239,0.948836276,2849.537259,3029.965869,5060.083844,3582.790196,9968,661.4465826,19936,-4842496,261120,-4581376,-1
83,22,25,5,0.20952381,0.79047619,30.27875525,29.48248535,54.77108434,46.31818182,105,2.048780488,210,-42496,11264,-31232,-1
9334,611,21,9,0.0614379085,0.938562092,2845.731821,2954.802196,5055.849582,3707.340426,9945,583.2844575,19890,-4779008,312832,-4466176,-1
9607,375,19,11,0.0375676217,0.962432378,2862.28707,3180.797481,5030.197252,4000.128,9982,1146.039036,19964,-4918784,192000,-4726784,-1
9363,602,20,10,0.06041144,0.93958856,2849.213389,2937.486861,5073.087686,3581.852159,9965,223.9829175,19930,-4793856,308224,-4485632,-1
1679,77,19,11,0.0438496583,0.956150342,501.0368519,582.9539277,888.147707,668.1298701,1756,142.9967427,3512,-859648,39424,-820224,-1
9428,536,21,9,0.0537936572,0.946206343,2877.653885,2849.278857,4991.066928,4831.811567,9964,515.2016546,19928,-4827136,274432,-4552704,-1
893,162,22,8,0.153554502,0.846445498,299.5527635,317.5328936,543.4535274,442.8148148,1055,28.11084466,2110,-457216,82944,-374272,-1
3705,266,27,3,0.0669856459,0.933014354,1149.052688,1106.805386,1982.922537,2028.864662,3971,179.60199,7942,-1896960,136192,-1760768,-1
2233,235,23,7,0.0952188006,0.904781199,714.0645691,696.3504836,1237.328258,1207.625532,2468,87.42472547,4936,-1143296,120320,-1022976,-1
2051,222,22,8,0.0976682798,0.90233172,631.6412043,849.3863298,1134.118966,1163.617117,2273,74.96701847,4546,-1050112,113664,-936448,-1
61,16,25,5,0.207792208,0.792207792,22.99859197,17.78506659,40.55737705,33.0625,77,2.261380323,154,-31232,8192,-23040,-1
4224,214,24,6,0.0482199189,0.951780081,1272.46845,1323.141216,2247.794508,1661.014019,4438,170.7579838,8876,-2162688,109568,-2053120,-1
7484,505,21,9,0.0632119164,0.936788084,2267.662087,2812.001667,3984.607964,4149.007921,7989,462.8621089,15978,-3831808,258560,-3573248,-1
2206,181,21,9,0.0758273984,0.924172602,678.9015766,795.139511,1185.338169,1299.569061,2387,184.4667697,4774,-1129472,92672,-1036800,-1
8544,1295,20,10,0.131619067,0.868380933,2795.818463,3006.977806,4803.669944,5687.50888,9839,499.1882293,19678,-4374528,663040,-3711488,-1
2730,366,27,3,0.118217054,0.881782946,904.7790408,805.7765637,1553.171429,1513.655738,3096,93.84662019,6192,-1397760,187392,-1210368,-1
831,47,17,13,0.0535307517,0.946469248,247.7440485,290.4132676,449.1131167,269.5319149,878,279.6178344,1756,-425472,24064,-401408,-1
3466,393,18,12,0.101839855,0.898160145,1115.892139,1094.232359,1938.584247,1854.292621,3859,252.0574788,7718,-1774592,201216,-1573376,-1
9524,446,21,9,0.0447342026,0.955265797,2862.592617,3143.979819,5010.51575,4451.307175,9970,1036.382536,19940,-4876288,228352,-4647936,-1
652,58,18,12,0.0816901408,0.918309859,199.6097806,257.1625983,356.7177914,341.8103448,710,30.77589944,1420,-333824,29696,-304128,-1
67,28,21,9,0.294736842,0.705263158,28.40480069,22.34889738,51.86567164,38.75,95,10.99537037,190,-34304,14336,-19968,-1
3134,333,27,3,0.0960484569,0.903951543,982.9037482,1095.642793,1696.738673,2084.681682,3467,154.5697726,6934,-1604608,170496,-1434112,-1
1225,103,17,13,0.077560241,0.922439759,374.7186831,456.8921788,674.7559184,542.5242718,1328,265.0698603,2656,-627200,52736,-574464,-1
42,17,21,9,0.288135593,0.711864407,16.42161689,18.40715973,30.4047619,29,59,9.262166405,118,-21504,8704,-12800,-1
9543,433,21,9,0.04340417,0.95659583,2857.702977,3115.521256,5040.708163,3837.87067,9976,908.56102,19952,-4886016,221696,-4664320,-1
9371,589,21,9,0.0591365462,0.940863454,2856.703748,2935.673459,5050.962757,3859.436333,9960,829.3089092,19920,-4797952,301568,-4496384,-1
2766,303,27,3,0.0987292278,0.901270772,878.9640042,931.3171986,1553.013015,1370.564356,3069,74.78070175,6138,-1416192,155136,-1261056,-1
9619,365,21,9,0.0365584936,0.963441506,2878.199238,2983.650633,4993.993554,4953.139726,9984,782.4451411,19968,-4924928,186880,-4738048,-1
1147,124,18,12,0.0975609756,0.902439024,360.9709656,356.9898712,658.2972973,429.75,1271,236.6852886,2542,-587264,63488,-523776,-1
7067,1221,17,13,0.147321429,0.852678571,2400.137163,2246.522587,4035.517193,4775.279279,8288,179.3163133,16576,-3618304,625152,-2993152,-1
9279,657,18,12,0.0661231884,0.933876812,2853.401968,3066.51829,4979.413083,4814.371385,9936,832.160804,19872,-4750848,336384,-4414464,-1
5710,801,20,10,0.123022577,0.876977423,1852.055431,2058.858405,3234.974256,3405.883895,6511,200.7708912,13022,-2923520,410112,-2513408,-1
6134,1039,19,11,0.144848738,0.855151262,1984.313225,2133.656134,3376.707532,4828.514918,7173,137.5983119,14346,-3140608,531968,-2608640,-1
3885,191,20,10,0.0468596663,0.953140334,1162.247102,1430.403008,2045.801802,1889.979058,4076,135.0115932,8152,-1989120,97792,-1891328,-1
2814,449,20,10,0.137603432,0.862396568,931.6932771,957.7595172,1587.457356,1911.160356,3263,210.2448454,6526,-1440768,229888,-1210880,-1
6082,390,16,14,0.0602595797,0.93974042,1851.077571,2051.781155,3269.394771,2723.510256,6472,307.6045627,12944,-3113984,199680,-2914304,-1
39,18,20,10,0.315789474,0.684210526,16.67096591,15.63827214,30.23076923,26.33333333,57,2.234417875,114,-19968,9216,-10752,-1
8630,479,27,3,0.0525853551,0.947414645,2625.32776,2674.915541,4576.493627,4167.755741,9109,193.561411,18218,-4418560,245248,-4173312,-1
5204,279,17,13,0.0508845523,0.949115448,1572.112758,1755.412202,2754.029785,2517.616487,5483,101.1810297,10966,-2664448,142848,-2521600,-1
3050,286,21,9,0.0857314149,0.914268585,952.214425,1065.287642,1658.169508,1778.667832,3336,156.7669173,6672,-1561600,146432,-1415168,-1
9529,442,16,14,0.0443285528,0.955671447,2849.842745,3110.788058,5052.213139,3558.522624,9971,460.767098,19942,-4878848,226304,-4652544,-1
4360,457,20,10,0.0948723272,0.905127673,1368.721479,1538.479148,2371.516972,2766.606127,4817,169.9118166,9634,-2232320,233984,-1998336,-1
59,16,24,6,0.213333333,0.786666667,22.44089559,17.17726968,39.61016949,32.0625,75,2.254960914,150,-30208,8192,-22016,-1
8631,539,22,8,0.058778626,0.941221374,2647.692056,2550.494176,4626.435407,3930.001855,9170,191.2010008,18340,-4419072,275968,-4143104,-1
87,18,27,3,0.171428571,0.828571429,29.49687771,33.03911823,51.51724138,60.16666667,105,23.2300885,210,-44544,9216,-35328,-1
2165,174,21,9,0.0743907653,0.925609235,675.8549362,662.7592943,1175.907159,1096.5,2339,94.50505051,4678,-1108480,89088,-1019392,-1
752,47,21,9,0.0588235294,0.941176471,227.8840554,243.8453432,407.1848404,285.0425532,799,61.22605364,1598,-385024,24064,-360960,-1
7687,541,19,11,0.0657510938,0.934248906,2329.073143,2925.450688,4086.624821,4510.574861,8228,189.9792196,16456,-3935744,276992,-3658752,-1
1487,151,22,8,0.0921855922,0.907814408,472.7996824,389.563542,845.5144586,563.3178808,1638,77.74086379,3276,-761344,77312,-684032,-1
5897,462,25,5,0.0726529329,0.927347067,1810.91581,2125.961693,3175.917755,3232.106061,6359,117.6720947,12718,-3019264,236544,-2782720,-1
8021,703,22,8,0.0805823017,0.919417698,2499.921489,2718.854157,4354.835183,4449.953058,8724,225.3681219,17448,-4106752,359936,-3746816,-1
7100,711,22,8,0.0910254769,0.908974523,2234.738666,2293.817618,3824.764085,4717.216596,7811,185.931921,15622,-3635200,364032,-3271168,-1
7077,568,21,9,0.0742969261,0.925703074,2157.325726,2725.345861,3794.12477,4182.771127,7645,223.8653001,15290,-3623424,290816,-3332608,-1
3475,287,22,8,0.0762892079,0.923710792,1071.905053,1202.853259,1906.688058,1576.522648,3762,240.5370844,7524,-1779200,146944,-1632256,-1
3013,372,20,10,0.109896603,0.890103397,975.1341592,988.9529276,1681.985397,1782.212366,3385,308.5688241,6770,-1542656,190464,-1352192,-1
7603,753,25,5,0.0901148875,0.909885112,2427.366614,2121.278679,4250.20755,3454.472776,8356,198.4326763,16712,-3892736,385536,-3507200,-1
6510,939,18,12,0.126057189,0.873942811,2101.362593,2454.270064,3696.635945,3921.645367,7449,161.5134432,14898,-3333120,480768,-2852352,-1
9136,793,22,8,0.0798670561,0.920132944,2815.54519,3353.954972,5009.514886,4452.152585,9929,487.4324988,19858,-4677632,406016,-4271616,-1
4893,322,22,8,0.0617449664,0.938255034,1501.230001,1522.158403,2632.001226,2243.285714,5215,151.5107496,10430,-2505216,164864,-2340352,-1
8978,920,20,10,0.0929480703,0.90705193,2840.630709,2958.732862,4892.815772,5502.66413,9898,458.665431,19796,-4596736,471040,-4125696,-1
58,16,23,7,0.216216216,0.783783784,22.12694431,17.04027857,39.13793103,31.5625,74,2.217560683,148,-29696,8192,-21504,-1
9359,589,20,10,0.059207881,0.940792119,2860.329317,3041.659208,4963.159739,5154.692699,9948,597.4774775,19896,-4791808,301568,-4490240,-1
7379,467,21,9,0.0595207749,0.940479225,2240.101204,2617.949326,3910.510096,4128.751606,7846,190.9002433,15692,-3778048,239104,-3538944,-1
9244,693,20,10,0.069739358,0.930260642,2819.549201,3436.996007,4995.542298,4614.949495,9937,576.7266396,19874,-4732928,354816,-4378112,-1
904,104,16,14,0.103174603,0.896825397,278.5920541,357.3307224,519.2544248,376.25,1008,96.45933014,2016,-462848,53248,-409600,-1
2321,259,27,3,0.100387597,0.899612403,731.0563544,853.3069682,1280.978027,1375.830116,2580,73.54618016,5160,-1188352,132608,-1055744,-1
7710,713,20,10,0.0846491749,0.915350825,2374.508242,2978.966325,4210.22607,4231.182328,8423,253.3995187,16846,-3947520,365056,-3582464,-1
2345,301,19,11,0.113756614,0.886243386,747.8241766,878.6254652,1323.882729,1320.518272,2646,74.17998318,5292,-1200640,154112,-1046528,-1
4745,458,19,11,0.0880261388,0.911973861,1474.452962,1749.117678,2621.609905,2398.836245,5203,99.92318033,10406,-2429440,234496,-2194944,-1
458,89,24,6,0.162705667,0.837294333,153.4107251,171.3564677,264.639738,322.1685393,547,19.64093357,1094,-234496,45568,-188928,-1
9243,690,20,10,0.0694654183,0.930534582,2832.662982,3104.189427,4886.836958,6040.836232,9933,373.1404959,19866,-4732416,353280,-4379136,-1
4087,946,21,9,0.187959468,0.812040532,1433.794136,1477.415694,2431.897969,2884.665962,5033,99.94042891,10066,-2092544,484352,-1608192,-1
9455,517,20,10,0.0518451665,0.948154834,2847.83628,3219.705784,5043.577684,3942.651838,9972,605.0970874,19944,-4840960,264704,-4576256,-1
2504,222,27,3,0.0814380044,0.918561996,783.8729078,689.774154,1401.271965,937.4594595,2726,423.9502333,5452,-1282048,113664,-1168384,-1
1107,190,27,3,0.146491904,0.853508096,371.3246429,391.909678,649.2764228,647.3894737,1297,35.1681128,2594,-566784,97280,-469504,-1
7739,554,21,9,0.0668033281,0.933196672,2337.503503,2928.569156,4212.153637,3236.848375,8293,199.398894,16586,-3962368,283648,-3678720,-1
4547,363,21,9,0.0739307536,0.926069246,1404.147497,1542.744963,2479.445569,2155.553719,4910,354.001442,9820,-2328064,185856,-2142208,-1
683,64,20,10,0.0856760375,0.914323963,213.9940822,228.5454852,377.8169839,333.265625,747,16.5926255,1494,-349696,32768,-316928,-1
2023,187,25,5,0.0846153846,0.915384615,632.6865791,565.8173967,1140.822046,723.3796791,2210,315.7142857,4420,-1035776,95744,-940032,-1
5758,547,20,10,0.0867565424,0.913243458,1794.332232,1986.461241,3206.477249,2590.071298,6305,127.0913122,12610,-2948096,280064,-2668032,-1
613,46,17,13,0.0698027314,0.930197269,184.8849134,190.3834319,341.8254486,172.4130435,659,65.18298714,1318,-313856,23552,-290304,-1
3137,312,26,4,0.0904610032,0.909538997,973.7317315,1097.539297,1769.542875,1277.144231,3449,133.993784,6898,-1606144,159744,-1446400,-1
2023,189,21,9,0.085443038,0.914556962,621.0850049,801.9159447,1105.430549,1117.94709,2212,193.0191972,4424,-1035776,96768,-939008,-1
9530,441,22,8,0.044228262,0.955771738,2874.183826,2898.383352,5014.827912,4363.029478,9971,469.0028222,19942,-4879360,225792,-4653568,-1
2225,176,21,9,0.0733027905,0.926697209,688.4248729,749.7879927,1201.396404,1195.988636,2401,230.6436119,4802,-1139200,90112,-1049088,-1
6788,580,20,10,0.0787187839,0.921281216,2083.391797,2538.589419,3645.486889,4141.087931,7368,152.9900332,14736,-3475456,296960,-3178496,-1
9485,369,20,10,0.0374467221,0.962553278,2834.581545,3065.197607,4942.745387,4535.623306,9854,817.0812604,19708,-4856320,188928,-4667392,-1
9435,527,27,3,0.0529010239,0.947098976,2864.094734,2972.329663,5024.862639,4205.16888,9962,633.7150127,19924,-4830720,269824,-4560896,-1
4831,245,27,3,0.0482663515,0.951733649,1456.269472,1628.729579,2532.342786,2659.910204,5076,124.9938439,10152,-2473472,125440,-2348032,-1
3108,267,21,9,0.0791111111,0.920888889,972.4630241,972.9618494,1705.234556,1487.382022,3375,82.65980896,6750,-1591296,136704,-1454592,-1
1352,137,20,10,0.0920080591,0.907991941,424.3468337,480.021396,742.5939349,768.7445255,1489,126.1864407,2978,-692224,70144,-622080,-1
1117,103,23,7,0.0844262295,0.91557377,345.855029,330.2527306,632.6239928,370.5728155,1220,66.95938529,2440,-571904,52736,-519168,-1
323,16,24,6,0.0471976401,0.95280236,96.21405958,116.6570829,172.377709,122,339,41.95544554,678,-165376,8192,-157184,-1
954,108,27,3,0.101694915,0.898305085,300.8415652,323.7992299,546.6331237,397.8240741,1062,203.4482759,2124,-488448,55296,-433152,-1
7362,1209,20,10,0.141057053,0.858942947,2413.987074,2564.914329,4110.054876,5357.387924,8571,185.4392038,17142,-3769344,619008,-3150336,-1
5297,414,21,9,0.0724916827,0.927508317,1616.570147,1664.600226,2941.364735,1763.785024,5711,541.8406072,11422,-2712064,211968,-2500096,-1
8417,423,27,3,0.0478506787,0.952149321,2536.754511,2587.425653,4477.471664,3286.858156,8840,245.6920511,17680,-4309504,216576,-4092928,-1
5158,635,16,14,0.109615053,0.890384947,1640.07987,1913.058405,2903.926522,2840.737008,5793,113.255132,11586,-2640896,325120,-2315776,-1
2899,169,20,10,0.0550847458,0.944915254,869.1197993,1031.238227,1560.998965,1079.940828,3068,226.5878877,6136,-1484288,86528,-1397760,-1
5452,502,21,9,0.0843130668,0.915686933,1676.416281,2098.828382,3006.841159,2658.838645,5954,143.5736677,11908,-2791424,257024,-2534400,-1
9323,624,21,9,0.0627324822,0.937267518,2853.57902,2986.300847,5033.95066,4078.294872,9947,1048.155954,19894,-4773376,319488,-4453888,-1
3484,217,17,13,0.0586328019,0.941367198,1047.1051,1360.948995,1844.354765,1957.691244,3701,68.25894504,7402,-1783808,111104,-1672704,-1
2919,302,19,11,0.093759702,0.906240298,922.2238253,976.5161431,1589.645084,1817.407285,3221,67.89629005,6442,-1494528,154624,-1339904,-1
3255,251,19,11,0.0715915573,0.928408443,996.1221637,986.5161099,1804.280492,1094.972112,3506,148.748409,7012,-1666560,128512,-1538048,-1
1423,154,19,11,0.097653773,0.902346227,441.471997,565.7105125,792.7069571,754.7467532,1577,54.51088835,3154,-728576,78848,-649728,-1
48,32,22,8,0.4,0.6,22.45519265,23.14355252,37.1875,45.46875,80,3.598740441,160,-24576,16384,-8192,-1
6311,383,22,8,0.0572154168,0.942784583,1907.094414,2289.020979,3329.341467,3646.712794,6694,231.3861044,13388,-3231232,196096,-3035136,-1
4547,310,20,10,0.0638254066,0.936174593,1389.753132,1483.881358,2463.23664,1926.825806,4857,423.0836237,9714,-2328064,158720,-2169344,-1
3544,170,20,10,0.0457727518,0.954227248,1067.857331,1125.862535,1870.156038,1593.658824,3714,73.39920949,7428,-1814528,87040,-1727488,-1
470,106,16,14,0.184027778,0.815972222,165.2282779,162.2605704,299.3957447,240.1886792,576,16.5232358,1152,-240640,54272,-186368,-1
9572,405,20,10,0.0405933647,0.959406635,2869.598322,3020.885982,5021.047952,4231.560494,9977,1106.097561,19954,-4900864,207360,-4693504,-1
1866,127,18,12,0.0637230306,0.936276969,562.1748221,741.9074349,998.3724544,976.8346457,1993,97.36199316,3986,-955392,65024,-890368,-1
8936,943,22,8,0.0954550056,0.904544994,2830.192136,2941.771694,4859.49004,5702.923648,9879,454.2068966,19758,-4575232,482816,-4092416,-1
1681,148,26,4,0.0809185347,0.919081465,527.6889864,434.2521566,940.845925,621.4391892,1829,128.531272,3658,-860672,75776,-784896,-1
2781,360,19,11,0.114613181,0.885386819,895.0905772,977.226547,1550.194894,1731.719444,3141,100.7376523,6282,-1423872,184320,-1239552,-1
80,15,20,10,0.157894737,0.842105263,26.70538335,12.82636174,52.85,22.13333333,95,9.047619048,190,-40960,7680,-33280,-1
8691,712,20,10,0.0757205147,0.924279485,2688.997594,3004.828374,4711.743528,4583.066011,9403,188.4368737,18806,-4449792,364544,-4085248,-1
3998,618,21,9,0.133882149,0.866117851,1327.066726,1367.301895,2308.068034,2311.294498,4616,89.98050682,9232,-2046976,316416,-1730560,-1
2726,256,20,10,0.0858484239,0.914151576,851.1166372,949.7239232,1480.104549,1612.84375,2982,112.2318404,5964,-1395712,131072,-1264640,-1
2697,255,27,3,0.0863821138,0.913617886,850.4659354,848.4670927,1459.124954,1660.266667,2952,236.7281476,5904,-1380864,130560,-1250304,-1
6008,328,17,13,0.0517676768,0.948232323,1815.701739,2045.909629,3180.448402,2949.640244,6336,227.4228284,12672,-3076096,167936,-2908160,-1
4258,390,16,14,0.0839070568,0.916092943,1310.946224,1628.434444,2342.25458,2130.65641,4648,160.1102308,9296,-2180096,199680,-1980416,-1
3857,440,22,8,0.102397021,0.897602979,1232.34989,1298.330087,2130.811252,2308.440909,4297,122.4565403,8594,-1974784,225280,-1749504,-1
6407,389,21,9,0.0572395527,0.942760447,1953.660611,2079.761511,3385.234431,3616.989717,6796,250.4053058,13592,-3280384,199168,-3081216,-1
117,28,19,11,0.193103448,0.806896552,40.03162421,37.87425489,79.5982906,45.42857143,145,16.88009313,290,-59904,14336,-45568,-1
6395,593,22,8,0.0848597596,0.91514024,1986.338739,2289.616321,3458.782955,3879.677909,6988,260.551827,13976,-3274240,303616,-2970624,-1
9620,364,19,11,0.0364583333,0.963541667,2876.529035,2997.71641,5007.957277,4583.986264,9984,772.1577726,19968,-4925440,186368,-4739072,-1
9520,456,16,14,0.0457097033,0.954290297,2856.992993,3098.39055,5044.409454,3821.267544,9976,1153.294798,19952,-4874240,233472,-4640768,-1
9342,612,25,5,0.061482821,0.938517179,2850.696565,2786.052726,5077.541961,3450.388889,9954,701.4799154,19908,-4783104,313344,-4469760,-1
1150,155,18,12,0.118773946,0.881226054,358.7215335,442.5234777,679.6321739,455.4064516,1305,48.89471712,2610,-588800,79360,-509440,-1
3163,385,20,10,0.108511838,0.891488162,1008.333109,908.4640263,1854.86595,1114.246753,3548,81.93995381,7096,-1619456,197120,-1422336,-1
9277,660,20,10,0.0664184361,0.933581564,2863.518152,2722.718771,5044.990945,3900.866667,9937,927.8244631,19874,-4749824,337920,-4411904,-1
3507,209,21,9,0.0562432723,0.943756728,1062.553736,1120.734768,1887.953236,1364.277512,3716,257.1626298,7432,-1795584,107008,-1688576,-1
547,46,20,10,0.0775716695,0.922428331,167.5287303,168.838129,307.0621572,177.3478261,593,64.59694989,1186,-280064,23552,-256512,-1
502,49,15,15,0.0889292196,0.91107078,153.100954,170.3695471,287.5358566,157.8163265,551,158.7896254,1102,-257024,25088,-231936,-1
9564,418,21,9,0.0418753757,0.958124624,2864.345855,3052.918675,5039.244668,3899.083732,9982,752.7903469,19964,-4896768,214016,-4682752,-1
1251,198,20,10,0.136645963,0.863354037,414.9119269,394.7173216,753.2685851,546.3939394,1449,55.60245587,2898,-640512,101376,-539136,-1
767,92,21,9,0.107101281,0.892898719,243.5816235,281.8874786,430.5136897,425.7173913,859,58.55487389,1718,-392704,47104,-345600,-1
9583,394,27,3,0.0394908289,0.960509171,2872.522269,3048.082957,4999.363039,4736.946701,9977,431.5311419,19954,-4906496,201728,-4704768,-1
2605,194,19,11,0.069310468,0.930689532,808.7588791,792.1487005,1406.788484,1308.845361,2799,187.2240803,5598,-1333760,99328,-1234432,-1
1384,206,22,8,0.129559748,0.870440252,440.8825071,558.7750992,807.8735549,712.368932,1590,157.2700297,3180,-708608,105472,-603136,-1
9402,561,20,10,0.0563083409,0.943691659,2854.252012,3052.165771,5041.435546,3985.898396,9963,1058.767269,19926,-4813824,287232,-4526592,-1
7862,703,20,10,0.0820782253,0.917921775,2426.442528,2938.463124,4287.025057,4237.985775,8565,340.9633758,17130,-4025344,359936,-3665408,-1
2409,262,22,8,0.0980906028,0.901909397,764.2848335,802.7556338,1358.061851,1133.148855,2671,251.2699906,5342,-1233408,134144,-1099264,-1
3275,231,20,10,0.0658870508,0.934112949,999.6517842,1085.431865,1784.068702,1320.112554,3506,309.1710758,7012,-1676800,118272,-1558528,-1
2048,193,17,13,0.0861222668,0.913877733,636.1669588,731.9387654,1136.39209,957.6683938,2241,86.25866051,4482,-1048576,98816,-949760,-1
64,22,20,10,0.255813953,0.744186047,24.32373917,25.43976844,45.390625,38,86,16.8297456,172,-32768,11264,-21504,-1
3881,198,20,10,0.0485413091,0.951458691,1164.870121,1402.360445,2040.345014,2033.237374,4079,312.3277182,8158,-1987072,101376,-1885696,-1
3520,265,23,7,0.07001321,0.92998679,1079.30573,1193.06522,1921.583523,1513.324528,3785,94.15422886,7570,-1802240,135680,-1666560,-1
2565,184,21,9,0.0669334303,0.93306657,782.1483462,889.3893577,1395.738791,1085.896739,2749,93.40808699,5498,-1313280,94208,-1219072,-1
9187,738,21,9,0.0743576826,0.925642317,2818.766219,3232.072663,5041.852618,3981.402439,9925,902.2727273,19850,-4703744,377856,-4325888,-1
4825,512,22,8,0.0959340453,0.904065955,1531.594827,1622.821862,2674.059067,2621.324219,5337,226.431905,10674,-2470400,262144,-2208256,-1
9546,433,20,10,0.0433911214,0.956608879,2855.311869,3102.776304,5050.833857,3648.845266,9979,815.944399,19958,-4887552,221696,-4665856,-1
2060,191,21,9,0.0848511773,0.915148823,635.1397631,746.7663631,1149.106796,876.7853403,2251,40.6097781,4502,-1054720,97792,-956928,-1
3992,440,18,12,0.0992779783,0.900722022,1266.731368,1380.540624,2200.351202,2363.013636,4432,99.52840781,8864,-2043904,225280,-1818624,-1
2942,221,25,5,0.0698703762,0.930129624,898.877986,885.036604,1627.415704,977.4162896,3163,119.7199092,6326,-1506304,113152,-1393152,-1
7076,667,21,9,0.0861423221,0.913857678,2206.458048,2494.78378,3839.874647,4212.808096,7743,260.7948804,15486,-3622912,341504,-3281408,-1
232,50,24,6,0.177304965,0.822695035,80.47575354,81.25201536,146.7586207,117.1,282,19.35483871,564,-118784,25600,-93184,-1
9382,593,19,11,0.0594486216,0.940551378,2861.053194,2773.105892,5080.561501,3523.561551,9975,792.2954726,19950,-4803584,303616,-4499968,-1
5150,473,21,9,0.0841187978,0.915881202,1587.466503,1947.932924,2785.590874,3099.541226,5623,391.8466899,11246,-2636800,242176,-2394624,-1
645,91,18,12,0.123641304,0.876358696,210.5008767,192.4512827,384.1224806,257.7692308,736,69.30320151,1472,-330240,46592,-283648,-1
171,49,27,3,0.222727273,0.777272727,65.14578884,56.80038775,112.6374269,103.0408163,220,9.306260575,440,-87552,25088,-62464,-1
9354,595,17,13,0.0598050055,0.940194994,2856.487954,2987.335633,5027.479153,4149.97479,9949,240.6627963,19898,-4789248,304640,-4484608,-1
3954,317,22,8,0.0742214938,0.925778506,1201.167155,1491.594846,2096.69221,2626.293375,4271,83.23913467,8542,-2024448,162304,-1862144,-1
94,24,19,11,0.203389831,0.796610169,33.60754647,22.45145225,65.85106383,34.625,118,31.97831978,236,-48128,12288,-35840,-1
3175,156,21,9,0.0468327829,0.953167217,953.6215545,1091.794203,1675.913071,1464.24359,3331,156.826742,6662,-1625600,79872,-1545728,-1
38,16,20,10,0.296296296,0.703703704,15.5538783,15.34550015,28.60526316,24.875,54,1.962922574,108,-19456,8192,-11264,-1
3592,388,21,9,0.0974874372,0.902512563,1138.233164,1211.30718,2019.378898,1723.146907,3980,247.3586078,7960,-1839104,198656,-1640448,-1
6245,1494,22,8,0.193048197,0.806951803,2015.520502,1865.722651,3370.978863,5955.935074,7739,188.0680437,15478,-3197440,764928,-2432512,-1
9099,306,27,3,0.0325358852,0.967464115,2707.40711,2892.376302,4718.791516,4233.434641,9405,770.2702703,18810,-4658688,156672,-4502016,-1
9528,444,20,10,0.0445246691,0.955475331,2858.846129,3140.861169,5028.798594,4078.795045,9972,541.0743353,19944,-4878336,227328,-4651008,-1
9481,491,21,9,0.049237866,0.950762134,2851.807822,3256.503769,5027.340681,4197.88391,9972,1238.757764,19944,-4854272,251392,-4602880,-1
7686,714,25,5,0.085,0.915,2415.283624,2524.818771,4206.672782,4134.051821,8400,154.3550165,16800,-3935232,365568,-3569664,-1
9409,539,21,9,0.0541817451,0.945818255,2850.37595,3078.427824,5027.476246,4049.725417,9948,832.4686192,19896,-4817408,275968,-4541440,-1
6537,714,21,9,0.0984691767,0.901530823,2098.601735,2042.776224,3623.594921,3648.019608,7251,253.0006978,14502,-3346944,365568,-2981376,-1
5358,397,21,9,0.0689834926,0.931016507,1619.768265,2106.044185,2848.974431,3269.735516,5755,139.8881867,11510,-2743296,203264,-2540032,-1
3329,210,21,9,0.0593387963,0.940661204,1013.277736,1141.795297,1775.855212,1677.180952,3539,228.7653523,7078,-1704448,107520,-1596928,-1
9386,559,18,12,0.0562091503,0.94379085,2868.852032,2904.56866,4972.025037,4989.370304,9945,649.151436,19890,-4805632,286208,-4519424,-1
3206,197,21,9,0.057890097,0.942109903,967.0665708,1152.675297,1722.798503,1363.522843,3403,216.8897387,6806,-1641472,100864,-1540608,-1
3362,165,21,9,0.0467819677,0.953218032,1013.043646,1051.173219,1782.1395,1394.393939,3527,87.32359495,7054,-1721344,84480,-1636864,-1
6521,461,22,8,0.0660269264,0.933973074,1995.467694,2261.197298,3511.721975,3205.453362,6982,129.3681675,13964,-3338752,236032,-3102720,-1
8536,580,19,11,0.0636243967,0.936375603,2590.930679,3169.532827,4561.565487,4513.384483,9116,325.10699,18232,-4370432,296960,-4073472,-1
1270,132,24,6,0.0941512126,0.905848787,397.0794589,466.9647368,708.2850394,636.219697,1402,108.8509317,2804,-650240,67584,-582656,-1
2049,205,22,8,0.0909494232,0.909050577,645.5388752,699.2373139,1130.469497,1097.819512,2254,152.2972973,4508,-1049088,104960,-944128,-1
686,178,23,7,0.206018519,0.793981481,250.9250162,243.200972,435.3294461,421.5955056,864,19.96303142,1728,-351232,91136,-260096,-1
303,33,20,10,0.0982142857,0.901785714,93.94295275,87.01480195,177.2673267,88,336,43.35483871,672,-155136,16896,-138240,-1
9215,719,19,11,0.0723776928,0.927622307,2841.067995,2974.051655,5054.07325,3857.941586,9934,585.041225,19868,-4718080,368128,-4349952,-1
3198,222,21,9,0.0649122807,0.935087719,975.6208048,1141.55027,1712.544403,1681.04955,3420,263.8888889,6840,-1637376,113664,-1523712,-1
1365,153,18,12,0.100790514,0.899209486,431.3496213,377.2773545,793.5956044,455.3137255,1518,97.05882353,3036,-698880,78336,-620544,-1
67,19,20,10,0.220930233,0.779069767,25.37294118,19.05495769,46.62686567,32.47368421,86,20.09345794,172,-34304,9728,-24576,-1
3764,750,20,10,0.166149756,0.833850244,1161.762336,1259.951971,2009.440489,3502.428,4514,117.7360459,9028,-1927168,384000,-1543168,-1
9567,403,20,10,0.0404212638,0.959578736,2859.615334,3286.042428,4983.694366,5028.364764,9970,1167.447307,19940,-4898304,206336,-4691968,-1
2872,144,21,9,0.0477453581,0.952254642,861.9685711,1025.185901,1512.537256,1427.979167,3016,143.4141702,6032,-1470464,73728,-1396736,-1
1307,117,20,10,0.0821629213,0.917837079,402.4533697,490.9708505,719.2884468,636.6666667,1424,126.129318,2848,-669184,59904,-609280,-1
790,167,21,9,0.174503657,0.825496343,262.178139,331.2820883,488.4987342,434.0658683,957,38.55761483,1914,-404480,85504,-318976,-1
3698,302,22,8,0.0755,0.9245,1133.889506,1381.136966,2007.948621,1909.291391,4000,108.8435374,8000,-1893376,154624,-1738752,-1
2054,234,22,8,0.102272727,0.897727273,651.1482347,585.4979001,1192.890458,719.7393162,2288,42.95100432,4576,-1051648,119808,-931840,-1
9486,483,22,8,0.0484501956,0.951549804,2850.768451,3178.331443,5039.893844,3906.898551,9969,785.5791962,19938,-4856832,247296,-4609536,-1
8487,763,20,10,0.0824864865,0.917513514,2667.072402,2692.851481,4647.808295,4377.360419,9250,322.7494766,18500,-4345344,390656,-3954688,-1
9279,671,19,11,0.0674371859,0.932562814,2813.535853,3568.706688,4949.709128,5332.152012,9950,236.9047619,19900,-4750848,343552,-4407296,-1
6147,317,20,10,0.0490408416,0.950959158,1862.973463,1923.425683,3234.037905,3202.678233,6464,153.4662868,12928,-3147264,162304,-2984960,-1
477,88,23,7,0.155752212,0.844247788,164.5774862,152.7006162,287.3626834,259.3522727,565,12.49447147,1130,-244224,45056,-199168,-1
2901,227,22,8,0.0725703325,0.927429668,883.9801401,1117.224791,1562.148225,1594.555066,3128,116.7164179,6256,-1485312,116224,-1369088,-1
331,83,25,5,0.200483092,0.799516908,118.7791325,115.8419632,198.6465257,242.8072289,414,14.39499305,828,-169472,42496,-126976,-1
4485,294,21,9,0.0615191463,0.938480854,1369.086996,1334.920356,2437.570123,1664.312925,4779,206.2580924,9558,-2296320,150528,-2145792,-1
515,102,21,9,0.165316045,0.834683955,168.9311507,217.6876265,312.7242718,290.1960784,617,55.53555356,1234,-263680,52224,-211456,-1
5946,300,20,10,0.0480307397,0.95196926,1784.541703,2135.05787,3118.65523,3219.523333,6246,247.7588259,12492,-3044352,153600,-2890752,-1
9449,514,19,11,0.0515908863,0.948409114,2854.54909,3142.453044,5025.167108,4188.447471,9963,883.2446809,19926,-4837888,263168,-4574720,-1
4052,239,22,8,0.0556979725,0.944302027,1225.388328,1442.389793,2140.205577,2244.238494,4291,108.0856423,8582,-2074624,122368,-1952256,-1
1498,169,21,9,0.101379724,0.898620276,472.927542,549.2563254,834.6448598,828.2840237,1667,117.3117523,3334,-766976,86528,-680448,-1
5586,1008,21,9,0.152866242,0.847133758,1931.035433,1633.27515,3196.309882,3858.261905,6594,312.5118483,13188,-2860032,516096,-2343936,-1
2717,381,20,10,0.122982569,0.877017431,892.0804767,864.5016644,1586.854251,1283.11811,3098,71.71296296,6196,-1391104,195072,-1196032,-1
5963,647,20,10,0.097881997,0.902118003,1889.741719,1984.039007,3244.646654,3866.347759,6610,124.6464266,13220,-3053056,331264,-2721792,-1
72,28,19,11,0.28,0.72,29.98657107,20.45789604,55.66666667,37.21428571,100,18.86792453,200,-36864,14336,-22528,-1
2419,256,27,3,0.0957009346,0.904299065,762.0872117,806.236143,1368.687888,1048.023438,2675,147.2206935,5350,-1238528,131072,-1107456,-1
9420,558,21,9,0.0559230307,0.944076969,2875.659968,2924.539968,4963.477601,5428.802867,9978,787.5295975,19956,-4823040,285696,-4537344,-1
66,15,22,8,0.185185185,0.814814815,21.09972386,31.31389468,40.27272727,44.2,81,13.27868852,162,-33792,7680,-26112,-1
577,45,24,6,0.0723472669,0.927652733,180.0355593,164.4887028,315.5944541,259,622,37.74271845,1244,-295424,23040,-272384,-1
132,22,23,7,0.142857143,0.857142857,44.22454496,32.48448454,82.48484848,47.59090909,154,15.87628866,308,-67584,11264,-56320,-1
2949,157,26,4,0.0505473278,0.949452672,887.9263389,921.3853634,1579.258732,1069.66242,3106,114.781966,6212,-1509888,80384,-1429504,-1
9396,549,21,9,0.0552036199,0.94479638,2846.711435,3108.339769,5028.197637,4028.306011,9945,750,19890,-4810752,281088,-4529664,-1
849,39,21,9,0.0439189189,0.956081081,253.3042044,283.2557499,450.7232038,309.025641,888,131.3609467,1776,-434688,19968,-414720,-1
5586,433,20,10,0.0719388603,0.92806114,1708.865405,2065.063326,3022.771035,2845.244804,6019,263.6443276,12038,-2860032,221696,-2638336,-1
1036,163,16,14,0.135946622,0.864053378,332.8579386,403.8329582,617.2779923,490.1840491,1199,81.78717599,2398,-530432,83456,-446976,-1
9435,524,21,9,0.0526157245,0.947384276,2856.949969,3178.948172,4986.304505,4866.482824,9959,593.5041716,19918,-4830720,268288,-4562432,-1
2730,265,19,11,0.0884808013,0.911519199,845.0295986,1043.247683,1492.519414,1554.460377,2995,258.6355786,5990,-1397760,135680,-1262080,-1
201,34,20,10,0.144680851,0.855319149,65.71255773,76.58884521,121.1840796,99.17647059,235,4.542818481,470,-102912,17408,-85504,-1
2134,157,23,7,0.0685290266,0.931470973,653.814529,740.4357802,1156.985005,996.6878981,2291,102.0035619,4582,-1092608,80384,-1012224,-1
9596,382,20,10,0.0382842253,0.961715775,2870.071274,3030.482782,5019.864527,4226.730366,9978,1004.833837,19956,-4913152,195584,-4717568,-1
107,22,20,10,0.170542636,0.829457364,36.33294616,37.67170058,68.19626168,49.45454545,129,9.750566893,258,-54784,11264,-43520,-1
8875,1022,20,10,0.103263615,0.896736385,2862.331586,2710.411929,4867.959437,5652.752446,9897,297.7436823,19794,-4544000,523264,-4020736,-1
8219,1628,21,9,0.165329542,0.834670458,2853.051446,2335.649474,4648.123494,6316.769656,9847,292.1091664,19694,-4208128,833536,-3374592,-1
4711,795,18,12,0.14438794,0.85561206,1544.488569,1691.45521,2643.100403,3407.704403,5506,103.6325993,11012,-2412032,407040,-2004992,-1
9147,808,20,10,0.0811652436,0.918834756,2829.192681,3255.031717,4915.741555,5682.799505,9955,683.7225275,19910,-4683264,413696,-4269568,-1
9226,707,18,12,0.0711768851,0.928823115,2826.120304,3080.570259,5066.081509,3674.035361,9933,977.6574803,19866,-4723712,361984,-4361728,-1
2858,293,20,10,0.0929863535,0.907013646,886.9537824,1086.70756,1596.385234,1377.156997,3151,61.3393031,6302,-1463296,150016,-1313280,-1
9261,689,21,9,0.0692462312,0.930753769,2859.076111,3009.797055,5008.502214,4531.910015,9950,569.8739977,19900,-4741632,352768,-4388864,-1
8554,501,20,10,0.0553285478,0.944671452,2576.634431,2832.061334,4610.875497,3112.996008,9055,178.5643857,18110,-4379648,256512,-4123136,-1
2750,308,21,9,0.100719424,0.899280576,869.8446704,966.9345964,1506.583636,1734.11039,3058,73.8647343,6116,-1408000,157696,-1250304,-1
2570,206,18,12,0.0742074928,0.925792507,785.6402835,947.0721485,1406.834241,1159.76699,2776,332.853717,5552,-1315840,105472,-1210368,-1
9364,578,21,9,0.0581371957,0.941862804,2867.802226,2905.50068,4970.999252,4979.612457,9942,574.6820809,19884,-4794368,295936,-4498432,-1
748,78,20,10,0.0944309927,0.905569007,234.3267129,260.3838102,422.2245989,329.8333333,826,83.35015136,1652,-382976,39936,-343040,-1
107,33,17,13,0.235714286,0.764285714,39.12291079,38.77478472,76.29906542,51.6969697,140,22.58064516,280,-54784,16896,-37888,-1
9507,458,20,10,0.045960863,0.954039137,2867.427963,3020.19242,5006.660776,4491.858079,9965,992.5298805,19930,-4867584,234496,-4633088,-1
442,80,18,12,0.153256705,0.846743295,144.5005615,153.4296617,277.5248869,172.9625,522,40.49650892,1044,-226304,40960,-185344,-1
263,32,20,10,0.108474576,0.891525424,82.02386507,65.54577807,157.7908745,67.53125,295,43.06569343,590,-134656,16384,-118272,-1
9593,389,25,5,0.0389701463,0.961029854,2875.753142,2989.032042,5008.955593,4561.033419,9982,952.480916,19964,-4911616,199168,-4712448,-1
34,24,16,14,0.413793103,0.586206897,17.01820723,16.18636043,30.70588235,27.79166667,58,13.15192744,116,-17408,12288,-5120,-1
9449,515,24,6,0.0516860699,0.94831393,2863.888163,3065.521019,5005.601651,4558.640777,9964,622.3610244,19928,-4837888,263680,-4574208,-1
113,26,18,12,0.18705036,0.81294964,38.01184634,36.95681552,76.43362832,42.03846154,139,15.30837004,278,-57856,13312,-44544,-1
1759,265,20,10,0.130928854,0.869071146,583.2284496,590.1752351,1017.38772,980.0566038,2024,54.14660246,4048,-900608,135680,-764928,-1
9668,319,26,4,0.031941524,0.968058476,2876.608364,3056.783979,5003.364605,4710.184953,9987,1595.367412,19974,-4950016,163328,-4786688,-1
9257,668,25,5,0.0673047859,0.932695214,2867.273108,2830.806784,4973.51453,4817.291916,9925,458.8534443,19850,-4739584,342016,-4397568,-1
2798,174,25,5,0.0585464334,0.941453567,850.0573067,855.9376099,1514.802001,1031.390805,2972,183.7971552,5944,-1432576,89088,-1343488,-1
9463,508,21,9,0.0509477485,0.949052252,2858.849553,2976.494807,5050.323576,3787.783465,9971,907.2793449,19942,-4845056,260096,-4584960,-1
9504,462,19,11,0.0463576159,0.953642384,2853.05043,3282.509829,5010.24537,4433.309524,9966,952.7724665,19932,-4866048,236544,-4629504,-1
9535,437,21,9,0.0438227036,0.956177296,2868.391787,3008.967294,5018.86366,4280.350114,9972,1160.88475,19944,-4881920,223744,-4658176,-1
3223,194,19,11,0.0567749488,0.943225051,983.5540896,1009.816777,1721.605337,1499.582474,3417,375.9075908,6834,-1650176,99328,-1550848,-1
8588,324,21,9,0.0363554758,0.963644524,2565.615104,2702.352868,4475.997555,3939.694444,8912,688.7171561,17824,-4397056,165888,-4231168,-1
6782,447,20,10,0.0618342786,0.938165721,2044.912388,2521.832106,3665.393542,2850.416107,7229,264.9926686,14458,-3472384,228864,-3243520,-1
783,82,20,10,0.0947976879,0.905202312,243.1813441,303.848346,435.6845466,407.3658537,865,22.9321315,1730,-400896,41984,-358912,-1
1421,107,22,8,0.070026178,0.929973822,433.4402551,528.0006245,759.5270936,830.5420561,1528,70.22058824,3056,-727552,54784,-672768,-1
7865,534,21,9,0.0635789975,0.936421003,2398.876277,2760.834097,4181.115321,4478.142322,8399,185.8185841,16798,-4026880,273408,-3753472,-1
8449,425,19,11,0.0478927203,0.95210728,2536.662366,2686.247676,4504.8775,3098.035294,8874,653.460972,17748,-4325888,217600,-4108288,-1
7350,302,27,3,0.0394668061,0.960533194,2195.244387,2365.463484,3861.426395,2976.470199,7652,306.8163593,15304,-3763200,154624,-3608576,-1
9354,573,20,10,0.057721366,0.942278634,2851.594717,2895.730951,5027.524802,3926.982548,9927,304.5092025,19854,-4789248,293376,-4495872,-1
7188,369,20,10,0.0488289004,0.9511711,2160.948557,2478.879217,3808.794519,3198.612466,7557,333.2010582,15114,-3680256,188928,-3491328,-1
9360,591,22,8,0.059391016,0.940608984,2853.921576,2968.741673,5041.18344,3943.65313,9951,582.6112412,19902,-4792320,302592,-4489728,-1
9334,608,21,9,0.0611546972,0.938845303,2840.975107,3186.345432,5021.580887,4202.659539,9942,453.5583942,19884,-4779008,311296,-4467712,-1
40,11,21,9,0.215686275,0.784313725,14.74067502,12.75840349,27.75,19.63636364,51,11.30820399,102,-20480,5632,-14848,-1
8841,657,21,9,0.0691724574,0.930827543,2705.879116,3029.492221,4820.323606,3796.453577,9498,347.6573939,18996,-4526592,336384,-4190208,-1
4092,383,19,11,0.0855865922,0.914413408,1276.223717,1447.135635,2233.479228,2286.300261,4475,106.2440646,8950,-2095104,196096,-1899008,-1
1508,91,19,11,0.0569105691,0.943089431,453.2572109,568.7961835,807.3866048,677.5934066,1599,226.4872521,3198,-772096,46592,-725504,-1
1898,186,21,9,0.0892514395,0.91074856,581.9426956,721.3439128,1016.217597,1310.693548,2084,166.5867306,4168,-971776,95232,-876544,-1
603,90,18,12,0.12987013,0.87012987,191.5773799,242.5869906,355.1276949,292.5444444,693,69.3,1386,-308736,46080,-262656,-1
9385,564,20,10,0.0566891145,0.943310886,2868.835073,2853.238743,5012.495471,4351.072695,9949,563.3635334,19898,-4805120,288768,-4516352,-1
39,16,20,10,0.290909091,0.709090909,16.24289659,14.21212071,29.58974359,24.125,55,6.532066508,110,-19968,8192,-11776,-1
9572,403,21,9,0.0404010025,0.959598997,2866.028747,3097.537719,5018.309131,4268.101737,9975,861.3989637,19950,-4900864,206336,-4694528,-1
4089,370,20,10,0.0829782462,0.917021754,1249.585398,1604.213997,2197.813157,2585.708108,4459,287.6774194,8918,-2093568,189440,-1904128,-1
3959,509,18,12,0.113921218,0.886078782,1271.892959,1420.45062,2240.799697,2185.500982,4468,151.5603799,8936,-2027008,260608,-1766400,-1
108,41,21,9,0.275167785,0.724832215,41.90564799,45.72463685,75.83333333,72.80487805,149,19.32555123,298,-55296,20992,-34304,-1
9483,494,17,13,0.0495138819,0.950486118,2846.883356,3252.578818,5048.419382,3848.364372,9977,730.3806735,19954,-4855296,252928,-4602368,-1
3669,265,20,10,0.0673614642,0.932638536,1128.2221,1187.9697,1990.7577,1645.490566,3934,481.5177479,7868,-1878528,135680,-1742848,-1
3051,388,20,10,0.112823495,0.887176505,980.5737989,1081.700173,1728.01901,1656.943299,3439,74.5017331,6878,-1562112,198656,-1363456,-1
9577,405,21,9,0.0405730315,0.959426969,2870.171395,3031.053682,5025.26313,4193.106173,9982,978.627451,19964,-4903424,207360,-4696064,-1
7506,657,23,7,0.0804851158,0.919514884,2337.308646,2537.600177,4050.573808,4441.033486,8163,212.3016905,16326,-3843072,336384,-3506688,-1
1602,172,21,9,0.0969560316,0.903043968,514.851718,483.5570841,892.2858926,842.9244186,1774,66.56660413,3548,-820224,88064,-732160,-1
5715,366,21,9,0.0601874692,0.939812531,1735.64668,2035.118677,3049.436045,2909.273224,6081,125.3555968,12162,-2926080,187392,-2738688,-1
9599,382,19,11,0.0382727182,0.961727282,2867.444121,3064.447869,5028.179498,4056.743455,9981,440.0793651,19962,-4914688,195584,-4719104,-1
455,99,18,12,0.178700361,0.821299639,149.3622377,191.3377492,289.9428571,220.3131313,554,13.0077483,1108,-232960,50688,-182272,-1
153,24,22,8,0.13559322,0.86440678,49.60517702,57.68724043,91.25490196,74.625,177,8.32157969,354,-78336,12288,-66048,-1
9466,514,19,11,0.051503006,0.948496994,2842.171033,3177.634274,5070.576696,3515.780156,9980,1102.762431,19960,-4846592,263168,-4583424,-1
3376,377,21,9,0.100452971,0.899547029,1067.232479,1218.623309,1877.577607,1871.827586,3753,77.41336634,7506,-1728512,193024,-1535488,-1
9578,394,22,8,0.0395106298,0.96048937,2866.879194,3135.609451,4999.33222,4674.553299,9972,957.0057582,19944,-4903936,201728,-4702208,-1
1136,94,18,12,0.0764227642,0.923577236,349.8500637,333.1915294,634.9022887,381.0212766,1230,171.5481172,2460,-581632,48128,-533504,-1
9527,450,25,5,0.0451037386,0.954896261,2872.880012,2827.848234,5039.1205,3927.893333,9977,884.4858156,19954,-4877824,230400,-4647424,-1
9495,470,17,13,0.0471650778,0.952834922,2865.040717,3075.244638,5002.586309,4587.314894,9965,1152.023121,19930,-4861440,240640,-4620800,-1
9615,364,27,3,0.0364766009,0.963523399,2867.337712,3104.679098,5020.790224,4176.681319,9979,969.776482,19958,-4922880,186368,-4736512,-1
4044,340,23,7,0.0775547445,0.922445255,1234.454909,1456.385777,2141.096439,2803.9,4384,243.0155211,8768,-2070528,174080,-1896448,-1
4736,264,22,8,0.0528,0.9472,1427.594958,1692.448262,2510.161106,2327.185606,5000,263.9915523,10000,-2424832,135168,-2289664,-1
3225,320,22,8,0.0902679831,0.909732017,1013.763541,1076.529079,1745.372403,2051.434375,3545,193.9277899,7090,-1651200,163840,-1487360,-1
8145,645,19,11,0.0733788396,0.92662116,2522.771492,2713.229549,4404.929036,4276.431008,8790,201.4668806,17580,-4170240,330240,-3840000,-1
9455,508,18,12,0.050988658,0.949011342,2859.781934,3076.906645,5020.580539,4263.931102,9963,508.3163265,19926,-4840960,260096,-4580864,-1
7313,353,24,6,0.0460474824,0.953952518,2192.335187,2598.548383,3841.568713,3666.342776,7666,945.2527744,15332,-3744256,180736,-3563520,-1
555,104,20,10,0.157814871,0.842185129,178.8396761,242.135683,329.5207207,332.5576923,659,16.78553235,1318,-284160,53248,-230912,-1
6550,648,21,9,0.0900250069,0.909974993,2057.393263,2269.043542,3584.421832,3751.910494,7198,347.3938224,14396,-3353600,331776,-3021824,-1
2944,301,21,9,0.0927580894,0.907241911,906.8723871,1189.425854,1626.814878,1585.687708,3245,108.7466488,6490,-1507328,154112,-1353216,-1
590,124,20,10,0.173669468,0.826330532,197.4966231,230.211516,372.340678,286.8870968,714,36.04240283,1428,-302080,63488,-238592,-1
76,25,18,12,0.247524752,0.752475248,29.51954843,21.48301655,56.13157895,35.4,101,20.65439673,202,-38912,12800,-26112,-1
9316,638,21,9,0.0640948362,0.935905164,2857.944925,2814.190146,5062.258909,3739.860502,9954,804.6887631,19908,-4769792,326656,-4443136,-1
3819,725,21,9,0.159551056,0.840448944,1293.313011,1278.088283,2171.017806,2807.066207,4544,90.14084507,9088,-1955328,371200,-1584128,-1
4309,261,25,5,0.0571115974,0.942888403,1306.868624,1496.591285,2296.848225,2098.145594,4570,638.2681564,9140,-2206208,133632,-2072576,-1
5352,1463,21,9,0.214673514,0.785326486,1727.626692,2088.905929,3006.519432,4876.710868,6815,161.8764846,13630,-2740224,749056,-1991168,-1
40,18,21,9,0.310344828,0.689655172,15.86960538,18.52925615,29.425,29.66666667,58,2.102973169,116,-20480,9216,-11264,-1
3723,335,27,3,0.0825529818,0.917447018,1170.540388,1162.667769,2047.577491,1828.597015,4058,76.00674284,8116,-1906176,171520,-1734656,-1
2759,168,17,13,0.0573966519,0.942603348,830.2096422,1057.859984,1465.251903,1443.440476,2927,180.6790123,5854,-1412608,86016,-1326592,-1
1742,153,21,9,0.0807387863,0.919261214,528.7805125,723.0349745,948.9305396,937.4052288,1895,34.7706422,3790,-891904,78336,-813568,-1
5725,500,19,11,0.0803212851,0.919678715,1762.48899,2006.721209,3047.642096,3861.348,6225,180.2258251,12450,-2931200,256000,-2675200,-1
64,21,21,9,0.247058824,0.752941176,24.46042722,23.74648798,45,36.9047619,85,9.199134199,170,-32768,10752,-22016,-1
9572,406,16,14,0.0406895169,0.959310483,2863.678411,3093.770936,5030.832428,4015.03202,9978,838.487395,19956,-4900864,207872,-4692992,-1
771,84,19,11,0.098245614,0.901754386,244.4346169,264.2928624,432.4020752,387.5952381,855,93.85290889,1710,-394752,43008,-351744,-1
6917,504,25,5,0.0679153753,0.932084625,2105.692381,2589.045418,3720.408848,3581.871032,7421,238.7709138,14842,-3541504,258048,-3283456,-1
9414,542,20,10,0.0544395339,0.945560466,2851.416564,2937.665226,5055.283726,3644.843173,9956,958.2290664,19912,-4819968,277504,-4542464,-1
53,16,24,6,0.231884058,0.768115942,19.70586488,20.53341408,35.43396226,33.5625,69,37.91208791,138,-27136,8192,-18944,-1
9521,444,21,9,0.0445559458,0.955444054,2859.584373,3220.048362,4986.312992,4911.957207,9965,1200.60241,19930,-4874752,227328,-4647424,-1
9517,457,19,11,0.0458191297,0.95418087,2870.779617,2968.152742,5020.464747,4301.010941,9974,776.7912773,19948,-4872704,233984,-4638720,-1
453,114,26,4,0.201058201,0.798941799,162.5851173,158.4089067,296.5540839,234.1140351,567,16.92537313,1134,-231936,58368,-173568,-1
954,147,27,3,0.133514986,0.866485014,308.9634312,368.0410743,556.7987421,513.3673469,1101,104.3601896,2202,-488448,75264,-413184,-1
3575,2055,19,11,0.365008881,0.634991119,1354.788699,1295.367562,2110.996923,4041.095377,5630,109.5117681,11260,-1830400,1052160,-778240,-1
1734,172,21,9,0.0902413431,0.909758657,546.7119235,558.0217982,969.9100346,788.0639535,1906,90.89175012,3812,-887808,88064,-799744,-1
9009,928,21,9,0.0933883466,0.906611653,2912.1171,2340.118221,4914.531247,5497.78125,9937,299.668275,19874,-4612608,475136,-4137472,-1
9499,464,19,11,0.0465723176,0.953427682,2844.016831,3386.962624,5017.493841,4255.37069,9963,750.2259036,19926,-4863488,237568,-4625920,-1
281,19,21,9,0.0633333333,0.936666667,84.38499404,86.33645452,155.4199288,77.73684211,300,45.38577912,600,-143872,9728,-134144,-1
2070,304,21,9,0.128053917,0.871946083,675.1394838,677.3895904,1231.949275,884.8355263,2374,45.26215443,4748,-1059840,155648,-904192,-1
9522,447,22,8,0.0448390009,0.955160999,2850.320098,3291.265036,5026.10565,4109.36689,9969,658.4544254,19938,-4875264,228864,-4646400,-1
8901,990,19,11,0.100090992,0.899909008,2868.632472,2705.861813,4905.947309,5306.110101,9891,278.0714085,19782,-4557312,506880,-4050432,-1
2703,339,18,12,0.111439842,0.888560158,860.6526702,997.649181,1505.45209,1649.457227,3042,62.08163265,6084,-1383936,173568,-1210368,-1
5506,633,20,10,0.103111256,0.896888744,1757.459556,1881.389308,3044.976389,3287.661927,6139,145.4394693,12278,-2819072,324096,-2494976,-1
9597,383,19,11,0.0383767535,0.961623246,2862.525556,3181.778143,5026.195061,4096.073107,9980,1048.319328,19960,-4913664,196096,-4717568,-1
4184,305,21,9,0.0679438628,0.932056137,1285.531659,1355.498155,2212.924713,2685.009836,4489,99.73339258,8978,-2142208,156160,-1986048,-1
41,14,22,8,0.254545455,0.745454545,14.66557601,18.90470193,28.48780488,26.57142857,55,1.014011799,110,-20992,7168,-13824,-1
7937,414,20,10,0.0495749012,0.950425099,2399.018687,2564.41437,4204.536349,3628.915459,8351,355.8159352,16702,-4063744,211968,-3851776,-1
1262,117,20,10,0.0848440899,0.91515591,392.9232802,443.0822166,696.9667195,614.8547009,1379,39.53555046,2758,-646144,59904,-586240,-1
4045,471,19,11,0.104295837,0.895704163,1294.431553,1345.754533,2224.657849,2549.140127,4516,89.76346651,9032,-2071040,241152,-1829888,-1
9416,541,20,10,0.0543336346,0.945666365,2881.434007,2610.799725,5026.891461,4145.45841,9957,359.588299,19914,-4820992,276992,-4544000,-1
1994,120,22,8,0.0567644276,0.943235572,605.1658619,687.8839774,1060.177031,1013.016667,2114,182.5561313,4228,-1020928,61440,-959488,-1
42,12,22,8,0.222222222,0.777777778,15.77098357,11.54580251,29.88095238,19.16666667,54,4.112718964,108,-21504,6144,-15360,-1
1240,104,21,9,0.0773809524,0.922619048,374.668275,510.2046273,663.9524194,774.4134615,1344,41.57129601,2688,-634880,53248,-581632,-1
7205,502,20,10,0.065135591,0.934864409,2211.308021,2349.308493,3890.329771,3332.573705,7707,192.1945137,15414,-3688960,257024,-3431936,-1
8080,381,20,10,0.0450301383,0.954969862,2431.32796,2554.375378,4266.501856,3478.099738,8461,306.0036166,16922,-4136960,195072,-3941888,-1
8815,1094,18,12,0.110404683,0.889595317,2714.275876,3115.816507,4692.17266,7072.754113,9909,367.2720534,19818,-4513280,560128,-3953152,-1
2349,152,27,3,0.0607756897,0.93922431,717.802325,782.7547336,1248.636441,1287.526316,2501,229.8713235,5002,-1202688,77824,-1124864,-1
7480,630,21,9,0.0776818742,0.922318126,2314.401145,2629.334944,4038.065775,4262.496825,8110,160.9126984,16220,-3829760,322560,-3507200,-1
38,18,20,10,0.321428571,0.678571429,14.77169281,18.74759244,28.81578947,27.83333333,56,5.938494168,112,-19456,9216,-10240,-1
9527,446,27,3,0.044720746,0.955279254,2869.011565,2945.212214,5028.817046,4093.746637,9973,1084.021739,19946,-4877824,228352,-4649472,-1
2499,136,18,12,0.0516129032,0.948387097,748.5846962,955.0540112,1316.07403,1353.389706,2635,131.4214464,5270,-1279488,69632,-1209856,-1
2901,204,25,5,0.0657004831,0.934299517,885.9834251,930.8113776,1583.352637,1121.367647,3105,74.71126083,6210,-1485312,104448,-1380864,-1
145,10,23,7,0.064516129,0.935483871,43.34432886,44.83257744,80.8137931,37.2,155,27.92792793,310,-74240,5120,-69120,-1
7485,1092,21,9,0.127317244,0.872682756,2469.122227,2128.580996,4104.554442,5553.262821,8577,162.2894986,17154,-3832320,559104,-3273216,-1
6536,351,20,10,0.0509655873,0.949034413,1959.264953,2206.513315,3501.399633,2375.156695,6887,430.1686446,13774,-3346432,179712,-3166720,-1
9553,423,20,10,0.0424017642,0.957598236,2872.403092,3021.912368,4973.159112,5334.957447,9976,708.5227273,19952,-4891136,216576,-4674560,-1
7868,330,21,9,0.0402537204,0.95974628,2359.00007,2491.41717,4119.840874,3614.524242,8198,932.6507395,16396,-4028416,168960,-3859456,-1
48,27,19,11,0.36,0.64,23.38710322,17.75028739,39.70833333,34.96296296,75,18.56435644,150,-24576,13824,-10752,-1
4653,231,20,10,0.0472972973,0.952702703,1407.352583,1427.395239,2457.37911,2142.792208,4884,323.4437086,9768,-2382336,118272,-2264064,-1
3631,1432,22,8,0.282836263,0.717163737,1492.415767,1035.505116,2227.213991,3304.819832,5063,105.2598753,10126,-1859072,733184,-1125888,-1
1633,117,21,9,0.0668571429,0.933142857,496.1019436,572.3289738,891.6625842,649.9145299,1750,33.74469726,3500,-836096,59904,-776192,-1
990,76,18,12,0.0712945591,0.928705441,302.247897,342.1868465,544.2575758,393.3684211,1066,64.25557565,2132,-506880,38912,-467968,-1
44,28,16,14,0.388888889,0.611111111,21.81679683,17.64195342,40.06818182,30.89285714,72,3.020134228,144,-22528,14336,-8192,-1
253,45,18,12,0.151006711,0.848993289,83.14732414,69.85216841,161.3833992,82.68888889,298,54.57875458,596,-129536,23040,-106496,-1
4273,454,18,12,0.0960440025,0.903955997,1370.094637,1276.086969,2333.462907,2651.411894,4727,92.12629117,9454,-2187776,232448,-1955328,-1
8632,461,17,13,0.0506983394,0.949301661,2599.95122,2998.981272,4516.685704,5114.62039,9093,195.0032168,18186,-4419584,236032,-4183552,-1
2248,154,18,12,0.064113239,0.935886761,678.2626512,885.3276155,1201.907028,1195.558442,2402,89.76083707,4804,-1150976,78848,-1072128,-1
459,110,25,5,0.193321617,0.806678383,159.0772964,184.2211669,286.167756,280.1272727,569,26.26962142,1138,-235008,56320,-178688,-1
9106,819,22,8,0.0825188917,0.917481108,2858.01769,2750.333985,5053.156271,3960.603175,9925,407.4302135,19850,-4662272,419328,-4242944,-1
9626,361,24,6,0.0361469911,0.963853009,2874.492975,3060.533436,5012.431851,4502.518006,9987,832.25,19974,-4928512,184832,-4743680,-1
58,16,23,7,0.216216216,0.783783784,22.12507012,16.90599006,39.22413793,31.25,74,2.222889757,148,-29696,8192,-21504,-1
1847,142,20,10,0.0713926596,0.92860734,565.7530735,629.8300189,1012.82079,763.2042254,1989,56.25,3978,-945664,72704,-872960,-1
9551,428,21,9,0.0428900691,0.957109931,2863.717029,3118.842791,5027.886609,4144.544393,9979,914.6654445,19958,-4890112,219136,-4670976,-1
733,130,20,10,0.150637312,0.849362688,245.0535994,263.1006112,442.5811733,372.3384615,863,17.57995518,1726,-375296,66560,-308736,-1
589,81,22,8,0.120895522,0.879104478,190.6661488,196.1368403,345.9813243,259.2839506,670,54.03225806,1340,-301568,41472,-260096,-1
1362,59,21,9,0.0415200563,0.958479944,405.8255631,468.3848653,718.5183554,537.440678,1421,93.73350923,2842,-697344,30208,-667136,-1
5068,466,21,9,0.0842067221,0.915793278,1579.213644,1688.497562,2716.660418,3320.407725,5534,312.4788255,11068,-2594816,238592,-2356224,-1
3958,299,27,3,0.0702372563,0.929762744,1213.828778,1409.841969,2136.109904,2034.882943,4257,107.4728604,8514,-2026496,153088,-1873408,-1
5000,395,25,5,0.0732159407,0.926784059,1556.564858,1447.156572,2743.9004,2116.982278,5395,209.5145631,10790,-2560000,202240,-2357760,-1
5268,254,19,11,0.0459978269,0.954002173,1589.030941,1683.561198,2770.792901,2568.76378,5522,114.730937,11044,-2697216,130048,-2567168,-1
453,62,24,6,0.12038835,0.87961165,140.1680242,196.27924,253.0066225,294.483871,515,14.60992908,1030,-231936,31744,-200192,-1
5009,308,22,8,0.0579274027,0.942072597,1533.482388,1477.319051,2688.445997,2180.12013,5317,164.9705244,10634,-2564608,157696,-2406912,-1
3223,294,21,9,0.0835939721,0.916406028,1000.422456,1164.504427,1754.377909,1809.670068,3517,255.7818182,7034,-1650176,150528,-1499648,-1
1795,264,17,13,0.128217581,0.871782419,581.9679696,670.1230025,1038.143175,974.6325758,2059,61.53616258,4118,-919040,135168,-783872,-1
3426,368,19,11,0.0969952557,0.903004744,1103.735447,1012.551169,1895.97373,1911.709239,3794,236.2391034,7588,-1754112,188416,-1565696,-1
131,28,20,10,0.176100629,0.823899371,44.83136503,45.0735227,84.45801527,59.14285714,159,3.294653958,318,-67072,14336,-52736,-1
9440,521,21,9,0.0523039855,0.947696014,2859.357854,3148.258156,4990.838242,4802.740883,9961,1112.960894,19922,-4833280,266752,-4566528,-1
118,41,19,11,0.257861635,0.742138365,45.82025651,40.13026083,86.80508475,60.41463415,159,24.27480916,318,-60416,20992,-39424,-1
122,28,20,10,0.186666667,0.813333333,41.18225953,50.40928152,77.70491803,65.89285714,150,20.13422819,300,-62464,14336,-48128,-1
5289,484,22,8,0.0838385588,0.916161441,1639.13897,1929.182303,2868.482133,3089.357438,5773,360.8125,11546,-2707968,247808,-2460160,-1
9584,400,20,10,0.0400641026,0.959935897,2864.22238,3238.15599,5014.404737,4467.6625,9984,1038.917794,19968,-4907008,204800,-4702208,-1
4694,603,19,11,0.113838022,0.886161978,1480.661278,1852.76082,2624.623775,2838.754561,5297,99.36222097,10594,-2403328,308736,-2094592,-1
889,104,14,16,0.104733132,0.895266868,280.7955574,235.3336937,523.007874,274.6826923,993,133.6473755,1986,-455168,53248,-401920,-1
3467,170,21,9,0.0467418202,0.95325818,1045.720925,1129.35772,1822.696279,1743.617647,3637,113.1963897,7274,-1775104,87040,-1688064,-1
5078,491,20,10,0.0881666367,0.911833363,1572.18761,1860.232878,2735.309374,3298.90835,5569,157.4498162,11138,-2599936,251392,-2348544,-1
97,29,17,13,0.23015873,0.76984127,34.70657103,35.993856,68.89690722,45.44827586,126,23.42007435,252,-49664,14848,-34816,-1
3809,452,17,13,0.106078385,0.893921615,1218.392026,1250.329569,2082.080074,2543.247788,4261,91.93096009,8522,-1950208,231424,-1718784,-1
4509,316,20,10,0.065492228,0.934507772,1383.86707,1505.226701,2424.842315,2244.022152,4825,133.1034483,9650,-2308608,161792,-2146816,-1
9255,668,21,9,0.0673183513,0.932681649,2849.720674,2783.10883,5051.040951,3728.356287,9923,1196.984318,19846,-4738560,342016,-4396544,-1
6172,366,20,10,0.0559804221,0.944019578,1876.010941,1997.006107,3300.75162,2742.491803,6538,179.172376,13076,-3160064,187392,-2972672,-1
2639,401,18,12,0.131907895,0.868092105,866.5353561,946.8303652,1523.06745,1503.603491,3040,97.34229907,6080,-1351168,205312,-1145856,-1
133,27,25,5,0.16875,0.83125,45.08854863,49.85980345,82.69924812,69.66666667,160,31.06796117,320,-68096,13824,-54272,-1
9079,829,19,11,0.0836697618,0.916330238,2838.257271,3076.040256,4980.378786,4671.082027,9908,262.4635762,19816,-4648448,424448,-4224000,-1
4419,454,19,11,0.0931664273,0.906833573,1409.81854,1344.927438,2465.507128,2159.526432,4873,209.5913978,9746,-2262528,232448,-2030080,-1
1456,111,22,8,0.0708359923,0.929164008,448.7580618,488.8662345,790.6284341,697.0540541,1567,197.8535354,3134,-745472,56832,-688640,-1
152,15,21,9,0.0898203593,0.910179641,46.92977271,46.06208371,87.56578947,47.86666667,167,17.67195767,334,-77824,7680,-70144,-1
9009,878,20,10,0.0888034793,0.911196521,2773.758889,3427.717023,4849.216339,5916.558087,9887,688.0306193,19774,-4612608,449536,-4163072,-1
9489,486,27,3,0.0487218045,0.951278195,2881.38923,2832.042614,5000.501212,4743.917695,9975,960.982659,19950,-4858368,248832,-4609536,-1
1354,85,27,3,0.0590687978,0.940931202,411.2369246,461.1584606,727.3973412,602.1647059,1439,201.8232819,2878,-693248,43520,-649728,-1
5278,467,22,8,0.0812880766,0.918711923,1655.187939,1584.688726,2923.949792,2297.169165,5745,362.4605678,11490,-2702336,239104,-2463232,-1
2887,241,20,10,0.0770460358,0.922953964,894.023351,998.5058404,1572.936959,1463.431535,3128,202.8534371,6256,-1478144,123392,-1354752,-1
4891,325,17,13,0.0623082822,0.937691718,1482.528846,1720.259284,2646.636884,2034.569231,5216,201.4677482,10432,-2504192,166400,-2337792,-1
9323,628,19,11,0.0631092353,0.936890765,2841.858163,3021.686466,5061.751689,3702.969745,9951,592.6742108,19902,-4773376,321536,-4451840,-1
9362,585,21,9,0.058811702,0.941188298,2834.969528,3347.64133,4937.117924,5564.239316,9947,899.3670886,19894,-4793344,299520,-4493824,-1
64,28,20,10,0.304347826,0.695652174,27.02382033,25.20697486,47.796875,43.53571429,92,7.70519263,184,-32768,14336,-18432,-1
9433,528,23,7,0.0530067262,0.946993274,2850.999523,3195.690812,5021.829641,4251.556818,9961,511.8705036,19922,-4829696,270336,-4559360,-1
2051,188,21,9,0.0839660563,0.916033944,644.49685,649.8058592,1132.869332,979.6010638,2239,189.1047297,4478,-1050112,96256,-953856,-1
131,32,21,9,0.196319018,0.803680982,43.87357547,57.94973576,80.6259542,87.625,163,9.183098592,326,-67072,16384,-50688,-1
8039,370,16,14,0.0440004757,0.955999524,2400.521123,2935.284094,4219.478293,3890.42973,8409,523.9252336,16818,-4115968,189440,-3926528,-1
6384,301,20,10,0.045026178,0.954973822,1915.169791,2093.286595,3376.694392,2628.365449,6685,373.4636872,13370,-3268608,154112,-3114496,-1
7235,330,17,13,0.0436219432,0.956378057,2175.132291,2221.263622,3819.403594,2984.878788,7565,675.4464286,15130,-3704320,168960,-3535360,-1
4881,514,20,10,0.0952734013,0.904726599,1578.129983,1321.867055,2722.737964,2463.085603,5395,100,10790,-2499072,263168,-2235904,-1
9451,506,20,10,0.0508185196,0.94918148,2852.322524,3119.220392,5028.129404,4061.367589,9957,808.8545898,19914,-4838912,259072,-4579840,-1
2273,378,22,8,0.142587703,0.857412297,758.5280031,786.3330796,1299.696436,1484.169312,2651,65.44063194,5302,-1163776,193536,-970240,-1
5997,480,24,6,0.0741083835,0.925891616,1830.549879,2262.497094,3205.494581,3657.608333,6477,184.3198634,12954,-3070464,245760,-2824704,-1
327,35,19,11,0.0966850829,0.903314917,101.0641441,105.2798564,189.6605505,105.2571429,362,28.17120623,724,-167424,17920,-149504,-1
3526,495,25,5,0.123103706,0.876896294,1159.18982,1146.260175,1978.946682,2239.323232,4021,79.84511517,8042,-1805312,253440,-1551872,-1
9521,445,20,10,0.0446518162,0.955348184,2863.260557,3007.542915,5027.103981,4050.570787,9966,587.9646018,19932,-4874752,227840,-4646912,-1
9280,670,21,9,0.0673366834,0.932663317,2834.202249,3345.284112,4956.803664,5234.458209,9950,1030.020704,19900,-4751360,343040,-4408320,-1
1063,92,22,8,0.0796536797,0.92034632,325.6580229,412.5019093,577.1006585,588.3913043,1155,49.8489426,2310,-544256,47104,-497152,-1
8316,478,21,9,0.0543552422,0.945644758,2498.505352,3128.058601,4420.829606,3991.623431,8794,602.3287671,17588,-4257792,244736,-4013056,-1
2959,150,21,9,0.0482470248,0.951752975,895.2720956,938.2616439,1557.977695,1496.26,3109,63.51378958,6218,-1515008,76800,-1438208,-1
9554,425,22,8,0.0425894378,0.957410562,2866.828139,3045.247251,5029.31233,4106.258824,9979,481.147541,19958,-4891648,217600,-4674048,-1
8354,1012,20,10,0.108050395,0.891949605,2650.477357,3104.152508,4702.696553,4525.033597,9366,178.2302569,18732,-4277248,518144,-3759104,-1
3047,388,25,5,0.112954876,0.887045124,994.6102397,964.3064903,1708.395471,1793.425258,3435,82.67148014,6870,-1560064,198656,-1361408,-1
3887,364,21,9,0.0856269113,0.914373089,1212.924891,1338.036118,2099.672498,2407.14011,4251,139.5600788,8502,-1990144,186368,-1803776,-1
4919,872,21,9,0.150578484,0.849421516,1655.492069,1760.407013,2897.968693,2884.894495,5791,170.5743741,11582,-2518528,446464,-2072064,-1
4038,429,19,11,0.0960376091,0.903962391,1290.457076,1207.418436,2190.904408,2639.641026,4467,161.3217768,8934,-2067456,219648,-1847808,-1
2144,181,19,11,0.0778494624,0.922150538,666.0769519,728.7880918,1162.818563,1165.149171,2325,141.8547895,4650,-1097728,92672,-1005056,-1
5982,582,21,9,0.0886654479,0.911334552,1881.85632,1865.613405,3209.667837,4031.094502,6564,322.0804711,13128,-3062784,297984,-2764800,-1
393,77,20,10,0.163829787,0.836170213,132.4874211,135.5082684,247.3994911,174.7662338,470,36.01532567,940,-201216,39424,-161792,-1
590,62,18,12,0.0950920245,0.904907975,182.5780977,220.7381265,334.6169492,249.2580645,652,87.6344086,1304,-302080,31744,-270336,-1
2346,300,20,10,0.113378685,0.886621315,760.5177227,779.9930591,1308.956095,1437.233333,2646,74.07614782,5292,-1201152,153600,-1047552,-1
5640,758,17,13,0.118474523,0.881525477,1857.316506,1759.384676,3177.693617,3361.753298,6398,198.0804954,12796,-2887680,388096,-2499584,-1
3860,233,19,11,0.0569264598,0.94307354,1176.346909,1234.01406,2063.20285,1778.575107,4093,331.9545823,8186,-1976320,119296,-1857024,-1
2438,178,27,3,0.0680428135,0.931957187,740.6691643,926.3157739,1301.664889,1402.117978,2616,130.5389222,5232,-1248256,91136,-1157120,-1
165,52,17,13,0.239631336,0.760368664,59.87911606,61.57557475,118.5454545,78.71153846,217,30.82386364,434,-84480,26624,-57856,-1
1148,135,24,6,0.105222136,0.894777864,363.8452732,390.8180604,659.6489547,491.9185185,1283,101.6640254,2566,-587776,69120,-518656,-1
9564,413,21,9,0.041395209,0.958604791,2866.002724,3075.196149,5024.76652,4160.74092,9977,608.7248322,19954,-4896768,211456,-4685312,-1
1346,114,20,10,0.0780821918,0.921917808,414.9193176,481.331541,738.872214,631.6491228,1460,50.03427005,2920,-689152,58368,-630784,-1
2377,344,21,9,0.126424109,0.873575891,784.7389355,777.9757833,1380.050063,1229.366279,2721,131.7675545,5442,-1217024,176128,-1040896,-1
9470,486,20,10,0.0488147851,0.951185215,2860.029018,3024.430542,5019.759451,4174.534979,9956,1067.095391,19912,-4848640,248832,-4599808,-1
6588,330,25,5,0.0477016479,0.952298352,1976.633599,2357.414846,3470.517608,3239.548485,6918,551.6746411,13836,-3373056,168960,-3204096,-1
9350,604,20,10,0.060679124,0.939320876,2856.270474,2920.107793,5047.653904,3891.508278,9954,886.3757792,19908,-4787200,309248,-4477952,-1
37,21,19,11,0.362068966,0.637931034,15.80635188,18.18025143,28.67567568,30.95238095,58,1.086142322,116,-18944,10752,-8192,-1
7716,512,22,8,0.0622265435,0.937773456,2360.123449,2440.470877,4170.630378,3268.597656,8228,482.5806452,16456,-3950592,262144,-3688448,-1
920,83,17,13,0.0827517448,0.917248255,279.3129967,355.1466667,514.8728261,359.313253,1003,171.4529915,2006,-471040,42496,-428544,-1
1115,75,21,9,0.0630252101,0.93697479,336.4548822,435.156649,596.1560538,585.7466667,1190,22.91546312,2380,-570880,38400,-532480,-1
8686,1182,22,8,0.119781111,0.880218889,2808.122488,3067.408051,4854.735782,5520.652284,9868,722.9304029,19736,-4447232,605184,-3842048,-1
1078,171,20,10,0.136909528,0.863090472,352.3398972,391.2196042,642.3543599,515.5964912,1249,96.5970611,2498,-551936,87552,-464384,-1
5975,477,20,10,0.0739305642,0.926069436,1857.958377,1867.269937,3192.533891,3651.966457,6452,124.5800348,12904,-3059200,244224,-2814976,-1
8414,1018,21,9,0.10793045,0.89206955,2729.091365,2520.596209,4615.840623,5548.472495,9432,215.4900617,18864,-4307968,521216,-3786752,-1
9392,566,20,10,0.0568387226,0.943161277,2840.263143,3357.597419,5008.69112,4495.113074,9958,951.0983763,19916,-4808704,289792,-4518912,-1
8040,337,21,9,0.040229199,0.959770801,2399.710703,2696.199866,4223.533085,3365.124629,8377,311.7603275,16754,-4116480,172544,-3943936,-1
65,32,16,14,0.329896907,0.670103093,28.61953651,25.45321612,52.24615385,42.40625,97,10.87443946,194,-33280,16384,-16896,-1
8377,839,21,9,0.0910373264,0.908962674,2661.335239,2453.692118,4512.575027,5566.263409,9216,243.6161776,18432,-4289024,429568,-3859456,-1
355,55,24,6,0.134146341,0.865853659,113.9071341,137.701577,211.4732394,166.9454545,410,33.63412633,820,-181760,28160,-153600,-1
3253,172,24,6,0.0502189781,0.949781022,981.8995025,1053.486652,1730.971104,1373.116279,3425,75.09318132,6850,-1665536,88064,-1577472,-1
9530,444,22,8,0.0445157409,0.955484259,2855.931025,3072.216021,5047.25383,3704.945946,9974,1256.171285,19948,-4879360,227328,-4652032,-1
9552,422,20,10,0.042310006,0.957689994,2873.591093,2955.114796,5010.929858,4457.163507,9974,345.3601108,19948,-4890624,216064,-4674560,-1
1233,125,20,10,0.0920471281,0.907952872,378.2737325,487.029667,665.5231144,817.368,1358,90.95780308,2716,-631296,64000,-567296,-1
5917,684,21,9,0.103620664,0.896379336,1891.890789,2013.628,3283.71979,3450.483918,6601,187.3687198,13202,-3029504,350208,-2679296,-1
5491,1315,20,10,0.193211872,0.806788128,1941.227019,1975.067986,3277.619377,3929.135361,6806,129.7369424,13612,-2811392,673280,-2138112,-1
833,56,23,7,0.062992126,0.937007874,250.0163369,266.6649128,458.7442977,240.5535714,889,170.6333973,1778,-426496,28672,-397824,-1
4475,875,20,10,0.163551402,0.836448598,1518.072255,1518.4471,2550.056536,3317.053714,5350,128.1437126,10700,-2291200,448000,-1843200,-1
296,85,16,14,0.223097113,0.776902887,106.0523207,109.8065843,204.8581081,142.7411765,381,27.37068966,762,-151552,43520,-108032,-1
5778,402,20,10,0.0650485437,0.934951456,1761.12755,1869.671446,3152.636552,2197.402985,6180,325.2631579,12360,-2958336,205824,-2752512,-1
49,18,21,9,0.268656716,0.731343284,18.81579529,19.60725489,36.08163265,28.33333333,67,6.957424714,134,-25088,9216,-15872,-1
124,36,22,8,0.225,0.775,44.94033723,49.32735043,82.94354839,72.08333333,160,11.14206128,320,-63488,18432,-45056,-1
2510,137,20,10,0.0517567057,0.948243294,758.1534734,848.6748708,1333.2251,1154.985401,2647,259.2556317,5294,-1285120,70144,-1214976,-1
7851,663,20,10,0.0778717407,0.922128259,2407.823771,2951.993582,4220.807413,4692,8514,382.3080377,17028,-4019712,339456,-3680256,-1
9415,553,21,9,0.0554775281,0.944522472,2847.063521,3351.54768,4977.514817,5103.424955,9968,287.2622478,19936,-4820480,283136,-4537344,-1
8888,986,25,5,0.0998582135,0.900141787,2840.790618,2860.110928,4867.979748,5564.169371,9874,430.8027923,19748,-4550656,504832,-4045824,-1
2433,115,17,13,0.045133438,0.954866562,725.8711469,835.7351809,1291.883272,906.7304348,2548,256.3380282,5096,-1245696,58880,-1186816,-1
9111,696,21,9,0.0709697155,0.929030284,2797.753797,3228.26736,4919.705082,4698.412356,9807,191.3187671,19614,-4664832,356352,-4308480,-1
4725,793,22,8,0.14371149,0.85628851,1577.977291,1626.027043,2694.436614,3147.172762,5518,110.2497502,11036,-2419200,406016,-2013184,-1
459,70,25,5,0.132325142,0.867674858,148.6411139,174.508984,269.2723312,236.9857143,529,43.93687708,1058,-235008,35840,-199168,-1
9107,404,20,10,0.0424771317,0.957522868,2737.475666,2855.887087,4782.934556,4148.839109,9511,636.187291,19022,-4662784,206848,-4455936,-1
1697,203,22,8,0.106842105,0.893157895,538.1697038,538.4926281,987.0530348,644.9310345,1900,53.325849,3800,-868864,103936,-764928,-1
6910,2517,21,9,0.266999045,0.733000955,2471.662804,2482.121884,4030.446599,6590.58085,9427,187.5646637,18854,-3537920,1288704,-2249216,-1
804,41,20,10,0.0485207101,0.95147929,241.0909911,251.8291632,430.5584577,274.7804878,845,88.2045929,1690,-411648,20992,-390656,-1
2265,391,20,10,0.147213855,0.852786145,761.1134288,792.9872378,1313.662252,1414.452685,2656,48.79661951,5312,-1159680,200192,-959488,-1
106,18,16,14,0.14516129,0.85483871,33.60680995,31.91737984,67.83962264,31.05555556,124,13.46362649,248,-54272,9216,-45056,-1
99,31,18,12,0.238461538,0.761538462,35.20327375,42.11005847,69.11111111,53.96774194,130,17.33333333,260,-50688,15872,-34816,-1
8099,570,20,10,0.0657515284,0.934248472,2504.012367,2444.056819,4364.131498,3921.077193,8669,165.6602331,17338,-4146688,291840,-3854848,-1
342,34,20,10,0.0904255319,0.909574468,105.7864496,99.6253362,196.871345,104.2941176,376,60.25641026,752,-175104,17408,-157696,-1
1860,197,20,10,0.0957705396,0.90422946,592.3019448,556.1118182,1053.705376,795.7411168,2057,170.4225352,4114,-952320,100864,-851456,-1
436,52,23,7,0.106557377,0.893442623,134.4297549,186.3185093,244.7270642,242.5961538,488,11.28584644,976,-223232,26624,-196608,-1
9578,401,20,10,0.0401843872,0.959815613,2854.497885,3236.222682,5038.758196,3825.396509,9979,830.1996672,19958,-4903936,205312,-4698624,-1
3769,190,19,11,0.0479919172,0.952008083,1134.243714,1221.327749,2002.211462,1539.394737,3959,223.167982,7918,-1929728,97280,-1832448,-1
2074,304,20,10,0.12783852,0.87216148,680.3137751,723.7401525,1199.023144,1124.529605,2378,48.28426396,4756,-1061888,155648,-906240,-1
43,13,22,8,0.232142857,0.767857143,16.00574532,15.74500954,29.95348837,23.69230769,56,8.484848485,112,-22016,6656,-15360,-1
9572,396,21,9,0.0397271268,0.960272873,2862.409224,3058.090146,5025.520685,3992.959596,9968,728.6549708,19936,-4900864,202752,-4698112,-1
9227,700,19,11,0.0705147577,0.929485242,2849.435955,2869.905805,5044.098949,3908.181429,9927,949.9521531,19854,-4724224,358400,-4365824,-1
6316,706,25,5,0.100541156,0.899458844,2029.44787,2004.267061,3503.353072,3584.383853,7022,190.9189777,14044,-3233792,361472,-2872320,-1
1420,244,18,12,0.146634615,0.853365385,471.0579822,531.2368147,832.0697183,835.0040984,1664,99.28400955,3328,-727040,124928,-602112,-1
675,89,27,3,0.116492147,0.883507853,215.7580624,253.9266804,382.0814815,385.6741573,764,62.41830065,1528,-345600,45568,-300032,-1
154,32,18,12,0.172043011,0.827956989,51.81157071,34.46430162,103.2337662,46.65625,186,23.57414449,372,-78848,16384,-62464,-1
2375,224,20,10,0.086186995,0.913813005,734.3681356,887.1363655,1314.579368,1145.419643,2599,79.26197011,5198,-1216000,114688,-1101312,-1
6850,462,24,6,0.0631838074,0.936816193,2077.68282,2286.453506,3730.463796,2559.850649,7312,137.443609,14624,-3507200,236544,-3270656,-1
8546,1309,21,9,0.132825977,0.867174023,2853.030216,2786.86912,4905.860051,5072.543927,9855,700.9246088,19710,-4375552,670208,-3705344,-1
9368,570,21,9,0.0573556047,0.942644395,2835.636726,3170.833013,5036.604718,3866.62807,9938,601.5738499,19876,-4796416,291840,-4504576,-1
4973,464,21,9,0.0853411808,0.914658819,1551.359019,1752.238092,2721.458476,2692.650862,5437,249.5181276,10874,-2546176,237568,-2308608,-1
4577,395,21,9,0.0794448914,0.920555109,1430.771867,1438.565128,2517.562814,2126.564557,4972,156.9444444,9944,-2343424,202240,-2141184,-1
6475,411,20,10,0.0596863201,0.94031368,1991.086441,1927.513304,3454.36556,3272.321168,6886,487.6770538,13772,-3315200,210432,-3104768,-1
2006,173,25,5,0.0793942175,0.920605782,621.9370768,678.7554399,1106.076271,903.5895954,2179,78.40949982,4358,-1027072,88576,-938496,-1
9022,875,22,8,0.0884106295,0.911589371,2846.441495,2894.142524,4889.819663,5559.2,9897,722.93645,19794,-4619264,448000,-4171264,-1
4121,432,22,8,0.0948824951,0.905117505,1304.864226,1389.079701,2295.563213,2099.918981,4553,152.1216171,9106,-2109952,221184,-1888768,-1
9572,407,16,14,0.0407856499,0.95921435,2866.991539,3131.599297,5014.390932,4416.363636,9979,1143.069874,19958,-4900864,208384,-4692480,-1
1523,266,21,9,0.148686417,0.851313583,524.8062851,462.3792562,903.8798424,844.1578947,1789,37.20108131,3578,-779776,136192,-643584,-1
2446,212,17,13,0.0797592175,0.920240783,763.8578161,725.2274028,1358.727719,992.2783019,2658,355.8232932,5316,-1252352,108544,-1143808,-1
4284,298,25,5,0.0650371017,0.934962898,1305.048108,1508.388147,2316.801587,1927.768456,4582,320.4195804,9164,-2193408,152576,-2040832,-1
2707,195,19,11,0.0671950379,0.932804962,816.6158565,1080.984075,1460.910602,1320.861538,2902,106.2614427,5804,-1385984,99840,-1286144,-1
3430,206,27,3,0.0566556656,0.943344334,1043.998296,1137.017277,1822.611079,1750.048544,3636,108.2465019,7272,-1756160,105472,-1650688,-1
71,18,23,7,0.202247191,0.797752809,25.01615427,28.01438123,45.71830986,42.16666667,89,19.34782609,178,-36352,9216,-27136,-1
45,12,22,8,0.210526316,0.789473684,16.56368182,14.39979745,30.66666667,22.75,57,9.878682842,114,-23040,6144,-16896,-1
8375,365,20,10,0.0417620137,0.958237986,2509.054625,2814.425991,4380.70209,4136.410959,8740,671.2749616,17480,-4288000,186880,-4101120,-1
1729,164,21,9,0.0866349709,0.913365029,537.5934169,622.874716,937.0676692,1051.713415,1893,37.05951449,3786,-885248,83968,-801280,-1
6027,495,21,9,0.0758969641,0.924103036,1875.377225,1955.383413,3242.477352,3493.115152,6522,157.4221579,13044,-3085824,253440,-2832384,-1
6529,462,16,14,0.0660849664,0.933915034,1991.840003,2346.715688,3479.894164,3723.608225,6991,184.7515856,13982,-3342848,236544,-3106304,-1
9516,450,21,9,0.045153522,0.954846478,2871.475661,2961.064843,5002.700925,4577.464444,9966,1148.156682,19932,-4872192,230400,-4641792,-1
7689,1678,22,8,0.179139532,0.820860468,2652.738092,2708.359733,4464.245155,5690.969607,9367,192.5385406,18734,-3936768,859136,-3077632,-1
763,43,27,3,0.0533498759,0.946650124,229.5567061,264.157184,408.9580603,306.6511628,806,131.4845024,1612,-390656,22016,-368640,-1
3951,661,27,3,0.143321769,0.856678231,1231.727354,1617.186538,2178.452037,3071.881997,4612,86.56156156,9224,-2022912,338432,-1684480,-1
368,34,25,5,0.0845771144,0.915422886,112.4928467,137.9290883,206.5271739,147.0882353,402,75.28089888,804,-188416,17408,-171008,-1
3745,272,22,8,0.0677122231,0.932287777,1148.147547,1302.982974,2001.621362,2110.591912,4017,121.6167121,8034,-1917440,139264,-1778176,-1
97,13,20,10,0.118181818,0.881818182,30.563667,26.70593755,59.16494845,28.15384615,110,18.90034364,220,-49664,6656,-43008,-1
2121,159,20,10,0.0697368421,0.930263158,650.2169727,748.3650971,1132.540311,1246.679245,2280,55.19244735,4560,-1085952,81408,-1004544,-1
9254,688,22,8,0.0692013679,0.930798632,2842.448903,3128.161132,5025.610223,4243.686047,9942,781.6037736,19884,-4738048,352256,-4385792,-1
59,16,24,6,0.213333333,0.786666667,22.42342775,17.23368794,39.62711864,32,75,2.163253533,150,-30208,8192,-22016,-1
689,50,27,3,0.0676589986,0.932341001,213.2151843,198.8022495,375.7213353,291.16,739,76.18556701,1478,-352768,25600,-327168,-1
2754,169,20,10,0.057817311,0.942182689,828.5006664,1060.451467,1465.903776,1398.384615,2923,285.7282502,5846,-1410048,86528,-1323520,-1
4839,312,27,3,0.060570763,0.939429237,1475.677549,1645.495171,2566.711511,2720.060897,5151,399.9223602,10302,-2477568,159744,-2317824,-1
4541,245,21,9,0.0511909737,0.948809026,1369.628038,1563.003296,2408.014975,2124.469388,4786,179.2509363,9572,-2324992,125440,-2199552,-1
9503,461,19,11,0.0462665596,0.95373344,2862.927484,3079.466834,5011.681048,4380.965293,9964,1007.482305,19928,-4865536,236032,-4629504,-1
1766,117,24,6,0.0621348911,0.937865109,532.5715675,672.37045,951.5441676,797.9401709,1883,145.4054054,3766,-904192,59904,-844288,-1
9614,371,19,11,0.0371557336,0.962844266,2869.776193,3081.597818,5024.612544,4173.800539,9985,745.7057506,19970,-4922368,189952,-4732416,-1
8529,443,27,3,0.0493758359,0.950624164,2555.847485,2956.184884,4545.382577,3352.844244,8972,410.0548446,17944,-4366848,226816,-4140032,-1
244,59,20,10,0.194719472,0.805280528,86.29645252,86.3457172,158.9877049,123.1016949,303,23.7274863,606,-124928,30208,-94720,-1
9493,494,21,9,0.0494643036,0.950535696,2848.411099,3230.443704,5059.864005,3728.317814,9987,960.2884615,19974,-4860416,252928,-4607488,-1
1323,71,19,11,0.0509325681,0.949067432,395.8325379,463.7298643,708.5623583,491.3661972,1394,129.6744186,2788,-677376,36352,-641024,-1
5996,885,22,8,0.128615027,0.871384973,1982.282646,1913.597926,3354.535857,4026.80678,6881,172.5426279,13762,-3069952,453120,-2616832,-1
2972,387,24,6,0.115212861,0.884787139,944.3537409,1122.069988,1651.757402,1896.891473,3359,117.6120448,6718,-1521664,198144,-1323520,-1
1346,148,27,3,0.0990629183,0.900937082,426.8157442,466.6581214,753.2890045,694.8513514,1494,102.7510316,2988,-689152,75776,-613376,-1
1249,69,20,10,0.0523520486,0.947647951,376.6575698,401.3386281,669.7021617,474.826087,1318,117.7837355,2636,-639488,35328,-604160,-1
9439,525,21,9,0.0526896829,0.947310317,2852.462876,3250.189299,5004.885051,4580.038095,9964,1102.212389,19928,-4832768,268800,-4563968,-1
4179,585,22,8,0.12279597,0.87720403,1347.567312,1491.343166,2323.048337,2807.198291,4764,103.7908497,9528,-2139648,299520,-1840128,-1
3976,238,18,12,0.0564784053,0.943521595,1200.144992,1448.822721,2119.140594,1913.033613,4214,264.0350877,8428,-2035712,121856,-1913856,-1
9406,549,20,10,0.0551481668,0.944851833,2858.594038,3075.117583,5008.643632,4452.983607,9955,1080.890337,19910,-4815872,281088,-4534784,-1
1213,140,26,4,0.103473762,0.896526238,389.1373581,400.8927586,681.3215169,639.5571429,1353,73.65269461,2706,-621056,71680,-549376,-1
1160,176,21,9,0.131736527,0.868263473,383.567961,398.8488846,671.0189655,651.8977273,1336,57.21627409,2672,-593920,90112,-503808,-1
4664,1008,25,5,0.177715092,0.822284908,1436.423992,1622.739131,2502.438036,4382.199405,5672,112.9880478,11344,-2387968,516096,-1871872,-1
9503,464,21,9,0.046553627,0.953446373,2869.768599,2946.972078,5016.734715,4313.573276,9967,1083.369565,19934,-4865536,237568,-4627968,-1
9473,495,18,12,0.0496589085,0.950341091,2869.251396,2919.363444,5026.073789,4188.886869,9968,659.2592593,19936,-4850176,253440,-4596736,-1
3026,234,20,10,0.0717791411,0.928220859,922.9947625,1106.120374,1653.835757,1328.730769,3260,92.71899886,6520,-1549312,119808,-1429504,-1
2100,142,22,8,0.0633363069,0.936663693,642.892371,692.0508779,1131.275714,976.9295775,2242,78.88810697,4484,-1075200,72704,-1002496,-1
120,44,20,10,0.268292683,0.731707317,46.29811611,49.8064228,84.13333333,78.04545455,164,27.10743802,328,-61440,22528,-38912,-1
846,193,22,8,0.185755534,0.814244466,265.5878802,310.7339358,462.3073286,772.8911917,1039,44.51585261,2078,-433152,98816,-334336,-1
2766,251,22,8,0.083195227,0.916804773,859.9273272,982.5531189,1504.215835,1561.721116,3017,127.2995781,6034,-1416192,128512,-1287680,-1
7664,773,17,13,0.0916202442,0.908379756,2434.741746,2397.973567,4173.832724,4666.8163,8437,158.6200414,16874,-3923968,395776,-3528192,-1
1244,166,20,10,0.117730496,0.882269504,399.5891526,458.2801846,708.6800643,681.6686747,1410,64.70858192,2820,-636928,84992,-551936,-1
7346,359,22,8,0.0465931213,0.953406879,2209.206266,2400.047366,3888.422134,3128.178273,7705,472.4095647,15410,-3761152,183808,-3577344,-1
4365,871,22,8,0.166348358,0.833651642,1471.896233,1550.122855,2493.075143,3247.064294,5236,110.1851852,10472,-2234880,445952,-1788928,-1
7917,530,21,9,0.0627441695,0.93725583,2411.266755,2812.568628,4219.959707,4284.35283,8447,215.3199082,16894,-4053504,271360,-3782144,-1
539,130,20,10,0.19431988,0.80568012,189.2299411,207.1423351,329.8719852,356.2615385,669,52.55302435,1338,-275968,66560,-209408,-1
9580,398,21,9,0.0398877531,0.960112247,2865.21811,3215.327003,4999.311065,4753.344221,9978,679.7002725,19956,-4904960,203776,-4701184,-1
9028,379,20,10,0.0402891464,0.959710854,2708.592914,2751.474616,4738.52603,3881.569921,9407,185.1771654,18814,-4622336,194048,-4428288,-1
5732,256,22,8,0.042752171,0.957247829,1717.481889,1844.032299,3023.629449,2342.273438,5988,237.0546318,11976,-2934784,131072,-2803712,-1
9560,419,22,8,0.0419881752,0.958011825,2873.261209,2952.365379,5022.018305,4259.463007,9979,751.9969857,19958,-4894720,214528,-4680192,-1
9306,627,20,10,0.0631229236,0.936877076,2839.622798,3127.484078,5025.13228,4104.194577,9933,990.329013,19866,-4764672,321024,-4443648,-1
1032,106,21,9,0.0931458699,0.90685413,324.0646392,367.5736271,572.6947674,538.3962264,1138,91.40562249,2276,-528384,54272,-474112,-1
2932,324,21,9,0.0995085995,0.9004914,929.7186904,1018.732038,1614.295703,1757.040123,3256,121.2211467,6512,-1501184,165888,-1335296,-1
8747,510,21,9,0.0550934428,0.944906557,2644.819364,2884.699944,4694.176632,3511.156863,9257,530.1832761,18514,-4478464,261120,-4217344,-1
1919,153,20,10,0.0738416988,0.926158301,586.338221,684.3439417,1056.015633,791.7254902,2072,142.5034388,4144,-982528,78336,-904192,-1
9668,319,22,8,0.031941524,0.968058476,2877.423156,3039.923207,5000.803062,4787.818182,9987,522.6059655,19974,-4950016,163328,-4786688,-1
9475,503,20,10,0.050410904,0.949589096,2837.997475,3182.841829,5075.033668,3378.304175,9978,774.0884407,19956,-4851200,257536,-4593664,-1
5382,606,18,12,0.101202405,0.898797595,1724.665292,1745.061631,3021.301375,2756.471947,5988,121.4111922,11976,-2755584,310272,-2445312,-1
9389,556,22,8,0.0559074912,0.944092509,2867.86113,2845.790123,5010.966557,4331.870504,9945,966.4723032,19890,-4807168,284672,-4522496,-1
4886,462,21,9,0.0863874346,0.913612565,1525.628536,1721.548373,2665.151248,2773.37013,5348,117.2035941,10696,-2501632,236544,-2265088,-1
9439,520,21,9,0.0522140777,0.947785922,2855.386667,3153.467609,5011.825193,4402.311538,9959,1075.485961,19918,-4832768,266240,-4566528,-1
2186,157,27,3,0.0670081093,0.932991891,669.1670607,769.5730574,1172.669716,1162.675159,2343,127.1986971,4686,-1119232,80384,-1038848,-1
3659,204,21,9,0.0528086979,0.947191302,1102.899378,1290.914881,1945.786554,1684.720588,3863,204.0676175,7726,-1873408,104448,-1768960,-1
9493,476,27,3,0.0477480189,0.952251981,2876.448027,2852.446251,5011.832614,4449.869748,9969,492.2962963,19938,-4860416,243712,-4616704,-1
9641,347,21,9,0.03474169,0.96525831,2879.16924,2949.989199,5012.881548,4483.789625,9988,991.857001,19976,-4936192,177664,-4758528,-1
5457,691,22,8,0.112394275,0.887605725,1746.12445,1749.29902,2962.181418,3961.507959,6148,117.0378831,12296,-2793984,353792,-2440192,-1
451,103,21,9,0.185920578,0.814079422,154.3280473,158.6688202,296.0487805,196.2815534,554,46.51553317,1108,-230912,52736,-178176,-1
9297,651,21,9,0.0654402895,0.93455971,2838.423522,3212.364847,5028.844036,4198.407066,9948,458.0110497,19896,-4760064,333312,-4426752,-1
1711,553,22,8,0.244257951,0.755742049,590.9621032,655.2668981,995.1952075,1557.325497,2264,54.46235266,4528,-876032,283136,-592896,-1
7559,679,22,8,0.0824229182,0.917577082,2389.329622,2190.946555,4163.327953,3631.583211,8238,160.7101053,16476,-3870208,347648,-3522560,-1
9224,696,19,11,0.0701612903,0.92983871,2821.364655,3347.719403,4991.348873,4551.663793,9920,1218.673219,19840,-4722688,356352,-4366336,-1
5917,867,21,9,0.127800708,0.872199292,1946.657578,1771.238672,3254.964509,4331.136101,6784,164.1025641,13568,-3029504,443904,-2585600,-1
273,17,21,9,0.0586206897,0.94137931,81.49140815,100.9285608,148.6520147,94.88235294,290,18.3312263,580,-139776,8704,-131072,-1
2274,226,22,8,0.0904,0.9096,701.2858945,901.5418265,1249.273527,1262.840708,2500,62.57822278,5000,-1164288,115712,-1048576,-1
2643,203,22,8,0.0713281799,0.92867182,800.316038,1055.286383,1430.954219,1326.448276,2846,197.3647712,5692,-1353216,103936,-1249280,-1
1642,84,20,10,0.0486674392,0.951332561,492.4927254,570.3977577,872.7630938,682.4285714,1726,40.10223048,3452,-840704,43008,-797696,-1
8526,894,27,3,0.0949044586,0.905095541,2694.266923,2937.288961,4735.033427,4476.526846,9420,186.9789599,18840,-4365312,457728,-3907584,-1
40,12,20,10,0.230769231,0.769230769,15.46738504,10.71991915,28.6,19.5,52,9.647495362,104,-20480,6144,-14336,-1
1075,130,16,14,0.107883817,0.892116183,338.9636825,313.1530408,633.9506977,347.0615385,1205,122.0871327,2410,-550400,66560,-483840,-1
1696,158,19,11,0.0852211435,0.914778857,523.6206319,512.4662954,962.6326651,550.3797468,1854,241.40625,3708,-868352,80896,-787456,-1
2731,152,21,9,0.0527228581,0.947277142,818.7292275,1042.582611,1446.448554,1362.072368,2883,52.9185022,5766,-1398272,77824,-1320448,-1
33,22,17,13,0.4,0.6,15.70322796,16.03798435,28.87878788,26.68181818,55,10.33834586,110,-16896,11264,-5632,-1
60,22,21,9,0.268292683,0.731707317,22.50145674,26.51917286,40.86666667,43.22727273,82,2.318348883,164,-30720,11264,-19456,-1
9394,558,19,11,0.0560691318,0.943930868,2857.578497,3054.317928,4939.896317,5592.727599,9952,1009.330629,19904,-4809728,285696,-4524032,-1
2430,520,20,10,0.176271186,0.823728814,764.2069451,939.753871,1337.907819,2118.478846,2950,60.61228683,5900,-1244160,266240,-977920,-1
9277,662,22,8,0.0666062984,0.933393702,2858.725414,2945.332127,5013.226366,4364.243202,9939,720.7396664,19878,-4749824,338944,-4410880,-1
2184,282,21,9,0.114355231,0.885644769,716.2796168,676.1725222,1230.037546,1260.315603,2466,72.04206836,4932,-1118208,144384,-973824,-1
6129,434,20,10,0.066128295,0.933871705,1859.530761,2255.748788,3241.004568,3860.942396,6563,152.6634101,13126,-3138048,222208,-2915840,-1
9578,401,27,3,0.0401843872,0.959815613,2880.600458,2878.19446,4996.686156,4830.299252,9979,738.6380459,19958,-4903936,205312,-4698624,-1
621,92,19,11,0.129032258,0.870967742,200.9727118,233.3282519,361.8808374,324.0543478,713,54.05610311,1426,-317952,47104,-270848,-1
839,109,27,3,0.114978903,0.885021097,269.657366,299.0180253,480.2789035,430.0183486,948,49.81607987,1896,-429568,55808,-373760,-1
5767,277,27,3,0.0458305758,0.954169424,1741.411166,1805.05895,3030.411999,2857.776173,6044,358.056872,12088,-2952704,141824,-2810880,-1
9165,763,16,14,0.0768533441,0.923146656,2808.994467,3289.040767,5054.98156,3877.653997,9928,600.968523,19856,-4692480,390656,-4301824,-1
418,63,21,9,0.130977131,0.869022869,131.5685584,176.6861767,236.2751196,272.3492063,481,57.53588517,962,-214016,32256,-181760,-1
7689,731,16,14,0.0868171021,0.913182898,2430.946973,2421.833935,4225.508779,4052.630643,8420,447.1587892,16840,-3936768,374272,-3562496,-1
8976,939,19,11,0.0947049924,0.905295008,2807.776438,2985.221841,4809.320744,6379.240682,9915,300.8191748,19830,-4595712,480768,-4114944,-1
412,30,19,11,0.0678733032,0.932126697,124.1859388,142.0543753,227.7427184,135.7666667,442,52.80764636,884,-210944,15360,-195584,-1
4428,206,21,9,0.0444540354,0.955545965,1327.882575,1467.673708,2337.792909,1881.300971,4634,86.64921466,9268,-2267136,105472,-2161664,-1
5834,544,21,9,0.0852931954,0.914706805,1825.588426,1894.832873,3246.75917,2575.4375,6378,123.7725597,12756,-2987008,278528,-2708480,-1
9600,381,21,9,0.0381725278,0.961827472,2875.521986,2962.574265,5014.292188,4404.110236,9981,755.5639667,19962,-4915200,195072,-4720128,-1
9579,400,21,9,0.0400841768,0.959915823,2860.752142,3144.168344,5033.945819,3937.6075,9979,567.3109721,19958,-4904448,204800,-4699648,-1
2944,188,26,4,0.0600255428,0.939974457,892.2082066,1061.061399,1576.668139,1407.271277,3132,228.2798834,6264,-1507328,96256,-1411072,-1
4903,330,25,5,0.0630613415,0.936938659,1497.682131,1688.465728,2623.560473,2519.527273,5233,276.439514,10466,-2510336,168960,-2341376,-1
4038,951,22,8,0.190619363,0.809380637,1321.420224,1673.171046,2321.893759,3230.018927,4989,104.7229219,9978,-2067456,486912,-1580544,-1
9434,523,21,9,0.0525258612,0.947474139,2845.898726,3118.04905,5044.516218,3797.202677,9957,1082.282609,19914,-4830208,267776,-4562432,-1
7827,489,22,8,0.0588023088,0.941197691,2382.672247,2594.800847,4197.039351,3541.633947,8316,559.2468056,16632,-4007424,250368,-3757056,-1
9497,476,21,9,0.0477288679,0.952271132,2859.09309,3209.862709,5011.905023,4490.102941,9973,564.7225368,19946,-4862464,243712,-4618752,-1
49,15,22,8,0.234375,0.765625,18.36886615,17.72756799,34.18367347,27,64,4.942084942,128,-25088,7680,-17408,-1
7462,422,22,8,0.0535261289,0.946473871,2269.193161,2367.906027,3960.99598,3615.445498,7884,482.7924066,15768,-3820544,216064,-3604480,-1
9526,458,18,12,0.0458733974,0.954126603,2842.712205,3256.707516,5065.170061,3481.026201,9984,773.3539892,19968,-4877312,234496,-4642816,-1
9257,681,21,9,0.0685248541,0.931475146,2839.961171,3231.115806,4956.741277,5142.932452,9938,957.4181118,19876,-4739584,348672,-4390912,-1
5938,583,22,8,0.0894034657,0.910596534,1852.215777,2166.309583,3258.337487,3288.118353,6521,195.7670369,13042,-3040256,298496,-2741760,-1
5203,644,22,8,0.110141953,0.889858047,1650.80651,1941.181401,2890.794926,3192.270186,5847,148.8922842,11694,-2663936,329728,-2334208,-1
76,11,22,8,0.126436782,0.873563218,24.42279656,19.58832508,46.97368421,23.45454545,87,10.36948749,174,-38912,5632,-33280,-1
157,19,18,12,0.107954545,0.892045455,48.290018,56.63627451,92.82802548,52.73684211,176,15.47933157,352,-80384,9728,-70656,-1
8541,1308,17,13,0.132805361,0.867194639,2816.483782,2978.160231,4861.215783,5341.499235,9849,439.4912985,19698,-4372992,669696,-3703296,-1
4812,623,22,8,0.114627415,0.885372585,1557.341144,1655.748915,2715.555071,2736.88443,5435,134.4964118,10870,-2463744,318976,-2144768,-1
5318,323,21,9,0.0572593512,0.942740649,1605.536493,1966.170422,2824.802181,2758.399381,5641,307.0767556,11282,-2722816,165376,-2557440,-1
9424,537,22,8,0.05391025,0.94608975,2872.616584,2723.15489,5040.256685,3941.083799,9961,823.2231405,19922,-4825088,274944,-4550144,-1
2150,146,17,13,0.0635888502,0.93641115,654.0120074,763.1463825,1159.353953,988.6643836,2296,156.8306011,4592,-1100800,74752,-1026048,-1
1946,156,18,12,0.0742150333,0.925784967,598.9812353,642.6471347,1072.302158,792.0064103,2102,233.2963374,4204,-996352,79872,-916480,-1
9359,595,22,8,0.0597749648,0.940225035,2863.769088,2961.955167,5014.452185,4396.263866,9954,1216.870416,19908,-4791808,304640,-4487168,-1
8879,967,21,9,0.0982124721,0.901787528,2804.851318,2431.309097,5133.142358,2998.562565,9846,199.029715,19692,-4546048,495104,-4050944,-1
66,23,18,12,0.258426966,0.741573034,25.86221171,17.44209973,50.45454545,29.34782609,89,20.27334852,178,-33792,11776,-22016,-1
7797,816,22,8,0.0947405085,0.905259491,2441.402839,2808.631144,4243.2138,4916.48652,8613,172.3634181,17226,-3992064,417792,-3574272,-1
4006,233,22,8,0.0549657938,0.945034206,1220.465536,1207.9845,2143.576136,1714.652361,4239,225.839105,8478,-2051072,119296,-1931776,-1
9557,418,20,10,0.0419047619,0.958095238,2874.924712,2943.09285,5008.816051,4512.069378,9975,1324.701195,19950,-4893184,214016,-4679168,-1
1297,215,21,9,0.142195767,0.857804233,427.1201857,489.0065098,754.7548188,767.027907,1512,67.56032172,3024,-664064,110080,-553984,-1
191,33,19,11,0.147321429,0.852678571,62.6689914,67.80993532,117.6753927,82.54545455,224,19.70096746,448,-97792,16896,-80896,-1
56,24,21,9,0.3,0.7,24.04531755,19.9044593,42.53571429,35.75,80,14.65201465,160,-28672,12288,-16384,-1
9517,457,21,9,0.0458191297,0.95418087,2861.463856,2985.508296,5044.998529,3790.09628,9974,575.2018454,19948,-4872704,233984,-4638720,-1
1919,88,21,9,0.0438465371,0.956153463,574.0971851,653.6840686,1013.081813,805.9545455,2007,187.7455566,4014,-982528,45056,-937472,-1
5711,249,21,9,0.0417785235,0.958221477,1703.989372,2055.550339,2972.872177,3155.449799,5960,324.6187364,11920,-2924032,127488,-2796544,-1
2696,155,21,9,0.0543668888,0.945633111,810.8535952,1005.548891,1432.065282,1320.503226,2851,55.09178744,5702,-1380352,79360,-1300992,-1
6571,264,17,13,0.0386247257,0.961375274,1960.869235,2162.807406,3443.298433,2788.318182,6835,590.7519447,13670,-3364352,135168,-3229184,-1
2987,189,21,9,0.0595088161,0.940491184,907.8446541,952.9982302,1615.356545,1164.05291,3176,238.7969925,6352,-1529344,96768,-1432576,-1
9140,798,21,9,0.0802978466,0.919702153,2818.722837,3389.763966,4975.710394,4898.368421,9938,465.9165495,19876,-4679680,408576,-4271104,-1
3731,266,22,8,0.0665499124,0.933450088,1143.531759,1101.750484,2045.179845,1351.266917,3997,141.037403,7994,-1910272,136192,-1774080,-1
643,88,18,12,0.120383037,0.879616963,199.6713055,263.092628,353.5738725,456.7954545,731,30.68849706,1462,-329216,45056,-284160,-1
290,35,22,8,0.107692308,0.892307692,92.93995709,91.08608173,167.9241379,122.2,325,26.37987013,650,-148480,17920,-130560,-1
9107,832,20,10,0.0837106349,0.916289365,2879.260878,2599.153896,5050.135281,4092.846154,9939,544.0065681,19878,-4662784,425984,-4236800,-1
3991,263,20,10,0.0618241655,0.938175835,1218.95654,1291.78526,2154.28013,1721.114068,4254,102.4073182,8508,-2043392,134656,-1908736,-1
2985,236,20,10,0.0732691711,0.926730829,921.1182013,984.5510143,1634.948744,1308.088983,3221,132.0081967,6442,-1528320,120832,-1407488,-1
114,30,18,12,0.208333333,0.791666667,39.45442415,38.67982535,79.45614035,46.06666667,144,35.55555556,288,-58368,15360,-43008,-1
2461,291,20,10,0.105741279,0.894258721,778.5216567,893.0360359,1400.295408,1175.261168,2752,115.5816884,5504,-1260032,148992,-1111040,-1
1854,184,25,5,0.0902845927,0.909715407,582.4091809,639.0867098,1027.649946,937.3804348,2038,90.81996435,4076,-949248,94208,-855040,-1
1271,76,21,9,0.0564216778,0.943578322,383.6116734,413.8448419,686.6648308,462.1973684,1347,87.24093264,2694,-650752,38912,-611840,-1
1428,281,17,13,0.16442364,0.83557636,474.0406294,578.2433026,866.2773109,797.6903915,1709,48.16798196,3418,-731136,143872,-587264,-1
5308,607,16,14,0.102620456,0.897379544,1686.160964,1846.103161,2917.297852,3313.925865,5915,131.4444444,11830,-2717696,310784,-2406912,-1
5640,379,21,9,0.0629672703,0.93703273,1712.02274,2079.974141,3013.19344,2962.477573,6019,136.2072867,12038,-2887680,194048,-2693632,-1
9446,517,21,9,0.0518920004,0.948108,2867.340918,2830.748839,5039.760534,3926.669246,9963,543.5351882,19926,-4836352,264704,-4571648,-1
490,91,18,12,0.156626506,0.843373494,161.5224772,169.5948154,308.355102,197.5494505,581,58.80566802,1162,-250880,46592,-204288,-1
5866,347,20,10,0.0558506358,0.944149364,1780.690649,1995.139222,3113.425844,2998.371758,6213,387.5857767,12426,-3003392,177664,-2825728,-1
1351,127,21,9,0.0859269283,0.914073072,418.5725522,474.9428911,754.8586232,576.1181102,1478,125.466893,2956,-691712,65024,-626688,-1
61,11,23,7,0.152777778,0.847222222,20.28243203,17.85941426,39,22.63636364,72,11.30298273,144,-31232,5632,-25600,-1
8238,550,25,5,0.0625853437,0.937414656,2505.768352,2698.153258,4315.19058,5582.410909,8788,208.0985082,17576,-4217856,281600,-3936256,-1
1628,190,25,5,0.104510451,0.895489549,519.3228991,564.887473,901.3605651,979.2421053,1818,65.94124048,3636,-833536,97280,-736256,-1
7123,349,23,7,0.0467077088,0.953292291,2156.78257,2160.84221,3737.818897,3709.581662,7472,613.9687757,14944,-3646976,178688,-3468288,-1
443,60,23,7,0.119284294,0.880715706,137.2788986,190.689815,247.5079007,285.1666667,503,14.10544027,1006,-226816,30720,-196096,-1
2992,172,20,10,0.0543615676,0.945638432,905.7956283,1030.591172,1588.560495,1477.075581,3164,192.5745587,6328,-1531904,88064,-1443840,-1
1807,196,22,8,0.0978532202,0.90214678,572.7414999,588.620849,979.9153293,1205.607143,2003,139.0972222,4006,-925184,100352,-824832,-1
3914,440,20,10,0.1010565,0.8989435,1226.868619,1497.33084,2181.047011,2145.947727,4354,81.53558052,8708,-2003968,225280,-1778688,-1
4292,362,21,9,0.0777825526,0.922217447,1322.488275,1561.437618,2313.272134,2496.190608,4654,325.9103641,9308,-2197504,185344,-2012160,-1
76,24,19,11,0.24,0.76,29.52015838,18.42477197,55.81578947,33.66666667,100,19.26782274,200,-38912,12288,-26624,-1
6026,333,18,12,0.0523667243,0.947633276,1815.702029,1878.058442,3238.01394,2130.174174,6359,293.447162,12718,-3085312,170496,-2914816,-1
7672,654,19,11,0.0785491232,0.921450877,2352.072154,2932.850374,4180.814129,3960.389908,8326,152.6585992,16652,-3928064,334848,-3593216,-1
5911,408,21,9,0.0645671784,0.935432822,1813.513942,1668.875581,3230.088141,2144.580882,6319,131.9757728,12638,-3026432,208896,-2817536,-1
3288,281,22,8,0.0787335388,0.921266461,1022.197591,1114.484458,1775.451642,1896.725979,3569,82.29190685,7138,-1683456,143872,-1539584,-1
1681,150,21,9,0.0819224468,0.918077553,520.2645251,576.6168688,934.0249851,714,1831,109.4441124,3662,-860672,76800,-783872,-1
9344,571,21,9,0.0575895108,0.942410489,2846.199264,2956.393156,5015.760167,4012.796848,9915,766.8213457,19830,-4784128,292352,-4491776,-1
415,32,19,11,0.0715883669,0.928411633,125.3034044,138.5700938,231.3421687,128.78125,447,107.9710145,894,-212480,16384,-196096,-1
9281,661,20,10,0.0664856166,0.933514383,2849.463405,2940.014361,5048.223144,3894.242057,9942,619.4392523,19884,-4751872,338432,-4413440,-1
1908,231,22,8,0.10799439,0.89200561,614.990451,621.1711491,1086.46174,934.030303,2139,57.73279352,4278,-976896,118272,-858624,-1
43,11,22,8,0.203703704,0.796296296,15.6044952,13.64121126,29.18604651,20.90909091,54,11.25,108,-22016,5632,-16384,-1
648,105,21,9,0.139442231,0.860557769,210.4536473,253.9364921,381.8333333,347.1714286,753,44.87485101,1506,-331776,53760,-278016,-1
4719,377,18,12,0.0739795918,0.926020408,1448.278895,1653.984349,2509.152787,3041.018568,5096,178.6189975,10192,-2416128,193024,-2223104,-1
2313,222,22,8,0.0875739645,0.912426036,715.6322282,876.1003871,1277.8984,1164.869369,2535,96.79266896,5070,-1184256,113664,-1070592,-1
5106,403,27,3,0.0731530223,0.926846978,1580.559405,1698.225558,2769.596357,2570.064516,5509,185.5506905,11018,-2614272,206336,-2407936,-1
9451,509,20,10,0.0511044177,0.948895582,2860.462551,3058.243337,5016.99545,4302.860511,9960,618.6335404,19920,-4838912,260608,-4578304,-1
2365,223,27,3,0.0861669243,0.913833076,733.9290088,856.9612626,1278.758562,1461.443946,2588,575.1111111,5176,-1210880,114176,-1096704,-1
487,95,22,8,0.163230241,0.836769759,160.872328,195.0122405,299.9240246,248.3157895,582,40.75630252,1164,-249344,48640,-200704,-1
9410,552,19,11,0.0554105601,0.94458944,2839.516731,3019.512859,5074.936876,3388.672101,9962,1214.878049,19924,-4817920,282624,-4535296,-1
999,116,21,9,0.104035874,0.895964126,317.551832,355.9037886,560.965966,532.4568966,1115,96.03789836,2230,-511488,59392,-452096,-1
3289,169,26,4,0.0488721805,0.95112782,984.3933115,1079.016743,1759.834296,1139.147929,3458,63.78896882,6916,-1683968,86528,-1597440,-1
4606,367,22,8,0.073798512,0.926201488,1421.355302,1427.341461,2543.018888,1783.940054,4973,113.3834929,9946,-2358272,187904,-2170368,-1
7497,712,21,9,0.0867340724,0.913265928,2394.57102,2066.936795,4133.3328,3806.669944,8209,178.2240556,16418,-3838464,364544,-3473920,-1
925,129,21,9,0.122390892,0.877609108,301.4682117,323.2219927,525.4562162,542.1550388,1054,43.16134316,2108,-473600,66048,-407552,-1
410,97,17,13,0.191321499,0.808678501,136.6669222,165.8994345,269.7658537,187.3608247,507,20.05537975,1014,-209920,49664,-160256,-1
376,91,25,5,0.194860814,0.805139186,134.7926773,131.7024261,240.3271277,207.8571429,467,41.58504007,934,-192512,46592,-145920,-1
5710,1091,19,11,0.160417586,0.839582414,1911.678947,1839.277853,3185.296322,4529.934922,6801,133.9834515,13602,-2923520,558592,-2364928,-1
3828,158,21,9,0.0396387356,0.960361264,1143.992396,1250.447833,2008.141327,1638.772152,3986,234.4705882,7972,-1959936,80896,-1879040,-1
7279,400,20,10,0.0520901159,0.947909884,2183.955923,2650.006281,3801.549251,4539.7075,7679,279.1348601,15358,-3726848,204800,-3522048,-1
2188,241,18,12,0.0992177851,0.900782215,686.3576276,822.0508635,1220.505941,1165.012448,2429,137.1541502,4858,-1120256,123392,-996864,-1
75,24,18,12,0.242424242,0.757575758,28.46548319,20.65351564,55.64,32.375,99,19.41176471,198,-38400,12288,-26112,-1
3044,349,18,12,0.102858827,0.897141173,968.7331256,1068.097581,1700.540736,1666.117479,3393,193.9965695,6786,-1558528,178688,-1379840,-1
6061,459,21,9,0.070398773,0.929601227,1867.715087,2040.094152,3283.111368,2961.921569,6520,214.544258,13040,-3103232,235008,-2868224,-1
3665,424,22,8,0.103692834,0.896307166,1160.650382,1297.733667,2008.887585,2357.150943,4089,154.1855204,8178,-1876480,217088,-1659392,-1
8704,591,21,9,0.0635825713,0.936417429,2636.341061,3228.281256,4692.167854,3997.514382,9295,402.032872,18590,-4456448,302592,-4153856,-1
9052,875,20,10,0.0881434472,0.911856553,2837.04464,3109.870493,5008.273641,4505.982857,9927,699.577167,19854,-4634624,448000,-4186624,-1
6680,732,21,9,0.0987587696,0.90124123,2107.244566,2414.862116,3712.081587,3655.564208,7412,280.332829,14824,-3420160,374784,-3045376,-1
465,96,16,14,0.171122995,0.828877005,153.6027006,174.0670366,298.511828,196.1770833,561,75.70850202,1122,-238080,49152,-188928,-1
9149,773,21,9,0.0779076799,0.92209232,2854.440161,2920.137568,5008.778118,4401.930142,9922,416.7156657,19844,-4684288,395776,-4288512,-1
2145,162,25,5,0.0702210663,0.929778934,665.6639835,652.9630847,1164.951981,1008.987654,2307,171.9076006,4614,-1098240,82944,-1015296,-1
9495,482,21,9,0.0483111156,0.951688884,2850.0318,3217.078469,5046.344286,3859.365145,9977,1124.802706,19954,-4861440,246784,-4614656,-1
6174,521,21,9,0.0778192681,0.922180732,1921.048761,1922.069565,3409.292193,2621.669866,6695,284.4095157,13390,-3161088,266752,-2894336,-1
3009,205,16,14,0.0637834474,0.936216553,917.6677664,912.0443419,1643.816218,1074.44878,3214,105.3770492,6428,-1540608,104960,-1435648,-1
9158,798,22,8,0.0801526718,0.919847328,2824.430337,3338.466638,4928.374536,5553.749373,9956,755.3869499,19912,-4688896,408576,-4280320,-1
9189,730,23,7,0.0735961286,0.926403871,2879.113731,2580.537422,5008.455327,4350.060274,9919,646.1889251,19838,-4704768,373760,-4331008,-1
1684,156,18,12,0.0847826087,0.915217391,520.0393315,638.5812785,918.3942993,943.2307692,1840,121.3720317,3680,-862208,79872,-782336,-1
2825,324,21,9,0.102889806,0.897110194,903.6777836,954.4413978,1576.143363,1565.030864,3149,80.02541296,6298,-1446400,165888,-1280512,-1
5567,334,21,9,0.0566005762,0.943399424,1693.735989,1838.102872,2966.903359,2685.928144,5901,318.2847896,11802,-2850304,171008,-2679296,-1
6428,388,19,11,0.0569248826,0.943075117,1964.292055,2001.789346,3425.124922,3133.074742,6816,417.9031269,13632,-3291136,198656,-3092480,-1
9339,610,21,9,0.0613126947,0.938687305,2860.674875,3031.213927,4990.081915,4744.098361,9949,798.4751204,19898,-4781568,312320,-4469248,-1
1161,120,27,3,0.093676815,0.906323185,365.1885315,395.9441385,652.0956072,533.65,1281,171.9463087,2562,-594432,61440,-532992,-1
8087,554,27,3,0.0641129499,0.93588705,2487.149169,2461.486547,4376.195004,3515.292419,8641,341.1369917,17282,-4140544,283648,-3856896,-1
9366,590,19,11,0.0592607473,0.940739253,2830.318923,3234.230036,5059.554986,3691.786441,9956,624.5922208,19912,-4795392,302080,-4493312,-1
3198,249,22,8,0.0722367276,0.927763272,979.554056,1169.37023,1733.5,1601.987952,3447,265.767155,6894,-1637376,127488,-1509888,-1
9159,773,20,10,0.0778292388,0.922170761,2802.337411,3540.977617,4981.390108,4790.072445,9932,808.7947883,19864,-4689408,395776,-4293632,-1
9494,476,20,10,0.0477432297,0.95225677,2856.053798,3286.043146,4989.202022,4911.661765,9970,241.6383907,19940,-4860928,243712,-4617216,-1
9664,320,27,3,0.0320512821,0.967948718,2874.864364,3062.711215,5006.705505,4563.49375,9984,1379.005525,19968,-4947968,163840,-4784128,-1
8902,391,20,10,0.0420746799,0.95792532,2669.752913,2933.113979,4664.52067,4248.102302,9293,550.2072232,18586,-4557824,200192,-4357632,-1
4055,288,22,8,0.0663136081,0.933686392,1236.591438,1467.402922,2162.545993,2305.111111,4343,119.1822173,8686,-2076160,147456,-1928704,-1
9198,724,21,9,0.0729691594,0.927030841,2861.139191,2879.862852,4933.614264,5315.772099,9922,507.2597137,19844,-4709376,370688,-4338688,-1
2733,290,18,12,0.0959311942,0.904068806,872.5912238,866.4742089,1523.042078,1407.937931,3023,245.3733766,6046,-1399296,148480,-1250816,-1
5771,261,21,9,0.0432692308,0.956730769,1726.999832,1859.941075,3052.667822,2216.789272,6032,345.2776188,12064,-2954752,133632,-2821120,-1
9129,785,22,8,0.0791809562,0.920819044,2817.928084,3297.774577,4918.671158,5409.052229,9914,734.3703704,19828,-4674048,401920,-4272128,-1
9542,429,21,9,0.0430247718,0.956975228,2863.489763,3149.411017,5008.765458,4479.641026,9971,680.6143345,19942,-4885504,219648,-4665856,-1
6355,791,21,9,0.110691296,0.889308704,2056.685004,2036.717925,3507.935012,4100.257901,7146,163.0762209,14292,-3253760,404992,-2848768,-1
42,17,21,9,0.288135593,0.711864407,16.69482316,17.74365718,30.5952381,28.52941176,59,3.722397476,118,-21504,8704,-12800,-1
5601,393,20,10,0.0655655656,0.934434434,1711.72378,1935.725036,3024.559364,2611.852417,5994,228.6913392,11988,-2867712,201216,-2666496,-1
665,67,21,9,0.0915300546,0.908469945,205.5149195,214.7011268,380.9142857,223.4328358,732,45.63591022,1464,-340480,34304,-306176,-1
448,87,24,6,0.162616822,0.837383178,150.5985157,167.3380816,260.2834821,307.7356322,535,13.96502219,1070,-229376,44544,-184832,-1
39,12,20,10,0.235294118,0.764705882,14.91743659,12.61915431,27.66666667,20.58333333,51,17.5257732,102,-19968,6144,-13824,-1
2471,404,25,5,0.140521739,0.859478261,807.3581162,952.0594766,1423.996358,1523.65099,2875,110.0689127,5750,-1265152,206848,-1058304,-1
3337,375,22,8,0.101023707,0.898976293,1070.807283,1078.208307,1857.57267,1846.954667,3712,108.7287639,7424,-1708544,192000,-1516544,-1
4503,270,19,11,0.0565681961,0.943431804,1354.717114,1687.081087,2405.987342,2070.333333,4773,205.3786575,9546,-2305536,138240,-2167296,-1
4999,659,21,9,0.116472252,0.883527748,1636.599644,1607.970557,2833.264853,2800.940819,5658,109.5874492,11316,-2559488,337408,-2222080,-1
7674,550,18,12,0.0668774319,0.933122568,2344.882687,2741.637914,4126.515637,3916.943636,8224,247.1153846,16448,-3929088,281600,-3647488,-1
9230,688,22,8,0.0693688244,0.930631176,2863.706779,2854.409861,4956.795775,4995.77907,9918,749.0936556,19836,-4725760,352256,-4373504,-1
42,13,23,7,0.236363636,0.763636364,16.23229892,14.35022627,28.80952381,25.38461538,55,2.272727273,110,-21504,6656,-14848,-1
8875,1015,19,11,0.102628918,0.897371082,2830.860374,3055.211245,4959.491268,4823.162562,9890,355.3719008,19780,-4544000,519680,-4024320,-1
325,36,22,8,0.0997229917,0.900277008,100.340233,101.2094302,190.2615385,97.38888889,361,25.4763585,722,-166400,18432,-147968,-1
363,43,17,13,0.10591133,0.89408867,114.1743447,125.3579537,210.5261708,144.1860465,406,26.74571805,812,-185856,22016,-163840,-1
8052,313,27,3,0.0374178123,0.962582188,2403.003568,2631.026031,4206.098112,3588.795527,8365,570.2113156,16730,-4122624,160256,-3962368,-1
4052,186,21,9,0.0438886267,0.956111373,1212.789786,1432.207768,2123.730997,2027.327957,4238,385.9744991,8476,-2074624,95232,-1979392,-1
94,25,23,7,0.210084034,0.789915966,34.66869158,31.76649808,62.22340426,51.64,119,2.309782609,238,-48128,12800,-35328,-1
7929,619,20,10,0.0724145999,0.9275854,2429.512622,2873.200094,4309.975154,3820.085622,8548,218.8428059,17096,-4059648,316928,-3742720,-1
1249,140,21,9,0.100791937,0.899208063,390.0010551,465.7843703,710.4843875,556.8571429,1389,25.70318283,2778,-639488,71680,-567808,-1
2053,142,22,8,0.0646924829,0.935307517,625.2709882,657.1350891,1121.367755,760.1549296,2195,262.8742515,4390,-1051136,72704,-978432,-1
426,97,16,14,0.185468451,0.814531549,141.4608774,174.4513687,275.9107981,200.9072165,523,53.1504065,1046,-218112,49664,-168448,-1
6681,838,21,9,0.111450991,0.888549009,2144.157606,2369.996331,3765.56758,3715.612172,7519,194.8937273,15038,-3420672,429056,-2991616,-1
577,95,17,13,0.141369048,0.858630952,186.1993988,216.3227982,350.8318891,249.4526316,672,58.33333333,1344,-295424,48640,-246784,-1
3772,238,22,8,0.0593516209,0.940648379,1142.23761,1287.157897,2035.648727,1527.680672,4010,146.350365,8020,-1931264,121856,-1809408,-1
3958,594,21,9,0.130492091,0.869507909,1284.785172,1217.338208,2155.179889,3084.892256,4552,90.60509554,9104,-2026496,304128,-1722368,-1
8815,363,20,10,0.0395511005,0.9604489,2639.786164,2772.293543,4620.145207,3845.319559,9178,233.2994408,18356,-4513280,185856,-4327424,-1
1556,276,20,10,0.150655022,0.849344978,516.5394457,576.6741208,893.5546272,1045.858696,1832,100.770077,3664,-796672,141312,-655360,-1
3836,303,22,8,0.0732060884,0.926793912,1177.541885,1390.377596,2061.136079,2182.217822,4139,228.8004422,8278,-1964032,155136,-1808896,-1
2145,164,16,14,0.0710264184,0.928973582,663.3834972,706.6628785,1155.253613,1151.682927,2309,199.3955095,4618,-1098240,83968,-1014272,-1
691,67,26,4,0.0883905013,0.911609499,217.5171642,210.5426133,388.4732272,286.9552239,758,31.49148317,1516,-353792,34304,-319488,-1
40,24,18,12,0.375,0.625,18.53333146,18.27903892,33.375,31.04166667,64,14.84918794,128,-20480,12288,-8192,-1
34,22,17,13,0.392857143,0.607142857,16.41442631,15.4492638,30.08823529,26.04545455,56,18.36065574,112,-17408,11264,-6144,-1
9204,682,20,10,0.0689864455,0.931013555,2842.255365,2880.193245,5004.988049,4113.681818,9886,249.394551,19772,-4712448,349184,-4363264,-1
1003,140,25,5,0.122484689,0.877515311,321.8923229,371.7952026,583.9082752,486.6857143,1143,66.22247972,2286,-513536,71680,-441856,-1
9395,550,16,14,0.055304173,0.944695827,2844.473767,3112.219743,5033.577541,3938.225455,9945,1215.770171,19890,-4810240,281600,-4528640,-1
8380,445,22,8,0.0504249292,0.949575071,2512.973637,2770.408654,4488.178282,2997.283146,8825,196.9866071,17650,-4290560,227840,-4062720,-1
2040,293,22,8,0.12558937,0.87441063,643.1822113,788.8687564,1122.659314,1475.720137,2333,153.8918206,4666,-1044480,150016,-894464,-1
262,22,18,12,0.0774647887,0.922535211,79.22589721,84.11950374,148.1679389,75,284,49.1349481,568,-134144,11264,-122880,-1
235,60,19,11,0.203389831,0.796610169,83.58855408,88.04455312,153.2851064,127.3,295,19.62741184,590,-120320,30720,-89600,-1
7346,1122,20,10,0.132498819,0.867501181,2429.695988,2423.05031,4126.451402,4941.919786,8468,218.3599794,16936,-3761152,574464,-3186688,-1
2724,187,24,6,0.0642390931,0.935760907,833.3275018,890.3968413,1475.264317,1175.379679,2911,109.7248398,5822,-1394688,95744,-1298944,-1
9554,423,21,9,0.0423975143,0.957602486,2856.419042,3127.4557,5043.526376,3757.451537,9977,782.5098039,19954,-4891648,216576,-4675072,-1
1769,171,20,10,0.0881443299,0.91185567,551.4463144,630.9334064,981.5189373,856.5087719,1940,117.5757576,3880,-905728,87552,-818176,-1
6868,313,21,9,0.0435872441,0.956412756,2053.835502,2237.795988,3636.073093,2601.984026,7181,132.125115,14362,-3516416,160256,-3356160,-1
6101,608,22,8,0.0906245342,0.909375466,1909.686653,2027.241706,3433.633175,2565.952303,6709,173.7632738,13418,-3123712,311296,-2812416,-1
2428,135,21,9,0.0526726492,0.947327351,728.3439908,871.9933113,1298.371087,987.562963,2563,173.0587441,5126,-1243136,69120,-1174016,-1
3558,126,22,8,0.0342019544,0.965798046,1059.266827,1155.36755,1850.173131,1625.825397,3684,222.8675136,7368,-1821696,64512,-1757184,-1
4347,332,21,9,0.0709553323,0.929044668,1325.359258,1439.301915,2398.943639,1568.228916,4679,546.6121495,9358,-2225664,169984,-2055680,-1
3291,174,21,9,0.0502164502,0.94978355,989.7297906,1137.082826,1749.606806,1418.902299,3465,233.805668,6930,-1684992,89088,-1595904,-1
5248,310,18,12,0.0557754588,0.944224541,1591.926566,1790.34546,2767.0625,2990.054839,5558,159.1182365,11116,-2686976,158720,-2528256,-1
9393,559,17,13,0.0561696141,0.943830386,2862.786394,3010.743601,4999.855957,4584.044723,9952,789.2149088,19904,-4809216,286208,-4523008,-1
4477,439,22,8,0.0893002441,0.910699756,1403.723536,1547.762218,2435.240116,2695.708428,4916,280.2736602,9832,-2292224,224768,-2067456,-1
9312,627,20,10,0.0630848174,0.936915183,2852.789886,2936.276686,5035.169996,4002.116427,9939,608.2619339,19878,-4767744,321024,-4446720,-1
9269,676,22,8,0.0679738562,0.932026144,2865.663744,2939.813968,4979.771712,4880.149408,9945,819.1927512,19890,-4745728,346112,-4399616,-1
106,41,19,11,0.278911565,0.721088435,40.97487269,43.4609509,78.94339623,61.2195122,147,23.04075235,294,-54272,20992,-33280,-1
2845,174,24,6,0.0576349785,0.942365022,864.6626512,956.7759957,1521.648506,1319.54023,3019,82.03804348,6038,-1456640,89088,-1367552,-1
3875,542,22,8,0.12270772,0.87729228,1260.164419,1359.208425,2180.090581,2415.686347,4417,95.87584111,8834,-1984000,277504,-1706496,-1
2315,186,23,7,0.0743702519,0.925629748,710.7121477,775.7656971,1277.810799,917.3064516,2501,66.81806038,5002,-1185280,95232,-1090048,-1
2484,209,27,3,0.0776086149,0.922391385,779.541194,709.0465116,1367.124799,1107.813397,2693,241.5246637,5386,-1271808,107008,-1164800,-1
3716,318,18,12,0.0788299455,0.921170055,1155.883024,1246.429563,2001.791442,2201.062893,4034,114.2129105,8068,-1902592,162816,-1739776,-1
240,59,19,11,0.197324415,0.802675585,85.32838924,84.78207697,156.7875,122.3898305,299,6.337431115,598,-122880,30208,-92672,-1
1537,88,18,12,0.0541538462,0.945846154,460.9668943,507.6999662,830.1047495,514.25,1625,131.8993506,3250,-786944,45056,-741888,-1
8023,1046,20,10,0.115337964,0.884662036,2582.403062,2829.809166,4598.215879,4050.123327,9069,169.3557423,18138,-4107776,535552,-3572224,-1
5659,726,21,9,0.113703994,0.886296006,1792.697125,2044.572613,3095.767803,3950.902204,6385,185.6104651,12770,-2897408,371712,-2525696,-1
9552,426,26,4,0.0426939266,0.957306073,2871.635728,3067.157615,4995.622487,4852.21831,9978,964.057971,19956,-4890624,218112,-4672512,-1
9418,535,21,9,0.0537526374,0.946247363,2870.775231,2913.669031,4982.311531,4883.497196,9953,429.9352052,19906,-4822016,273920,-4548096,-1
9589,397,22,8,0.0397556579,0.960244342,2870.925248,3019.000326,5030.536448,4098.934509,9986,705.2259887,19972,-4909568,203264,-4706304,-1
7891,439,20,10,0.0527010804,0.94729892,2369.701175,2874.504259,4204.549613,3463.585421,8330,387.9832324,16660,-4040192,224768,-3815424,-1
3169,224,20,10,0.0660182729,0.933981727,969.5600461,1103.479178,1705.39066,1578.294643,3393,152.5629496,6786,-1622528,114688,-1507840,-1
1909,199,19,11,0.094402277,0.905597723,598.6579784,681.1668484,1068.740178,917.8944724,2108,124.8075784,4216,-977408,101888,-875520,-1
7844,338,16,14,0.0413101931,0.958689807,2340.289678,2630.596973,4134.13794,3101.997041,8182,955.8411215,16364,-4016128,173056,-3843072,-1
9312,622,21,9,0.0626132474,0.937386753,2887.601568,2544.639046,4955.641323,5145.036977,9934,472.8224655,19868,-4767744,318464,-4449280,-1
2151,232,27,3,0.0973562736,0.902643726,680.0592063,738.7031492,1208.884705,1035.452586,2383,120.9030949,4766,-1101312,118784,-982528,-1
9400,557,20,10,0.0559405443,0.944059456,2866.256587,2968.72089,5006.699362,4511.54219,9957,951.9120459,19914,-4812800,285184,-4527616,-1
2240,206,20,10,0.0842191333,0.915780867,688.0409141,874.6122091,1215.935714,1305.752427,2446,45.2962963,4892,-1146880,105472,-1041408,-1
5589,358,20,10,0.0601984194,0.939801581,1719.169619,1620.269284,3001.225264,2548.96648,5947,206.9241475,11894,-2861568,183296,-2678272,-1
8049,483,22,8,0.0566104079,0.943389592,2426.869947,2943.767148,4300.619456,3697.913043,8532,268.9785624,17064,-4121088,247296,-3873792,-1
867,114,17,13,0.116207951,0.883792049,278.6680588,297.6584733,503.916955,392.7631579,981,18.19699499,1962,-443904,58368,-385536,-1
629,54,25,5,0.0790629575,0.920937042,192.4828241,242.626942,344.9205087,307.9814815,683,58.27645051,1366,-322048,27648,-294400,-1
9588,391,21,9,0.0391822828,0.960817717,2870.255568,3065.129446,5014.46965,4389.961637,9979,1281.001284,19958,-4909056,200192,-4708864,-1
9421,533,27,3,0.053546313,0.946453687,2837.92408,2947.924318,5075.267594,3249.41651,9954,978.7610619,19908,-4823552,272896,-4550656,-1
972,355,18,12,0.267520723,0.732479277,325.3975923,395.0708182,563.9063786,938.0591549,1327,73.9275766,2654,-497664,181760,-315904,-1
2074,235,22,8,0.10177566,0.89822434,658.8603767,730.1559265,1151.404532,1186.731915,2309,81.3028169,4618,-1061888,120320,-941568,-1
932,131,20,10,0.123236124,0.876763876,305.8210277,308.0713651,540.1040773,474.3435115,1063,82.02160494,2126,-477184,67072,-410112,-1
450,64,16,14,0.124513619,0.875486381,142.3945727,169.0897614,267.5111111,187.109375,514,44.65682016,1028,-230400,32768,-197632,-1
6968,1427,25,5,0.169982132,0.830017868,2445.723499,2213.944991,4074.049082,4803.248774,8395,161.1324376,16790,-3567616,730624,-2836992,-1
1520,284,20,10,0.157427938,0.842572062,513.8660065,555.4458644,897.3230263,930.2077465,1804,49.30308828,3608,-778240,145408,-632832,-1
839,76,26,4,0.0830601093,0.916939891,260.7890585,270.777163,468.9213349,337.4342105,915,132.6086957,1830,-429568,38912,-390656,-1
4494,540,19,11,0.10727056,0.89272944,1442.410631,1524.787223,2541.997997,2313.622222,5034,100.0994233,10068,-2300928,276480,-2024448,-1
1741,91,19,11,0.0496724891,0.950327511,522.9685506,622.7130689,921.677197,817.4505495,1832,90.7379891,3664,-891392,46592,-844800,-1
1426,122,18,12,0.0788113695,0.92118863,434.2687331,526.1127752,793.345021,554.2295082,1548,29.8265896,3096,-730112,62464,-667648,-1
157,35,17,13,0.182291667,0.817708333,51.68229481,69.76674841,96.82802548,95.02857143,192,7.103218646,384,-80384,17920,-62464,-1
9423,537,22,8,0.0539156627,0.946084337,2850.842859,3231.212511,5009.507269,4471.495345,9960,835.5704698,19920,-4824576,274944,-4549632,-1
36,22,17,13,0.379310345,0.620689655,17.17556404,15.54392603,31.33333333,26.5,58,13.33333333,116,-18432,11264,-7168,-1
7069,477,21,9,0.0632122979,0.936787702,2176.027446,2193.314344,3754.577734,4053.922432,7546,238.044164,15092,-3619328,244224,-3375104,-1
1188,255,17,13,0.176715177,0.823284823,410.785224,441.8775287,717.5749158,742.6156863,1443,69.44177093,2886,-608256,130560,-477696,-1
9597,388,21,9,0.0388582874,0.961141713,2861.280797,3196.92441,5034.407732,3968.798969,9985,915.2153987,19970,-4913664,198656,-4715008,-1
9424,532,21,9,0.0534351145,0.946564885,2855.485716,3167.44524,4996.84688,4653.49812,9956,1020.081967,19912,-4825088,272384,-4552704,-1
1509,114,19,11,0.0702402957,0.929759704,454.7512183,559.9920937,831.8409543,549.3684211,1623,234.1991342,3246,-772608,58368,-714240,-1
1617,99,23,7,0.0576923077,0.942307692,487.2549473,590.7230336,868.1966605,700.1212121,1716,91.86295503,3432,-827904,50688,-777216,-1
4214,192,24,6,0.0435769405,0.956423059,1261.860864,1394.511949,2224.93925,1732.953125,4406,198.2006298,8812,-2157568,98304,-2059264,-1
4024,414,21,9,0.0932852636,0.906714736,1279.04595,1301.227733,2217.977883,2234.294686,4438,233.0882353,8876,-2060288,211968,-1848320,-1
8669,418,23,7,0.0459997799,0.95400022,2601.43148,2947.548349,4578.953397,3819.093301,9087,378.625,18174,-4438528,214016,-4224512,-1
7540,586,22,8,0.0721142013,0.927885799,2331.674809,2517.125573,4054.242308,4182.617747,8126,536.369637,16252,-3860480,300032,-3560448,-1
5895,489,19,11,0.0765977444,0.923402256,1841.034052,1706.794681,3252.47447,2469.494888,6384,319.6795193,12768,-3018240,250368,-2767872,-1
94,26,23,7,0.216666667,0.783333333,34.91973756,32.98719942,62.07446809,54.80769231,120,2.407221665,240,-48128,13312,-34816,-1
3460,435,21,9,0.111681643,0.888318357,1116.035147,1129.428691,1904.057514,2297.51954,3895,84.58197611,7790,-1771520,222720,-1548800,-1
7026,396,19,11,0.0533548909,0.946645109,2124.006074,2391.783405,3682.826786,4220.232323,7422,201.465798,14844,-3597312,202752,-3394560,-1
5928,542,17,13,0.0837712519,0.916228748,1831.268856,2226.774935,3229.36724,3302.575646,6470,456.2764457,12940,-3035136,277504,-2757632,-1
219,45,17,13,0.170454545,0.829545455,73.43158603,71.93378299,142.1461187,85.55555556,264,60.96997691,528,-112128,23040,-89088,-1
5057,514,21,9,0.0922635074,0.907736493,1569.636424,1923.863874,2815.224244,2498.476654,5571,194.5860985,11142,-2589184,263168,-2326016,-1
8300,1018,20,10,0.109250912,0.890749088,2695.180071,2644.901496,4649.818193,4738.438114,9318,381.8852459,18636,-4249600,521216,-3728384,-1
9482,472,27,3,0.0474181234,0.952581877,2863.405138,3004.077561,5007.940835,4365.974576,9954,1033.64486,19908,-4854784,241664,-4613120,-1
4571,352,21,9,0.0715011172,0.928498883,1419.24493,1442.142148,2469.445636,2365.3125,4923,405.1851852,9846,-2340352,180224,-2160128,-1
1648,125,20,10,0.0705019741,0.929498026,501.1468383,624.4919905,895.8125,770.816,1773,139.3867925,3546,-843776,64000,-779776,-1
7048,605,22,8,0.0790539658,0.920946034,2154.623746,2706.025016,3779.378263,4381.773554,7653,148.9490074,15306,-3608576,309760,-3298816,-1
1494,156,22,8,0.0945454545,0.905454545,458.9368472,617.5887601,822.2014726,857.0897436,1650,126.3399694,3300,-764928,79872,-685056,-1
37,14,22,8,0.274509804,0.725490196,14.21940155,15.8688824,26.56756757,24.5,51,2.3977433,102,-18944,7168,-11776,-1
2062,472,20,10,0.186266772,0.813733228,662.4917942,727.5454248,1132.721629,1856.298729,2534,99.92113565,5068,-1055744,241664,-814080,-1
3700,354,23,7,0.0873211643,0.912678836,1166.714644,1206.610227,2030.354595,1997.663842,4054,153.0966767,8108,-1894400,181248,-1713152,-1
9656,335,21,9,0.0335301772,0.966469823,2873.6585,3137.30778,5011.901823,4537.647761,9991,1163.096624,19982,-4943872,171520,-4772352,-1
1908,215,21,9,0.101271785,0.898728215,602.0652181,701.1133718,1064.111635,1043.260465,2123,57.89473684,4246,-976896,110080,-866816,-1
7375,547,22,8,0.0690482201,0.93095178,2291.869848,2201.94659,3980.901559,3699.915905,7922,144.5093032,15844,-3776000,280064,-3495936,-1
77,23,17,13,0.23,0.77,26.42371122,33.40907589,53.90909091,39.08695652,100,8.547008547,200,-39424,11776,-27648,-1
9493,478,22,8,0.0479390232,0.952060977,2851.734168,3040.847715,5056.696935,3581.970711,9971,1207.142857,19942,-4860416,244736,-4615680,-1
8935,954,20,10,0.0964708262,0.903529174,2829.806681,3071.011735,4923.706659,5144.429769,9889,778.6614173,19778,-4574720,488448,-4086272,-1
9630,349,19,11,0.0349734442,0.965026556,2870.773268,3067.063156,5014.280997,4320.011461,9979,267.3901393,19958,-4930560,178688,-4751872,-1
5857,408,25,5,0.0651237031,0.934876297,1793.25393,1949.575327,3167.401912,2639.147059,6265,466.4929263,12530,-2998784,208896,-2789888,-1
3342,607,20,10,0.1537098,0.8462902,1037.664376,1174.569142,1796.081688,2960.082372,3949,75.01899696,7898,-1711104,310784,-1400320,-1
2767,279,20,10,0.0915955351,0.908404465,865.8597739,971.5244909,1547.431876,1286.154122,3046,117.879257,6092,-1416704,142848,-1273856,-1
4989,227,19,11,0.0435199387,0.956480061,1492.401909,1620.973155,2640.52255,1904.709251,5216,170.8483459,10432,-2554368,116224,-2438144,-1
5774,268,20,10,0.0443561735,0.955643827,1733.338629,1946.946002,3032.928819,2775.268657,6042,452.245509,12084,-2956288,137216,-2819072,-1
153,27,21,9,0.15,0.85,50.94629914,43.55662634,96.5751634,56.07407407,180,4.984768762,360,-78336,13824,-64512,-1
39,12,20,10,0.235294118,0.764705882,14.91743659,12.61915431,27.66666667,20.58333333,51,11.69724771,102,-19968,6144,-13824,-1
8563,699,21,9,0.075469661,0.924530339,2668.365746,2725.358429,4652.387948,4375.615165,9262,420.2359347,18524,-4384256,357888,-4026368,-1
527,119,22,8,0.184210526,0.815789474,179.0562239,214.5129946,329.2125237,298.2016807,646,60.94339623,1292,-269824,60928,-208896,-1
7390,1134,21,9,0.133036133,0.866963867,2267.244658,3095.965784,4039.803654,5713.757496,8524,360.1182932,17048,-3783680,580608,-3203072,-1
1881,107,17,13,0.0538229376,0.946177062,565.9940576,625.6231881,1011.651781,692.9813084,1988,279.6061885,3976,-963072,54784,-908288,-1
9418,537,21,9,0.0539427423,0.946057258,2844.443598,3126.035959,5044.239541,3816.27933,9955,586.9693396,19910,-4822016,274944,-4547072,-1
1302,169,27,3,0.114887831,0.885112169,422.0837039,443.8399654,735.6497696,738.6982249,1471,108.8823094,2942,-666624,86528,-580096,-1
9353,587,20,10,0.059054326,0.940945674,2857.305047,3002.161357,5005.318721,4415.713799,9940,894.6894689,19880,-4788736,300544,-4488192,-1
115,35,16,14,0.233333333,0.766666667,41.85445662,41.36740312,81.85217391,54.62857143,150,30.06012024,300,-58880,17920,-40960,-1
2463,205,17,13,0.0768365817,0.923163418,755.3897923,912.338201,1348.808364,1162.590244,2668,77.37819026,5336,-1261056,104960,-1156096,-1
9436,531,22,8,0.0532758102,0.94672419,2851.264643,3069.476219,5051.04716,3792.555556,9967,645.1132686,19934,-4831232,271872,-4559360,-1
524,67,27,3,0.113367174,0.886632826,166.4937796,190.0601117,288.5515267,354.2537313,591,29.92405063,1182,-268288,34304,-233984,-1
9279,664,21,9,0.0667806497,0.93321935,2874.213399,2808.555634,4958.844811,5155.835843,9943,497.6476476,19886,-4750848,339968,-4410880,-1
105,41,18,12,0.280821918,0.719178082,40.90413104,42.08410604,78.93333333,59.58536585,146,22.42703533,292,-53760,20992,-32768,-1
6265,467,16,14,0.0693701723,0.930629828,1934.60512,1910.658757,3421.337749,2630.828694,6732,202.9544769,13464,-3207680,239104,-2968576,-1
4017,535,19,11,0.117530756,0.882469244,1240.541355,1681.061583,2206.761016,2800.128972,4552,330.0942712,9104,-2056704,273920,-1782784,-1
2275,179,22,8,0.0729421353,0.927057865,704.2781377,668.7219531,1254.69011,881.9273743,2454,144.9497933,4908,-1164800,91648,-1073152,-1
2049,259,20,10,0.112218371,0.887781629,658.3853843,681.4800944,1184.163982,919.8223938,2308,111.014911,4616,-1049088,132608,-916480,-1
9403,560,22,8,0.0562079695,0.943792031,2856.294291,3124.670868,5019.124003,4358.648214,9963,1188.902148,19926,-4814336,286720,-4527616,-1
1348,122,21,9,0.0829931973,0.917006803,423.5384264,361.4526654,756.2010386,506.7704918,1470,134.9862259,2940,-690176,62464,-627712,-1
9507,466,20,10,0.0467261606,0.953273839,2858.594384,3217.745588,5013.989061,4436.388412,9973,1045.387841,19946,-4867584,238592,-4628992,-1
4604,410,21,9,0.0817710411,0.918228959,1412.993701,1724.39151,2466.826672,2964.231707,5014,98.25592789,10028,-2357248,209920,-2147328,-1
539,94,27,3,0.14849921,0.85150079,177.1011447,200.2624989,328.2671614,252.393617,633,69.10480349,1266,-275968,48128,-227840,-1
4680,296,27,3,0.0594855305,0.940514469,1427.428369,1478.414118,2521.306197,1969.807432,4976,538.5281385,9952,-2396160,151552,-2244608,-1
250,58,21,9,0.188311688,0.811688312,79.27079916,108.8868127,142.98,204.1551724,308,34.64566929,616,-128000,29696,-98304,-1
231,53,21,9,0.186619718,0.813380282,80.61076193,82.46658924,148.6839827,115.5471698,284,20.14184397,568,-118272,27136,-91136,-1
1532,100,22,8,0.0612745098,0.93872549,460.0061395,584.509564,828.9582245,625.64,1632,43.026628,3264,-784384,51200,-733184,-1
4909,510,17,13,0.094113305,0.905886695,1564.013331,1555.02999,2690.582196,2896.905882,5419,103.3765738,10838,-2513408,261120,-2252288,-1
2704,391,20,10,0.126332795,0.873667205,874.7352227,1004.792433,1565.871302,1424.409207,3095,65.46108291,6190,-1384448,200192,-1184256,-1
442,71,17,13,0.138401559,0.861598441,143.2031324,161.0650379,267.3846154,192.3521127,513,59.23787529,1026,-226304,36352,-189952,-1
4445,393,22,8,0.081231914,0.918768086,1365.342223,1650.404829,2381.273341,2851.860051,4838,258.8550027,9676,-2275840,201216,-2074624,-1
9482,492,21,9,0.0493282535,0.950671747,2863.330451,2878.970978,5054.674436,3692.890244,9974,1151.732102,19948,-4854784,251904,-4602880,-1
97,20,20,10,0.170940171,0.829059829,32.74218365,34.82542175,62.03092784,44.3,117,9.77443609,234,-49664,10240,-39424,-1
454,59,23,7,0.115009747,0.884990253,140.4722116,192.2916606,251.7136564,297.6779661,513,14.74985624,1026,-232448,30208,-202240,-1
1253,185,24,6,0.128650904,0.871349096,399.0285754,510.814055,720.8156425,710.5891892,1438,36.35903919,2876,-641536,94720,-546816,-1
6968,378,21,9,0.051456575,0.948543425,2101.725342,2257.14372,3722.83539,2764.058201,7346,664.7963801,14692,-3567616,193536,-3374080,-1
9403,551,18,12,0.0553546313,0.944645369,2839.74782,3070.780415,5060.331809,3563.947368,9954,1446.802326,19908,-4814336,282112,-4532224,-1
9157,771,20,10,0.0776591459,0.922340854,2819.780885,3364.020735,4954.276401,5085.923476,9928,895.2209197,19856,-4688384,394752,-4293632,-1
2871,138,22,8,0.0458624128,0.954137587,863.8560282,962.4648266,1505.018809,1504.608696,3009,90.98881161,6018,-1469952,70656,-1399296,-1
198,17,19,11,0.0790697674,0.920930233,59.46393182,73.5403286,111.7979798,63.76470588,215,24.4596132,430,-101376,8704,-92672,-1
2054,209,18,12,0.0923552806,0.907644719,626.366338,753.5595099,1175.056475,708.8516746,2263,59.19434999,4526,-1051648,107008,-944640,-1
6419,424,20,10,0.0619611282,0.938038872,1974.277512,1990.973445,3417.212962,3494.471698,6843,213.5101404,13686,-3286528,217088,-3069440,-1
3705,483,21,9,0.115329513,0.884670487,1117.954219,1306.182255,1950.452632,3199.459627,4188,100.5522209,8376,-1896960,247296,-1649664,-1
59,16,23,7,0.213333333,0.786666667,22.39179991,16.93542423,39.88135593,31.0625,75,2.226840855,150,-30208,8192,-22016,-1
2148,194,21,9,0.0828351836,0.917164816,670.8669693,726.7455338,1164.460894,1249.438144,2342,81.77374302,4684,-1099776,99328,-1000448,-1
1991,174,18,12,0.080369515,0.919630485,609.2614998,734.2125157,1105.728277,822.9310345,2165,195.9276018,4330,-1019392,89088,-930304,-1
9608,383,21,9,0.0383345011,0.961665499,2872.786824,3049.330762,5027.792777,4198.441253,9991,1429.327611,19982,-4919296,196096,-4723200,-1
60,19,21,9,0.240506329,0.759493671,23.20414235,18.60732885,42.96666667,30.63157895,79,3.167602245,158,-30720,9728,-20992,-1
9412,548,21,9,0.0550200803,0.94497992,2880.704433,2748.240377,5003.852954,4579.408759,9960,626.4150943,19920,-4818944,280576,-4538368,-1
3068,294,25,5,0.0874479477,0.912552052,956.9464247,965.2338176,1730.230769,1172.97619,3362,93.54479688,6724,-1570816,150528,-1420288,-1
4353,290,18,12,0.0624596166,0.937540383,1331.911627,1423.727875,2300.932231,2638.234483,4643,105.8354228,9286,-2228736,148480,-2080256,-1
9538,435,22,8,0.043617768,0.956382232,2865.786857,3113.186238,5009.540784,4492.76092,9973,359.3873874,19946,-4883456,222720,-4660736,-1
9438,521,19,11,0.0523144894,0.947685511,2853.922047,3070.625898,5034.142933,3999.191939,9959,1054.978814,19918,-4832256,266752,-4565504,-1
3186,303,22,8,0.086844368,0.913155632,994.0340069,1060.752826,1782.028876,1355.646865,3489,193.8333333,6978,-1631232,155136,-1476096,-1
9373,571,21,9,0.0574215607,0.942578439,2871.467543,2856.067625,4972.393364,4974.250438,9944,922.4489796,19888,-4798976,292352,-4506624,-1
9414,536,21,9,0.0538693467,0.946130653,2839.436798,3369.796996,4999.843425,4547.945896,9950,873.5733099,19900,-4819968,274432,-4545536,-1
8980,929,17,13,0.0937531537,0.906246846,2861.702875,2790.019713,5011.626726,4407.628633,9909,557.9391892,19818,-4597760,475648,-4122112,-1
6433,320,27,3,0.0473863468,0.952613653,1927.698465,2251.424889,3408.636561,2741.00625,6753,609.4765343,13506,-3293696,163840,-3129856,-1
566,99,21,9,0.14887218,0.85112782,187.092488,204.9658934,344.8674912,265.1515152,665,49.36896808,1330,-289792,50688,-239104,-1
62,20,21,9,0.243902439,0.756097561,22.72747195,26.11106087,42.5483871,38.25,82,19.20374707,164,-31744,10240,-21504,-1
4579,542,22,8,0.105838703,0.894161297,1460.218554,1622.310443,2566.609303,2513.610701,5121,193.3182333,10242,-2344448,277504,-2066944,-1
8924,705,22,8,0.0732163257,0.926783674,2768.08123,2856.900494,4861.709211,4223.747518,9629,396.0921432,19258,-4569088,360960,-4208128,-1
8082,331,27,3,0.0393438726,0.960656127,2420.772747,2533.249744,4232.71851,3579.033233,8413,907.5512406,16826,-4137984,169472,-3968512,-1
3618,217,22,8,0.0565840939,0.943415906,1092.51342,1326.374744,1917.320896,1929.322581,3835,75.19607843,7670,-1852416,111104,-1741312,-1
42,29,20,10,0.408450704,0.591549296,20.3668732,20.3306204,34,38.89655172,71,6.379155436,142,-21504,14848,-6656,-1
4087,216,20,10,0.0501975366,0.949802463,1226.998098,1492.753734,2159.888427,2002.740741,4303,344.24,8606,-2092544,110592,-1981952,-1
6159,672,21,9,0.0983750549,0.901624945,1898.74861,2448.226767,3343.386913,4081.511905,6831,136.0485959,13662,-3153408,344064,-2809344,-1
9105,813,20,10,0.0819721718,0.918027828,2801.695443,3420.592233,4905.997144,5558.692497,9918,595.3181273,19836,-4661760,416256,-4245504,-1
501,46,19,11,0.084095064,0.915904936,151.9671233,153.2139814,286.8842315,133.673913,547,96.47266314,1094,-256512,23552,-232960,-1
3000,196,27,3,0.0613266583,0.938673342,924.1188371,819.5077752,1621.915,1240.107143,3196,171.9203873,6392,-1536000,100352,-1435648,-1
9300,652,19,11,0.0655144695,0.934485531,2870.133936,2900.350516,4994.129247,4725.039877,9952,487.3653281,19904,-4761600,333824,-4427776,-1
1170,92,22,8,0.0729001585,0.927099842,356.0333103,438.3614321,641.1846154,508.3369565,1262,96.04261796,2524,-599040,47104,-551936,-1
5178,334,21,9,0.0605950653,0.939404935,1562.659051,1948.365286,2733.950946,3106.077844,5512,328.4862932,11024,-2651136,171008,-2480128,-1
4801,675,17,13,0.123265157,0.876734843,1552.292468,1480.142853,2610.661737,3647.761481,5476,128.5446009,10952,-2458112,345600,-2112512,-1
2136,217,20,10,0.0922226944,0.907777306,669.4219269,651.9096162,1216.544007,787.7557604,2353,44.39622642,4706,-1093632,111104,-982528,-1
1470,146,20,10,0.0903465347,0.909653465,466.012564,394.8066307,832.8938776,562.890411,1616,134.2192691,3232,-752640,74752,-677888,-1
4223,217,21,9,0.0488738739,0.951126126,1264.257735,1455.256489,2251.800379,1611.368664,4440,81.55767818,8880,-2162176,111104,-2051072,-1
6337,318,18,12,0.0477836213,0.952216379,1913.713377,1990.369044,3354.649834,2796.930818,6655,514.2967543,13310,-3244544,162816,-3081728,-1
3425,227,22,8,0.0621577218,0.937842278,1043.879678,1192.898891,1818.270365,1950.669604,3652,98.17204301,7304,-1753600,116224,-1637376,-1
4496,365,22,8,0.0750874306,0.924912569,1397.397566,1460.583213,2446.158808,2244.276712,4861,571.2103408,9722,-2301952,186880,-2115072,-1
4180,413,20,10,0.0899194426,0.910080557,1337.407077,1173.380403,2271.961722,2550.414044,4593,143.1287005,9186,-2140160,211456,-1928704,-1
4663,447,19,11,0.0874755382,0.912524462,1450.994832,1621.869237,2506.849024,3063.01566,5110,132.3148628,10220,-2387456,228864,-2158592,-1
302,59,19,11,0.163434903,0.836565097,101.2417554,118.2453202,181.1754967,180.1016949,361,10.33495563,722,-154624,30208,-124416,-1
413,96,21,9,0.188605108,0.811394892,138.8481336,166.6671221,242.1694915,310.1979167,509,42.98986486,1018,-211456,49152,-162304,-1
9668,322,21,9,0.0322322322,0.967767768,2876.437267,3076.060409,5007.719797,4628.602484,9990,1038.461538,19980,-4950016,164864,-4785152,-1
